id,label,size,statuses_count,followers_count,friends_count,listed_count,favourites_count,klout_score,klout_score_bucket,kred_influence,kred_outreach,indegree,outdegree,degree,weighted degree,weighted indegree,weighted outdegree,eccentricity,closnesscentrality,betweenesscentrality,eigencentrality,newClusteringCoefficient,clustering,componentnumber,strongcompnum,pageranks,authority,hub,modularity_class,interaction_count,temp_term_score,num_tweets,term_score_distinct_tweets,final_term_score
808387,MichelleBlanc,10,49835,35554,16979,1963,42,65.9842975772,60-69,879,9,30,20,50,50,30,20,6,2.703046535,26160.0924296572,0.0255664282,0.047755102,0.15462185,0,66,2.8729724129291067E-4,1.8573774E-4,1.8208082E-4,390,14,0,200,0,0
956281,ingridrkonopka,10,3494,159,394,7,87,42.7503642181,40-49,685,6,8,30,38,38,8,30,6,2.6488115166,105.6255390381,0.0089713995,0.2091038407,0.4688172,0,66,1.0071960218379318E-4,5.392386E-5,5.4624245E-5,140,12,2,200,2,0.01
1307791,kady,10,130573,27144,3131,1793,40,72.812631238,70-79,969,10,1324,217,1541,1541,1324,217,6,2.2480749916,195564.364197078,1,0.0273599535,0.048092734,0,66,0.0075012887,0.00793879,0.007871961,140,3425,0,200,0,0
1323671,BLOGBloke,10,41619,7033,6094,150,2088,53.3576045388,50-59,783,8,1,2,3,3,1,2,7,3.1295614329,0,0.0015679932,0.1666666667,0.5,0,66,4.689617954764729E-5,1.198308E-5,1.2138721E-5,372,11,0,201,0,0
2183601,dougsymington,10,22795,2239,1121,130,4180,52.7847785255,50-59,729,7,49,44,93,93,49,44,6,2.4609976565,1958.5762525751,0.0773469306,0.0718793829,0.39366516,0,66,2.3720990906718996E-4,2.99577E-4,3.0346803E-4,47,8,1,199,1,0.0050251256
4093441,marcellam,10,7536,2324,2134,90,65,66.1522354509,60-69,743,7,151,154,305,305,151,154,6,2.3086709073,9763.705707339,0.2207432307,0.0810504745,0.23522907,0,66,9.852560215345611E-4,9.107141E-4,9.1647345E-4,390,55,0,201,0,0
5130001,DataBrokers,10,7713,291,276,19,15,41.6521474189,40-49,587,7,1,1,2,2,1,1,8,3.432541011,0,5.14203510396076E-4,0,0,0,66,4.918548551045996E-5,1.198308E-5,1.2138721E-5,47,0,0,202,0,0
5708752,andymckay,10,6339,707,362,64,10,47.9212045473,40-49,718,6,1,2,3,3,1,2,7,3.2313357884,0.0657527674,0.0013080333,0,0,0,66,4.807502566858628E-5,1.198308E-5,1.2138721E-5,372,1,0,200,0,0
5748362,Senturion,10,10214,631,775,31,197,54.0183461108,50-59,748,7,4,8,12,12,4,8,7,3.1660528959,2.9853206695,0.0023686614,0.1893939394,0.3888889,0,66,6.538418947001583E-5,2.99577E-5,3.0346804E-5,140,1,0,200,0,0
5837592,dilip_andrade,10,7160,309,239,9,22,42.0056625437,40-49,642,6,16,18,34,34,16,18,7,2.8704385671,40.7506324687,0.0377751802,0.196969697,0.47578347,0,66,2.577057430978078E-4,1.0185618E-4,1.0317913E-4,140,0,0,200,0,0
6013662,infil00p,10,39867,2008,1384,138,3042,45.7222114044,40-49,770,9,36,19,55,55,36,19,7,2.7927686642,964.0632961027,0.0487040176,0.0831649832,0.17487922,0,66,1.9415180752583173E-4,2.2168698E-4,2.2456635E-4,47,10,0,199,0,0
6034422,Winooski,10,11106,811,406,54,2303,53.6319384951,50-59,742,8,0,0,0,0,0,0,0,0,0,0,0,0,57,147,4.4780486537007367E-5,0,0,48,16,0,201,0,0
6038862,draymaker,10,1887,525,875,9,20,42.170339424,40-49,662,5,41,47,88,88,41,47,7,2.6933377971,4779.682007531,0.0660671384,0.1084117032,0.30107528,0,66,4.35613554422834E-4,2.5164467E-4,2.5491315E-4,140,12,0,200,0,0
6114122,anndouglas,10,33630,13968,10377,1068,16118,,,798,9,172,199,371,371,172,199,7,2.2162705055,35833.0328815927,0.2758591483,0.0465724485,0.19972096,0,66,9.313369090933538E-4,0.0010365364,0.0010499994,390,31,0,200,0,0
6351532,redgirl13,10,10817,654,645,53,525,,,727,7,7,9,16,16,7,9,7,3.3170405089,5406.1374585568,0.0053327859,0.0666666667,0.3472222,0,66,1.5428951632540577E-4,4.793232E-5,4.8554884E-5,372,57,0,200,0,0
6563122,BenWest,10,11642,3952,2426,200,135,68.6827304074,60-69,780,8,218,86,304,304,218,86,7,2.4288583863,9581.3402552413,0.2338797364,0.0761464304,0.15654553,0,66,9.995136242315719E-4,0.0013121472,0.00132919,55,154,0,201,0,0
6634632,saskboy,10,29761,2296,1843,103,9873,63.3853378963,60-69,784,9,281,233,514,514,281,233,6,2.1707398728,38964.0286318159,0.354393906,0.049305603,0.1737426,0,66,9.954857836028388E-4,0.0016896143,0.0017115597,47,160,1,213,1,0.0046948357
7075582,trasie,10,11740,1147,681,72,129,50.0658787157,50-59,701,7,35,40,75,75,35,40,7,2.5537328423,1478.8961490055,0.0599760949,0.1005405405,0.27239057,0,66,2.495679995605151E-4,2.1569544E-4,2.1849698E-4,372,4,13,200,13,0.065
7417792,WernerPatels,10,26870,763,455,47,0,48.8561742337,40-49,740,8,45,33,78,78,45,33,7,2.7094074322,826.769471283,0.0434366433,0.0985680986,0.23224044,0,66,2.9994056535061344E-4,2.7561083E-4,2.791906E-4,372,17,0,203,0,0
7638772,D_V,10,420,112,91,4,0,29.7955957126,20-29,553,3,1,1,2,2,1,1,1,1,0,7.953281450388369E-5,0,0,0,57,6.127222374028747E-4,1.198308E-5,1.2138721E-5,320,2,0,200,0,0
7727422,brashley46,10,8561,244,300,10,48,41.2374981314,40-49,608,7,15,23,38,38,15,23,7,2.6735855373,53.5758646121,0.0223514881,0.1493598862,0.46153846,0,66,1.0152936009594545E-4,9.586464E-5,9.710977E-5,390,1,0,202,0,0
8150292,jjackunrau,10,3703,247,309,17,55,,,665,5,4,7,11,11,4,7,8,3.8536993639,3109.7461667303,4.4382198829289674E-4,0.1090909091,0.45238096,0,66,1.0731040853801889E-4,2.99577E-5,3.0346804E-5,372,11,0,200,0,0
8228752,arenosa,10,1707,319,688,8,111,40.1911964642,40-49,568,5,0,0,0,0,0,0,0,0,0,0,0,0,256,486,4.4780486537007367E-5,0,0,251,0,0,200,0,0
8447542,Forian,10,18137,4615,811,93,21,61.0924975872,60-69,749,7,52,71,123,123,52,71,6,2.4188148644,3616.4038138896,0.0722835148,0.131014261,0.2969491,0,66,4.4089675330796486E-4,3.175516E-4,3.216761E-4,140,48,2,200,2,0.01
8795262,renaudjoly,10,8666,4023,520,423,540,64.648167687,60-69,759,7,10,7,17,17,10,7,2,1.125,24807.9,8.132067806486679E-4,0.0588235294,0.21818182,0,56,8.743283348264202E-4,6.590694E-5,6.069361E-5,320,58,0,200,0,0
8833682,chellenator,10,18497,129,156,8,176,43.2429539851,40-49,756,7,1,1,2,2,1,1,7,3.5286240375,0,6.127778001487688E-4,0,0,0,66,4.857584331375936E-5,1.198308E-5,1.2138721E-5,390,3,1,200,1,0.005
9697172,stevebrister,10,21,36,34,0,1,,,46,0,0,0,0,0,0,0,0,0,0,0,0,0,16,88,4.4780486537007367E-5,0,0,12,0,0,22,0,0
10085872,AntoniaZ,10,34988,9760,4261,810,263,61.1991416066,60-69,882,8,507,332,839,839,507,332,6,2.1315701373,119157.144121285,0.5812432403,0.0358123235,0.124597795,0,66,0.0024905454,0.0030437023,0.003065027,47,215,0,200,0,0
10151752,ceverest,10,26,20,78,0,1,20.9402845018,20-29,523,5,1,7,8,8,1,7,7,3.0662872447,1.1627910215,2.875964514721856E-4,0.125,0.1904762,0,66,4.8588054145079814E-5,1.198308E-5,1.2138721E-5,372,0,0,1,0,0
10206822,neilbakshi,10,8318,882,1125,40,1013,49.2140285948,40-49,705,7,13,24,37,37,13,24,7,2.5199196518,6385.9702077661,0.0231910851,0.0825825826,0.3115942,0,66,1.253190964194543E-4,8.388156E-5,8.497105E-5,390,10,0,201,0,0
10711672,cmkl,10,3782,638,779,47,73,53.8905223685,50-59,677,6,53,94,147,147,53,94,6,2.4435888852,2867.7011274198,0.0820698648,0.0870841487,0.24699011,0,66,3.258550946551255E-4,3.2354315E-4,3.2774548E-4,390,17,2,200,2,0.01
11244852,chadrogers,10,7871,1448,1990,31,5,62.7371826688,60-69,735,7,87,77,164,164,87,77,7,2.7013726147,3214.4696858521,0.1083619353,0.0944186742,0.23079528,0,66,7.349890598639209E-4,5.272555E-4,5.341037E-4,372,31,0,200,0,0
11267302,ajproc,10,88036,2399,1707,131,854,59.7218870682,50-59,796,10,33,20,53,53,33,20,7,2.7114161366,952.5509334702,0.0337921351,0.074383164,0.2579365,0,66,2.320676758822866E-4,2.0371236E-4,2.0635827E-4,372,23,0,200,0,0
11582802,JonSThompson,10,518,265,301,15,31,43.288435468,40-49,612,4,18,14,32,32,18,14,7,2.859390693,91.7250262444,0.0245960364,0.1219758065,0.29347825,0,66,1.4797051668233495E-4,1.1383926E-4,1.1531785E-4,55,19,0,198,0,0
11609972,cwindley,10,58506,4430,4869,167,10443,66.6771041906,60-69,862,10,0,1,1,1,0,1,1,1,0,0,0,0,0,216,4.4780486537007367E-5,0,6.0693606E-6,320,31,0,201,0,0
11627292,JerThis,10,1940,245,253,3,104,54.4477029786,50-59,578,5,0,0,0,0,0,0,0,0,0,0,0,0,254,484,4.4780486537007367E-5,0,0,250,12,0,198,0,0
11698322,hjarche,10,28660,7729,874,862,3939,,,839,8,14,6,20,20,14,6,7,3.0231001004,878.9635397023,0.0111815833,0.0473684211,0.12857144,0,66,1.4803219189020474E-4,8.98731E-5,9.104041E-5,55,29,0,201,0,0
12034642,davidakin,10,51986,17777,3063,1222,122,71.5684308131,70-79,918,8,909,286,1195,1195,909,286,6,2.1831268832,178951.046673382,0.8087527266,0.0320675904,0.069113195,0,66,0.0069428364,0.0054523014,0.005468494,372,1911,17,274,17,0.0620437956
12046772,JProssa,10,14831,1248,934,29,176,45.509516029,40-49,718,7,47,52,99,99,47,52,6,2.4727150988,4070.4632244447,0.0614398946,0.0610183467,0.20442891,0,66,3.558126287885791E-4,2.8759392E-4,2.913293E-4,372,7,0,200,0,0
12987202,acoyne,10,65157,39143,1049,2018,15854,78.3336113616,70-79,962,9,1251,91,1342,1342,1251,91,6,2.4703716103,102782.750754377,0.9063029723,0.0300940975,0.045380842,0,66,0.0073911778,0.007501408,0.007441036,140,2353,0,202,0,0
13075932,Mannzhu,10,3418,514,240,46,15,42.5992097823,40-49,608,6,33,26,59,59,33,26,7,2.6638767995,127.3450847083,0.0444352986,0.1084161309,0.4125178,0,66,1.6901909623462573E-4,2.0371236E-4,2.0635827E-4,390,10,0,200,0,0
13179482,Tigerlily007,10,2371,228,298,3,119,45.6540744553,40-49,637,6,20,45,65,65,20,45,6,2.4984934717,275.6682925812,0.0255206025,0.1103365385,0.3550505,0,66,9.840802926073806E-5,1.2582233E-4,1.2745657E-4,47,38,0,205,0,0
13230662,DianneKnight,10,394,1268,1948,2,6,29.6361403349,20-29,536,4,2,7,9,9,2,7,7,3.0200870439,3.8045985995,0.0067909952,0.2222222222,0.39285713,0,66,6.053091611183764E-5,1.797462E-5,1.8208082E-5,390,0,0,200,0,0
13350372,jedgar,10,19174,18473,229,176,43,66.7005979378,60-69,782,7,11,1,12,12,11,1,7,3.6066287245,0.0192307692,0.0133282506,0.1893939394,0.35454544,0,66,1.0684920708774411E-4,7.189848E-5,7.283233E-5,140,4,0,200,0,0
13699242,sailsmart,10,16473,747,1787,22,63,50.9871892094,50-59,736,8,182,309,491,491,182,309,6,2.1228657516,22424.2875605671,0.2368264261,0.0630533272,0.19272661,0,66,4.8218476229356175E-4,0.0010964518,0.0011046237,47,96,3,210,3,0.0142857143
14049092,erlking,10,6858,456,469,35,196,59.3972383264,50-59,705,7,5,3,8,8,5,3,7,3.1848008035,3.1416425908,0.0047060826,0.1428571429,0.36666667,0,66,6.152580017945455E-5,3.594924E-5,3.6416164E-5,47,4,1,201,1,0.0049751244
14070067,MosesIngram,10,530,2,56,0,0,15.6708586376,10-19,142,3,0,11,11,11,0,11,7,3.0515394913,0,0,0.3909090909,0.59090906,0,481,4.4780486537007367E-5,0,6.0693606E-6,390,0,0,200,0,0
14103001,nofx1337,10,709,203,1075,5,156,23.3728559229,20-29,493,4,3,12,15,15,3,12,7,2.7428858386,0.9823534283,0.0051856434,0.2285714286,0.4679487,0,66,5.00564022920962E-5,2.396616E-5,2.4277442E-5,47,1,0,199,0,0
14103847,garychisholm,10,1156,163,268,6,8,36.6554307053,30-39,560,5,6,13,19,19,6,13,7,2.765651155,78.3752633759,0.0091818783,0.1725146199,0.46703297,0,66,7.141302880969611E-5,4.194078E-5,4.2485524E-5,390,3,1,200,1,0.005
14181214,rabbleca,10,24330,17239,2832,1080,110,65.6267096719,60-69,882,7,788,221,1009,1009,788,221,6,2.2581185136,128005.313785599,0.6539047039,0.037960931,0.07448969,0,66,0.0039247962,0.004727325,0.004728032,390,1018,0,202,0,0
14195066,matness,10,16493,2430,1909,131,7552,,,779,8,90,89,179,179,90,89,7,2.4154670238,6729.7472611808,0.12072721,0.0518799824,0.2051478,0,66,4.4537082150766983E-4,5.452301E-4,5.5231183E-4,390,101,1,200,1,0.005
14231419,RobSilver,10,14599,6406,984,291,13,64.5790432263,60-69,808,8,553,80,633,633,553,80,6,2.6069635085,12998.3201337533,0.5324882625,0.0573594697,0.09593055,0,66,0.0031778453,0.003319313,0.003332079,140,349,0,201,0,0
14241069,klashton27,10,12762,901,393,57,7,56.5942915033,50-59,752,7,15,10,25,25,15,10,7,2.8533645798,107.2359519445,0.0177065701,0.15,0.2904762,0,66,1.992473439556927E-4,9.586464E-5,9.710977E-5,140,11,0,200,0,0
14244309,balleyne,10,4455,1114,644,72,359,44.6925230836,40-49,637,5,18,15,33,33,18,15,7,2.8918647472,6991.4864697904,0.0309161125,0.0899621212,0.3763158,0,66,3.0233822254835407E-4,1.1383926E-4,1.1531785E-4,372,8,0,200,0,0
14258863,Justance,10,5253,184,214,0,870,40.4826655961,40-49,644,6,7,10,17,17,7,10,7,2.9350518915,2.8771032441,0.010333351,0.2242647059,0.37619048,0,66,6.535885245709097E-5,4.793232E-5,4.8554884E-5,140,5,0,201,0,0
14276665,naterotman,10,2197,1352,1187,43,6,52.6945631611,50-59,694,6,265,198,463,463,265,198,6,2.3076665551,11477.3874667768,0.3144539873,0.0807083485,0.20511948,0,66,0.0015077364,0.0015937496,0.0016144499,390,163,6,199,5,0.0301507538
14360480,manuelsagra,10,9424,922,35,70,105,50.7600089978,50-59,730,6,1,1,2,2,1,1,2,1.5,2,7.34391852452689E-5,0,0,45,131,8.284390166388585E-5,1.198308E-5,6.0693606E-6,75,8,0,200,0,0
14363552,alainsaffel,10,17952,2533,1005,212,75,54.1232891801,50-59,735,7,32,33,65,65,32,33,6,2.5892199531,2007.6315641065,0.0301791779,0.0644230769,0.22259136,0,66,2.2439181174704775E-4,1.9772082E-4,2.0028891E-4,372,6,0,200,0,0
14388426,bebeasley,10,18099,530,443,17,22,49.3392989202,40-49,752,7,41,26,67,67,41,26,7,2.9487780382,371.3788436896,0.0427129668,0.1374943464,0.28350168,0,66,2.3285746284112493E-4,2.5164467E-4,2.5491315E-4,372,31,0,200,0,0
14390356,carlena,10,7753,891,689,33,285,53.3213213668,50-59,729,7,96,48,144,144,96,48,6,2.6062939404,836.1872827436,0.1510201532,0.1457362082,0.32706147,0,66,5.533952896855136E-4,5.811794E-4,5.826586E-4,140,58,1,200,1,0.005
14467651,patzaph,10,10242,378,382,20,43,47.8394219812,40-49,739,7,3,2,5,5,3,2,7,3.1389353867,2.6137319381,0.001573248,0.1,0.25,0,66,5.2347543175348286E-5,2.396616E-5,2.4277442E-5,372,5,0,200,0,0
14483082,ntozubod,10,6716,165,1303,4,8,22.442067303,20-29,485,7,9,49,58,58,9,49,7,2.5530632742,305.0867284443,0.014916349,0.1705989111,0.31259426,0,66,6.932561758136213E-5,5.99154E-5,6.069361E-5,140,0,0,200,0,0
14485907,tamtar,10,7602,161,167,7,287,60.6321296613,60-69,705,6,1,1,2,2,1,1,8,4.067626381,0,1.5096752289432534E-4,0,0,0,66,6.57575833059089E-5,1.198308E-5,1.2138721E-5,390,5,0,200,0,0
14522779,rockermom53,10,17344,908,1991,19,1016,58.3730744351,50-59,774,8,5,11,16,16,5,11,7,2.9715433545,89.6165279648,6.707366013635812E-4,0.0333333333,0.10909091,0,66,7.499491801414388E-5,3.594924E-5,3.6416164E-5,47,35,0,201,0,0
14538949,MichelleRempel,10,3137,3934,681,168,37,61.6234413043,60-69,757,6,297,87,384,384,297,87,6,2.5965852025,13793.8190457044,0.261044373,0.0534704091,0.11358998,0,66,0.0023494316,0.0017854789,0.0017965308,372,296,14,200,14,0.07
14560819,amymyoung,10,44319,737,594,112,41,54.1532016304,50-59,775,9,5,5,10,10,5,5,7,3.0070304653,4.2591737058,0.0060172562,0.0666666667,0.6,0,66,6.213639989472136E-5,3.594924E-5,3.6416164E-5,55,7,0,201,0,0
14631451,kulpreetsingh,10,32724,14409,4747,880,1714,62.5532343633,60-69,818,8,131,116,247,247,131,116,6,2.2674924674,24225.3566545426,0.1476546312,0.0362397551,0.14666946,0,66,6.35954810913654E-4,7.9088326E-4,7.9508626E-4,47,22,0,200,0,0
14638851,frankejames,10,20383,8058,6522,634,5566,67.4399247056,60-69,824,8,387,336,723,723,387,336,7,2.1536658855,83583.5658853455,0.4176249409,0.0307295318,0.13632508,0,66,0.0014280388,0.0023247176,0.002354912,47,300,1,199,1,0.0050251256
14678279,stephen_taylor,10,30542,20455,16936,825,23,73.882869792,70-79,893,8,633,626,1259,1259,633,626,6,1.9829260127,690709.847314175,0.5380945566,0.0169703414,0.06348681,0,66,0.0040948985,0.0037986364,0.0038419054,372,594,0,200,0,0
14678965,frederikkau,10,11,5,10,0,3,11.5576855183,10-19,14,1,0,0,0,0,0,0,0,0,0,0,0,0,13,85,4.4780486537007367E-5,0,0,9,0,0,13,0,0
14690573,romeoinottawa,10,25312,1295,914,48,291,60.2686627228,60-69,755,8,62,42,104,104,62,42,6,2.6052895882,1117.040712863,0.108153465,0.0880321135,0.2615694,0,66,6.036934618230773E-4,3.7746702E-4,3.8236973E-4,140,112,1,201,1,0.0049751244
14696380,PatHanlon,10,6619,353,1112,23,3,41.3538190689,40-49,662,7,9,23,32,32,9,23,7,2.7167726816,3681.5429455952,0.0124353114,0.1068548387,0.24833333,0,66,9.366164443498463E-5,5.99154E-5,6.069361E-5,372,0,0,200,0,0
14718629,NoamGoldUtting,10,1185,43,111,1,1,16.034313484,10-19,469,4,9,19,28,28,9,19,7,2.713424841,140.2479603207,0.0188725787,0.1851851852,0.58157897,0,66,1.2505834753984127E-4,5.99154E-5,6.069361E-5,390,2,7,198,7,0.0353535354
14721346,TimGoos,10,6128,720,941,50,25,53.8160121371,50-59,673,7,15,24,39,39,15,24,7,2.7820555742,343.7465050166,0.0116372369,0.0701754386,0.23692308,0,66,1.1555027895969922E-4,9.586464E-5,9.710977E-5,372,3,0,197,0,0
14795481,alexbungle35,10,2094,64,201,4,5,38.7991299808,30-39,579,6,1,4,5,5,1,4,7,3.0525610981,0.7291879983,1.7956815627953587E-4,0.4,0.5,0,66,4.683012808773789E-5,1.198308E-5,1.2138721E-5,390,1,0,200,0,0
14819714,seanmhair,10,16145,485,744,37,1736,44.1184011276,40-49,713,7,54,99,153,153,54,99,7,2.3826581855,2231.8101318676,0.1144417293,0.103629171,0.33754578,0,66,3.1178918600227747E-4,3.295347E-4,3.3381482E-4,47,9,1,204,1,0.0049019608
14826248,MelissaLou5,10,8146,635,1999,8,1,45.3153557489,40-49,717,7,86,259,345,345,86,259,6,2.1573485102,12754.3386176273,0.1305768223,0.08190091,0.20170097,0,66,2.960807886614005E-4,5.21264E-4,5.280344E-4,47,5,0,200,0,0
14860927,BCLaraby,10,21011,1039,476,44,3646,53.3871106516,50-59,786,8,254,100,354,354,254,100,7,2.4054235018,7422.7138678901,0.2803150425,0.0845457019,0.20990777,0,66,7.028964901170916E-4,0.0015278427,0.001547687,47,154,1,200,1,0.005
14861810,stevesanterre,10,15436,1353,1658,18,457,54.1497992734,50-59,771,8,71,92,163,163,71,92,6,2.4047539337,12996.1120205763,0.0707640947,0.0368855563,0.16677631,0,66,2.663961423306277E-4,4.313909E-4,4.3699396E-4,390,113,0,202,0,0
14862531,DerfVader,10,1287,135,579,1,135,22.0937866908,20-29,469,5,5,13,18,18,5,13,7,2.7700033478,2.4232692288,0.014915204,0.2026143791,0.61538464,0,66,7.373707279410766E-5,3.594924E-5,3.6416164E-5,140,0,0,200,0,0
14871120,indigosky9,10,1526,76,188,1,2,20.4183649103,20-29,424,6,10,21,31,31,10,21,7,2.666889856,74.158970671,0.0116504671,0.1612903226,0.34,0,66,7.862491543886517E-5,6.590694E-5,6.6762965E-5,47,0,1,199,1,0.0050251256
14884259,masonsherry,10,1414,395,543,34,16,48.6815728096,40-49,639,5,13,47,60,60,13,47,7,2.6454636759,1051.5463072007,0.0172673474,0.2271186441,0.41579315,0,66,7.813340437685252E-5,8.388156E-5,8.497105E-5,140,25,0,200,0,0
14950403,mjecclestone,10,9742,575,458,53,59,50.3519014179,50-59,722,7,18,8,26,26,18,8,7,3.166722464,1760.4332092207,0.0170990177,0.0861538462,0.23684211,0,66,2.6959108036295985E-4,1.1383926E-4,1.1531785E-4,372,88,0,201,0,0
14954158,Aprila,10,2352,53,102,0,11,44.4364416407,40-49,664,5,0,2,2,2,0,2,7,3.1726907631,0,0,0.5,1,0,401,4.4780486537007367E-5,0,6.0693606E-6,55,1,0,200,0,0
14988819,ratsamy,10,10031,458,309,23,15,48.204308331,40-49,683,7,8,18,26,26,8,18,7,2.7254770673,10.8323960838,0.0114111055,0.2923076923,0.49166667,0,66,6.581185647123467E-5,5.392386E-5,5.4624245E-5,140,3,0,201,0,0
14997147,DavidGrant,10,47,34,79,0,1,22.5928156804,20-29,437,2,0,2,2,2,0,2,7,3.2235609103,0,0,0,0,0,517,4.4780486537007367E-5,0,6.0693606E-6,140,0,0,48,0,0
15031337,Geoff_Sharpe,10,9222,1829,1960,79,112,67.7501788895,60-69,761,7,118,132,250,250,118,132,6,2.3833277536,9630.8644691453,0.1148622434,0.0815100402,0.2034583,0,66,5.100837491066581E-4,7.1299326E-4,7.222539E-4,140,72,0,201,0,0
15049217,CanadaGood,10,3503,206,259,8,201,42.4927436812,40-49,585,5,9,8,17,17,9,8,7,3.1935051892,65.8566076878,0.0118265401,0.1213235294,0.19166666,0,66,1.2045151599800823E-4,5.99154E-5,6.069361E-5,55,10,3,200,3,0.015
15066876,JimHarris,10,17386,13252,8256,611,45,73.0144682935,70-79,789,8,244,217,461,461,244,217,6,2.1446267158,127766.232067737,0.2837631299,0.0255210789,0.13866757,0,66,0.0011086382,0.0014679272,0.0014869934,47,81,0,200,0,0
15077420,TonyDaws,10,151,36,61,2,3,17.2540313491,10-19,312,2,0,0,0,0,0,0,0,0,0,0,0,0,270,509,4.4780486537007367E-5,0,0,268,0,0,152,0,0
15142813,BFSingh,10,11289,1904,989,118,42,64.337621702,60-69,749,7,47,29,76,76,47,29,7,2.6605289588,1152.9913705527,0.0551789855,0.0661403509,0.20065312,0,66,3.1610844525774257E-4,2.8759392E-4,2.913293E-4,372,19,0,200,0,0
15152494,cheriak,10,1160,272,537,6,26,42.1567935276,40-49,558,5,8,16,24,24,8,16,6,2.5547371945,26.1761077551,0.0203766046,0.1358695652,0.525,0,66,7.510849402671351E-5,5.392386E-5,5.4624245E-5,47,2,0,200,0,0
15156469,techberry,10,8342,429,409,35,26,46.8636607079,40-49,684,6,3,4,7,7,3,4,7,3.2356879813,5.4324610057,0.0017662181,0.0238095238,0.1,0,66,6.227689053834909E-5,2.396616E-5,2.4277442E-5,55,0,0,200,0,0
15206059,janfromthebruce,10,3006,298,576,7,40,44.894271974,40-49,616,6,75,130,205,205,75,130,6,2.3327753599,4117.9671097173,0.1064425427,0.0794356767,0.28302994,0,66,3.1838697975410406E-4,4.5535705E-4,4.612714E-4,390,33,1,201,1,0.0049751244
15215453,ReynoldR,10,1262,104,344,0,12,33.0373065452,30-39,578,5,20,36,56,56,20,36,6,2.4934717107,1251.681063799,0.0361731336,0.211038961,0.4091312,0,66,1.0592839358303633E-4,1.2582233E-4,1.2745657E-4,390,3,1,199,1,0.0050251256
15223577,Johnny222,10,1709,232,294,3,26,40.937518047,40-49,599,5,25,36,61,61,25,36,7,2.6839638433,280.9751767251,0.0224241855,0.1275956284,0.3212121,0,66,1.4938229689932873E-4,1.5578004E-4,1.5780337E-4,390,13,1,200,1,0.005
15254148,mode23,10,21234,808,725,24,1,51.5736796839,50-59,754,8,155,192,347,347,155,192,6,2.2289923,8189.0735988088,0.1952208625,0.063842015,0.25940064,0,66,4.2940926167006567E-4,9.346802E-4,9.4682025E-4,47,104,7,216,5,0.0324074074
15264238,polarlawyer,10,130,185,235,10,1,34.2237786445,30-39,523,3,15,23,38,38,15,23,7,2.885169066,187.2849190332,0.0106471054,0.1145092461,0.2936508,0,66,1.2578735217963347E-4,9.586464E-5,9.710977E-5,47,1,0,132,0,0
15278776,jimbobbysez,10,29181,2366,2062,136,3,50.9616830374,50-59,838,9,442,470,912,912,442,470,6,2.0535654503,95929.0801918118,0.5152901524,0.032453011,0.1371998,0,66,0.0014799716,0.002654252,0.0026826574,47,256,4,211,4,0.018957346
15285969,JCookie6201,10,1679,61,118,0,121,20.8876007147,20-29,543,3,2,2,4,4,2,2,1,1,0,1.529712617250445E-4,0.0833333333,1,218,414,2.985240256774393E-4,1.797462E-5,1.8208082E-5,213,1,0,200,0,0
15315875,diije,10,11561,1049,324,84,1,58.4149883382,50-59,749,8,4,3,7,7,4,3,2,1.625,0,3.40790399913428E-4,0.1428571429,0.9166667,0,56,4.931171092423478E-4,2.99577E-5,3.0346804E-5,320,1,0,201,0,0
15331235,claudlemire,10,23769,1165,1626,20,1683,54.2426620811,50-59,765,8,87,106,193,193,87,106,6,2.4439236692,4053.6888808634,0.0650776093,0.0787996546,0.24168375,0,66,4.535835052354686E-4,5.272555E-4,5.341037E-4,372,77,2,200,2,0.01
15338360,nomad411,10,24847,1299,1968,48,147,66.576499175,60-69,718,8,7,10,17,17,7,10,7,2.901238701,209.0307459936,0.0192046959,0.1102941176,0.44545454,0,66,1.6049799266591955E-4,4.793232E-5,4.8554884E-5,140,2,0,201,0,0
15395122,stint,10,2507,327,441,9,54,50.1915541003,50-59,659,6,26,39,65,65,26,39,6,2.677268162,730.7902074984,0.0300125325,0.0896634615,0.26280195,0,66,1.6985475537362223E-4,1.6177158E-4,1.6387274E-4,372,1,2,200,2,0.01
15395708,ryanbaldwin,10,10486,569,282,34,63,46.2179295451,40-49,727,7,3,4,7,7,3,4,7,3.0917308336,13.7711182925,0.0038434594,0.1428571429,0.3,0,66,5.637974640122858E-5,2.396616E-5,2.4277442E-5,390,2,0,200,0,0
15397836,ShireenJ,10,27556,1023,771,65,449,47.8074838703,40-49,750,8,28,29,57,57,28,29,7,2.7020421828,827.2975960521,0.052438068,0.1187343358,0.29016912,0,66,2.512491303328712E-4,1.7375466E-4,1.7601145E-4,140,19,0,202,0,0
15419003,lexinc,10,1054,72,284,3,35,42.3998625657,40-49,548,5,19,54,73,73,19,54,7,2.4683629059,539.5012554333,0.0220842317,0.1113013699,0.2855219,0,66,1.0554720828052856E-4,1.198308E-4,1.2138722E-4,47,15,0,200,0,0
15427232,CandiceKei,10,21778,981,1999,33,58,55.6915062537,50-59,690,6,26,51,77,77,26,51,6,2.760629394,1343.4586177637,0.0122008822,0.1262816131,0.30520266,0,66,1.356567573910933E-4,1.6177158E-4,1.6387274E-4,372,30,5,200,5,0.025
15432179,raulpacheco,10,19939,3809,2178,290,1480,62.6055397056,60-69,775,8,36,24,60,60,36,24,7,2.8885169066,3442.1507896283,0.0357149876,0.0330508475,0.13663663,0,66,2.2851691594287925E-4,2.2168698E-4,2.2456635E-4,55,40,0,201,0,0
15443546,RickZaleski,10,7036,1012,1511,21,0,35.9108625769,30-39,570,5,4,9,13,13,4,9,7,2.8915299632,13.6802016335,0.0049934342,0.1730769231,0.4,0,66,5.6615237402784754E-5,2.99577E-5,3.0346804E-5,55,0,0,200,0,0
15446865,luvtosmock,10,12167,227,466,27,444,46.0298663984,40-49,711,8,20,32,52,52,20,32,6,2.6344158018,95.4924909059,0.04246885,0.1881598793,0.48910257,0,66,1.985312790553397E-4,1.2582233E-4,1.2745657E-4,140,3,1,200,1,0.005
15569103,Suaveman,10,10182,3069,3379,65,80,62.7810489983,60-69,755,7,232,282,514,514,232,282,6,2.1663876799,31643.169868793,0.2804541557,0.0396538254,0.17408027,0,66,9.433620137588312E-4,0.0013960288,0.0014141611,390,192,4,205,4,0.0195121951
15608428,Paulbhaven,10,15294,518,954,14,328,42.4011318794,40-49,686,7,6,25,31,31,6,25,7,2.6427854034,53.0986460294,0.0100935685,0.1720430108,0.3323077,0,66,6.452466160695358E-5,4.194078E-5,4.2485524E-5,47,15,1,200,1,0.005
15612072,gregsdouglas,10,4813,981,1263,17,6,59.1302450661,50-59,669,6,31,76,107,107,31,76,6,2.390693003,1278.3392297061,0.0259621012,0.1020983953,0.3016063,0,66,1.719621231011968E-4,1.9172928E-4,1.9421954E-4,372,10,0,200,0,0
15616667,MyPetGloat,10,25762,1120,643,62,36,56.4475603035,50-59,783,8,185,99,284,284,185,99,7,2.3361232005,4091.8282834418,0.225750363,0.0860498681,0.25339094,0,66,4.911768770219707E-4,0.0011144264,0.0011228317,47,258,0,209,0,0
15636921,LloydHLawrence,10,213,9,6,0,1,14.7471614865,10-19,230,4,2,1,3,3,2,1,8,3.6558419819,1.5477297572,0.0012012852,0,0,0,66,5.1872112453307355E-5,1.797462E-5,1.8208082E-5,390,1,1,185,1,0.0054054054
15641725,Deb_Prothero,10,2992,181,796,8,87,33.1381982467,30-39,449,5,11,48,59,59,11,48,6,2.5008369602,214.7678430569,0.0267646278,0.2022209234,0.4659864,0,66,1.6896336486647932E-4,7.189848E-5,7.283233E-5,140,3,0,200,0,0
15675351,pdamerica,10,8319,2798,1769,168,22,57.865958336,50-59,770,6,15,6,21,21,15,6,7,3.1051221962,6275.190860551,0.0040086609,0.0166666667,0.042857144,0,66,3.0928396338146964E-4,9.586464E-5,9.104041E-5,47,50,0,201,0,0
15682499,marcy_catherine,10,2002,121,390,0,11,24.6984765749,20-29,594,6,26,89,115,115,26,89,6,2.3451623703,1040.9972749032,0.0449742233,0.1399694889,0.33040294,0,66,1.6136071717876994E-4,1.6177158E-4,1.6387274E-4,47,0,0,198,0,0
15682552,stephenhui,10,11207,6205,2584,645,323,59.5697616451,50-59,763,7,108,65,173,173,108,65,7,2.541680616,9911.9038220657,0.133284609,0.0778330421,0.18640429,0,66,8.325430635729455E-4,6.5307785E-4,6.494216E-4,55,24,0,200,0,0
15702055,amyboughner,10,37890,2485,2386,201,80,56.1220383538,50-59,798,8,73,114,187,187,73,114,6,2.3324405758,3174.5184111222,0.1489032345,0.1258984532,0.4069882,0,66,6.101216346664503E-4,4.4337395E-4,4.491327E-4,390,53,0,201,0,0
15726214,dmac53,10,916,92,508,0,20,27.9990324631,20-29,528,5,3,28,31,31,3,28,7,2.6695681286,4.562482387,0.009426303,0.2150537634,0.3994709,0,66,5.766097907329967E-5,2.396616E-5,2.4277442E-5,140,3,0,200,0,0
15726720,BoardofTrade,10,5332,9545,2428,397,7,57.8778005813,50-59,769,7,69,31,100,100,69,31,7,2.7231335788,5694.7530452728,0.054393116,0.0674747475,0.16859649,0,66,4.1020732563500024E-4,4.194078E-4,4.1878587E-4,55,91,0,200,0,0
15728569,2Uinc,10,638,1656,312,97,4,53.1590994376,50-59,736,5,1,1,2,2,1,1,1,1,0,7.49471721243357E-5,0,0,193,372,2.9852402567743944E-4,1.198308E-5,1.2138721E-5,196,63,0,200,0,0
15782873,pcasey,10,2714,242,509,10,10,39.4736281366,30-39,691,6,40,75,115,115,40,75,7,2.5025108805,376.4894599964,0.0437098842,0.1321128909,0.3378933,0,66,1.767614637393278E-4,2.4565315E-4,2.4884377E-4,390,9,1,200,1,0.005
15816745,NBToryGal,10,5650,218,407,12,9,39.0976008362,30-39,628,6,37,56,93,93,37,56,6,2.6397723468,578.4771273053,0.0258163719,0.0903459561,0.31311476,0,66,2.621899696221627E-4,2.2767852E-4,2.306357E-4,372,3,2,200,2,0.01
15823471,KenCox,10,1504,129,33,9,9,32.3320173818,30-39,664,5,7,0,7,7,7,0,0,0,0,0.0132465438,0.2857142857,0.52380955,0,42,6.050239148591744E-5,4.793232E-5,0,47,2,0,200,0,0
15827727,wrikent3500,10,236252,1378,2001,15,21352,51.0025907792,50-59,700,11,8,11,19,19,8,11,7,2.8018078339,15.5981608919,0.0131970548,0.2514619883,0.48897058,0,66,8.067569007030168E-5,5.392386E-5,5.4624245E-5,140,4,0,204,0,0
15830174,Emile_BC,10,17378,1509,1265,63,8,68.5437679819,60-69,764,8,80,77,157,157,80,77,6,2.6129896217,11392.2915475969,0.0826969183,0.069859546,0.2228342,0,66,5.07963782350066E-4,4.8531473E-4,4.8554887E-4,372,116,0,205,0,0
15881932,offsprog,10,7298,338,433,15,43,42.7419745693,40-49,703,7,5,3,8,8,5,3,7,3.1817877469,199.0160786236,0.0102989509,0.0535714286,0.2,0,66,1.2821718030125005E-4,3.594924E-5,3.6416164E-5,55,2,0,199,0,0
15959069,jamesbow,10,10242,860,446,61,10,49.0839117003,40-49,738,7,53,31,84,84,53,31,7,2.6370940743,530.5419405716,0.0837716286,0.1061388411,0.34724742,0,66,2.5505858412125853E-4,3.2354315E-4,3.2774548E-4,47,14,0,200,0,0
15964090,TakeoverMonkey,10,3089,114,100,4,16,28.8862687863,20-29,590,6,7,8,15,15,7,8,7,3.1442919317,22.1426354842,0.0130795627,0.2904761905,0.42380953,0,66,6.0192384655731965E-5,4.793232E-5,4.8554884E-5,140,4,3,200,3,0.015
15966995,l_stone,10,4178,3327,2298,149,8,60.1406792561,60-69,741,6,253,115,368,368,253,115,6,2.3943756277,8469.960800303,0.3430935448,0.0829581803,0.18072172,0,66,0.0022261738,0.0015218512,0.0015294789,372,103,3,200,3,0.015
15970856,TotallyTolen,10,1111,174,354,9,1,29.0237687357,20-29,556,5,31,54,85,85,31,54,7,2.5460328088,1009.4310656216,0.0455967526,0.162605042,0.36189258,0,66,1.4478934741729406E-4,1.9172928E-4,1.9421954E-4,390,4,3,200,3,0.015
16025963,jah08,10,65921,1427,1301,76,259,43.5875199746,40-49,770,9,6,5,11,11,6,5,7,3.3806494811,902.7848668477,0.001424394,0.0454545455,0.33333334,0,66,1.0944947610565627E-4,4.194078E-5,4.2485524E-5,47,0,0,202,0,0
16028749,swoolf001,10,530,64,398,3,23,34.6309437455,30-39,519,4,0,0,0,0,0,0,0,0,0,0,0,0,74,172,4.4780486537007367E-5,0,0,66,2,0,200,0,0
16044997,MacleansMag,10,21878,41366,1645,1747,31,80.9235366527,80-89,849,7,608,133,741,741,608,133,6,2.3223970539,85895.5381452681,0.5227092402,0.0415399205,0.073979035,0,66,0.0033211456,0.0036488478,0.0036173388,140,386,10,202,8,0.0495049505
16087107,tidewaters,10,19703,1567,726,114,1,53.6262142074,50-59,742,8,131,136,267,267,131,136,7,2.3424840978,9392.55052933,0.201791184,0.0674720509,0.24778977,0,66,6.974405292544307E-4,7.9088326E-4,8.0115563E-4,140,98,2,200,2,0.01
16087953,bourque,10,2771,10303,0,124,0,48.1057325189,40-49,672,3,111,0,111,111,111,0,0,0,0,0.1446185526,0.1067977068,0.14185095,0,8,8.922924251427797E-4,6.710525E-4,0,372,11,0,200,0,0
16106522,kinsellawarren,10,17379,11302,915,490,289,65.4808449081,60-69,832,8,581,79,660,660,581,79,6,2.5256109809,20315.1423966138,0.5231722976,0.0480732975,0.07882081,0,66,0.0031629068,0.0034870761,0.003465605,140,345,3,201,2,0.0149253731
16116004,JPGallant,10,8333,371,398,13,32,56.7321433048,50-59,730,7,19,20,39,39,19,20,7,2.7281553398,1725.2124657968,0.0327848097,0.0836707152,0.33333334,0,66,2.0692948758394204E-4,1.198308E-4,1.2138722E-4,140,38,0,200,0,0
16116073,braedencaley,10,4331,2932,2882,159,1,49.3816900529,40-49,731,7,200,266,466,466,200,266,6,2.2233009709,17374.1703191089,0.2516999591,0.0614195394,0.19807136,0,66,0.0010563958,0.0012042995,0.0012199415,140,18,0,199,0,0
16132289,jneilson42,10,2086,303,210,24,5,44.4027975051,40-49,595,5,10,7,17,17,10,7,7,3.0917308336,243.3528487771,0.0082369509,0.1544117647,0.33516484,0,66,9.855297031252113E-5,6.590694E-5,6.6762965E-5,372,2,0,200,0,0
16135612,leftcoastrant,10,5602,271,438,10,99,52.0959638817,50-59,706,7,39,47,86,86,39,47,7,2.4569802477,696.8890734154,0.0374114612,0.1280437756,0.27432713,0,66,1.7261174605333042E-4,2.396616E-4,2.4277443E-4,55,204,0,213,0,0
16149936,duncancameron,10,2615,458,709,11,110,46.4952072823,40-49,649,6,81,84,165,165,81,84,6,2.4516237027,1906.4874127327,0.1121450835,0.1223207687,0.26850566,0,66,4.372054897718681E-4,4.913063E-4,4.9768755E-4,390,46,5,200,5,0.025
16161679,natnewswatch,10,46256,11152,356,683,10,69.8956556489,60-69,909,7,760,65,825,825,760,65,6,2.5145631068,21077.5868499101,0.7416217983,0.0536172404,0.08295863,0,66,0.0050002953,0.004559562,0.0045520207,140,1299,0,210,0,0
16166161,Lamarche,10,14083,4038,6130,135,5542,60.5305322595,60-69,762,8,147,257,404,404,147,257,6,2.1623702712,40403.8681985197,0.181029051,0.0544063091,0.15097603,0,66,8.118832159930935E-4,8.867479E-4,8.982654E-4,140,39,0,199,0,0
16173574,oberhoffner,10,10275,1375,829,58,22,61.5268084773,60-69,764,7,61,37,98,98,61,37,7,2.765651155,1494.9943714778,0.0378742581,0.066379129,0.23363096,0,66,3.9541940192790355E-4,3.7147547E-4,3.7630036E-4,372,94,1,200,1,0.005
16178972,countryrose763,10,6399,223,428,4,366,54.882384856,50-59,710,7,21,38,59,59,21,38,7,2.5329762303,1203.9903436804,0.0368157884,0.1116306254,0.40350878,0,66,9.918235888013131E-5,1.3181388E-4,1.3352593E-4,47,18,0,204,0,0
16180205,joycemurray,10,3584,5508,3989,337,21,65.3765731009,60-69,784,6,534,356,890,890,534,356,6,2.1054569802,183640.428793769,0.4940985477,0.0285347758,0.0918963,0,66,0.002587889,0.0032054738,0.0031864143,140,2088,3,200,3,0.015
16180559,Roseblue,10,41576,5788,5166,318,41,56.5369778344,50-59,831,8,42,70,112,112,42,70,6,2.5386675594,34373.2819426699,0.0427850086,0.054456242,0.19600938,0,66,4.247669710152758E-4,2.5763622E-4,2.6098252E-4,372,143,1,201,1,0.0049751244
16189107,DonDavies,10,2377,4433,2126,294,12,56.868830303,50-59,760,5,383,193,576,576,383,193,6,2.2256444593,42950.7495238808,0.4411723594,0.0520410628,0.1493361,0,66,0.0020191286,0.0023007514,0.002318496,390,160,6,200,6,0.03
16194080,jimnewt,10,5346,16334,16987,70,322,55.0636922664,50-59,715,7,9,10,19,19,9,10,7,2.6863073318,7147.086326842,0.0091695764,0.0233918129,0.13333334,0,66,1.057052422573548E-4,5.99154E-5,6.069361E-5,372,1,0,200,0,0
16208964,cheena1,10,15423,477,379,15,433,59.2691001995,50-59,739,8,164,146,310,310,164,146,6,2.2882490793,2547.3070845554,0.2172397527,0.0937362982,0.31979284,0,66,4.2225367687705444E-4,9.88604E-4,0.0010014445,47,43,2,201,2,0.0099502488
16211114,GerryNic,10,17768,2815,1163,150,104,59.9920533556,50-59,794,8,284,106,390,390,284,106,7,2.5487110814,14794.5610387198,0.318272567,0.068169534,0.13879266,0,66,0.0020095999,0.0017075889,0.001717629,372,195,1,200,1,0.005
16216473,Kevin_Wright,10,887,286,363,11,12,39.0933873671,30-39,556,5,39,60,99,99,39,60,6,2.4626715768,791.1789554089,0.043700429,0.1234796949,0.38740122,0,66,1.7828343019609666E-4,2.396616E-4,2.4277443E-4,390,16,2,200,2,0.01
16220555,ElizabethMay,10,11378,58457,5398,2519,37,70.2287019325,70-79,936,8,1428,136,1564,1564,1428,136,6,2.2912621359,291360.863805496,0.933496961,0.0230919456,0.037543252,0,66,0.0074796645,0.00856191,0.008375717,55,2090,9,201,7,0.0447761194
16229679,katiegibbs,10,3166,1285,1704,63,3,51.5796678916,50-59,699,6,66,83,149,149,66,83,6,2.3662537663,12560.5736010086,0.0801803158,0.0583620533,0.19020203,0,66,4.2321200534972475E-4,4.0143318E-4,4.0664716E-4,55,47,0,200,0,0
16269084,bobbilou,10,6733,815,1068,24,175,61.3049658162,60-69,665,6,66,108,174,174,66,108,6,2.3076665551,3960.0729153971,0.0996396891,0.0865723208,0.30049682,0,66,3.795977207291184E-4,4.0143318E-4,4.0664716E-4,140,13,1,197,1,0.0050761421
16272618,iclysdale,10,552,301,314,20,4,51.5990255459,50-59,591,4,19,26,45,45,19,26,7,2.6555071979,1524.8702236501,0.0285094803,0.1035353535,0.3915344,0,66,1.7337885679532798E-4,1.198308E-4,1.2138722E-4,390,8,0,200,0,0
16276647,HermanThind,10,4784,447,1157,5,113,46.1407684875,40-49,609,7,90,212,302,302,90,212,6,2.1463006361,10657.7145811603,0.1245213214,0.0794371961,0.22642516,0,66,3.828943217962984E-4,5.452301E-4,5.5231183E-4,140,56,0,212,0,0
16278418,danlindenas,10,1803,236,344,6,3,42.0693114585,40-49,617,5,31,48,79,79,31,48,6,2.5440241045,361.6131475086,0.0572088498,0.1744563453,0.42517185,0,66,2.3393235227167072E-4,1.9172928E-4,1.9421954E-4,140,4,10,200,10,0.05
16312570,mbeckrubin,10,9988,750,886,28,12,46.0754479685,40-49,700,7,52,60,112,112,52,60,7,2.6206896552,842.1689301794,0.0785244687,0.1510617761,0.3805221,0,66,3.349259245074724E-4,3.175516E-4,3.216761E-4,140,12,1,200,1,0.005
16315028,bmaggiemay,10,24473,765,808,48,46,52.9922581782,50-59,770,8,148,107,255,255,148,107,6,2.3049882826,2650.2950470728,0.2207643891,0.0921568627,0.30559433,0,66,4.5826850587922497E-4,8.9273945E-4,9.043347E-4,47,149,0,221,0,0
16335073,ashleyscorpio,10,21122,2659,2409,137,2194,55.5354397933,50-59,746,8,83,100,183,183,83,100,6,2.4907934382,5505.080094915,0.073851409,0.0942472828,0.22183384,0,66,5.485155517345097E-4,5.0328934E-4,5.098263E-4,372,33,10,200,10,0.05
16343593,MarjiStevens,10,6867,217,505,13,116,44.7747253517,40-49,571,7,1,6,7,7,1,6,7,2.9906260462,0,0.0067470785,0.3571428571,0.8333333,0,66,5.8138540981807526E-5,1.198308E-5,1.2138721E-5,140,0,1,199,1,0.0050251256
16367019,bulldog11,10,757,131,171,2,34,34.7197945249,30-39,542,4,7,17,24,24,7,17,6,2.6491463006,50.5820061003,0.0113386335,0.1358695652,0.3529412,0,66,7.82843282304817E-5,4.793232E-5,4.8554884E-5,372,2,0,197,0,0
16372926,BernieMason,10,44,12,86,0,0,18.9223777275,10-19,92,1,2,14,16,16,2,14,7,2.9357214597,0.4867082927,5.480959604405217E-4,0.3125,0.6868132,0,66,4.9358822703194175E-5,1.797462E-5,1.8208082E-5,140,3,0,42,0,0
16384038,EverettColdwell,10,20610,2068,1895,89,553,50.3615812602,50-59,837,8,409,444,853,853,409,444,6,2.0291262136,66438.3072576788,0.4549267292,0.0368734486,0.15903293,0,66,0.0012034688,0.0024565314,0.0024884378,47,59,1,198,1,0.0050505051
16391511,garifuna,10,2909,417,299,37,1,43.7301405547,40-49,654,5,1,2,3,3,1,2,3,1.875,0,8.741684755576348E-5,0.1666666667,1,0,56,1.5206314911483688E-4,1.198308E-5,1.2138721E-5,320,0,0,200,0,0
16405982,mooseandskwerl,10,31371,5200,4954,114,391,57.8237499901,50-59,776,8,84,91,175,175,84,91,6,2.5316370941,5624.9298808079,0.0471826455,0.0592118227,0.25247252,0,66,4.63536408302431E-4,5.092809E-4,5.1589566E-4,372,101,1,202,1,0.004950495
16407144,IvanOresnik,10,687,135,127,9,4,41.9113320121,40-49,555,5,5,6,11,11,5,6,8,3.328088383,3947.3077554619,0.00146852,0.0818181818,0.5,0,66,1.462521116782171E-4,3.594924E-5,3.6416164E-5,55,39,0,200,0,0
16422863,queerthoughts,10,15751,1477,1924,61,653,61.5119727529,60-69,753,8,217,301,518,518,217,301,6,2.1409440911,24994.3863573951,0.2916052793,0.0601890921,0.19157243,0,66,8.335013986554599E-4,0.0013061557,0.0013231207,390,113,1,203,1,0.0049261084
16425076,notsteveharper,10,6686,1052,2000,23,141,46.2028469115,40-49,697,7,41,79,120,120,41,79,6,2.3635754938,5995.8003607089,0.0648839752,0.0531512605,0.17851347,0,66,2.586412354068558E-4,2.5164467E-4,2.5491315E-4,372,143,0,200,0,0
16428261,djflipflop,10,8046,1376,318,49,5,43.8920518749,40-49,723,6,6,6,12,12,6,6,2,1.25,1,5.008976206219274E-4,0.0984848485,0.8666667,214,407,3.162001656099139E-4,4.194078E-5,4.2485524E-5,266,31,0,200,0,0
16437983,WilliamNorman,10,5968,1019,1737,45,37,47.3936575213,40-49,705,7,100,148,248,248,100,148,6,2.3846668899,5392.4981883582,0.1271789598,0.1066507771,0.3067238,0,66,4.929602364831361E-4,6.051455E-4,6.130054E-4,140,29,2,200,2,0.01
16438512,ArtTherapyPlus,10,147,49,146,0,2,16.0429048908,10-19,200,3,0,10,10,10,0,10,7,3.2540160643,0,0,0.3444444444,0.47777778,0,365,4.4780486537007367E-5,0,6.0693606E-6,390,0,0,173,0,0
16438548,aelan,10,1004,16,61,0,134,20.1605079585,20-29,397,5,2,8,10,10,2,8,7,3.0080348175,0.1951413104,0.0019081194,0.3888888889,0.56666666,0,66,4.7654556883821264E-5,1.797462E-5,1.8208082E-5,140,0,1,200,1,0.005
16458926,markalanwhittle,10,15963,943,1669,20,0,53.0085445894,50-59,734,8,34,79,113,113,34,79,6,2.3890190827,1781.871282507,0.0399852446,0.1014538559,0.30055177,0,66,1.7251047935518108E-4,2.097039E-4,2.1242762E-4,372,12,0,201,0,0
16474992,winterthur,10,136025,4332,4732,289,78,48.3959135312,40-49,853,10,28,30,58,58,28,30,7,2.776029461,6748.307356488,0.0234691633,0.0468844525,0.15853658,0,66,1.9980386179907456E-4,1.7375466E-4,1.7601145E-4,47,10,0,201,0,0
16493164,Kaymee,10,124705,2601,896,129,6625,59.4414934513,50-59,889,10,83,44,127,127,83,44,7,2.7117509207,4334.598267817,0.0600288312,0.0714910636,0.19361702,0,66,3.6542239229355806E-4,5.0328934E-4,5.098263E-4,47,152,0,202,0,0
16496346,Aotearoanz,10,22555,2139,1843,43,3410,53.1520950928,50-59,732,8,4,4,8,8,4,4,7,3.0629394041,4.43192365,0.0035173291,0.0535714286,0.41666666,0,66,5.639387130805373E-5,2.99577E-5,3.0346804E-5,47,8,0,201,0,0
16535205,d5e5,10,5627,607,486,18,267,47.3386984525,40-49,689,7,18,20,38,38,18,20,6,2.5758285906,386.6911001653,0.0259998582,0.0810810811,0.41774893,0,66,9.876356151601167E-5,1.1383926E-4,1.1531785E-4,47,9,0,199,0,0
16540752,chrisalecanada,10,5370,304,238,13,7,46.1366407646,40-49,664,6,17,11,28,28,17,11,7,2.8038165383,42.2237186545,0.0241427678,0.1587301587,0.3097826,0,66,9.241421393180225E-5,1.0784772E-4,1.0924849E-4,55,15,0,200,0,0
16546939,The_Jedinator,10,920,88,204,1,65,41.229222845,40-49,580,5,3,3,6,6,3,3,7,3.2152661533,1.0165910142,0.0059168405,0.1666666667,0.5,0,66,7.752144940072851E-5,2.396616E-5,2.4277442E-5,47,2,0,200,0,0
16561725,Indefatigabl_,10,11869,603,732,22,326,47.897189982,40-49,732,7,47,61,108,108,47,61,6,2.3254101105,1245.1416928142,0.0805524945,0.0750259605,0.31947115,0,66,1.9964414642583745E-4,2.8759392E-4,2.913293E-4,47,10,0,198,0,0
16580153,BrockWHarrison,10,7079,1750,900,53,3,58.8536455473,50-59,757,7,96,66,162,162,96,66,6,2.6468028122,4807.5917640276,0.089462018,0.0948546891,0.24122748,0,66,7.169135723087898E-4,5.811794E-4,5.826586E-4,372,74,2,200,2,0.01
16581816,shaminis,10,5416,928,494,24,92,48.365305199,40-49,721,6,100,41,141,141,100,41,7,2.7251422832,544.8806046677,0.1144164958,0.1399696049,0.31362614,0,66,4.732022565643697E-4,6.051455E-4,6.0693605E-4,390,31,2,200,2,0.01
16583536,greatgodfrey,10,27580,1138,2001,32,90,44.4147831946,40-49,738,9,186,259,445,445,186,259,6,2.1935051892,14502.6506455721,0.2613712008,0.0674663427,0.23531815,0,66,6.078433067338311E-4,0.001120418,0.0011349705,140,26,6,202,6,0.0297029703
16603504,bryw,10,3294,204,289,5,1313,45.241760287,40-49,626,6,15,19,34,34,15,19,7,2.817877469,530.9961629392,0.0189464552,0.1096256684,0.28666666,0,66,1.3192974135100874E-4,9.586464E-5,9.710977E-5,390,5,0,200,0,0
16606268,MHallFindlay,10,2396,7823,393,367,1,64.2152874487,60-69,775,6,543,76,619,619,543,76,6,2.5165718112,28920.5603630445,0.5020668174,0.0526347434,0.08807767,0,66,0.0030630466,0.0032593978,0.0032288998,140,970,2,199,2,0.0100502513
16616320,miraoreck,10,505,348,532,7,0,33.8547597742,30-39,568,4,14,25,39,39,14,25,6,2.5918982256,220.6312257076,0.0339961754,0.1524966262,0.408867,0,66,2.3318741770187316E-4,8.98731E-5,9.104041E-5,55,0,0,199,0,0
16636799,hfxgirl,10,11889,635,335,33,70,47.3786457316,40-49,740,7,7,1,8,8,7,1,7,3.1208570472,6.9109464287,0.0060745302,0.1964285714,0.3392857,0,66,6.0592880266960905E-5,4.793232E-5,4.8554884E-5,140,1,0,200,0,0
16646460,David_Rentzsch,10,2370,88,277,1,5,38.0825374099,30-39,585,5,0,0,0,0,0,0,0,0,0,0,0,0,186,350,4.4780486537007367E-5,0,0,181,2,0,199,0,0
16654103,BramptonNewf,10,504,14,34,0,1,17.5411198243,10-19,273,2,0,0,0,0,0,0,0,0,0,0,0,0,202,386,4.4780486537007367E-5,0,0,198,1,0,200,0,0
16658420,ianangus,10,296,77,418,1,8,21.9873524587,20-29,481,4,4,26,30,30,4,26,6,2.6645463676,38.8958728025,0.0081716806,0.232183908,0.4876923,0,66,7.674335379130044E-5,2.99577E-5,3.0346804E-5,140,0,1,200,1,0.005
16658644,ottawasteph,10,17785,1019,881,115,150,53.4845157481,50-59,721,7,95,95,190,190,95,95,6,2.411449615,1160.7709122096,0.1891508687,0.1388471178,0.3553137,0,66,6.652949763460695E-4,5.7518785E-4,5.826586E-4,140,6,12,200,12,0.06
16676172,ktorrie,10,9096,1683,750,61,89,61.002096613,60-69,733,7,182,81,263,263,182,81,6,2.4378975561,3643.6682396313,0.2370327342,0.1087278321,0.26843816,0,66,0.0010707683,0.0010964518,0.001110693,140,40,2,200,2,0.01
16707686,Magnafan,10,1882,150,438,2,4,38.27236935,30-39,560,5,9,17,26,26,9,17,7,2.8955473719,640.2282168413,0.0060141634,0.1369230769,0.38304093,0,66,1.2902487181723547E-4,5.99154E-5,6.069361E-5,372,5,0,200,0,0
16727909,earthdroplet,10,311,63,181,0,12,18.0259694988,10-19,272,3,3,5,8,8,3,5,7,2.9474389019,0.4279329984,0.00433778,0.1964285714,0.6333333,0,66,5.744702824758924E-5,2.396616E-5,2.4277442E-5,55,1,0,200,0,0
16730316,KendallAdelaide,10,701,114,270,0,0,25.1985094191,20-29,564,4,17,43,60,60,17,43,6,2.4640107131,1346.465322073,0.0293937674,0.1288135593,0.38648948,0,66,1.367503329459474E-4,1.0784772E-4,1.0924849E-4,140,5,0,200,0,0
16740019,DalydeGagne,10,57948,3047,2836,159,39,49.1506107547,40-49,792,9,195,109,304,304,195,109,7,2.3475058587,16113.0435018096,0.2400392151,0.086590238,0.2040438,0,66,6.677443064454137E-4,0.0011743419,0.0011895947,47,122,5,206,4,0.0242718447
16744001,shafto3,10,108,31,147,0,1,15.3271531957,10-19,71,1,2,3,5,5,2,3,7,2.875125544,0.0664966187,0.0071470002,0.1,0.5,0,66,5.235188313114724E-5,1.797462E-5,1.8208082E-5,390,1,0,109,0,0
16751014,daroco,10,684,164,1149,0,4,19.7132662009,10-19,613,5,5,50,55,55,5,50,6,2.5614328758,71.3555180421,0.0042100609,0.2845117845,0.47206095,0,66,6.172432956940052E-5,3.594924E-5,3.6416164E-5,372,1,1,200,1,0.005
16751415,jamesphieffer,10,4424,720,1962,29,14,40.7467971585,40-49,625,6,9,44,53,53,9,44,6,2.5995982591,71.7370046419,0.020146247,0.2053701016,0.48255813,0,66,1.113717645208416E-4,5.99154E-5,6.069361E-5,372,2,1,199,1,0.0050251256
16753407,Justin_Ling,10,27953,3053,988,149,77,65.2764326254,60-69,830,8,312,138,450,450,312,138,6,2.3250753264,17897.6756932979,0.3780639687,0.0651571393,0.14815624,0,66,0.0015561659,0.001875352,0.0018936405,390,439,15,201,15,0.0746268657
16755552,GarethPerry314,10,8421,583,1411,30,14,49.4869026617,40-49,736,7,51,140,191,191,51,140,6,2.3110143957,2114.3463834624,0.0766543263,0.1099751998,0.25315437,0,66,2.4303484066694412E-4,3.1156008E-4,3.1560674E-4,140,43,2,202,2,0.0099009901
16795670,salwind,10,664,25,234,0,81,29.8594938538,20-29,334,5,5,15,20,20,5,15,7,2.7475728155,5.8659832141,0.0057733015,0.1815789474,0.4125,0,66,5.34220489573608E-5,3.594924E-5,3.6416164E-5,55,6,0,202,0,0
16801721,njsh2008,10,7322,192,783,1,44,47.6160779518,40-49,715,7,35,93,128,128,35,93,6,2.3568798125,2478.4384183751,0.0570407113,0.1112204724,0.2673969,0,66,1.760614470014048E-4,2.1569544E-4,2.1849698E-4,140,14,1,203,1,0.0049261084
16831607,aaronwebber,10,2708,313,165,13,2,34.1221809467,30-39,593,6,26,14,40,40,26,14,7,2.8466688986,83.6801204868,0.0334621382,0.1711538462,0.3806818,0,66,1.3823258529749996E-4,1.6177158E-4,1.6387274E-4,390,30,0,200,0,0
16832788,Koschany,10,741,429,132,24,1,43.1134987719,40-49,581,5,13,8,21,21,13,8,7,2.9183126883,76.9508008961,0.0324981335,0.1880952381,0.5375,0,66,3.0605254274966364E-4,8.388156E-5,8.497105E-5,140,8,0,200,0,0
16861429,canadian_stix,10,1350,129,552,0,14,20.5209013648,20-29,424,5,7,25,32,32,7,25,7,2.6555071979,11.1897369323,0.0093773921,0.1643145161,0.36923078,0,66,5.8064899315446634E-5,4.793232E-5,4.8554884E-5,47,0,0,200,0,0
16871500,dawnskarma,10,1030,287,781,3,6,38.123867756,30-39,536,5,15,54,69,69,15,54,7,2.4814194844,631.9951839596,0.0205226055,0.1076300085,0.2557652,0,66,1.2086583657882202E-4,9.586464E-5,9.710977E-5,47,3,0,195,0,0
16874564,FloydusMaxximus,10,6428,525,544,20,277,46.0964857799,40-49,659,7,18,21,39,39,18,21,7,2.7509206562,119.5963335322,0.0135304338,0.0782726046,0.29833335,0,66,9.971330541539442E-5,1.1383926E-4,1.1531785E-4,47,5,0,203,0,0
16903221,Octoate,10,9708,349,242,17,20,44.1963360962,40-49,685,6,1,1,2,2,1,1,1,1,0,7.64551590034024E-5,0,0,45,130,5.142041496909928E-4,1.198308E-5,1.2138721E-5,75,7,0,200,0,0
16969753,Pheartattack,10,1426,67,109,1,201,38.1410408078,30-39,571,6,25,40,65,65,25,40,6,2.4931369267,916.9950254908,0.0452402682,0.0942307692,0.375,0,66,1.1017499358989281E-4,1.5578004E-4,1.5780337E-4,47,15,6,197,6,0.0304568528
17025223,debrah6,10,6280,5205,5205,85,2,41.205730339,40-49,644,6,14,23,37,37,14,23,7,2.604285236,2028.8323851575,0.0220509027,0.0945945946,0.36050725,0,66,1.1148220074918025E-4,8.98731E-5,9.104041E-5,47,0,0,200,0,0
17031126,exovirtuelle,10,15742,3017,1157,125,6,61.5731182463,60-69,778,7,31,17,48,48,31,17,6,2.5641111483,650.726591322,0.0302655975,0.100177305,0.31907308,0,66,1.574101492929468E-4,1.9172928E-4,1.9421954E-4,390,13,0,200,0,0
17076793,wjordan,10,13925,556,700,27,1331,54.0132586554,50-59,738,8,55,60,115,115,55,60,7,2.4656846334,840.8294617913,0.086118638,0.0608695652,0.31678322,0,66,2.118623179278659E-4,3.3552625E-4,3.398842E-4,47,9,1,200,1,0.005
17078094,subha26,10,28090,1049,1371,66,1891,37.8793213146,30-39,783,8,2,19,21,21,2,19,7,2.7452293271,3100.4354631854,0.0047011277,0.2452380952,0.47076023,0,66,5.3801070870540714E-5,1.797462E-5,1.8208082E-5,140,3,1,200,1,0.005
17116017,Pple1st,10,4862,388,579,13,875,48.561716097,40-49,690,7,123,165,288,288,123,165,7,2.2226314027,8683.7554448658,0.1576525921,0.0825348432,0.28379717,0,66,3.555430763201254E-4,7.4295094E-4,7.526007E-4,47,104,1,215,1,0.0046511628
17141770,bpellerin,10,7765,786,114,56,0,55.2110878085,50-59,711,7,81,16,97,97,81,16,7,2.9812520924,479.1876901785,0.0969943451,0.1049183849,0.19453782,0,66,7.051511242816461E-4,4.913063E-4,4.9161824E-4,372,62,2,201,2,0.0099502488
17143599,prowomanprolife,10,2546,467,244,34,7,45.50993018,40-49,605,4,20,30,50,50,20,30,6,2.7780381654,1637.1320430495,0.0097845949,0.1473469388,0.37651822,0,66,2.0583166501963974E-4,1.2582233E-4,1.2745657E-4,372,32,1,200,1,0.005
17171476,rzypci,10,11278,250,285,5,645,46.8245462345,40-49,714,7,6,6,12,12,6,6,7,3.067961165,6256.5162278889,0.011836965,0.0833333333,0.22222222,0,66,1.4807357401652382E-4,4.194078E-5,4.2485524E-5,390,9,0,200,0,0
17178342,drmaggiesa,10,4227,258,1047,10,649,43.3269072343,40-49,617,7,1,2,3,3,1,2,8,3.5497154335,4.8450084209,3.0280442900443825E-4,0,0,0,66,5.8129038212847856E-5,1.198308E-5,1.2138721E-5,47,0,0,199,0,0
17180475,JyotiM,10,1099,267,1754,2,54,38.6435299008,30-39,473,5,4,44,48,48,4,44,6,2.5544024104,60.9449128737,0.0062568992,0.2043439716,0.36363637,0,66,6.0229371679750144E-5,2.99577E-5,3.0346804E-5,140,1,0,200,0,0
17193885,MatusStraznicky,10,2866,206,260,15,161,30.498802516,30-39,502,4,0,0,0,0,0,0,0,0,0,0,0,0,292,543,4.4780486537007367E-5,0,0,288,1,0,200,0,0
17203795,ShaktiLila,10,209,217,1755,3,306,39.9300416496,30-39,415,4,13,73,86,86,13,73,7,2.526280549,1248.1716472921,0.0113646013,0.126128591,0.26122525,0,66,8.217549387013305E-5,8.388156E-5,8.497105E-5,47,1,0,198,0,0
17213033,JoeyCuba,10,152,32,99,0,5,19.6014222043,10-19,192,1,1,1,2,2,1,1,8,4.1245396719,0,1.0194397698599662E-4,0,0,0,66,7.003356437602543E-5,1.198308E-5,1.2138721E-5,390,0,0,150,0,0
17221430,BillTieleman,10,4997,4616,188,233,21,66.837167653,60-69,776,6,210,14,224,224,210,14,7,2.8965517241,2847.753317367,0.2003922439,0.0757527226,0.117499776,0,66,0.0011993979,0.001264215,0.001262427,55,145,0,200,0,0
17224196,helesialuke,10,2671,1127,2001,42,135,61.0466948159,60-69,689,6,66,108,174,174,66,108,7,2.3947104118,2718.5761466253,0.0820386636,0.1004916617,0.25532946,0,66,3.280612064300104E-4,4.0143318E-4,4.0664716E-4,55,51,0,200,0,0
17235459,NutkinNB,10,11305,837,1001,37,5,49.4848220307,40-49,710,7,17,36,53,53,17,36,7,2.5694676933,301.2251772468,0.0261970514,0.1331640058,0.33141026,0,66,9.930713877578065E-5,1.0784772E-4,1.0924849E-4,390,3,3,200,3,0.015
17257492,manuelcosta,10,907,327,863,5,12,39.9244238271,30-39,526,4,19,66,85,85,19,66,6,2.4452628055,3203.5551287295,0.0336726356,0.1329131653,0.27112675,0,66,1.6894492523590997E-4,1.198308E-4,1.2138722E-4,47,13,0,200,0,0
17291311,LeahvanHouten,10,1765,979,497,33,0,46.9017288527,40-49,663,6,119,80,199,199,119,80,6,2.5035152327,2496.8809687995,0.1264985309,0.1121770469,0.30181992,0,66,5.647967463645699E-4,7.189848E-4,7.283233E-4,140,41,1,200,1,0.005
17300548,ddsnorth,10,171277,4867,150,319,2425,,,891,10,90,42,132,132,90,42,6,2.5537328423,1209.0848388124,0.1141879712,0.0886537127,0.29741478,0,66,2.805240784905248E-4,5.452301E-4,5.5231183E-4,47,104,0,202,0,0
17300745,ckayaker,10,570,52,78,2,2,36.1699161416,30-39,489,5,4,11,15,15,4,11,7,2.7981252092,3.887123324,0.010502897,0.2428571429,0.4551282,0,66,6.439874905593154E-5,2.99577E-5,3.0346804E-5,47,8,2,200,2,0.01
17314758,PaulDewar,10,2463,11490,310,628,11,60.0792968388,60-69,796,5,688,63,751,751,688,63,7,2.5550719786,16996.6553002747,0.5999440556,0.0493972481,0.077821985,0,66,0.0032973576,0.004128171,0.004121096,390,376,0,200,0,0
17370412,jasonfekete,10,11447,4354,421,226,7,61.1884499354,60-69,770,7,273,58,331,331,273,58,6,2.5815199197,3431.2161316943,0.350621641,0.0955048979,0.17112157,0,66,0.0020946556,0.001641682,0.0016630049,372,107,6,200,6,0.03
17389318,bobraeMP,10,2536,36569,938,1341,0,69.5776966224,60-69,908,5,1178,64,1242,1242,1178,64,6,2.4613324406,110082.814793264,0.7999655777,0.0277612335,0.041203633,0,66,0.0060088045,0.0070640254,0.0068887244,140,2158,3,200,3,0.015
17393603,sfharris,10,6906,1350,798,45,11,52.4494787187,50-59,725,7,246,128,374,374,246,128,6,2.4432541011,7746.009335314,0.3409595889,0.0970308669,0.23236948,0,66,0.0015478857,0.0014799103,0.0014930627,390,138,16,202,15,0.0792079208
17394041,SDBSmith,10,393,19,128,0,11,21.6826995451,20-29,193,4,2,19,21,21,2,19,7,2.5818547037,4.2889490412,0.0039122733,0.280952381,0.5204678,0,66,5.3483119723601444E-5,1.797462E-5,1.8208082E-5,390,3,3,201,3,0.0149253731
17411801,niclariviere,10,720,143,225,2,14,48.6236758848,40-49,557,5,1,2,3,3,1,2,7,3.6682289923,0,2.5921031551874335E-4,0.1666666667,1,0,66,5.69906247607208E-5,1.198308E-5,1.2138721E-5,55,0,0,201,0,0
17435582,rwpickard,10,9604,729,379,30,692,50.6536083948,50-59,739,7,19,10,29,29,19,10,7,3.0097087379,665.3065530759,0.0095069797,0.0517241379,0.12770563,0,66,1.4241965789428085E-4,1.198308E-4,1.2138722E-4,55,36,0,203,0,0
17442269,davidvalentin,10,5242,844,312,33,4,47.6762125859,40-49,698,6,106,51,157,157,106,51,7,2.6484767325,2598.5819645867,0.1385065656,0.1357994447,0.3487395,0,66,6.139504888411827E-4,6.4109475E-4,6.494216E-4,140,33,1,200,1,0.005
17479221,thekatieyak,10,5580,228,880,9,33,37.3941648025,30-39,636,6,10,17,27,27,10,17,7,2.9273518581,65.2054441955,0.0102565211,0.1125356125,0.4227941,0,66,8.94259671279317E-5,6.590694E-5,6.6762965E-5,390,0,0,201,0,0
17482189,ejvanvuuren,10,388,102,102,4,5,43.0790964135,40-49,479,3,1,1,2,2,1,1,2,1.6666666667,0,7.497734636589823E-5,0.5,1,22,95,1.1704024304684287E-4,1.198308E-5,1.2138721E-5,182,1,0,200,0,0
17493663,pcz,10,14593,1933,1772,37,304,56.7778199014,50-59,697,8,18,31,49,49,18,31,7,2.5610980917,334.5426036768,0.0363419439,0.0956632653,0.3205645,0,66,1.8253881288575927E-4,1.1383926E-4,1.1531785E-4,55,2,0,200,0,0
17524392,duncankinney,10,14525,2187,1245,128,23,60.8706677964,60-69,769,7,54,45,99,99,54,45,7,2.76029461,2469.4883544711,0.0415612945,0.0591630592,0.15160407,0,66,3.71278542549099E-4,3.295347E-4,3.2774548E-4,372,39,0,201,0,0
17543769,verbz,10,9262,1537,1625,24,209,43.9062705506,40-49,717,6,8,8,16,16,8,8,1,1,8.6666666667,6.54381122337277E-4,0.0708333333,0.60714287,214,407,4.2075200114485736E-4,5.392386E-5,5.4624245E-5,266,8,0,200,0,0
17546396,mikes_r,10,5351,810,756,48,0,49.6702271743,40-49,694,6,50,42,92,92,50,42,7,2.6702376967,355.3527141288,0.0813261857,0.1637601529,0.41863355,0,66,3.433725975766674E-4,3.0556854E-4,3.095374E-4,140,17,0,198,0,0
17546540,nickcott,10,7165,383,1445,17,40,47.4630905691,40-49,733,7,17,85,102,102,17,85,6,2.3833277536,643.9161631124,0.0285165462,0.1668608037,0.33640736,0,66,1.669287645871527E-4,1.0784772E-4,1.0924849E-4,140,4,0,201,0,0
17551297,StevenDollansky,10,6257,815,477,39,8,46.8141017905,40-49,724,6,48,36,84,84,48,36,6,2.7094074322,981.8966558005,0.0420461539,0.1339644291,0.3725542,0,66,3.900856157302448E-4,2.9358547E-4,2.9739868E-4,372,32,0,200,0,0
17553618,RodSmelser,10,35174,943,898,37,1184,51.8958347674,50-59,787,9,128,142,270,270,128,142,6,2.3401406093,15036.2411596694,0.1557190529,0.066942035,0.18751723,0,66,6.245891839460668E-4,7.729087E-4,7.829475E-4,390,319,0,216,0,0
17556793,dougdela,10,4262,96,80,3,10,42.5126722724,40-49,698,7,27,12,39,39,27,12,7,2.7867425511,20.6689356804,0.0468912895,0.2105263158,0.46022728,0,66,1.0954130889504316E-4,1.6776312E-4,1.699421E-4,140,15,1,200,1,0.005
17583572,tinapittaway,10,24981,2057,2262,110,1843,58.7574285066,50-59,778,8,98,128,226,226,98,128,6,2.3545363241,3824.0206146989,0.1898786327,0.0904621436,0.28259373,0,66,8.620164186191404E-4,5.9316243E-4,6.008667E-4,140,17,1,200,1,0.005
17600181,LeslieSwartman,10,3462,1131,294,33,0,50.5406129191,50-59,687,6,109,40,149,149,109,40,6,2.7308336123,727.9192099994,0.1782635291,0.1398512607,0.30430138,0,66,9.58448892869883E-4,6.590694E-4,6.6762965E-4,140,33,0,200,0,0
17684375,GlobalNational,10,33609,27597,423,930,30,64.0071970564,60-69,809,8,188,5,193,193,188,5,7,3.1643789756,911.2941876595,0.2020110503,0.0774773316,0.110109225,0,66,0.0014183993,0.001132401,0.0011349705,372,100,0,201,0,0
17691510,Jennoit,10,2275,240,93,14,0,43.033441025,40-49,678,6,5,3,8,8,5,3,8,3.5875460328,1261.8486941006,0.0024159489,0.0714285714,0.35,0,66,9.603284109842125E-5,3.594924E-5,3.6416164E-5,372,6,0,200,0,0
17692961,StephanieLevitz,10,2163,4082,2113,238,7,53.6414046136,50-59,711,6,286,188,474,474,286,188,6,2.2982926013,17155.5449044072,0.3915134563,0.0720020339,0.17631657,0,66,0.0020818219,0.001719572,0.0017419065,372,32,6,200,6,0.03
17694287,slocanslim,10,5310,389,377,7,2,39.6810242465,30-39,647,6,32,50,82,82,32,50,7,2.5825242718,1153.502062066,0.0452630884,0.1195423065,0.26971152,0,66,2.6674541164592447E-4,1.9772082E-4,2.0028891E-4,55,3,0,200,0,0
17735910,Hankers,10,13633,192,232,6,4,50.3878706857,50-59,714,7,14,18,32,32,14,18,6,2.8031469702,16.5701792496,0.0118041458,0.1814516129,0.5731225,0,66,9.948417320383482E-5,8.98731E-5,9.104041E-5,372,29,0,199,0,0
17738467,tylercameron,10,9311,1287,621,46,1180,55.278611061,50-59,727,7,43,37,80,80,43,37,6,2.640441915,569.6096019004,0.0582096345,0.1348101266,0.35282487,0,66,3.102824103864714E-4,2.6362776E-4,2.6705186E-4,372,32,0,200,0,0
17768745,janeschmidt,10,5991,398,301,23,189,50.668543469,50-59,708,6,9,14,23,23,9,14,7,3.0532306662,2154.7671817049,0.0040430326,0.0869565217,0.27083334,0,66,1.6735691669324607E-4,5.99154E-5,6.069361E-5,372,79,1,200,1,0.005
17850064,CEamer,10,5552,378,553,33,0,46.0314038369,40-49,671,7,9,31,40,40,9,31,7,2.6468028122,242.1143433928,0.0203102357,0.1615384615,0.375,0,66,1.0238055919335763E-4,5.99154E-5,6.069361E-5,140,8,2,200,2,0.01
17869751,peterburbidge,10,1684,76,148,1,46,36.0739828237,30-39,631,6,28,44,72,72,28,44,6,2.4291931704,816.2438850836,0.048537664,0.130086072,0.38816327,0,66,1.3063750832311859E-4,1.7375466E-4,1.7601145E-4,390,11,2,200,2,0.01
17881636,chriskissoff,10,246,67,83,2,11,24.3682432204,20-29,417,3,0,2,2,2,0,2,7,3.1974564926,0,0,0.5,1,0,385,4.4780486537007367E-5,0,6.0693606E-6,390,1,0,200,0,0
17911191,derekmcb,10,3763,590,303,36,50,43.8423855966,40-49,701,6,19,18,37,37,19,18,7,2.7961165049,128.4465109118,0.0327428199,0.1771771772,0.29679143,0,66,1.341511982462597E-4,1.198308E-4,1.2138722E-4,372,4,0,200,0,0
17929477,pepprspraypatti,10,3033,52,203,5,379,43.3825544823,40-49,615,5,0,2,2,2,0,2,7,3.202476573,0,0,0.5,0.5,0,377,4.4780486537007367E-5,0,6.0693606E-6,55,1,0,201,0,0
17934964,KMason_Wpg,10,4379,437,1254,7,35,55.7071463136,50-59,702,7,16,52,68,68,16,52,7,2.5637763642,226.5697131102,0.0210852212,0.190737489,0.3972431,0,66,1.017487193922453E-4,1.0185618E-4,1.0317913E-4,390,18,0,200,0,0
17956672,csteffensen,10,687,48,301,2,795,24.6359149545,20-29,530,4,12,45,57,57,12,45,6,2.5142283227,48.9731976143,0.0201974722,0.201754386,0.4412581,0,66,7.717523667521975E-5,7.789002E-5,7.8901685E-5,390,0,3,200,3,0.015
17964900,ADAction,10,2280,700,574,62,6,46.6911063845,40-49,651,5,3,3,6,6,3,3,8,3.9681955139,9.7707882041,2.7849142948956784E-4,0.0666666667,0.33333334,0,66,1.058897663225307E-4,2.396616E-5,2.4277442E-5,47,1,0,200,0,0
18040291,ovadosepeace,10,6537,417,1828,13,4,43.2590093502,40-49,618,6,1,4,5,5,1,4,7,3.0709742216,2.3478603827,7.226737476380222E-4,0.05,0.16666667,0,66,4.644480038471271E-5,1.198308E-5,1.2138721E-5,47,3,0,201,0,0
18100698,logangamble,10,3162,109,146,2,18,39.5402956477,30-39,633,6,9,13,22,22,9,13,7,2.8225644459,96.3004610446,0.0087345882,0.1406926407,0.31985295,0,66,7.290079952402513E-5,5.99154E-5,6.069361E-5,390,2,0,200,0,0
18115619,glemarchand,10,5217,1518,622,110,15,49.6796326673,40-49,691,7,6,6,12,12,6,6,2,1.25,10.5333333333,4.8434177440154685E-4,0.1212121212,0.3611111,0,56,4.752427742128663E-4,4.194078E-5,3.6416164E-5,320,3,0,200,0,0
18117300,Proud_Canadian1,10,28943,1343,1673,74,178,46.2358011371,40-49,780,8,100,95,195,195,100,95,6,2.379979913,11488.7138451248,0.1139012219,0.0538725879,0.15051387,0,66,5.784017682771064E-4,6.051455E-4,6.130054E-4,372,143,2,202,2,0.0099009901
18124468,wrongkate,10,7016,289,465,12,36,46.5154107787,40-49,708,6,2,1,3,3,2,1,1,1,0.2833333333,5.159057946967325E-4,0,0,0,41,5.1174693243596224E-5,1.797462E-5,1.8208082E-5,55,3,0,200,0,0
18156244,Ben_Berman,10,5884,977,1149,37,0,49.6238522611,40-49,742,6,174,211,385,385,174,211,6,2.1791094744,17608.9696147372,0.2214434228,0.0523133117,0.23074885,0,66,5.343213380518655E-4,0.0010485195,0.0010621381,47,52,1,203,1,0.0049261084
18165363,alekt,10,8377,723,515,19,504,54.1140982516,50-59,755,7,61,50,111,111,61,50,7,2.5135587546,1323.2312216355,0.0631599685,0.0770679771,0.24396396,0,66,2.134369892058416E-4,3.7147547E-4,3.7630036E-4,47,41,1,200,1,0.005
18165715,paulcip,10,5943,1632,1996,68,0,50.6452605805,50-59,657,6,7,19,26,26,7,19,6,2.6588550385,165.7045975285,0.0149215002,0.1307692308,0.40643275,0,66,1.1434332057510807E-4,4.793232E-5,4.8554884E-5,55,0,1,200,1,0.005
18200731,Gregor_Ash,10,6392,1832,1494,62,80,54.3009186283,50-59,728,7,55,59,114,114,55,59,7,2.604285236,1913.7305997353,0.0578354131,0.1171401956,0.3355917,0,66,3.2147690030306356E-4,3.3552625E-4,3.398842E-4,390,39,1,200,1,0.005
18253198,mensaghic,10,3604,184,284,1,7,40.2322936605,40-49,659,6,13,28,41,41,13,28,6,2.7207900904,53.8236844994,0.0131901245,0.1670731707,0.42137095,0,66,1.1298120761163586E-4,8.388156E-5,8.497105E-5,372,8,1,200,1,0.005
18309340,topher_batty,10,1000,153,243,7,2,39.8285053134,30-39,526,5,1,3,4,4,1,3,7,3.2487445598,2.124584215,4.6720068345744854E-4,0.0833333333,0.16666667,0,66,5.602811429769493E-5,1.198308E-5,1.2138721E-5,55,1,0,199,0,0
18360735,suepeac,10,1906,74,131,0,43,25.0560438135,20-29,549,6,10,17,27,27,10,17,7,2.9086039505,137.7318823697,0.0076886317,0.1723646724,0.33003953,0,66,8.450813959339202E-5,6.590694E-5,6.6762965E-5,372,4,0,200,0,0
18411401,nashvillebound,10,3052,136,467,1,825,43.0056701262,40-49,575,6,17,35,52,52,17,35,7,2.5929025778,298.0604941963,0.020289155,0.1036953243,0.2672065,0,66,8.768406324770695E-5,1.0784772E-4,1.0924849E-4,47,21,0,201,0,0
18435883,Dwayne_Nashkawa,10,1428,542,634,18,79,42.2037061962,40-49,629,5,26,29,55,55,26,29,7,2.7234683629,232.7937010176,0.0282335102,0.1097643098,0.3224359,0,66,1.3783994797693583E-4,1.6177158E-4,1.6387274E-4,47,0,0,199,0,0
18436624,write_stuff_2,10,701,491,1996,5,1,22.110319985,20-29,528,4,13,85,98,98,13,85,6,2.4278540341,522.1155984401,0.0201011359,0.1652640438,0.29826352,0,66,1.0596076277715818E-4,8.388156E-5,8.497105E-5,372,0,2,200,2,0.01
18440389,blunt1,10,2657,801,412,47,73,61.7065619349,60-69,683,6,53,44,97,97,53,44,7,2.5590893873,975.1794992485,0.0669068802,0.0821520619,0.22932652,0,66,2.8199486899675177E-4,3.2354315E-4,3.2774548E-4,47,15,0,200,0,0
18445844,ocean_raven,10,21387,2017,2083,40,41,45.0583748596,40-49,693,7,10,16,26,26,10,16,7,2.6464680281,288.598919981,0.01066838,0.0538461538,0.225,0,66,7.820716800587586E-5,6.590694E-5,6.6762965E-5,47,1,0,199,0,0
18454463,KieranMcKenzie,10,3020,1441,2000,26,18,43.6919872398,40-49,676,6,94,226,320,320,94,226,6,2.2062269836,8491.9324847284,0.1622049861,0.0999118339,0.2584825,0,66,5.442532310557988E-4,5.691963E-4,5.7658926E-4,390,10,5,200,5,0.025
18460152,seanshaw,10,8993,721,499,50,6,50.5050055434,50-59,747,7,22,25,47,47,22,25,7,2.7519250084,338.3384081342,0.0205302839,0.1012950971,0.3155242,0,66,1.283302733792253E-4,1.3780541E-4,1.395953E-4,390,41,2,200,2,0.01
18464551,germstv,10,6264,336,428,8,2202,47.8179767899,40-49,694,7,78,116,194,194,78,116,6,2.3100100435,3249.6426468298,0.1076447729,0.0692270712,0.29929265,0,66,2.500194639686692E-4,4.7333166E-4,4.794795E-4,47,65,0,207,0,0
18491472,DWKeoughan,10,11839,500,1245,19,7,60.0582781201,60-69,738,8,2,7,9,9,2,7,7,2.994643455,5.7378346833,6.187718468579392E-4,0.1666666667,0.33333334,0,66,5.378369787780637E-5,1.797462E-5,1.8208082E-5,140,0,0,201,0,0
18547284,scotthpayne,10,4468,770,1461,30,4,44.6784587566,40-49,686,6,95,175,270,270,95,175,6,2.2597924339,10292.297467719,0.1263176993,0.0637339942,0.18773612,0,66,4.0612688140266215E-4,5.7518785E-4,5.826586E-4,390,23,6,200,6,0.03
18584466,MoniqueAC,10,195,52,452,0,0,18.4660438635,10-19,170,4,0,9,9,9,0,9,7,2.8915662651,0,0,0.3055555556,0.5138889,0,375,4.4780486537007367E-5,0,6.0693606E-6,140,0,3,199,2,0.0150753769
18588982,relliotmeyer,10,910,123,182,3,0,29.7538344697,20-29,580,6,3,8,11,11,3,8,7,2.9119517911,40.9071951371,0.0039313376,0.1818181818,0.51785713,0,66,5.82500756032248E-5,2.396616E-5,2.4277442E-5,140,2,1,200,1,0.005
18592513,Ivan_Avery_Frey,10,83,13,19,0,0,12.3207895825,10-19,53,2,0,0,0,0,0,0,0,0,0,0,0,0,142,284,4.4780486537007367E-5,0,0,138,0,0,86,0,0
18654401,nikiashton,10,3052,6125,594,334,27,60.5102654823,60-69,781,6,587,101,688,688,587,101,6,2.4733846669,32477.6517959729,0.5162482902,0.0507112995,0.08948247,0,66,0.0028218006,0.0035230254,0.0035384372,390,506,1,200,1,0.005
18666861,Mimiges,10,2714,159,180,2,9,42.3340116396,40-49,632,6,16,23,39,39,16,23,7,2.6314027452,154.3638661822,0.0219179223,0.1747638327,0.36290324,0,66,1.25603457425194E-4,1.0185618E-4,1.0317913E-4,47,20,1,198,1,0.0050505051
18681012,leftdog,10,2668,1025,853,61,68,43.8703049212,40-49,707,5,173,173,346,346,173,173,6,2.218948778,21259.7392816815,0.2160329498,0.0481025383,0.19637217,0,66,6.70360170305369E-4,0.001042528,0.0010560688,390,35,5,195,5,0.0256410256
18703833,kerrie12345,10,106,17,49,0,7,17.5152534531,10-19,239,3,1,4,5,5,1,4,7,2.9839303649,0.0606375149,9.012760169403337E-4,0.25,0.75,0,66,4.909407424415506E-5,1.198308E-5,1.2138721E-5,390,0,1,116,1,0.0086206897
18709858,LAWZSPOKEN,10,30044,800,526,18,796,44.8531627309,40-49,767,8,8,8,16,16,8,8,1,1,8.6666666667,6.54381122337277E-4,0.0708333333,0.60714287,214,407,4.2075200114485736E-4,5.392386E-5,5.4624245E-5,266,62,0,204,0,0
18711754,amyminsky,10,5823,2998,1035,153,5,53.340225765,50-59,762,6,329,140,469,469,329,140,6,2.3153665886,15237.2016851574,0.4285690501,0.075474277,0.16725698,0,66,0.0023466514,0.001977208,0.0019968196,140,39,2,200,2,0.01
18722095,richardfromm,10,2143,88,348,0,8,30.08996201,30-39,609,6,13,53,66,66,13,53,6,2.6786072983,338.2517221696,0.0146066329,0.1724941725,0.39762405,0,66,1.645813646972566E-4,8.388156E-5,8.497105E-5,372,12,0,199,0,0
18757095,JamieMasse,10,10867,888,742,43,9,56.094437169,50-59,731,8,151,118,269,269,151,118,6,2.4107800469,4972.3396661249,0.1810880278,0.1034511458,0.2780033,0,66,5.983296259787384E-4,9.107141E-4,9.225428E-4,390,71,5,200,5,0.025
18834072,HinkleGroup,10,12,19,32,0,0,17.5864448717,10-19,139,1,0,0,0,0,0,0,0,0,0,0,0,0,6,74,4.4780486537007367E-5,0,0,3,0,0,30,0,0
18844199,jeffsbrownlee,10,1958,276,460,9,8,41.7159012039,40-49,547,5,10,33,43,43,10,33,7,2.6732507533,11.1382299976,0.0345860297,0.2380952381,0.71117425,0,66,1.9159323477806273E-4,6.590694E-5,6.6762965E-5,140,0,0,200,0,0
18881147,JonnKmech,10,1448,222,244,18,3,41.7677809772,40-49,580,5,5,5,10,10,5,5,7,3.1275527285,18.3114805764,0.0038487617,0.1111111111,0.25,0,66,6.137152229227996E-5,3.594924E-5,3.6416164E-5,372,0,0,199,0,0
18929837,musicbaum,10,37331,1317,1694,29,3715,55.1083842775,50-59,785,9,20,24,44,44,20,24,7,2.6816203549,473.9621541149,0.0180064319,0.0465116279,0.19076923,0,66,1.1244209418366203E-4,1.2582233E-4,1.2745657E-4,372,42,0,203,0,0
18958712,KatyMackay,10,649,117,206,7,1,32.6112800403,30-39,467,4,3,4,7,7,3,4,7,3.1067961165,48.9589916939,0.0020841537,0.0952380952,0.5,0,66,6.45555880045126E-5,2.396616E-5,2.4277442E-5,372,1,1,200,1,0.005
18967986,impolitical,10,33049,3922,3030,352,44,,,787,8,478,403,881,881,478,403,6,2.0482089053,122342.938386631,0.555855388,0.0283691054,0.13557276,0,66,0.0020625502,0.0028699476,0.0029011543,140,261,5,203,4,0.0246305419
18975909,hervella,10,8227,3289,2538,337,22,57.9554727858,50-59,776,8,2,2,4,4,2,2,9,4.5918982256,1763.5568256974,1.6726027132621572E-4,0,0,0,66,1.9386352469239444E-4,1.797462E-5,1.8208082E-5,320,0,0,200,0,0
18999763,CBCCommunity,10,20965,7030,1388,417,92,62.3915199555,60-69,786,8,126,25,151,151,126,25,7,2.7298292601,2344.5310675811,0.1214655507,0.0445474614,0.08694097,0,66,5.422576164190153E-4,7.609256E-4,7.708088E-4,140,38,0,200,0,0
19006592,jmrob,10,7090,713,1351,15,202,45.0039590837,40-49,688,7,87,130,217,217,87,130,7,2.2982926013,3667.2961376331,0.1562874876,0.089520396,0.31555945,0,66,3.7456196279686576E-4,5.272555E-4,5.341037E-4,47,38,2,210,2,0.0095238095
19077807,IEWMrMatthew,10,413,56,99,1,12,43.8330669456,40-49,601,5,6,9,15,15,6,9,7,3.1412788751,48.0941923864,0.0023755138,0.0952380952,0.35555556,0,66,7.804548800634283E-5,4.194078E-5,4.2485524E-5,390,59,0,200,0,0
19082794,ThisHomelessLif,10,14487,463,400,36,26,49.4363429925,40-49,760,8,104,0,104,104,104,0,0,0,0,0.1403090724,0.1892270351,0.31198657,0,14,3.097397010837261E-4,6.291117E-4,0,47,21,1,210,1,0.0047619048
19088288,bannerite,10,38198,4778,4644,119,3698,64.8270851454,60-69,804,9,36,38,74,74,36,38,6,2.7130900569,19994.3651795854,0.0159855413,0.032950759,0.19551282,0,66,3.55461055673498E-4,2.2168698E-4,2.2456635E-4,47,78,0,201,0,0
19103646,djclimenhaga,10,2636,2271,1532,71,2,54.8818967121,50-59,755,6,196,128,324,324,196,128,6,2.275862069,35118.57376798,0.1842913026,0.0569984329,0.14677754,0,66,8.980844681044858E-4,0.0011803333,0.0011895947,372,135,0,198,0,0
19110210,una1rose,10,12581,824,1756,22,46,46.1403856507,40-49,685,7,8,33,41,41,8,33,7,2.6454636759,139.0944149301,0.0102845046,0.1262195122,0.2042042,0,66,6.495185076242444E-5,5.392386E-5,5.4624245E-5,390,2,1,199,1,0.0050251256
19134335,sddavis63,10,4165,118,76,11,4,35.038343329,30-39,623,4,5,5,10,10,5,5,7,3.2236357549,178.2185510221,0.0055536813,0.0222222222,0.13333334,0,66,9.938359068574483E-5,3.594924E-5,3.6416164E-5,55,1,0,200,0,0
19143481,kotlnc,10,2302,690,1809,36,23,41.9428086517,40-49,600,6,6,32,38,38,6,32,7,2.8208905256,3220.0556758417,6.570750100799769E-4,0.1159317212,0.26209676,0,66,1.5115647302662647E-4,4.194078E-5,4.2485524E-5,372,3,0,200,0,0
19143783,DanielJBeals,10,3932,975,995,76,218,48.2392346043,40-49,679,6,91,84,175,175,91,84,7,2.5426849682,3337.1377041915,0.125157891,0.1195730706,0.31551427,0,66,4.68544208699215E-4,5.5122166E-4,5.583812E-4,390,6,2,200,2,0.01
19193229,Tamarijuana,10,2927,646,864,16,99,62.5207461077,60-69,640,6,35,75,110,110,35,75,6,2.3458319384,4689.6554092449,0.0507153637,0.116263553,0.2767507,0,66,1.963904213891156E-4,2.1569544E-4,2.1849698E-4,47,13,0,201,0,0
19216594,mikelecouteur,10,5465,1072,473,38,1,52.8475873686,50-59,745,6,82,48,130,130,82,48,6,2.526280549,4260.830546721,0.1325438411,0.1360763268,0.31052223,0,66,9.962185723270968E-4,4.972978E-4,4.9768755E-4,372,65,6,200,6,0.03
19221008,Hepworks,10,6490,461,986,3,44,53.9287494161,50-59,690,6,47,100,147,147,47,100,6,2.2936056244,7613.1704549268,0.0707800855,0.0833566303,0.2255971,0,66,2.9848133336603954E-4,2.8759392E-4,2.913293E-4,47,26,0,204,0,0
19231224,LABcrab,10,2051,148,121,3,18,42.5814063529,40-49,689,7,3,0,3,3,3,0,0,0,0,0.0010482322,0.1666666667,0.33333334,0,31,5.600262376795542E-5,2.396616E-5,0,372,23,0,200,0,0
19240249,CKNW,10,39902,25782,802,1342,25,66.5972601057,60-69,899,8,155,23,178,178,155,23,7,2.6233679277,3252.256312263,0.1467137401,0.0856662223,0.13379265,0,66,9.402423032919597E-4,9.346802E-4,9.3468156E-4,55,310,0,203,0,0
19246319,Redroadie,10,67,55,129,0,6,15.0371286187,10-19,342,2,0,10,10,10,0,10,7,2.9735609103,0,0,0.4555555556,0.8888889,0,167,4.4780486537007367E-5,0,6.0693606E-6,140,0,0,69,0,0
19253829,nmucklow,10,443,84,175,3,1,32.3002799621,30-39,499,4,2,8,10,10,2,8,7,2.9963173753,0.5704195471,0.001404686,0.3555555556,0.6805556,0,66,5.062336500684136E-5,1.797462E-5,1.8208082E-5,140,0,0,199,0,0
19282352,nadlanu,10,13992,4313,774,51,680,57.7534162815,50-59,744,7,0,0,0,0,0,0,0,0,0,0,0,0,219,416,4.4780486537007367E-5,0,0,214,5,0,201,0,0
19295032,Duplisea,10,522,64,125,2,249,34.7618883096,30-39,446,5,10,20,30,30,10,20,7,2.8972212923,361.2452177484,0.023135918,0.1172413793,0.31385282,0,66,1.69416536910323E-4,6.590694E-5,6.6762965E-5,140,1,0,199,0,0
19304663,Miss_mobile_web,10,4127,4485,4099,126,242,57.5211393087,50-59,733,7,6,7,13,13,6,7,7,3.4208235688,30436.1625837669,4.8112458086909516E-4,0,0,0,66,4.7187643742849705E-4,4.194078E-5,3.6416164E-5,320,15,0,200,0,0
19328001,epptendo,10,28721,1044,644,35,44,42.8855748935,40-49,772,8,6,6,12,12,6,6,2,1.25,1,5.008976206219273E-4,0.0984848485,0.8666667,214,407,3.162001656099139E-4,4.194078E-5,4.2485524E-5,266,30,0,200,0,0
19365670,torontodan,10,9707,1578,2000,74,1402,56.0346374228,50-59,743,7,187,292,479,479,187,292,7,2.2219618346,24226.2898119745,0.2556801252,0.0596998629,0.17598188,0,66,8.624636908560881E-4,0.0011264095,0.0011410398,140,82,1,200,1,0.005
19365951,Jen_PaquetPhoto,10,1393,96,222,0,10,22.0270317405,20-29,541,5,1,1,2,2,1,1,8,3.4489454302,0,5.993717866074103E-4,0,0,0,66,4.8505140895042504E-5,1.198308E-5,1.2138721E-5,140,0,0,198,0,0
19388993,jrdnovotny,10,1419,290,574,2,12,43.7215944128,40-49,607,6,13,29,42,42,13,29,7,2.520924004,570.2934703557,0.0170299799,0.06271777,0.20073892,0,66,8.827363022842374E-5,8.388156E-5,8.497105E-5,372,27,1,200,1,0.005
19453805,Mike_Bull,10,4173,158,271,2,2,37.4417530031,30-39,714,7,1,1,2,2,1,1,1,1,0,7.49471721243357E-5,0,0,255,485,2.9852402567743944E-4,1.198308E-5,1.2138721E-5,253,53,0,200,0,0
19492704,Andrew_MTL,10,3439,100,140,2,7,41.1112590993,40-49,654,6,1,5,6,6,1,5,7,2.9966521594,1.8790389135,1.848841174028515E-4,0.2666666667,0.4,0,66,4.6713925543511025E-5,1.198308E-5,1.2138721E-5,140,2,0,199,0,0
19495609,Fansen,10,12257,450,165,11,60,54.2657083809,50-59,752,8,94,49,143,143,94,49,6,2.5456980248,724.1691603057,0.1188360467,0.1048951049,0.2969567,0,66,2.82103476793923E-4,5.691963E-4,5.7658926E-4,47,115,0,200,0,0
19549528,culturejunky,10,1679,518,976,16,17,41.4707717523,40-49,623,5,5,18,23,23,5,18,7,2.8111817877,57.6032221746,0.0039528184,0.2588932806,0.4199134,0,66,5.772706270403931E-5,3.594924E-5,3.6416164E-5,140,0,0,200,0,0
19557595,MPJulian,10,4156,5268,3582,338,22,55.6668943153,50-59,773,7,535,351,886,886,535,351,6,2.1225309675,108077.59630317,0.5600178594,0.0390302381,0.11675714,0,66,0.002690418,0.0032114654,0.0032410386,390,371,6,199,6,0.0301507538
19568866,SheikYurbouti,10,40512,324,279,39,1,46.4424353748,40-49,785,8,4,7,11,11,4,7,7,2.9892869099,134.1634183671,0.0069023466,0.1545454545,0.375,0,66,6.373106688304122E-5,2.99577E-5,3.0346804E-5,140,9,21,202,21,0.103960396
19581788,brianlinca,10,5397,367,550,16,150,55.1247709577,50-59,673,6,4,7,11,11,4,7,7,2.9758955474,19.5351010839,0.0035159269,0.0272727273,0.0952381,0,66,6.148196481636623E-5,2.99577E-5,3.0346804E-5,55,7,0,200,0,0
19598120,MattKreutz,10,1702,210,212,7,25,27.9059299214,20-29,586,5,0,0,0,0,0,0,0,0,0,0,0,0,101,210,4.4780486537007367E-5,0,0,96,3,0,200,0,0
19599799,mwlcarter,10,560,194,306,5,2,22.8762548618,20-29,431,3,7,10,17,17,7,10,7,2.9752259792,290.4471359283,0.0176990125,0.1360294118,0.43939394,0,66,1.5704801125995628E-4,4.793232E-5,4.8554884E-5,390,9,1,200,1,0.005
19613023,BoGoWo,10,439,77,186,3,1,25.5438385832,20-29,412,4,3,9,12,12,3,9,7,2.9849347171,7.8985951488,0.0116563546,0.2196969697,0.47777778,0,66,7.684784164179283E-5,2.396616E-5,2.4277442E-5,390,1,0,200,0,0
19661657,jeffjedras,10,21003,2613,423,195,0,61.7166913628,60-69,785,8,311,75,386,386,311,75,6,2.4603280884,5040.5743415313,0.3902651388,0.0899064666,0.17573383,0,66,0.0016278273,0.0018693605,0.0018815018,140,218,0,200,0,0
19793293,AnthonyMartinNS,10,10349,1372,1142,55,30,53.8545639214,50-59,744,7,43,78,121,121,43,78,6,2.4824238366,2114.6095658873,0.0695771066,0.1181129477,0.34095162,0,66,2.834778764193477E-4,2.6362776E-4,2.6705186E-4,140,8,1,200,1,0.005
19801825,mari_katz,10,3428,160,445,4,57,29.4661261423,20-29,608,6,13,30,43,43,13,30,7,2.8198861734,17.5978762401,0.0118373839,0.2325581395,0.48752227,0,66,7.55034115040472E-5,8.388156E-5,8.497105E-5,390,3,0,199,0,0
19801933,ThomasMilne,10,5990,246,475,2,84,40.449948495,40-49,687,7,44,72,116,116,44,72,6,2.40609307,607.3357951837,0.0685566319,0.0832833583,0.33744133,0,66,1.6451499284833284E-4,2.696193E-4,2.7312123E-4,47,8,0,200,0,0
19812883,4got,10,14961,567,698,23,510,47.1312988899,40-49,733,8,139,194,333,333,139,194,6,2.2387010378,11962.9037055386,0.2110466689,0.0661293824,0.2481445,0,66,5.037014028490376E-4,8.388156E-4,8.497105E-4,47,85,5,209,4,0.023923445
19825011,Jamie_Brace,10,11257,680,1003,11,1993,51.4612116098,50-59,745,8,31,52,83,83,31,52,7,2.6481419484,1215.364894806,0.0342592705,0.107699089,0.26969856,0,66,1.5615864115659046E-4,1.9172928E-4,1.9421954E-4,390,30,1,201,1,0.0049751244
19881665,roseneath_rd,10,21124,1285,921,49,3,61.3865364809,60-69,780,7,149,90,239,239,149,90,7,2.5584198192,2584.9301770821,0.2439860989,0.1094722408,0.25053763,0,66,0.0011449755,8.98731E-4,9.104041E-4,140,124,3,200,3,0.015
19881863,laurinliu,10,1495,1616,806,96,9,50.766572545,50-59,707,5,216,121,337,337,216,121,7,2.4261801138,14057.5639612041,0.2678439699,0.1044581037,0.24398574,0,66,0.0012429371,0.0013001641,0.0012988432,390,115,0,200,0,0
19883894,grizzelda3,10,8475,300,684,4,309,44.4615049108,40-49,719,7,51,109,160,160,51,109,6,2.3264144627,1380.3906009819,0.0788426106,0.0878537736,0.27428338,0,66,2.024760846595146E-4,3.1156008E-4,3.1560674E-4,47,20,0,200,0,0
19918228,groovystiles,10,1569,499,611,10,7,44.940543003,40-49,657,6,75,98,173,173,75,98,7,2.5215935721,1461.5401700725,0.0991564136,0.1128511897,0.33905426,0,66,3.840514861467986E-4,4.5535705E-4,4.612714E-4,390,39,3,200,3,0.015
19957201,Killandra,10,14944,3034,3351,90,556,42.0639541236,40-49,683,6,26,86,112,112,26,86,6,2.3783059926,1239.1433233543,0.0510553182,0.1562902188,0.35177046,0,66,1.7142191788401012E-4,1.6177158E-4,1.6387274E-4,140,7,8,200,8,0.04
19996935,org9,10,67557,14277,2861,576,987,59.1086683229,50-59,819,9,268,237,505,505,268,237,6,2.2022095748,65352.6193660509,0.3022574924,0.0360207449,0.14470491,0,66,0.0011330231,0.0016117243,0.0016265886,47,96,0,211,0,0
20023516,JohnRiche,10,7849,925,1763,18,641,62.4224574646,60-69,763,7,39,83,122,122,39,83,6,2.4027452293,8923.1210437042,0.0490709232,0.106828343,0.28077403,0,66,1.979308022890266E-4,2.396616E-4,2.4277443E-4,390,53,0,202,0,0
20025826,mi_mcDonald,10,2070,718,1936,12,284,44.188635392,40-49,629,6,45,104,149,149,45,104,6,2.3495145631,3980.3091268316,0.0578433426,0.1052965717,0.3021513,0,66,2.1610862816862954E-4,2.7561083E-4,2.791906E-4,140,23,0,199,0,0
20036361,danielbroche,10,10502,3638,759,245,584,64.6363196049,60-69,777,7,7,5,12,12,7,5,2,1.375,40.05,5.639081614891891E-4,0.0909090909,0.30357143,0,56,7.419313879699045E-4,4.793232E-5,4.2485524E-5,320,7,0,201,0,0
20054216,andrewsutton,10,7171,237,426,10,570,57.4661414757,50-59,690,7,0,4,4,4,0,4,7,3.2064926372,0,0,0.1666666667,0.16666667,0,362,4.4780486537007367E-5,0,6.0693606E-6,140,3,0,200,0,0
20059077,postshaggy,10,15133,338,486,19,4,43.9132799375,40-49,711,7,3,7,10,10,3,7,7,3.0294609977,3471.9385891546,0.0075598424,0.1555555556,0.35714287,0,66,1.2070653595976372E-4,2.396616E-5,2.4277442E-5,55,3,0,200,0,0
20059181,oliviachow,10,3120,26911,319,1037,0,64.8743473679,60-69,816,5,902,44,946,946,902,44,7,2.6471375963,35132.0165562863,0.7031462433,0.039230623,0.058234733,0,66,0.0043611145,0.0054103606,0.0053471066,390,427,6,200,5,0.03
20078507,junekaiser,10,611,180,435,5,38,38.3008201669,30-39,504,5,10,36,46,46,10,36,7,2.6749246736,47.9628031096,0.0158654126,0.1975845411,0.37989205,0,66,8.292307524192554E-5,6.590694E-5,6.6762965E-5,390,3,1,200,1,0.005
20094273,LeighPatrick,10,25098,4215,3932,56,20,61.1097689467,60-69,798,9,91,90,181,181,91,90,6,2.4499497824,10709.9545680668,0.0501061151,0.0477593616,0.2639662,0,66,4.475203880301868E-4,5.5122166E-4,5.583812E-4,372,245,0,201,0,0
20168768,JElmhirst,10,302,139,299,1,8,40.3894710493,40-49,473,4,15,36,51,51,15,36,7,2.7653163709,61.9199513138,0.0224481228,0.1352941176,0.3984127,0,66,1.550392725200646E-4,9.586464E-5,9.710977E-5,140,0,1,200,1,0.005
20207497,MohammadAliZ,10,6861,626,514,10,390,45.0263626942,40-49,692,6,4,5,9,9,4,5,7,2.9075995983,1.0658669326,0.0118250629,0.0833333333,0.36666667,0,66,5.8481066523831634E-5,2.99577E-5,3.0346804E-5,47,1,0,201,0,0
20268038,FamilyAction,10,26,402,81,21,1,39.5768660469,30-39,574,5,21,11,32,32,21,11,6,2.9233344493,1164.8376180172,0.0256673662,0.1683467742,0.32671958,0,66,3.277008086855755E-4,1.3181388E-4,1.3352593E-4,372,7,0,28,0,0
20273815,AudreyHuntley,10,16848,1824,627,187,2,54.7696391976,50-59,764,7,66,28,94,94,66,28,7,2.7201205223,988.9815135458,0.0699665633,0.0974605353,0.20646021,0,66,3.399243594196883E-4,4.0143318E-4,4.0664716E-4,47,45,0,199,0,0
20370879,Oemissions,10,38352,496,1530,18,39,48.4386491914,40-49,674,9,58,86,144,144,58,86,6,2.3937060596,2093.064727635,0.0883215837,0.1153846154,0.25493664,0,66,2.2910483516131054E-4,3.5350086E-4,3.5809228E-4,47,14,0,205,0,0
20387713,maybo__oker,10,3801,95,379,4,13,41.9100343035,40-49,619,6,4,25,29,29,4,25,7,2.5865416806,84.2369910514,0.0064381272,0.2142857143,0.39384615,0,66,5.773468369101087E-5,2.99577E-5,3.0346804E-5,47,4,0,200,0,0
20446073,jec79,10,8715,1644,713,72,3,54.1565338461,50-59,742,7,208,75,283,283,208,75,6,2.4626715768,3352.1501186738,0.2984309696,0.0991905371,0.21558696,0,66,0.00144605,0.0012522319,0.001262427,140,118,3,200,3,0.015
20476018,4zim,10,10793,845,553,34,137,51.10655461,50-59,699,7,9,4,13,13,9,4,7,3.4077669903,312.776502674,0.017031829,0.1346153846,0.36666667,0,66,1.3019352133194457E-4,5.99154E-5,6.069361E-5,372,4,1,200,1,0.005
20508361,gwander,10,1348,94,102,2,4,,,494,4,0,0,0,0,0,0,0,0,0,0,0,0,224,426,4.4780486537007367E-5,0,0,218,0,0,199,0,0
20508681,robbutz,10,1065,387,446,21,70,35.3900130657,30-39,573,5,13,21,34,34,13,21,7,2.7766990291,132.0100823096,0.0122601401,0.0980392157,0.37229437,0,66,9.170444904791577E-5,8.388156E-5,8.497105E-5,390,2,0,201,0,0
20530732,progright,10,4168,622,1124,18,10,48.3256553307,40-49,681,6,101,142,243,243,101,142,6,2.2905925678,10728.4863130894,0.159451021,0.0827976737,0.27916667,0,66,5.940877049306876E-4,6.111371E-4,6.130054E-4,140,49,6,200,6,0.03
20537310,d_phrase,10,24952,669,760,22,31,58.8919023096,50-59,742,7,6,8,14,14,6,8,7,2.9993304319,203.1994341465,0.0039633938,0.0494505495,0.19444445,0,66,8.585036290282857E-5,4.194078E-5,4.2485524E-5,372,11,0,201,0,0
20565770,joelduggan,10,13384,1147,476,97,43,59.2630223065,50-59,756,8,2,2,4,4,2,2,8,3.8500167392,2980.7915386195,6.283052275745382E-4,0,0,0,66,1.1475081413112345E-4,1.797462E-5,1.8208082E-5,390,23,0,200,0,0
20594175,mdrohan,10,681,396,118,24,1,47.0850040843,40-49,615,3,21,10,31,31,21,10,7,2.8449949782,45.341378889,0.0529903893,0.1677419355,0.486166,0,66,2.589677749226389E-4,1.3181388E-4,1.3352593E-4,140,15,0,200,0,0
20611338,paulvieira,10,40094,3253,1376,188,104,57.6764796542,50-59,787,8,168,47,215,215,168,47,7,2.703381319,3929.3853811845,0.2461825281,0.1011736579,0.20860428,0,66,0.001595179,0.0010125702,0.0010196526,140,187,0,200,0,0
20636473,djsaiyan,10,9160,459,803,9,7,36.5523304446,30-39,679,6,0,1,1,1,0,1,7,3.7754350736,0,0,0,0,0,281,4.4780486537007367E-5,0,6.0693606E-6,372,1,0,200,0,0
20644763,YoSammiSam,10,16507,1401,227,26,471,54.2164874903,50-59,782,8,20,10,30,30,20,10,7,2.9394040844,133.8123854619,0.0140004795,0.1137931034,0.46052632,0,66,1.2903463993322987E-4,1.2582233E-4,1.2745657E-4,47,52,0,202,0,0
20679494,ibushfield,10,5243,1034,1523,50,7,61.5122401161,60-69,686,6,62,120,182,182,62,120,6,2.3143622364,6474.4586675135,0.0967099552,0.0810211888,0.2408889,0,66,4.715549218081111E-4,3.7746702E-4,3.8236973E-4,390,14,0,200,0,0
20692578,watkwen,10,258,41,102,1,8,22.1812356183,20-29,480,3,2,15,17,17,2,15,7,2.7673250753,0.8989324224,0.0063694241,0.2904411765,0.6142857,0,66,5.12021012990578E-5,1.797462E-5,1.8208082E-5,140,3,3,200,3,0.015
20697134,briannemett,10,7196,443,680,11,1158,49.7823212376,40-49,721,8,50,78,128,128,50,78,7,2.4402410445,1092.3877438298,0.0851531821,0.1012549213,0.3394958,0,66,2.5303865537064894E-4,3.0556854E-4,3.0346803E-4,47,20,0,201,0,0
20722511,EmmaJean_,10,12536,236,139,4,1944,43.0323920315,40-49,722,7,5,5,10,10,5,5,2,1.375,0,4.225773238620951E-4,0.1111111111,1,214,407,2.680031814096455E-4,3.594924E-5,3.6416164E-5,266,1,0,200,0,0
20753028,JohnCollison,10,33666,824,57,38,7,43.8559858904,40-49,782,9,52,5,57,57,52,5,7,2.900903917,117.0778797819,0.0746927712,0.1676065163,0.3116836,0,66,1.9476964998556552E-4,3.175516E-4,3.216761E-4,47,36,0,202,0,0
20872037,markalannixon,10,31148,230,841,2,37,49.192085972,40-49,735,8,1,3,4,4,1,3,7,3.0482089053,16.5822744391,0.0039942769,0.1666666667,0.5,0,66,5.115688777847722E-5,1.198308E-5,1.2138721E-5,55,2,0,201,0,0
20878297,ezralevant,10,15392,20133,420,720,4,69.7752989975,60-69,927,8,486,38,524,524,486,38,6,2.6996986943,22096.7287253423,0.3293595816,0.0423386803,0.06368101,0,66,0.0032966144,0.00291788,0.0029132932,372,942,2,200,2,0.01
20880992,Kalohamora,10,958,178,710,0,41,27.9320204368,20-29,510,5,0,1,1,1,0,1,1,1,0,0,0,0,2,540,4.4780486537007367E-5,0,6.0693606E-6,322,2,0,199,0,0
21039946,christofow,10,3524,237,175,4,8,42.6463060473,40-49,658,6,10,13,23,23,10,13,7,2.8550385002,28.6415648671,0.0097006862,0.1956521739,0.3888889,0,66,8.303105080651049E-5,6.590694E-5,6.6762965E-5,390,6,1,200,1,0.005
21060644,RTEditorDerek,10,3463,462,435,15,9,44.3387400976,40-49,652,5,18,30,48,48,18,30,6,2.7244727151,923.9730601721,0.0249596693,0.1050531915,0.3042017,0,66,1.764330448267436E-4,1.1383926E-4,1.1531785E-4,372,15,0,200,0,0
21134069,Rylee_Ann,10,19950,616,1008,9,1694,39.1542181883,30-39,747,8,97,199,296,296,97,199,6,2.208235688,6876.6581655639,0.1378459162,0.0716674301,0.2357214,0,66,2.811969679125451E-4,5.8717094E-4,5.9479737E-4,47,44,2,204,2,0.0098039216
21139166,jordan_press,10,8876,1470,716,75,31,54.6678410421,50-59,736,7,133,54,187,187,133,54,7,2.5972547707,3526.8880226474,0.1999094142,0.0934678857,0.21604407,0,66,0.0011270182,8.0286636E-4,8.132943E-4,140,73,19,200,18,0.095
21243718,erikmistal,10,4029,1524,1715,38,0,53.6814361475,50-59,689,6,73,118,191,191,73,118,6,2.3140274523,4215.2475015324,0.1081728404,0.0869109948,0.31387445,0,66,3.227205270741852E-4,4.4337395E-4,4.491327E-4,140,5,2,200,2,0.01
21263260,pothen,10,9052,375,374,16,28,47.182253179,40-49,748,7,89,80,169,169,89,80,6,2.4573150318,4710.2703104849,0.1249655484,0.130776275,0.30771455,0,66,4.059844225004298E-4,5.392386E-4,5.4624246E-4,390,35,3,200,3,0.015
21269439,pattyk13,10,2422,124,276,1,269,45.9015309836,40-49,647,6,17,31,48,48,17,31,7,2.7455641111,156.0327672978,0.0160760744,0.1117021277,0.30840337,0,66,1.0494828785367013E-4,1.0784772E-4,1.0924849E-4,47,20,0,200,0,0
21312083,_katieconway,10,873,360,367,9,15,40.0072452072,40-49,608,5,1,1,2,2,1,1,8,4.4204887847,0,8.270926887873718E-5,0,0,0,66,1.0207987623313145E-4,1.198308E-5,1.2138721E-5,320,4,0,200,0,0
21315649,SeedyRoads,10,12163,568,823,11,5003,52.2660514557,50-59,714,8,183,225,408,408,183,225,6,2.1988617342,18672.4051662914,0.2233502819,0.0470323264,0.23624837,0,66,5.095552824244707E-4,0.0011024433,0.0011167624,47,124,16,229,12,0.0698689956
21349417,Jatsimpleposie,10,13324,1074,1658,41,359,,,734,7,166,211,377,377,166,211,6,2.1801138266,16271.2571203536,0.2659707574,0.0576358711,0.2442229,0,66,6.767611485520573E-4,0.0010005871,0.0010075138,47,76,11,207,11,0.0531400966
21357830,mrdanielha,10,350,128,235,2,5,34.1162404003,30-39,515,4,0,0,0,0,0,0,0,0,0,0,0,0,100,209,4.4780486537007367E-5,0,0,95,10,0,201,0,0
21379617,Manitobalex,10,32815,337,285,22,91,46.3301739863,40-49,774,8,16,4,20,20,16,4,7,2.9882825578,12.0078878925,0.0152965372,0.1973684211,0.40808824,0,66,9.999365261716786E-5,1.0185618E-4,1.0317913E-4,372,13,0,202,0,0
21421397,bruce_in,10,2063,106,108,4,4,40.2047678196,40-49,626,6,0,0,0,0,0,0,0,0,0,0,0,0,69,165,4.4780486537007367E-5,0,0,61,2,0,200,0,0
21422925,newcybersol,10,5545,181,581,4,9,47.2632375952,40-49,676,7,2,5,7,7,2,5,7,3.1499832608,3134.8208630617,7.76148498237197E-4,0.0952380952,0.25,0,66,6.490196350534426E-5,1.797462E-5,1.8208082E-5,372,12,0,199,0,0
21423190,MsMarieB,10,18495,382,256,4,990,49.3501072749,40-49,733,8,11,5,16,16,11,5,7,2.9266822899,43.5860467074,0.0190384321,0.1,0.22727273,0,66,9.291509593354949E-5,7.189848E-5,7.283233E-5,390,10,0,202,0,0
21448068,hannahbethbell,10,12238,1106,896,42,1432,57.4530014265,50-59,762,8,7,15,22,22,7,15,7,2.9159691999,9.6620064568,0.0090501303,0.1883116883,0.3859649,0,66,8.144128313810582E-5,4.793232E-5,4.8554884E-5,140,3,1,200,1,0.005
21460797,adamq112,10,10285,487,696,20,155,55.3807668533,50-59,739,7,87,86,173,173,87,86,7,2.5225979243,1984.2116193685,0.1035259682,0.1381234037,0.3424545,0,66,4.012245123419778E-4,5.272555E-4,5.341037E-4,140,92,5,203,5,0.0246305419
21510079,8skylark,10,3812,406,857,9,68,43.6311698004,40-49,641,7,14,29,43,43,14,29,6,2.4840977569,23.8425101545,0.0306842489,0.1301218162,0.46059114,0,66,8.515409995176238E-5,8.98731E-5,9.104041E-5,140,4,0,201,0,0
21515380,danspeerin,10,15346,1161,895,39,523,61.8439460584,60-69,761,7,110,45,155,155,110,45,7,2.5480415132,1923.9742749138,0.1613214307,0.1159195643,0.25271842,0,66,5.025837122284403E-4,6.6506094E-4,6.73699E-4,47,66,2,200,2,0.01
21545704,ndnstyl,10,61038,1508,1813,43,843,43.7594025284,40-49,774,10,69,39,108,108,69,39,7,2.749916304,1689.3080693066,0.0540928404,0.0834198685,0.25957376,0,66,2.8427495100528423E-4,4.194078E-4,4.2485524E-4,47,46,0,204,0,0
21547158,ThePhotowagon,10,3618,269,253,12,292,47.0240082548,40-49,652,6,29,32,61,61,29,32,7,2.5396719116,681.5397687737,0.0419218727,0.0849726776,0.35064012,0,66,1.3604539303221767E-4,1.797462E-4,1.8208082E-4,47,43,1,200,1,0.005
21576515,alexabboud,10,18354,1911,697,98,963,58.1134998228,50-59,766,8,39,21,60,60,39,21,7,2.8128557081,378.1158259986,0.0415656151,0.1073446328,0.246531,0,66,2.926812165883812E-4,2.396616E-4,2.4277443E-4,372,18,0,200,0,0
21594028,GlennThibeault,10,2498,3083,673,227,0,55.2731213381,50-59,730,6,275,88,363,363,275,88,7,2.5078674255,11038.6419630367,0.3365814123,0.1008249243,0.21616685,0,66,0.0016563186,0.001653665,0.0016690742,390,127,7,200,7,0.035
21610572,buddhaontheroad,10,7730,393,795,17,329,50.4292950003,50-59,711,6,18,39,57,57,18,39,7,2.5480415132,379.7735118724,0.0305437859,0.1118421053,0.2780127,0,66,1.234962014436607E-4,1.1383926E-4,1.1531785E-4,390,3,0,202,0,0
21622781,MikeSeager,10,5809,1795,2002,32,111,50.5871635321,50-59,669,7,35,41,76,76,35,41,7,2.7833947104,1237.2950127831,0.0161089167,0.0826315789,0.4010101,0,66,1.745883963199134E-4,2.1569544E-4,2.1849698E-4,372,23,0,202,0,0
21625747,RedAloud,10,10169,577,842,23,83,53.4814268082,50-59,738,7,63,72,135,135,63,72,7,2.5169065952,941.0905308606,0.0915395687,0.1351575456,0.3975364,0,66,3.152942101384842E-4,3.8345857E-4,3.8843908E-4,390,104,0,201,0,0
21665234,Uranowski,10,49425,3631,3295,213,1304,62.2800047216,60-69,802,9,340,343,683,683,340,343,6,2.1255440241,53415.4517845325,0.4107937444,0.0461157649,0.15187182,0,66,0.001571783,0.0020431152,0.002069652,140,163,4,202,3,0.0198019802
21671326,NatStechyson,10,2724,631,300,38,0,47.854733011,40-49,677,6,38,22,60,60,38,22,7,2.7753598929,639.0001818042,0.0593178369,0.1259887006,0.25346938,0,66,5.506536083894122E-4,2.3367006E-4,2.3670506E-4,372,11,2,200,2,0.01
21767372,FriendlyLawyer,10,3802,222,325,14,4,41.6038512321,40-49,627,6,21,33,54,54,21,33,7,2.6548376297,802.4263448953,0.0351781746,0.1624737945,0.45816463,0,66,1.3499390764531516E-4,1.3181388E-4,1.3352593E-4,140,11,0,200,0,0
21773382,RichardNorthern,10,1252,517,889,10,7,43.5687237665,40-49,634,5,84,129,213,213,84,129,6,2.3860060261,2145.7740547606,0.1081885749,0.1281114359,0.3882853,0,66,4.123849714339515E-4,5.092809E-4,5.1589566E-4,390,22,1,200,1,0.005
21790920,brianlogan,10,7233,208,103,2,119,41.623816278,40-49,698,6,1,0,1,1,1,0,0,0,0,7.49471721243357E-5,0,0,0,245,4.58919816623078E-5,1.198308E-5,0,47,3,0,201,0,0
21825027,DanFmTo,10,2223,121,241,8,166,51.0061842478,50-59,658,6,17,14,31,31,17,14,6,2.6534984935,74.6278353441,0.0239177322,0.1150537634,0.22461538,0,66,8.967857112159632E-5,1.0784772E-4,1.0924849E-4,390,38,0,201,0,0
21832884,chrisjamesdrew,10,20769,2954,3249,216,399,63.8811179594,60-69,769,8,136,154,290,290,136,154,7,2.3766320723,18734.2447367981,0.1573792559,0.067975182,0.194752,0,66,8.566548300099985E-4,8.20841E-4,8.3150243E-4,140,84,0,201,0,0
21875285,joewozny,10,1007,820,893,12,0,44.324193476,40-49,590,5,1,1,2,2,1,1,7,3.4482758621,0,5.838949913772955E-4,0,0,0,66,4.845255995854407E-5,1.198308E-5,1.2138721E-5,140,1,0,200,0,0
21889071,katiemjy,10,20177,870,1394,30,243,47.1999198366,40-49,773,8,108,142,250,250,108,142,6,2.2751925008,2464.8279832865,0.1698917155,0.0977991968,0.30373397,0,66,3.4107812272966365E-4,6.5307785E-4,6.6156033E-4,47,21,0,200,0,0
22065687,rayformayor,10,4394,173,336,0,723,39.2536896143,30-39,633,6,10,11,21,21,10,11,6,2.6203548711,224.9239014819,0.013030152,0.069047619,0.30128205,0,66,7.265940708632499E-5,6.590694E-5,6.6762965E-5,47,13,0,200,0,0
22094253,Omega_,10,2891,135,159,15,4,44.982753182,40-49,653,6,5,3,8,8,5,3,7,3.0562437228,1.8516691687,0.0144234879,0.125,0.45,0,66,1.0658218935157425E-4,3.594924E-5,3.6416164E-5,55,4,0,200,0,0
22100885,MatthewFCarroll,10,242,343,243,10,1,38.1420166665,30-39,557,4,43,40,83,83,43,40,7,2.5346501507,723.0907269368,0.0493309986,0.1178372025,0.28004807,0,66,2.339157800860564E-4,2.6362776E-4,2.6705186E-4,55,14,0,200,0,0
22104519,zita_dulock,10,13711,1139,1760,44,634,51.0529620571,50-59,771,8,33,72,105,105,33,72,6,2.5671242049,1290.0982265465,0.0207522715,0.0835164835,0.25786746,0,66,1.6900869199498874E-4,2.0371236E-4,2.0635827E-4,372,31,0,201,0,0
22147325,joshstuart,10,5193,1469,1317,87,103,56.1227925772,50-59,686,7,45,69,114,114,45,69,7,2.5085369936,1174.7352657638,0.0874698947,0.1165968017,0.36254463,0,66,3.0742740575675706E-4,2.7561083E-4,2.791906E-4,390,10,1,200,1,0.005
22166737,DrMJW,10,353,51,249,3,11,23.9703339495,20-29,333,4,4,29,33,33,4,29,7,2.6812855708,23.4419086175,0.0068038399,0.2765151515,0.47956988,0,66,6.4787573281212E-5,2.99577E-5,3.0346804E-5,140,1,0,200,0,0
22224357,TZohner,10,4359,153,262,2,8,44.866242021,40-49,665,6,15,23,38,38,15,23,6,2.5132239705,106.2725127687,0.0170485104,0.1507823613,0.3731527,0,66,9.095798949476147E-5,9.586464E-5,9.710977E-5,55,6,1,200,1,0.005
22229462,glyn1123,10,7838,887,1060,13,9,45.0122908332,40-49,660,7,93,121,214,214,93,121,6,2.2644794108,4953.0528813435,0.1441734394,0.0582686148,0.2715054,0,66,3.340749513922383E-4,5.6320475E-4,5.705199E-4,47,21,4,201,4,0.0199004975
22244391,ParmGill,10,1569,1548,185,102,5,50.6045869511,50-59,701,5,101,21,122,122,101,21,7,2.8148644125,366.8488996737,0.1241016373,0.1389378133,0.23122187,0,66,7.570160829890211E-4,6.111371E-4,6.0693605E-4,372,56,23,200,23,0.115
22253014,JuanPittau,10,34334,9894,8333,326,10,59.5979097751,50-59,779,8,9,8,17,17,9,8,8,3.5955808504,26301.0706915637,7.792743382666259E-4,0,0,0,66,4.893688019295989E-4,5.99154E-5,5.4624245E-5,320,12,0,201,0,0
22277694,steveouthouse,10,2060,921,313,27,8,41.2030715536,40-49,628,5,63,27,90,90,63,27,6,2.6866421158,5520.7907614056,0.1092806104,0.1420724095,0.3389234,0,66,6.695822336393884E-4,3.8345857E-4,3.8843908E-4,372,25,0,200,0,0
22279004,MurfAD,10,56824,395,302,9,13,42.7756354292,40-49,781,9,21,34,55,55,21,34,6,2.6226983596,574.7067414633,0.0299752035,0.1535353535,0.36627907,0,66,1.4509533190053075E-4,1.3181388E-4,1.3352593E-4,140,8,1,206,1,0.0048543689
22303151,robertlavigne,10,11033,271,502,5,16,49.2696483862,40-49,728,8,66,62,128,128,66,62,7,2.5406762638,2217.9416632231,0.1031279788,0.1258612205,0.29960024,0,66,3.3960757654687303E-4,4.0143318E-4,4.0664716E-4,140,49,0,202,0,0
22313084,JamesRADunn,10,92,16,71,0,41,23.8016531743,20-29,258,2,0,6,6,6,0,6,7,2.9725568942,0,0,0.4666666667,0.8333333,0,353,4.4780486537007367E-5,0,6.0693606E-6,140,4,0,102,0,0
22329923,fwhite46,10,176,10,25,0,2,16.9166760892,10-19,220,3,0,2,2,2,0,2,7,3.4263721553,0,0,0,0,0,326,4.4780486537007367E-5,0,6.0693606E-6,372,1,0,180,0,0
22330357,Canadian_Hockey,10,21955,7694,33,397,0,49.6379571617,40-49,736,5,10,1,11,11,10,1,7,3.2668228992,8.1108108833,0.003890941,0.0454545455,0.06363636,0,66,7.179973849982399E-5,6.590694E-5,6.6762965E-5,47,2,0,201,0,0
22333382,schizoidman,10,7361,535,1573,22,7,44.2907146613,40-49,704,7,29,86,115,115,29,86,6,2.3983930365,1469.1352304483,0.0535146152,0.1262395118,0.3196186,0,66,1.798347431400627E-4,1.797462E-4,1.8208082E-4,140,4,0,200,0,0
22372121,TraceyKent,10,39658,1782,1893,63,128,53.8351843939,50-59,807,9,295,360,655,655,295,360,7,2.1161700703,55511.0447580593,0.3547478266,0.0444732358,0.1618241,0,66,0.0010402262,0.0017734958,0.0017965308,47,334,0,201,0,0
22372600,richardlorello,10,11492,622,694,26,24,51.4045153294,50-59,772,7,120,153,273,273,120,153,7,2.2705055239,9869.3848551993,0.1709585082,0.0713612368,0.26757628,0,66,3.8704651963758133E-4,7.2497636E-4,7.343926E-4,47,100,0,201,0,0
22420494,incomplete2009,10,4914,369,864,10,14,41.9668616765,40-49,670,6,53,133,186,186,53,133,6,2.2718446602,1418.7563752091,0.0962139218,0.1164487068,0.33138818,0,66,2.0196745218583107E-4,3.2354315E-4,3.2774548E-4,140,11,1,199,1,0.0050251256
22505409,cwilhelmson,10,8530,1785,1790,101,14,58.793895298,50-59,735,7,62,64,126,126,62,64,6,2.4499497824,7274.9425856091,0.0815923897,0.0826666667,0.22946317,0,66,4.059018734290695E-4,3.7746702E-4,3.8236973E-4,55,42,0,200,0,0
22574670,hot_sushi,10,836,146,512,1,6,,,552,4,15,36,51,51,15,36,7,2.5694676933,31.9186147321,0.0262863453,0.1537254902,0.3974359,0,66,7.884941462973292E-5,9.586464E-5,9.710977E-5,47,0,0,200,0,0
22636784,climbrandon,10,12142,1040,1737,46,231,60.5055062362,60-69,733,7,68,122,190,190,68,122,6,2.4004017409,5826.772331799,0.1072009021,0.1188526873,0.29315135,0,66,3.8616663912251236E-4,4.1341624E-4,4.1878587E-4,140,22,0,200,0,0
22700185,peterlouwe,10,2912,1305,1261,22,4,46.6316528912,40-49,642,6,29,44,73,73,29,44,7,2.5704720455,969.9411868521,0.0313659327,0.0395738204,0.160148,0,66,1.9165358922912978E-4,1.797462E-4,1.8208082E-4,55,8,0,200,0,0
22717349,Piikaaksin,10,20286,770,1139,15,282,48.9750278615,40-49,734,7,68,45,113,113,68,45,7,2.6233679277,1375.5859673722,0.0560346222,0.0911030341,0.257273,0,66,2.496709186439643E-4,4.1341624E-4,4.1878587E-4,47,56,0,199,0,0
22733545,PitchforkTorchz,10,10823,747,442,17,614,51.7559895966,50-59,747,8,111,44,155,155,111,44,7,2.5423501841,706.2045040965,0.1175853853,0.1186007541,0.23392436,0,66,2.9516427255141286E-4,6.710525E-4,6.797684E-4,47,71,0,203,0,0
22758206,PluckyDog,10,84,17,57,0,16,18.515042871,10-19,121,3,0,2,2,2,0,2,7,3.25,0,0,0,0,0,469,4.4780486537007367E-5,0,6.0693606E-6,390,0,0,104,0,0
22787990,chewinglass,10,20546,1176,1992,36,115,52.6874357713,50-59,750,8,151,248,399,399,151,248,6,2.1566789421,11223.4392864394,0.2298658833,0.069520535,0.25316513,0,66,4.596259776743724E-4,9.107141E-4,9.225428E-4,47,37,1,204,1,0.0049019608
22819266,msunielsen,10,1860,334,1625,2,43,40.2851197569,40-49,553,6,1,5,6,6,1,5,7,2.9902912621,8.6195193153,8.607401234308447E-4,0.0666666667,0.15,0,66,4.726064281692426E-5,1.198308E-5,1.2138721E-5,47,1,0,200,0,0
22853441,katinedmonton,10,361,23,77,1,11,28.0260605451,20-29,476,4,0,1,1,1,0,1,8,3.7426372155,0,0,0,0,0,108,4.4780486537007367E-5,0,6.0693606E-6,140,2,0,199,0,0
22868993,lawrence_thomas,10,2033,974,1881,21,8,43.5014701705,40-49,617,6,5,15,20,20,5,15,6,2.6484767325,135.6391556039,0.0065054951,0.0921052632,0.24761905,0,66,6.110676555541325E-5,3.594924E-5,3.6416164E-5,140,2,0,200,0,0
22976448,jayfanmanitoba,10,2314,107,702,1,281,28.0192429327,20-29,366,6,26,95,121,121,26,95,7,2.4298627385,865.4929133712,0.0320162067,0.1243112948,0.26709446,0,66,1.0538892687637913E-4,1.6177158E-4,1.6387274E-4,140,0,7,215,7,0.0325581395
23009685,Sweetthang30,10,1061,91,679,1,0,21.1617114208,20-29,368,4,0,4,4,4,0,4,7,3.2904953146,0,0,0.0833333333,0.16666667,0,296,4.4780486537007367E-5,0,6.0693606E-6,47,0,0,200,0,0
23014499,cyclingzealot,10,1138,230,86,28,1,43.8455839806,40-49,560,5,16,9,25,25,16,9,7,2.8433210579,41.9922738407,0.0269062501,0.16,0.2987013,0,66,1.4377141860134245E-4,1.0185618E-4,1.0317913E-4,140,14,1,200,1,0.005
23020091,seanmoore80,10,8633,1390,1880,20,14,51.396663327,50-59,737,8,145,195,340,340,145,195,6,2.1971878139,6348.1590082634,0.2186538526,0.0711695298,0.2632483,0,66,4.936697285895131E-4,8.747648E-4,8.8612665E-4,47,54,1,202,1,0.004950495
23121610,Starfishlb,10,2054,30,157,0,12,29.3479812939,20-29,610,6,2,1,3,3,2,1,7,3.1017743555,0,0.0024669063,0.1666666667,1,0,66,4.717867437035941E-5,1.797462E-5,1.8208082E-5,47,0,0,200,0,0
23130850,DaleJr288,10,21093,662,1998,12,38,45.3108522994,40-49,741,9,56,165,221,221,56,165,6,2.2474054235,3264.3245262647,0.0839639435,0.120670506,0.2527776,0,66,1.9337742567557343E-4,3.4151776E-4,3.4595357E-4,390,13,0,199,0,0
23159696,ugottabekiddin,10,67988,1983,2119,63,2032,,,879,9,417,406,823,823,417,406,6,2.0857047205,88518.5236139636,0.4110261123,0.0344697608,0.12876494,0,66,0.0013137629,0.0025044638,0.0025187847,47,693,2,234,2,0.0085470085
23167983,YasminSadie,10,24832,1389,949,40,271,57.688574611,50-59,785,8,138,156,294,294,138,156,6,2.3039839304,15587.2422248517,0.1687600053,0.0781152051,0.23390955,0,66,4.720927188152344E-4,8.3282404E-4,8.436411E-4,47,48,1,199,1,0.0050251256
23241468,JackpineLiam,10,6429,1174,2001,21,896,67.8043743285,60-69,723,7,26,52,78,78,26,52,7,2.6776029461,1569.9087130006,0.0364701808,0.1153846154,0.25064003,0,66,1.6912987323190276E-4,1.6177158E-4,1.6387274E-4,140,17,0,201,0,0
23259960,trevorcharles,10,680,360,1006,16,12,46.4712850622,40-49,589,5,20,37,57,57,20,37,7,2.6431201875,12127.1584651537,0.012798326,0.0845864662,0.23658536,0,66,2.8161615848828933E-4,1.2582233E-4,1.2138722E-4,55,108,4,200,4,0.02
23263454,cehenne,10,8748,1604,653,100,2,54.2131475686,50-59,738,7,58,31,89,89,58,31,7,2.671911617,538.0254729962,0.089448783,0.1391726251,0.27600887,0,66,4.577005440589379E-4,3.5350086E-4,3.5809228E-4,140,14,4,200,4,0.02
23335823,lobbycanada,10,2266,1025,1246,58,13,41.3047397931,40-49,627,5,84,160,244,244,84,160,6,2.1951791095,5557.0371872382,0.1614136609,0.1035890171,0.28030255,0,66,4.1837995824380947E-4,5.092809E-4,5.1589566E-4,140,9,1,200,1,0.005
23399192,nealjennings,10,72866,1656,1273,84,1052,56.8408941712,50-59,795,9,41,24,65,65,41,24,7,2.6692333445,477.583778953,0.0578330264,0.1057692308,0.26196077,0,66,2.3951704890818449E-4,2.5164467E-4,2.5491315E-4,55,42,0,201,0,0
23467434,LizT1,10,4042,4835,1997,260,0,57.6487783886,50-59,756,6,424,233,657,657,424,233,6,2.2142618011,38083.9036262333,0.5545751642,0.0593908936,0.14760914,0,66,0.002797904,0.0025464045,0.0025612703,140,56,5,200,5,0.025
23533926,AminahMS,10,8157,339,216,0,3077,42.2794639561,40-49,717,7,2,1,3,3,2,1,2,1.5,0,1.514327029770266E-4,0.1666666667,1,275,520,2.9852402567743933E-4,1.797462E-5,1.8208082E-5,297,34,0,197,0,0
23534420,tararobertson,10,20859,1311,458,135,250,,,759,8,6,5,11,11,6,5,8,3.4248409776,1110.6188198109,0.0028664253,0.0818181818,0.22222222,0,66,9.176843158322455E-5,4.194078E-5,4.2485524E-5,372,6,0,200,0,0
23633041,bevincate,10,3599,276,450,2,17,49.9940532371,40-49,630,6,18,38,56,56,18,38,7,2.6116504854,140.2470665796,0.0243052098,0.1688311688,0.45296168,0,66,1.376244583385802E-4,1.1383926E-4,1.1531785E-4,390,11,1,200,1,0.005
23648440,catsagogo,10,5209,364,848,12,12,41.1897361709,40-49,664,7,73,151,224,224,73,151,6,2.2450619351,2657.23583736,0.135854545,0.0970731903,0.28755674,0,66,2.553053154978407E-4,4.4337395E-4,4.491327E-4,47,3,0,200,0,0
23676939,ALXV5,10,5211,304,794,12,18,43.2451274,40-49,671,7,24,64,88,88,24,64,6,2.4733846669,3935.6706989982,0.0264210905,0.1294409613,0.2973843,0,66,1.1401930976309062E-4,1.497885E-4,1.5173401E-4,372,18,0,201,0,0
23695888,iamtedking,10,6684,17399,413,1147,271,71.7070800402,70-79,803,7,7,0,7,7,7,0,0,0,0,0.0028615613,0,0,0,29,2.224331593169507E-4,4.793232E-5,0,43,26,0,200,0,0
23698727,SusanFelicity,10,122028,2430,2543,97,1275,55.8238273334,50-59,857,10,226,251,477,477,226,251,6,2.1814529628,31333.2399839062,0.2958547067,0.0532389056,0.18823774,0,66,7.375878086276215E-4,0.0013600796,0.0013777448,47,579,3,209,3,0.014354067
23713082,mjamesanderson,10,2633,456,452,10,116,60.5713373319,60-69,673,6,57,48,105,105,57,48,7,2.6374288584,1488.3329144254,0.0629441806,0.115018315,0.32710108,0,66,2.8981148308002505E-4,3.475093E-4,3.520229E-4,390,23,0,200,0,0
23764854,AlysonFair,10,3641,556,515,22,5,46.25316068,40-49,617,6,41,62,103,103,41,62,6,2.4804151322,1546.5096772756,0.0946747451,0.1811345898,0.5254054,0,66,5.052542872575658E-4,2.5164467E-4,2.5491315E-4,140,10,1,200,1,0.005
23768120,bdydbl,10,41708,3465,2440,87,77,53.8068303741,50-59,782,9,49,49,98,98,49,49,6,2.5085369936,1447.2570024656,0.0616562812,0.0537555228,0.31711915,0,66,2.2208835882976983E-4,2.99577E-4,3.0346803E-4,140,44,0,202,0,0
23797435,RobTrewartha,10,2342,293,581,2,4,40.5595436853,40-49,652,5,26,40,66,66,26,40,6,2.5892199531,127.1472378245,0.0402374361,0.1834498834,0.45058823,0,66,1.7249061075812048E-4,1.6177158E-4,1.6387274E-4,140,4,0,200,0,0
23829086,JordicusMaximus,10,2208,118,325,1,54,37.2312559834,30-39,611,5,2,6,8,8,2,6,7,2.932038835,4.1463833002,0.003531351,0.0892857143,0.23333333,0,66,5.082529066547927E-5,1.797462E-5,1.8208082E-5,55,2,0,200,0,0
23926358,web20_freenet,10,105989,278,18,8,0,39.2177691034,30-39,674,4,0,0,0,0,0,0,0,0,0,0,0,0,137,269,4.4780486537007367E-5,0,0,134,0,0,201,0,0
23968956,KatyChancey,10,12503,779,681,55,280,51.8313480608,50-59,739,7,9,7,16,16,9,7,7,2.9805825243,138.1866325568,0.013180921,0.1166666667,0.29545453,0,66,8.667023151679125E-5,5.99154E-5,6.069361E-5,390,1,0,200,0,0
23979828,graciestyle,10,53816,4049,1882,167,75,56.2962204778,50-59,831,8,188,135,323,323,188,135,6,2.3833277536,20287.5132083395,0.2292268162,0.0604195912,0.16392633,0,66,0.0016026813,0.001132401,0.0011410398,372,307,0,203,0,0
24004837,gillyadam,10,6860,432,364,4,68,42.8921111281,40-49,720,7,5,5,10,10,5,5,1,1,12412,3.956172996002823E-4,0.0888888889,0.55,0,49,5.881934283396008E-4,3.594924E-5,3.6416164E-5,27,39,0,200,0,0
24031034,daveschulz,10,11898,474,922,11,14,46.7307114779,40-49,678,7,19,35,54,54,19,35,6,2.6431201875,159.7716072714,0.0295862966,0.1467505241,0.41700405,0,66,1.9613922761978924E-4,1.198308E-4,1.2138722E-4,372,2,0,200,0,0
24087168,kdorse,10,2573,534,715,18,26,49.7863651864,40-49,687,6,91,152,243,243,91,152,6,2.3083361232,2985.8084604397,0.1448568857,0.1133727851,0.3630993,0,66,5.13370286418473E-4,5.5122166E-4,5.583812E-4,390,84,6,200,6,0.03
24116965,campbelljustin,10,9618,534,801,15,119,48.2183696541,40-49,735,7,49,54,103,103,49,54,6,2.6705724807,55392.3901546303,0.026800511,0.0579668761,0.21949404,0,66,2.861873970319508E-4,2.99577E-4,3.0346803E-4,372,52,6,203,6,0.0295566502
24121325,O2L,10,2341,256,243,4,11,42.6083299878,40-49,627,6,0,0,0,0,0,0,0,0,0,0,0,0,139,273,4.4780486537007367E-5,0,0,136,0,0,199,0,0
24306594,PMagouirk,10,6211,509,341,10,2947,51.7567634145,50-59,746,7,29,28,57,57,29,28,6,2.6431201875,525.0743831651,0.0275098534,0.0664160401,0.36774194,0,66,1.4621465451342984E-4,1.797462E-4,1.8208082E-4,47,119,0,200,0,0
24384002,lebatailleur,10,23799,535,464,19,47,44.3236452005,40-49,748,9,3,2,5,5,3,2,8,3.2216270506,6.6899809548,0.0012559726,0.05,0.16666667,0,66,6.0445403596684415E-5,2.396616E-5,2.4277442E-5,47,6,0,202,0,0
24421289,cnjazvac,10,9923,416,352,4,192,56.04981021,50-59,699,7,60,68,128,128,60,68,7,2.5621024439,1662.0328352633,0.0823522405,0.1649852362,0.45532727,0,66,3.1755796373140164E-4,3.6548392E-4,3.70231E-4,390,44,2,200,2,0.01
24444891,CreeClayton,10,2566,3530,1965,153,144,71.6344081684,70-79,756,6,195,100,295,295,195,100,6,2.3625711416,22591.5217782129,0.1896091554,0.059356624,0.13335946,0,66,0.0012832027,0.0011743419,0.0011895947,47,69,0,199,0,0
24474900,PaulCalandra,10,700,2108,619,157,0,46.5304775901,40-49,667,3,124,23,147,147,124,23,7,2.7217944426,677.7951654363,0.1500677108,0.1244059268,0.21628937,0,66,9.85772962290476E-4,7.489425E-4,7.4653135E-4,372,26,0,201,0,0
24497152,Eddie_Gravity,10,12422,274,443,2,18,46.6109544164,40-49,737,7,4,4,8,8,4,4,7,3.265818547,1.2025971141,0.0040219659,0.2142857143,0.46666667,0,66,5.382952073708526E-5,2.99577E-5,3.0346804E-5,140,15,0,200,0,0
24597118,charlielapin,10,17102,253,320,6,200,59.5349613095,50-59,740,8,3,8,11,11,3,8,7,3.1429527954,2.5570069274,0.0016531316,0.2272727273,0.5555556,0,66,6.0086853027491336E-5,2.396616E-5,2.4277442E-5,140,6,0,201,0,0
24598043,CorComm,10,3857,369,300,9,25,57.0323314853,50-59,695,6,51,39,90,90,51,39,7,2.7191161701,538.1589646559,0.0845050372,0.1656679151,0.33877194,0,66,3.728297884161908E-4,3.1156008E-4,3.1560674E-4,140,72,0,201,0,0
24639266,LadySnarksalot,10,98356,1731,782,76,8913,56.2149663326,50-59,827,10,83,41,124,124,83,41,7,2.6692333445,1225.0084248361,0.1019911762,0.0858248099,0.22873865,0,66,3.4676281033654295E-4,5.0328934E-4,5.098263E-4,47,116,0,205,0,0
24696861,grreengirl,10,1062,137,386,2,16,24.8431342937,20-29,534,5,22,64,86,86,22,64,7,2.546702377,127.6446643695,0.0497019384,0.2024623803,0.3935135,0,66,1.632904051114884E-4,1.3780541E-4,1.395953E-4,390,2,3,199,3,0.0150753769
24697131,krakout,10,1142,112,104,2,6,36.4642755472,30-39,578,5,2,1,3,3,2,1,1,1,2,1.4989434424867142E-4,0,0,45,130,5.522675648178714E-4,1.797462E-5,1.8208082E-5,75,4,0,199,0,0
24717531,sandra_harris,10,6058,484,261,9,318,47.7481282427,40-49,701,7,78,59,137,137,78,59,7,2.4422497489,709.7006808396,0.1081188279,0.1152855303,0.3929307,0,66,2.1489715729630128E-4,4.7333166E-4,4.794795E-4,47,47,0,200,0,0
24727570,leighhanssen,10,5455,551,543,24,156,44.2148712663,40-49,680,6,37,43,80,80,37,43,7,2.4660194175,262.1678348513,0.0749010387,0.0808544304,0.4704017,0,66,1.7064144038780302E-4,2.2767852E-4,2.306357E-4,47,6,0,200,0,0
24757830,Tumitravel,10,4563,8057,1185,298,2122,71.3660488988,70-79,774,7,1,1,2,2,1,1,8,3.5301204819,5976,7.49471721243357E-5,0,0,0,446,9.990168110805797E-5,1.198308E-5,1.2138721E-5,224,75,0,200,0,0
24775854,MitchellDuce,10,330,235,889,1,319,51.3953328844,50-59,553,5,19,106,125,125,19,106,6,2.447941078,2177.0672174079,0.0283517052,0.1609032258,0.2987715,0,66,1.386382942056111E-4,1.198308E-4,1.2138722E-4,390,27,0,200,0,0
24784150,sister_sage,10,20025,984,1288,92,332,44.5380375594,40-49,752,8,185,183,368,368,185,183,6,2.2005356545,6870.7828045055,0.2768389252,0.0927541168,0.25589445,0,66,6.381708668291113E-4,0.0011144264,0.001128901,47,49,2,200,2,0.01
24817065,RThompsonSun,10,154,474,616,5,3,43.5219121487,40-49,560,3,33,43,76,76,33,43,6,2.7214596585,886.2589667926,0.0426522841,0.1,0.3898551,0,66,3.739333041433042E-4,2.0371236E-4,2.0635827E-4,372,5,0,159,0,0
24836413,RichTweets,10,1369,929,937,25,14,65.2384458226,60-69,694,5,49,65,114,114,49,65,6,2.5507197857,2370.7932090191,0.0418471528,0.0772395591,0.2164557,0,66,2.5426024345840873E-4,2.99577E-4,2.9739868E-4,390,28,2,200,2,0.01
24851229,kirstenmay13,10,773,303,761,4,15,37.3318514712,30-39,503,5,18,42,60,60,18,42,6,2.7700033478,97.6778090108,0.0109193012,0.1610169492,0.35328013,0,66,1.0354224309473308E-4,1.1383926E-4,1.1531785E-4,372,4,5,198,5,0.0252525253
24892031,tomflem,10,43797,1641,1078,118,723,49.797788396,40-49,777,9,276,268,544,544,276,268,6,2.1981921661,34804.6301738649,0.3475874073,0.0490128372,0.18973625,0,66,8.687175848527885E-4,0.0016596565,0.0016812129,47,209,1,206,1,0.0048543689
24952644,brianlabelle,10,10159,837,223,42,81,50.191219558,50-59,744,7,75,17,92,92,75,17,7,2.8724472715,773.4802369075,0.0914580033,0.0948399427,0.22508772,0,66,2.957521353934328E-4,4.5535705E-4,4.612714E-4,390,31,0,201,0,0
24978284,mikofox,10,1818,27,125,0,0,22.4622286522,20-29,358,4,1,3,4,4,1,3,7,2.9082691664,0,0.0039162934,0.25,1,0,66,5.034065667458013E-5,1.198308E-5,1.2138721E-5,372,0,0,198,0,0
25025529,ChelsCalabrese,10,3223,343,330,15,85,60.2222137945,60-69,631,6,0,0,0,0,0,0,0,0,0,0,0,0,382,694,4.4780486537007367E-5,0,0,393,1,0,200,0,0
25068722,Youngblut,10,1673,2491,1141,84,44,49.9353182361,40-49,683,6,20,28,48,48,20,28,7,2.7154335454,330.0175170579,0.0207463373,0.1343085106,0.3257468,0,66,1.9575385251477265E-4,1.2582233E-4,1.2745657E-4,372,8,0,200,0,0
25095205,MichelleSimson,10,6052,1844,659,165,21,52.8567201366,50-59,733,7,155,77,232,232,155,77,7,2.5162370271,2108.2209503409,0.2390670429,0.112162263,0.27707717,0,66,9.248424720722667E-4,9.346802E-4,9.4682025E-4,140,83,7,200,7,0.035
25121600,random_noise,10,1056,130,226,4,0,35.7998399987,30-39,541,4,17,32,49,49,17,32,6,2.5420154001,94.1081696719,0.0442147404,0.1543367347,0.5124777,0,66,1.5949894538220318E-4,1.0784772E-4,1.0924849E-4,140,0,0,200,0,0
25127782,HedyFry,10,3556,6541,2847,431,15,60.0480673849,60-69,767,6,424,165,589,589,424,165,6,2.3056578507,37292.6226108029,0.4386141779,0.056702817,0.12236223,0,66,0.0019679424,0.0025464045,0.0025369928,140,311,4,200,4,0.02
25164154,bradleymw,10,2221,374,115,13,2,42.485949614,40-49,509,5,2,9,11,11,2,9,7,2.8754603281,0.522757005,0.0041284134,0.2636363636,0.46666667,0,66,5.244376196361784E-5,1.797462E-5,1.8208082E-5,140,13,2,201,2,0.0099502488
25198091,RachelDecoste,10,14573,988,597,20,619,60.5592235262,60-69,762,8,145,94,239,239,145,94,7,2.4204887847,9566.8199822621,0.170468057,0.0714988924,0.1873681,0,66,5.869972034326524E-4,8.747648E-4,8.8612665E-4,47,251,0,235,0,0
25217615,jofo2005,10,9846,887,2001,7,276,44.1503640477,40-49,703,7,90,200,290,290,90,200,7,2.234348845,13268.1089834616,0.1254107982,0.0649206539,0.20656717,0,66,3.0181418038215227E-4,5.452301E-4,5.5231183E-4,47,5,1,200,1,0.005
25230293,markleahy,10,480,49,124,2,4,39.8034927731,30-39,499,5,10,23,33,33,10,23,7,2.8051556746,20.0690121488,0.0089485119,0.1571969697,0.42166665,0,66,8.80370783843593E-5,6.590694E-5,6.6762965E-5,140,14,1,199,1,0.0050251256
25241610,misterdevans,10,30518,203,308,11,9,45.3609217943,40-49,771,8,36,35,71,71,36,35,7,2.6357549381,73.9426589027,0.0700463662,0.1754527163,0.4764151,0,66,1.700069522628914E-4,2.2168698E-4,2.2456635E-4,140,27,1,203,1,0.0049261084
25362154,jennrpeters,10,855,187,109,7,16,43.1022612853,40-49,605,5,4,2,6,6,4,2,8,3.7974556411,0.5222222222,4.2012503512328853E-4,0.1666666667,0.8333333,0,66,9.15078208574759E-5,2.99577E-5,3.0346804E-5,372,7,0,200,0,0
25376452,WendyPeters,10,1657,339,541,6,2,42.3911534276,40-49,662,5,99,153,252,252,99,153,6,2.1958486776,5731.1093829137,0.1445984642,0.0858628976,0.2976999,0,66,2.8193211495411213E-4,5.99154E-4,6.0693605E-4,47,18,4,200,4,0.02
25487241,talkingfrog,10,16649,602,33,17,72,55.3976726638,50-59,738,8,60,6,66,66,60,6,7,3.2005356545,15.7492794525,0.0828512739,0.141025641,0.22098215,0,66,2.7643903708904696E-4,3.6548392E-4,3.70231E-4,47,89,0,201,0,0
25562342,pauloteixeira13,10,13984,14832,4890,484,17,62.1233211074,60-69,900,7,5,3,8,8,5,3,2,1.25,12,3.733179036101763E-4,0.0357142857,0.06666667,203,412,2.0689471024981583E-4,3.594924E-5,1.8208082E-5,212,16,0,201,0,0
25590464,Tsamblac,10,1626,58,307,0,80,35.325648722,30-39,594,5,1,1,2,2,1,1,8,3.4924673586,0,2.7536534945216736E-4,0,0,0,66,4.686858941064033E-5,1.198308E-5,1.2138721E-5,47,6,0,200,0,0
25619895,JAYRON_SSE,10,1885,210,363,2,29,43.0681372887,40-49,630,6,4,4,8,8,4,4,2,1.5,0,3.395898455675363E-4,0.1071428571,1,214,407,2.2320849686773938E-4,2.99577E-5,3.0346804E-5,266,8,0,200,0,0
25636566,grahamur,10,974,1431,1961,40,117,46.5870481135,40-49,579,5,19,31,50,50,19,31,6,2.4646802812,569.0009860926,0.0388063717,0.0771428571,0.30040324,0,66,1.4271826443618967E-4,1.198308E-4,1.2138722E-4,372,4,1,200,1,0.005
25729759,Sattva01,10,21901,615,729,18,23,51.5167477468,50-59,794,9,36,34,70,70,36,34,6,2.5564111148,4676.7053850087,0.0292916213,0.1248447205,0.23845704,0,66,1.5230263181984418E-4,2.2168698E-4,2.2456635E-4,372,73,0,199,0,0
25760258,PerryMarleau,10,5222,394,671,4,15,46.7672442143,40-49,682,7,8,26,34,34,8,26,6,2.7224640107,187.8180312725,0.0070262992,0.0891265597,0.21538462,0,66,7.361479558582417E-5,5.392386E-5,5.4624245E-5,372,19,1,204,1,0.0049019608
25849601,sbaranski,10,6938,2181,1054,75,26,62.0575964101,60-69,754,7,104,58,162,162,104,58,6,2.6478071644,4079.1627674258,0.1083046095,0.0868798405,0.19877419,0,66,6.870413769012772E-4,6.291117E-4,6.3728285E-4,372,97,0,200,0,0
25869252,SunnyDeeLighted,10,10084,513,460,0,96,43.7469217191,40-49,744,7,1,1,2,2,1,1,1,1,0,7.49471721243357E-5,0,0,54,144,2.9852402567743944E-4,1.198308E-5,1.2138721E-5,171,37,0,196,0,0
25886969,TwalRa,10,20869,1199,592,28,58,53.6558570012,50-59,780,8,26,30,56,56,26,30,6,2.5236022765,1096.965066273,0.0454251556,0.0909090909,0.3805704,0,66,1.3947542226207078E-4,1.6177158E-4,1.6387274E-4,47,21,0,202,0,0
25947220,QueerVancouver,10,6488,325,228,13,179,60.8504269539,60-69,711,7,14,8,22,22,14,8,7,2.9909608303,46.8883771457,0.0115725116,0.1017316017,0.25367647,0,66,9.266131844766525E-5,8.98731E-5,9.104041E-5,55,17,0,201,0,0
26037015,Koldkanuck,10,464,25,81,1,4,34.3940274568,30-39,504,5,4,6,10,10,4,6,7,3.099096083,72.4270421696,0.0020444279,0.1,0.17857143,0,66,5.528929720467299E-5,2.99577E-5,3.0346804E-5,372,62,1,197,1,0.0050761421
26052727,psema4,10,20138,2385,2625,88,6705,52.1169077914,50-59,763,8,128,185,313,313,128,185,6,2.192500837,15491.3622613106,0.1891638796,0.0552347014,0.22946352,0,66,4.317853295668862E-4,7.729087E-4,7.829475E-4,47,13,0,201,0,0
26181736,cherylfougere,10,4826,562,837,22,2,44.032320737,40-49,684,6,57,79,136,136,57,79,6,2.4820890526,624.9820579612,0.1114744541,0.1442810458,0.4256579,0,66,4.529015816426106E-4,3.475093E-4,3.520229E-4,140,5,1,200,1,0.005
26230145,dprouss,10,2457,1338,475,87,1,52.2646364978,50-59,697,5,119,46,165,165,119,46,6,2.5647807164,7404.9839022028,0.1595303837,0.1169253511,0.24438916,0,66,0.0010268012,7.189848E-4,7.283233E-4,372,65,0,200,0,0
26245743,LVRoberts,10,35629,1070,1977,47,368,40.4642618114,40-49,749,9,15,52,67,67,15,52,6,2.4194844325,369.2473018517,0.0301190271,0.197874265,0.43636364,0,66,1.2111632654371709E-4,9.586464E-5,9.710977E-5,140,1,0,201,0,0
26248921,Opus420,10,4664,268,211,3,1808,46.3673202531,40-49,661,7,13,18,31,31,13,18,7,2.6919986609,6135.2439711113,0.0103014232,0.1623655914,0.365,0,66,1.1816638892718579E-4,8.388156E-5,8.497105E-5,47,28,0,207,0,0
26273435,HanlansPoint,10,1244,98,282,1,31,47.4874652285,40-49,645,6,15,41,56,56,15,41,7,2.6106461332,159.6359962848,0.0146947505,0.1678571429,0.3337766,0,66,9.780618738227978E-5,9.586464E-5,9.710977E-5,140,162,4,201,4,0.0199004975
26282371,LibbyDavies,10,3717,9380,640,554,8,59.2342296609,50-59,775,6,594,103,697,697,594,103,6,2.4101104787,27750.4415631591,0.5597591281,0.0547749798,0.095913716,0,66,0.0028691256,0.0035649664,0.003568784,390,251,1,200,1,0.005
26286207,clsmale,10,1622,106,221,2,88,43.8326645981,40-49,616,5,3,13,16,16,3,13,7,2.8520254436,185.491367291,6.523585306477453E-4,0.1541666667,0.3846154,0,66,7.18864816301732E-5,2.396616E-5,2.4277442E-5,140,1,0,200,0,0
26316027,bgrice,10,11297,2066,2251,122,0,67.3811300725,60-69,750,7,209,293,502,502,209,293,6,2.1396049548,28936.2357083047,0.2621822511,0.0533673688,0.19154067,0,66,9.97858693878161E-4,0.0012582234,0.0012745657,140,90,2,200,2,0.01
26344705,nevineb,10,33966,787,946,35,490,49.439496103,40-49,796,9,201,238,439,439,201,238,6,2.135587546,11399.1620217022,0.288534282,0.0563807325,0.2795971,0,66,5.680919080614939E-4,0.001210291,0.0012260108,47,323,0,208,0,0
26417074,liseravary,10,9853,4933,599,103,214,61.2032115114,60-69,791,7,22,16,38,38,22,16,7,2.9956478072,447.8612441892,0.0196061939,0.0981507824,0.18817204,0,66,3.562100848841306E-4,1.3780541E-4,1.395953E-4,140,62,1,200,1,0.005
26442278,ritchieage,10,5326,94,87,1,226,40.947744218,40-49,719,7,0,1,1,1,0,1,8,4.1151271754,0,0,0,0,0,392,4.4780486537007367E-5,0,6.0693606E-6,372,0,0,200,0,0
26593129,StephenLeahy,10,4296,1067,155,98,11,58.3938779813,50-59,713,7,44,9,53,53,44,9,7,2.8918647472,272.1981692802,0.0435453062,0.1103047896,0.2132285,0,66,3.180417126576165E-4,2.696193E-4,2.7312123E-4,47,72,0,201,0,0
26612007,torserda,10,3360,384,493,19,35,57.2326381922,50-59,611,6,15,23,38,38,15,23,7,2.7489119518,1870.167991267,0.0203460696,0.1251778094,0.32512316,0,66,1.485294821868111E-4,9.586464E-5,9.710977E-5,55,4,1,200,1,0.005
26648462,DouglasCS,10,1736,261,287,9,19,45.7563891025,40-49,641,5,23,24,47,47,23,24,6,2.635420154,170.4130765089,0.0324017308,0.1401480111,0.4403409,0,66,1.3829485180951148E-4,1.4379696E-4,1.4566466E-4,140,4,1,200,1,0.005
26678366,cydnaaaaay,10,44874,643,466,14,1188,44.9530460918,40-49,770,9,1,1,2,2,1,1,1,1,0,7.49471721243357E-5,0,0,348,635,2.9852402567743944E-4,1.198308E-5,1.2138721E-5,357,30,0,202,0,0
26774435,MtnGoat1,10,5370,348,964,11,1714,42.2839071101,40-49,628,7,34,80,114,114,34,80,6,2.4081017744,4249.576069313,0.0669658381,0.1132588107,0.32490215,0,66,1.5807006580892389E-4,2.097039E-4,2.1242762E-4,47,4,2,200,2,0.01
26776939,mertonwa,10,320,64,133,0,3,31.2463578336,30-39,402,3,8,11,19,19,8,11,7,2.7746903247,2.6294555165,0.0093909267,0.1929824561,0.67948717,0,66,6.657012343162654E-5,5.392386E-5,5.4624245E-5,390,6,0,200,0,0
26788120,meanmeaghan,10,3260,127,595,3,379,26.6784585124,20-29,620,6,1,16,17,17,1,16,7,2.8054904587,0,0.0049463508,0.3602941176,0.725,0,66,5.370319470653586E-5,1.198308E-5,1.2138721E-5,390,1,0,200,0,0
26854642,gjsproule,10,911,1812,2000,80,65,46.5364007819,40-49,618,5,72,107,179,179,72,107,6,2.3411449615,9975.3905008552,0.0908069542,0.067478501,0.23793103,0,66,4.0146655398267756E-4,4.373824E-4,4.3699396E-4,372,3,0,200,0,0
26898604,DanielDravotCFC,10,8015,452,1131,7,600,43.5679764575,40-49,712,7,2,2,4,4,2,2,7,3.0836960161,1.8250996955,0.0022410272,0,0,0,66,5.085283022889121E-5,1.797462E-5,1.8208082E-5,372,0,0,200,0,0
26904707,hiltonjohn,10,9433,1112,1302,17,211,54.2152399935,50-59,747,8,74,88,162,162,74,88,6,2.4914630064,6361.97178866,0.0538034093,0.0666359942,0.26980197,0,66,4.806255622508336E-4,4.493655E-4,4.5520204E-4,372,32,0,200,0,0
26913913,Schoukeir,10,1887,64,245,1,71,37.3603422952,30-39,522,5,4,4,8,8,4,4,7,3.0954134583,3.4949828772,0.0092045515,0.1964285714,0.4047619,0,66,6.917416485974334E-5,2.99577E-5,3.0346804E-5,47,1,0,200,0,0
26949351,MeganDoesNOLA,10,22057,1931,2108,64,1548,69.7434136146,60-69,766,8,0,1,1,1,0,1,7,3.2935073628,0,0,0,0,0,438,4.4780486537007367E-5,0,6.0693606E-6,390,3,0,200,0,0
26996143,DrDawg,10,27485,1285,593,77,18,59.6370297746,50-59,795,9,268,129,397,397,268,129,6,2.2427184466,11829.7911959658,0.3351697532,0.0711968552,0.18894057,0,66,9.654759360403251E-4,0.0016117243,0.0016326581,47,228,0,201,0,0
27016796,lpchampagne,10,1160,630,1535,14,0,44.6567550507,40-49,628,5,66,184,250,250,66,184,6,2.2882490793,6253.7664655802,0.0924752274,0.1086104418,0.2821287,0,66,4.061640657284634E-4,4.0143318E-4,4.0664716E-4,140,28,4,200,3,0.02
27161840,HamBaconTomato,10,10095,1177,1352,61,14,45.9364777175,40-49,703,7,114,121,235,235,114,121,7,2.4579845999,3654.0307154927,0.160073766,0.0958356065,0.32352942,0,66,5.857167362931752E-4,6.890271E-4,6.979765E-4,140,10,0,200,0,0
27261031,johnkapp,10,18702,554,788,7,2073,52.7882179932,50-59,740,8,46,121,167,167,46,121,6,2.3006360897,5304.6553110999,0.050752557,0.0968184114,0.24993443,0,66,1.8326877034857613E-4,2.8160238E-4,2.8525994E-4,390,18,0,201,0,0
27272767,dennisflood54,10,1009,88,172,0,40,36.2945968327,30-39,604,5,7,12,19,19,7,12,7,2.8761298962,13.2109526649,0.0083382031,0.1871345029,0.5494506,0,66,6.454711585422582E-5,4.793232E-5,4.8554884E-5,390,4,0,200,0,0
27279477,stacemcf,10,503,196,528,4,15,33.1566735857,30-39,509,4,2,4,6,6,2,4,7,3.0649481085,0.257393884,0.0044029123,0.1333333333,0.25,0,66,5.267096408277813E-5,1.797462E-5,1.8208082E-5,390,3,0,200,0,0
27347284,samlavoie,10,5011,1304,498,59,39,46.8709646615,40-49,713,7,130,58,188,188,130,58,7,2.6648811517,2391.3309021157,0.1518894383,0.1275173512,0.30108646,0,66,7.189453907859264E-4,7.848917E-4,7.9508626E-4,140,33,0,200,0,0
27349747,eli_d_m,10,6589,801,875,33,143,51.9667335788,50-59,729,7,58,62,120,120,58,62,6,2.5118848343,2824.1602944895,0.0492198768,0.0653361345,0.19965577,0,66,2.782036499762381E-4,3.5350086E-4,3.5809228E-4,47,51,1,199,1,0.0050251256
27371671,Norm_Farrell,10,2808,342,612,6,0,50.3805199123,50-59,686,6,54,96,150,150,54,96,7,2.4389019083,2888.8994406346,0.0638630762,0.0681431767,0.21425742,0,66,2.0950067410287757E-4,3.295347E-4,3.3381482E-4,55,96,1,201,1,0.0049751244
27434069,trev_harrison,10,4933,628,594,20,0,45.5583715631,40-49,711,7,73,59,132,132,73,59,6,2.5912286575,262.6507688137,0.1284818305,0.1825121443,0.4003594,0,66,4.866064371067483E-4,4.4337395E-4,4.491327E-4,140,11,2,199,2,0.0100502513
27446256,Celtic_Light,10,9704,227,201,10,677,47.3613232871,40-49,694,8,4,5,9,9,4,5,7,3.1767659859,8.4710187021,0.0014171233,0.0416666667,0.25,0,66,5.7807961791135786E-5,2.99577E-5,3.0346804E-5,47,1,0,12,0,0
27447051,querqle,10,2463,96,324,0,95,39.0202213714,30-39,532,6,12,37,49,49,12,37,7,2.5878808169,77.8973446391,0.0141887289,0.1203231293,0.28520626,0,66,6.964451258203926E-5,7.789002E-5,7.8901685E-5,47,4,0,200,0,0
27485292,ChrisDawnMonroe,10,24819,1424,1870,50,2962,63.5493061318,60-69,753,8,87,154,241,241,87,154,6,2.3200535655,5291.7659884054,0.1198099482,0.092219917,0.28931618,0,66,3.670117583753758E-4,5.272555E-4,5.341037E-4,140,38,0,202,0,0
27525925,judithjoy,10,885,205,627,1,54,31.6613265581,30-39,539,5,0,8,8,8,0,8,7,3.0013386881,0,0,0.25,0.39285713,0,333,4.4780486537007367E-5,0,6.0693606E-6,372,1,0,200,0,0
27576784,adnanraja08,10,1328,72,267,0,108,30.3933079877,30-39,504,5,0,7,7,7,0,7,7,2.9487951807,0,0,0.1666666667,0.33333334,0,382,4.4780486537007367E-5,0,6.0693606E-6,372,6,0,199,0,0
27655434,BrandanRowe,10,140,38,114,1,11,31.0804061221,30-39,317,3,7,28,35,35,7,28,7,2.7405423502,67.0582803921,0.0147074278,0.2504201681,0.4903226,0,66,1.1042914116322211E-4,4.793232E-5,4.8554884E-5,140,3,27,158,24,0.1708860759
27674307,JillyKaren,10,2427,156,518,3,123,36.5941900686,30-39,616,6,0,6,6,6,0,6,7,2.9096385542,0,0,0.2333333333,0.3,0,548,4.4780486537007367E-5,0,6.0693606E-6,47,1,0,200,0,0
27682432,trelayne,10,14196,515,917,23,95,50.4381450341,50-59,729,8,50,83,133,133,50,83,6,2.3813190492,4375.6978950168,0.0662706489,0.0637388927,0.23781513,0,66,2.0454610895464536E-4,3.0556854E-4,3.095374E-4,47,24,1,198,1,0.0050505051
27765177,alexfelsky,10,277,173,480,5,2,43.6609347284,40-49,515,4,17,35,52,52,17,35,7,2.5801807834,260.7644666233,0.016535852,0.1779788839,0.4534413,0,66,1.0460946582354624E-4,1.0784772E-4,1.0924849E-4,390,23,0,201,0,0
27823555,kennedystewart,10,2362,2368,386,154,2,62.1087223789,60-69,736,6,281,50,331,331,281,50,7,2.6906595246,33211.0409380755,0.305537171,0.0822210016,0.15625076,0,66,0.0015633296,0.0016896143,0.0016933517,390,491,2,203,2,0.0098522167
27885021,JesseTravis,10,3490,853,2000,40,731,45.742642283,40-49,720,7,104,235,339,339,104,235,6,2.1894877804,15819.5028277901,0.1565705506,0.0940549126,0.25193378,0,66,4.328806953723188E-4,6.291117E-4,6.3728285E-4,390,11,2,200,2,0.01
27935316,Teirersias,10,24186,1078,1849,36,347,61.084608874,60-69,776,8,19,47,66,66,19,47,7,2.5657850686,1237.1560283206,0.0282218749,0.0904428904,0.23537233,0,66,1.9086897224622712E-4,1.198308E-4,1.2138722E-4,140,52,0,200,0,0
28009693,jonbeharry,10,1207,86,444,2,3,28.6743698479,20-29,560,5,2,30,32,32,2,30,7,2.614328758,76.8153152687,0.0023452637,0.2610887097,0.41330644,0,66,5.7430226933839495E-5,1.797462E-5,1.8208082E-5,390,1,1,200,1,0.005
28058648,kwcmb,10,4217,273,381,4,516,45.7539935195,40-49,686,6,38,37,75,75,38,37,7,2.6501506528,379.5685888191,0.0339542241,0.0682882883,0.3871795,0,66,1.8379699054554583E-4,2.3367006E-4,2.3670506E-4,47,28,0,200,0,0
28115444,kkirkup,10,6132,3506,3218,175,1,62.1315325992,60-69,768,6,335,258,593,593,335,258,6,2.2159357215,47267.920369832,0.4235388823,0.0561705255,0.13604411,0,66,0.0023851875,0.0020131574,0.0020332357,372,318,4,203,4,0.0197044335
28127520,Sultan_Sadat,10,799,413,2000,4,352,36.3872196918,30-39,510,5,50,218,268,268,50,218,6,2.208570472,4753.123521187,0.0630945702,0.131421544,0.26800394,0,66,2.126799120035879E-4,3.0556854E-4,3.095374E-4,390,5,1,204,1,0.0049019608
28186031,atl058,10,519,38,157,1,15,22.9126413442,20-29,226,4,0,0,0,0,0,0,0,0,0,0,0,0,90,196,4.4780486537007367E-5,0,0,85,1,0,198,0,0
28191911,jjfantauzzi,10,9702,1589,1804,80,371,55.1672244445,50-59,742,7,69,151,220,220,69,151,6,2.2587880817,8862.4868270659,0.1062694062,0.0980697385,0.26005435,0,66,4.0399428317703127E-4,4.194078E-4,4.2485524E-4,390,107,13,216,13,0.0601851852
28286822,edgytimes,10,5041,761,1981,8,300,46.2876098561,40-49,689,7,80,189,269,269,80,189,7,2.2705055239,6408.1473956795,0.1022486504,0.0854879876,0.23819989,0,66,2.4450743966791246E-4,4.8531473E-4,4.9161824E-4,47,38,0,204,0,0
28405581,LisaMicheleM,10,7561,1624,1700,19,281,,,739,7,57,64,121,121,57,64,6,2.374958152,8547.3301207782,0.0822195709,0.0495179063,0.28125,0,66,2.655410262104255E-4,3.475093E-4,3.520229E-4,47,39,0,198,0,0
28421045,bow_en_arrow,10,5288,334,1019,8,116,39.246907445,30-39,700,7,47,94,141,141,47,94,6,2.3669233344,799.2398121533,0.0772172126,0.1093211753,0.31052223,0,66,1.6535954685809482E-4,2.8759392E-4,2.913293E-4,140,5,2,200,2,0.01
28429319,chickification,10,6535,799,1197,26,0,45.5596386806,40-49,688,7,11,27,38,38,11,27,7,2.6601941748,89.2482714648,0.0179649845,0.1586059744,0.30492425,0,66,7.888858338389049E-5,7.189848E-5,7.283233E-5,55,4,0,200,0,0
28569095,LaurieNorris,10,486,71,135,1,21,39.8465983611,30-39,532,4,21,40,61,61,21,40,7,2.6233679277,378.4692902957,0.0251990096,0.1120218579,0.35105205,0,66,1.1237464219455001E-4,1.3181388E-4,1.3352593E-4,47,6,1,200,1,0.005
28578004,Sabrina_B2011,10,451,60,199,1,20,29.3216038389,20-29,470,4,4,30,34,34,4,30,7,2.6290592568,48.0128162938,0.0025285081,0.192513369,0.3229885,0,66,6.305492711707701E-5,2.99577E-5,3.0346804E-5,47,4,0,197,0,0
28586596,etenebrislux,10,8666,646,1263,14,2264,49.7823921336,40-49,730,7,209,328,537,537,209,328,6,2.0997656512,25626.1300414682,0.2568397827,0.0567275355,0.19738978,0,66,6.262017603544564E-4,0.0012582234,0.0012745657,47,73,1,200,1,0.005
28885750,NewYork_Events,10,2708,1488,495,67,0,43.6579912669,40-49,620,5,2,0,2,2,2,0,0,0,0,8.567614523296557E-4,0,0,0,60,5.561744717538547E-5,1.797462E-5,0,140,7,0,200,0,0
28893318,sabrinasoti,10,20291,742,1299,24,587,47.1040171929,40-49,722,8,21,45,66,66,21,45,6,2.7716772682,770.0667222067,0.0138243609,0.1344988345,0.32367346,0,66,1.1982029882515193E-4,1.3181388E-4,1.3352593E-4,372,15,1,200,1,0.005
28952731,atgiggleswick,10,49619,4661,1987,173,47,46.7802343081,40-49,766,9,25,23,48,48,25,23,6,2.5952460663,3167.7673633086,0.0340070541,0.0403368794,0.2646154,0,66,2.0232674577722135E-4,1.5578004E-4,1.5780337E-4,47,6,0,201,0,0
28997331,SGMLaw,10,3122,749,162,35,138,48.5078067203,40-49,696,6,39,13,52,52,39,13,7,2.8674255105,289.1615311469,0.0388478528,0.1036953243,0.1884058,0,66,1.9860991682851982E-4,2.396616E-4,2.4277443E-4,390,13,0,200,0,0
29024261,andyingy,10,2696,302,948,2,1126,49.127013438,40-49,636,7,8,0,8,8,8,0,0,0,0,0.0056580077,0.0714285714,0.125,0,6,6.630710439037869E-5,5.392386E-5,0,140,39,0,6,0,0
29046868,London_UK,10,2000,2097,193,60,0,45.7902253844,40-49,688,5,3,0,3,3,3,0,0,0,0,5.247681215956126E-4,0,0,0,59,9.270004964483057E-5,2.396616E-5,0,140,31,0,200,0,0
29217969,AheadAhead9ja,10,2875,468,1048,1,83,45.08430979,40-49,682,6,1,1,2,2,1,1,3,2,0,7.49471721243357E-5,0,0,0,187,7.569917912644684E-5,1.198308E-5,1.2138721E-5,55,1,0,201,0,0
29253678,kellyelliottmcm,10,4271,209,230,5,83,47.5556430367,40-49,669,6,8,8,16,16,8,8,7,3.0281218614,22.6792105365,0.0064330316,0.1541666667,0.47272727,0,66,6.849572644336519E-5,5.392386E-5,5.4624245E-5,140,1,0,200,0,0
29458252,miss_nik,10,1970,130,486,2,11,27.1872857688,20-29,560,6,2,2,4,4,2,2,7,3.0388349515,0,0.008039095,0.0833333333,1,0,66,6.541145475649478E-5,1.797462E-5,1.8208082E-5,372,2,0,200,0,0
29480932,powers_rhonda,10,3794,242,694,4,247,42.8688006463,40-49,575,7,38,82,120,120,38,82,6,2.3414797456,3727.2126996196,0.0456529813,0.0980392157,0.26489028,0,66,1.5999430170404098E-4,2.3367006E-4,2.3670506E-4,47,5,0,205,0,0
29517549,First_Power,10,39720,4497,4946,235,24,61.4457999136,60-69,785,9,162,181,343,343,162,181,7,2.2902577837,33235.9983887035,0.146780574,0.0373979166,0.13093378,0,66,6.428777690400938E-4,9.76621E-4,9.893058E-4,47,48,0,198,0,0
29591741,donnwatt,10,66,19,36,0,1,12.8994027935,10-19,129,2,0,2,2,2,0,2,7,3.6964524766,0,0,0.5,0.5,0,664,4.4780486537007367E-5,0,6.0693606E-6,372,0,0,69,0,0
29620023,benrachinger,10,8896,396,437,6,1036,65.2467544068,60-69,695,8,4,6,10,10,4,6,7,2.9199866086,55.1031310335,0.0043320695,0.1111111111,0.23214285,0,66,6.374519948202205E-5,2.99577E-5,3.0346804E-5,47,24,0,201,0,0
29864721,oneritual,10,5590,158,161,1,458,35.0347619097,30-39,584,6,0,1,1,1,0,1,8,3.6345381526,0,0,0,0,0,109,4.4780486537007367E-5,0,6.0693606E-6,140,0,0,200,0,0
30006281,JimRossStrategy,10,4881,2018,1757,60,19,56.0294284525,50-59,687,6,124,119,243,243,124,119,6,2.5353197188,18739.0366523866,0.1420006841,0.0654014896,0.16246322,0,66,7.846101902520519E-4,7.489425E-4,7.586701E-4,372,27,1,200,1,0.005
30026134,akaratedad,10,1613,84,185,1,30,36.1760730452,30-39,637,6,3,16,19,19,3,16,7,2.8597254771,15.5236228381,0.0021022969,0.2339181287,0.5208333,0,66,5.207237300980639E-5,2.396616E-5,2.4277442E-5,140,1,1,200,1,0.005
30072340,MrTree2013,10,2054,74,80,0,130,29.4556201135,20-29,580,5,0,0,0,0,0,0,0,0,0,0,0,0,380,691,4.4780486537007367E-5,0,0,391,0,0,200,0,0
30264222,MorganCrockett,10,7831,668,363,26,1784,61.6243126057,60-69,734,7,57,38,95,95,57,38,6,2.505189153,3359.065549608,0.0585738699,0.0455767077,0.14927885,0,66,2.2898287206640102E-4,3.475093E-4,3.520229E-4,390,55,0,199,0,0
30268687,jennahussein,10,489,238,536,3,55,50.5880762025,50-59,543,4,3,11,14,14,3,11,7,2.864747238,36.6158305231,0.0075029982,0.2527472527,0.5378788,0,66,1.369297300185063E-4,2.396616E-5,2.4277442E-5,140,11,0,200,0,0
30310478,imarkhanlon,10,9037,975,1999,16,36,56.8359756912,50-59,722,7,135,262,397,397,135,262,6,2.1623702712,8504.4794301723,0.1898572237,0.0787026436,0.2386334,0,66,3.9313431549826543E-4,8.1484945E-4,8.2543306E-4,47,23,0,200,0,0
30373506,karalenamclean,10,1709,228,1014,3,7,41.148728641,40-49,545,6,24,137,161,161,24,137,6,2.3053230666,6014.907397175,0.0386328401,0.1482919255,0.29282954,0,66,1.4457983253198342E-4,1.497885E-4,1.5173401E-4,390,4,1,200,1,0.005
30381942,Liam_Toronto,10,1914,197,315,7,42,37.2046060315,30-39,545,5,3,14,17,17,3,14,7,2.9471041178,4.0320885102,0.0054514168,0.3014705882,0.5625,0,66,5.685110818358313E-5,2.396616E-5,2.4277442E-5,140,0,1,200,1,0.005
30465899,fstenson,10,827,798,1008,32,3,49.1375936649,40-49,678,4,67,101,168,168,67,101,7,2.3773016404,4033.4220251768,0.0687946783,0.0804462504,0.23665667,0,66,2.4237161819102754E-4,4.0742473E-4,4.1271653E-4,47,30,2,199,2,0.0100502513
30584980,JimWaterloo,10,2711,168,119,8,3,29.8882083,20-29,592,6,12,6,18,18,12,6,7,3.1158352862,16.7704976329,0.0115860766,0.1339869281,0.46153846,0,66,7.207115986842256E-5,7.789002E-5,7.8901685E-5,390,1,1,199,1,0.0050251256
30679892,JayDupes,10,5691,273,704,7,24,45.2814337339,40-49,691,7,32,50,82,82,32,50,7,2.6029460998,1598.403056897,0.0402048868,0.1559771153,0.43107346,0,66,1.5217501607158937E-4,1.9772082E-4,1.9421954E-4,140,58,0,200,0,0
30865662,sjkelly1,10,355,119,192,1,5,30.8774847106,30-39,571,5,10,23,33,33,10,23,7,2.8547037161,84.8823153873,0.0195497801,0.2367424242,0.48544973,0,66,1.327948809047974E-4,6.590694E-5,6.6762965E-5,372,1,0,199,0,0
30935659,WButler2011,10,14586,1044,714,62,6,49.9761543404,40-49,738,8,177,166,343,343,177,166,6,2.2828925343,10559.3218665902,0.2441683588,0.0744463199,0.21704446,0,66,6.127943769325657E-4,0.0010664942,0.0010803462,140,83,17,200,17,0.085
30959934,feaxie,10,3214,127,55,1,2,37.8170668768,30-39,655,6,0,0,0,0,0,0,0,0,0,0,0,0,68,163,4.4780486537007367E-5,0,0,60,5,0,198,0,0
30966415,tbeaudrymellor,10,5092,1011,766,30,314,49.7346317656,40-49,741,7,28,26,54,54,28,26,7,2.7485771677,626.6842423309,0.019525188,0.1292802236,0.29069766,0,66,1.696761186534835E-4,1.7375466E-4,1.7601145E-4,390,47,1,200,1,0.005
30967575,fvankalmthout,10,1075,102,204,5,0,40.7233970547,40-49,446,5,3,2,5,5,3,2,8,3.9722129227,2.852753499,7.673356884106623E-4,0.05,0.33333334,0,66,7.725395626920747E-5,2.396616E-5,2.4277442E-5,372,5,0,200,0,0
31158134,rleisti,10,2725,216,316,11,17,28.719343032,20-29,495,6,2,4,6,6,2,4,7,3.1486441245,0.0819774834,0.0022245483,0.2,0.45,0,66,5.147322323127064E-5,1.797462E-5,1.8208082E-5,55,0,0,199,0,0
31159339,Stephistan,10,157,78,381,0,21,20.8904748848,20-29,323,2,11,28,39,39,11,28,7,2.7020421828,159.2319852613,0.0148674069,0.1680161943,0.37849462,0,66,9.003882069306592E-5,7.189848E-5,7.283233E-5,140,1,0,157,0,0
31226332,Professorsan,10,10921,955,1193,49,5,53.3613772462,50-59,757,8,75,71,146,146,75,71,6,2.385671242,1506.0720978543,0.112622775,0.1134152102,0.33327454,0,66,2.3006189777743374E-4,4.5535705E-4,4.612714E-4,47,94,2,207,2,0.0096618357
31250479,Lazin_Ryder,10,3785,1594,630,90,381,59.5181705516,50-59,774,7,41,35,76,76,41,35,7,2.7264814195,4998.4615727486,0.0430940391,0.1073684211,0.22868852,0,66,2.7410356185700356E-4,2.5164467E-4,2.4884377E-4,140,17,0,134,0,0
31254552,aysha_marie,10,2644,216,545,3,144,35.5322835904,30-39,600,6,4,35,39,39,4,35,7,2.6521593572,19601.9224986617,0.0098081015,0.1983805668,0.39915967,0,66,7.393544865981357E-5,2.99577E-5,3.0346804E-5,372,3,0,201,0,0
31504538,MakereSH,10,4149,245,520,4,260,41.9085963984,40-49,606,7,13,18,31,31,13,18,7,2.8409775695,278.0970498615,0.0087387992,0.1150537634,0.4105263,0,66,1.2557153712882096E-4,8.388156E-5,8.497105E-5,47,5,0,200,0,0
31610556,beisan,10,8747,572,496,13,241,55.4927505516,50-59,740,7,118,119,237,237,118,119,7,2.3414797456,3016.7075887164,0.2115049323,0.1092040335,0.35551882,0,66,8.60557238822311E-4,7.1299326E-4,7.222539E-4,390,155,2,201,2,0.0099502488
31623014,maviau,10,6259,919,707,36,3,51.9356074414,50-59,728,6,151,98,249,249,151,98,7,2.5175761634,1747.510872487,0.251552728,0.1204171525,0.36862746,0,66,0.0012196869,9.107141E-4,9.225428E-4,390,146,19,200,18,0.095
31658445,CorneliusCotter,10,261,121,590,1,0,31.0880628071,30-39,553,3,34,91,125,125,34,91,7,2.4663542015,1112.136376743,0.0433591995,0.1563225806,0.37253007,0,66,1.607179359966174E-4,2.097039E-4,2.1242762E-4,390,6,1,200,1,0.005
32112311,M_Charpentier,10,13604,8537,9339,242,12,55.7843829159,50-59,778,7,46,80,126,126,46,80,6,2.4723803147,6996.8207509371,0.0577413389,0.0724444444,0.2131001,0,66,3.6153654607132794E-4,2.8160238E-4,2.791906E-4,390,20,0,200,0,0
32138687,melaniekarin,10,20168,1083,1142,30,498,51.4429086034,50-59,769,8,17,25,42,42,17,25,7,2.7087378641,327.2289516507,0.0168441111,0.0818815331,0.26108375,0,66,1.1961683540596241E-4,1.0784772E-4,1.0924849E-4,55,11,0,200,0,0
32257133,G_McLachlan,10,553,209,420,11,58,43.7784507776,40-49,553,5,16,44,60,60,16,44,6,2.6451288919,100.0685111963,0.0240255796,0.206779661,0.5062057,0,66,1.1796661521968705E-4,1.0185618E-4,1.0317913E-4,390,7,7,200,7,0.035
32343249,UBCIC,10,35250,8171,2018,478,5,61.7654941525,60-69,855,8,302,106,408,408,302,106,7,2.4593237362,29088.8497482811,0.2935965303,0.0611540685,0.1182453,0,66,0.0017709116,0.0018154366,0.0018329469,47,303,0,201,0,0
32359120,bicyclestc,10,4315,1293,1070,67,339,45.6934198476,40-49,695,6,30,43,73,73,30,43,6,2.4499497824,1060.4915552006,0.0408818758,0.0692541857,0.24778369,0,66,1.533842264683754E-4,1.8573774E-4,1.8815018E-4,47,4,0,200,0,0
32391060,tarashields,10,28035,1706,1793,38,348,47.9241732013,40-49,788,9,7,17,24,24,7,17,7,2.9072648142,15.4825764093,0.0078528376,0.2463768116,0.48809522,0,66,7.531919820236652E-5,4.793232E-5,4.8554884E-5,140,41,0,200,0,0
32444591,KyleSeeback,10,898,873,110,79,3,51.2568306441,50-59,683,5,82,13,95,95,82,13,7,2.7904251758,228.0669262093,0.0931918153,0.1737961926,0.26541275,0,66,7.542606432532307E-4,4.972978E-4,4.9768755E-4,372,36,1,200,1,0.005
32485442,jensaisrien,10,172,52,67,2,0,33.8652364446,30-39,496,3,5,4,9,9,5,4,7,3.3408101774,7.7640140378,6.984306124534738E-4,0.2222222222,0.6666667,0,66,8.881007204952608E-5,3.594924E-5,3.6416164E-5,55,12,0,190,0,0
32655878,Friendshipgal,10,216,20,46,0,0,15.7326965635,10-19,290,3,1,7,8,8,1,7,7,2.9564780716,0,0.0039162934,0.2857142857,0.6666667,0,66,5.034065667458013E-5,1.198308E-5,1.2138721E-5,372,0,12,200,12,0.06
32725169,JasonGaudet,10,676,171,344,5,10,40.4038071199,40-49,582,4,9,22,31,31,9,22,7,2.8476732508,119.8696749528,0.0106104006,0.1333333333,0.285,0,66,8.752761286846366E-5,5.99154E-5,6.069361E-5,140,6,0,201,0,0
32728797,MathiGir,10,3510,456,1414,14,17,43.4654572259,40-49,648,6,70,178,248,248,70,178,6,2.2946099766,4361.6975227597,0.0923130781,0.1139316965,0.27986634,0,66,3.3960340090373096E-4,4.2539934E-4,4.2485524E-4,390,21,6,200,6,0.03
32745985,Pennyvane10,10,33347,1575,2002,40,772,46.6480909673,40-49,788,9,381,413,794,794,381,413,6,2.0776699029,61150.5178900686,0.3944176501,0.0422859339,0.14256634,0,66,0.0010537629,0.0022887683,0.002318496,47,398,1,245,1,0.0040816327
32855469,trishaclarkin,10,11587,1494,1571,82,367,53.9040928783,50-59,754,8,8,15,23,23,8,15,6,2.6605289588,149.6671989482,0.0174782809,0.0612648221,0.21428572,0,66,8.600302249311846E-5,5.392386E-5,5.4624245E-5,390,15,0,199,0,0
32936416,jamesbridges16,10,1822,215,566,4,19,42.5733323392,40-49,591,6,23,58,81,81,23,58,7,2.6247070639,155.3890744896,0.0369521912,0.2089506173,0.471875,0,66,1.2252183367870105E-4,1.4379696E-4,1.4566466E-4,140,16,6,200,6,0.03
33089851,monettechris,10,1252,240,405,10,12,32.7412938399,30-39,567,5,20,41,61,61,20,41,6,2.46869769,101.4248936952,0.0362458111,0.193442623,0.5352657,0,66,1.4421717307639607E-4,1.2582233E-4,1.2745657E-4,140,2,0,199,0,0
33269047,Scruffy19,10,2462,104,148,0,20,38.3835014219,30-39,594,6,10,12,22,22,10,12,6,2.6662202879,51.8981889684,0.0152807872,0.0735930736,0.33333334,0,66,7.280026634806564E-5,6.590694E-5,6.6762965E-5,47,14,0,200,0,0
33309569,patriciatomala,10,248,140,632,0,10,29.5853692511,20-29,456,4,2,10,12,12,2,10,7,2.9598259123,7.1443910865,8.932509274998433E-4,0.2121212121,0.45555556,0,66,5.054200281046808E-5,1.797462E-5,1.8208082E-5,140,4,1,199,1,0.0050251256
33326848,CarolinaMartelo,10,1119,104,135,1,43,34.274192971,30-39,574,5,4,9,13,13,4,9,7,2.7974556411,1.6849205434,0.0099808898,0.2243589744,0.5222222,0,66,6.44096245741372E-5,2.99577E-5,3.0346804E-5,140,12,0,200,0,0
33351678,Chrazzie,10,608,166,163,10,56,43.2839551667,40-49,502,4,3,3,6,6,3,3,7,3.0502176096,26.4724169181,0.0029238409,0.0666666667,0.25,0,66,6.028956058194048E-5,2.396616E-5,2.4277442E-5,55,2,0,200,0,0
33432137,carter_AB,10,12535,5461,780,150,19,62.8609990804,60-69,787,8,228,48,276,276,228,48,6,2.5912286575,5839.954273978,0.2425312494,0.0754018445,0.14396024,0,66,0.0015238201,0.0013720626,0.0013898836,372,108,0,200,0,0
33565866,smrtchng,10,1898,154,422,1,25,45.0706193805,40-49,629,5,32,68,100,100,32,68,7,2.432206227,1189.8438189505,0.0443700268,0.0873737374,0.23250648,0,66,1.4449063303224657E-4,1.9772082E-4,2.0028891E-4,47,41,2,201,2,0.0099502488
33607722,DaveGreen93,10,5330,131,69,0,820,40.7774761379,40-49,733,7,0,0,0,0,0,0,0,0,0,0,0,0,88,191,4.4780486537007367E-5,0,0,82,2,0,201,0,0
33650839,communityp,10,2767,684,637,23,2,42.4795381466,40-49,633,6,1,1,2,2,1,1,1,1,0,7.49471721243357E-5,0,0,147,297,2.9852402567743944E-4,1.198308E-5,1.2138721E-5,144,70,0,200,0,0
33662678,ashleyynicole94,10,3036,272,258,0,565,42.6331688336,40-49,686,6,2,2,4,4,2,2,1,1,0,1.529712617250445E-4,0.0833333333,1,365,663,2.985240256774393E-4,1.797462E-5,1.8208082E-5,375,22,0,200,0,0
33666565,profaucoin,10,441,96,101,1,0,25.2310961151,20-29,435,4,4,5,9,9,4,5,7,3.2216270506,39.4997654251,0.0025601624,0.1527777778,0.6,0,66,1.1009257661652729E-4,2.99577E-5,3.0346804E-5,55,1,0,200,0,0
33699810,1anhaga,10,4709,240,255,9,611,47.9559753889,40-49,690,7,25,10,35,35,25,10,7,2.9440910613,378.0650207057,0.0200403815,0.0605042017,0.13423645,0,66,1.2165358833688427E-4,1.5578004E-4,1.5780337E-4,47,22,0,199,0,0
33763811,andyfalleur,10,2620,291,123,11,0,41.3684160162,40-49,621,5,4,2,6,6,4,2,7,3.9193170405,3099,3.468151826471217E-4,0.1,0.33333334,0,66,9.832542219935758E-5,2.99577E-5,3.0346804E-5,372,13,0,198,0,0
33959429,cmarcoux,10,742,69,549,0,10,27.9407866832,20-29,483,5,4,53,57,57,4,53,7,2.5175761634,1110.8279601869,0.0059298832,0.26660401,0.4756894,0,66,6.171364250266E-5,2.99577E-5,3.0346804E-5,140,3,1,200,1,0.005
34023172,RICSON_MOREIRA,10,110,19,29,0,6,14.1904744132,10-19,149,3,0,1,1,1,0,1,1,1,0,0,0,0,203,473,4.4780486537007367E-5,0,6.0693606E-6,212,2,0,131,0,0
34025552,DanielJardine,10,927,354,357,7,4,37.9512724765,30-39,562,5,7,10,17,17,7,10,7,2.8935386676,62.1821914899,0.0102194933,0.1985294118,0.42857143,0,66,6.537611546928994E-5,4.793232E-5,4.8554884E-5,140,3,0,199,0,0
34073187,hhpouliot,10,410,115,201,0,71,40.2513992932,40-49,571,4,22,40,62,62,22,40,7,2.5962504185,147.8126964697,0.0217418217,0.189846642,0.460034,0,66,1.3263663968919186E-4,1.3780541E-4,1.395953E-4,390,25,3,200,3,0.015
34159192,elquintron,10,675,106,500,2,16,24.6677820996,20-29,418,5,6,34,40,40,6,34,7,2.6119852695,66.0844901365,0.0055651524,0.1647435897,0.3467023,0,66,6.350124097460201E-5,4.194078E-5,4.2485524E-5,47,0,1,200,1,0.005
34268681,Gemini717,10,2811,82,94,0,7,35.3045672239,30-39,651,6,2,2,4,4,2,2,1,1,0,1.529712617250445E-4,0.0833333333,1,181,343,2.985240256774393E-4,1.797462E-5,1.8208082E-5,296,9,0,200,0,0
34275728,darrengenge,10,699,92,213,2,3,21.7765333992,20-29,529,4,0,5,5,5,0,5,7,3.1017402945,0,0,0.15,0.25,0,317,4.4780486537007367E-5,0,6.0693606E-6,55,1,0,199,0,0
34276060,jesse_helmer,10,17760,1436,2001,64,1505,56.1659637994,50-59,766,8,161,215,376,376,161,215,6,2.2504184801,17354.9156819339,0.2049942912,0.0682269504,0.2169478,0,66,9.740354616289866E-4,9.7062945E-4,9.832365E-4,140,80,0,201,0,0
34296179,priosleal,10,17867,227,141,2,114,43.4244054534,40-49,739,8,0,0,0,0,0,0,0,0,0,0,0,0,190,366,4.4780486537007367E-5,0,0,186,2,0,201,0,0
34478789,DufferinRider,10,2818,143,407,1,43,49.5567871709,40-49,643,6,16,33,49,49,16,33,7,2.6792768664,872.8218796927,0.0175834389,0.1284013605,0.33650795,0,66,1.375759711198486E-4,1.0185618E-4,1.0317913E-4,390,29,0,204,0,0
34509503,MomaLoves,10,212,11,109,0,44,23.9905291452,20-29,416,4,0,2,2,2,0,2,8,3.4725568942,0,0,0,0,0,594,4.4780486537007367E-5,0,6.0693606E-6,390,2,0,200,0,0
34533812,stevechacon,10,2705,141,128,2,42,37.2865872893,30-39,676,5,0,0,0,0,0,0,0,0,0,0,0,0,372,679,4.4780486537007367E-5,0,0,382,13,0,200,0,0
34573800,reddit_gowest,10,1609,91,170,1,2,23.9232763475,20-29,619,5,8,26,34,34,8,26,7,2.5326414463,16.3377787417,0.0188532358,0.2513368984,0.48390806,0,66,9.038891961922446E-5,5.392386E-5,5.4624245E-5,140,0,5,200,5,0.025
35018890,MPRandyHoback,10,1009,1382,265,109,4,46.2267691137,40-49,661,4,118,38,156,156,118,38,7,2.7462336793,701.0942338042,0.1397910506,0.1149710505,0.22428642,0,66,9.517863771939827E-4,7.1299326E-4,7.1618456E-4,372,18,4,200,4,0.02
35302544,DaveWhitton,10,1186,171,710,1,5,25.2506944911,20-29,489,4,10,34,44,44,10,34,7,2.5493806495,8.1129683782,0.019362099,0.1839323467,0.47504455,0,66,6.894310802114915E-5,6.590694E-5,6.6762965E-5,47,1,0,199,0,0
35342112,nklas,10,3388,104,333,1,423,44.4120822076,40-49,649,6,2,3,5,5,2,3,7,3.3029795782,9.1912572773,9.311877770343254E-4,0.05,0.16666667,0,66,6.115536515939523E-5,1.797462E-5,1.8208082E-5,372,12,0,201,0,0
35425956,areviaki,10,1000,92,382,0,10,28.2705066878,20-29,533,5,10,38,48,48,10,38,7,2.5580850352,3387.4764860019,0.014504256,0.1555851064,0.31602564,0,66,7.357575254687373E-5,6.590694E-5,6.6762965E-5,47,2,1,200,1,0.005
35494350,celuss,10,2540,206,401,4,0,37.7252638877,30-39,653,6,0,0,0,0,0,0,0,0,0,0,0,0,159,312,4.4780486537007367E-5,0,0,155,1,0,200,0,0
35559137,abiramyv,10,3321,236,186,7,134,45.7809374336,40-49,637,6,2,8,10,10,2,8,7,2.8871777703,25.7218759528,0.0031956822,0.2111111111,0.5,0,66,5.224265670914629E-5,1.797462E-5,1.8208082E-5,390,20,0,200,0,0
35798442,mynameisangie_,10,1037,106,118,0,20,28.895532411,20-29,606,4,5,6,11,11,5,6,1,1,4.6666666667,3.968362010061254E-4,0.0818181818,0.53333336,264,497,2.3638338785183269E-4,3.594924E-5,3.6416164E-5,261,19,0,197,0,0
35965408,16jesse31,10,4329,357,485,1,970,41.8653041837,40-49,668,7,2,7,9,9,2,7,7,3.0133913626,5.6102906741,0.0014224342,0.0555555556,0.14285715,0,66,5.02963348097726E-5,1.797462E-5,1.8208082E-5,140,7,0,199,0,0
35975222,alancomic,10,208,229,111,6,1,41.7205045903,40-49,588,3,4,0,4,4,4,0,0,0,0,7.558915904836374E-4,0,0,0,36,1.1181771310892493E-4,2.99577E-5,0,55,8,0,200,0,0
36009850,CalvinValentine,10,20057,1097,420,21,6,51.2852899313,50-59,782,8,7,7,14,14,7,7,2,1.125,2.6666666667,5.792179173817595E-4,0.0879120879,0.7619048,214,407,3.642021135260639E-4,4.793232E-5,4.8554884E-5,266,65,0,200,0,0
36073085,pt_tory,10,54,404,1,18,0,37.4785362592,30-39,474,2,5,0,5,5,5,0,0,0,0,0.0032084767,0.1,0.15,0,26,6.07446373394025E-5,3.594924E-5,0,372,3,0,55,0,0
36098759,Ellzabob,10,158,26,152,0,337,13.1898573515,10-19,166,3,0,6,6,6,0,6,7,3.0508701473,0,0,0.5,0.8,0,684,4.4780486537007367E-5,0,6.0693606E-6,140,0,2,158,2,0.0126582278
36126551,RyanHastman,10,8932,1988,420,106,0,62.0542008762,60-69,757,7,93,36,129,129,93,36,6,2.7894208236,1152.9485833362,0.0978979167,0.0987766473,0.2560488,0,66,6.592449165351668E-4,5.6320475E-4,5.705199E-4,372,41,1,200,1,0.005
36128402,RomaAhi,10,1970,553,1148,12,12,44.537161495,40-49,605,6,52,102,154,154,52,102,7,2.4653498493,1388.8788386144,0.0762079249,0.1202784144,0.31067887,0,66,2.693830948408914E-4,3.175516E-4,3.216761E-4,140,13,0,200,0,0
36175685,JJVergaraD,10,30949,1465,677,33,114,52.5673663208,50-59,785,8,2,2,4,4,2,2,3,1.8,0,1.5603344237391447E-4,0.0833333333,1,60,152,2.8446170349844565E-4,1.797462E-5,1.8208082E-5,53,5,0,201,0,0
36293581,ishienriquez,10,6742,140,252,0,1583,41.2110076966,40-49,658,6,0,0,0,0,0,0,0,0,0,0,0,0,119,235,4.4780486537007367E-5,0,0,116,3,0,200,0,0
36395646,Pam_Palmater,10,6850,9339,61,234,18,61.1656853799,60-69,835,7,526,10,536,536,526,10,7,3.0867090726,6934.6756497943,0.422817339,0.049808202,0.07330436,0,66,0.0025131401,0.0031575416,0.0031864143,47,468,1,200,1,0.005
36422158,TweetCanGreen,10,5192,238,256,14,74,39.1273181375,30-39,596,7,23,31,54,54,23,31,7,2.7161031135,1973.8981839756,0.029942882,0.1205450734,0.2746806,0,66,1.457913978630237E-4,1.4379696E-4,1.4566466E-4,47,1,2,200,2,0.01
36462468,OdysseusCA,10,8456,569,1132,10,763,47.9137803765,40-49,748,7,214,312,526,526,214,312,6,2.1037830599,23459.6595245582,0.2567884287,0.0568712656,0.21028829,0,66,6.116139565598859E-4,0.001288181,0.0013049125,47,64,2,200,2,0.01
36711954,longpre11,10,11693,315,165,33,20,46.1876885392,40-49,699,7,3,3,6,6,3,3,7,3.021091396,24.2383304601,0.0039156726,0.1666666667,0.5833333,0,66,5.445612889716313E-5,2.396616E-5,2.4277442E-5,140,6,0,200,0,0
36961616,ian_wayne,10,1381,679,989,19,4,40.7538215377,40-49,587,5,156,194,350,350,156,194,6,2.2936056244,5387.1517968754,0.2556492616,0.0898812935,0.31657755,0,66,0.0011362509,9.406718E-4,9.528896E-4,390,20,10,200,10,0.05
36984909,SusanDelacourt,10,19203,21447,7590,1327,8,72.0842680658,70-79,896,8,1080,401,1481,1481,1080,401,6,2.0880482089,285110.649609119,0.9484533922,0.0277866489,0.06470128,0,66,0.0063018537,0.006476855,0.0064699384,140,969,9,202,9,0.0445544554
36988297,KeithS462,10,1226,527,1472,25,4,46.9493930235,40-49,607,5,58,142,200,200,58,142,6,2.3167057248,2889.4488971685,0.0907111744,0.1083668342,0.29234767,0,66,3.1018121010771923E-4,3.5350086E-4,3.5809228E-4,390,1,1,200,1,0.005
37029797,parliamenthill,10,2601,2413,988,126,579,37.3515056475,30-39,609,6,212,157,369,369,212,157,6,2.3066622029,11982.5445250163,0.3163235695,0.1017585719,0.20266393,0,66,0.0013220073,0.001276198,0.0012927739,140,0,8,200,7,0.04
37085947,Sethpt,10,2150,227,194,4,32,43.8618687005,40-49,648,5,16,25,41,41,16,25,7,2.6819551389,126.641742082,0.0301256039,0.2054878049,0.4848485,0,66,1.3896979449443318E-4,1.0185618E-4,1.0317913E-4,140,6,0,199,0,0
37106938,hesa2,10,1891,3197,3520,65,2,40.2304730948,40-49,653,6,5,5,10,10,5,5,7,3.3850016739,14291.2572952457,8.60820290891357E-4,0.0111111111,0.1,0,66,2.1241655650718576E-4,3.594924E-5,3.6416164E-5,320,0,0,199,0,0
37208886,MusingsFrom_TO,10,6274,214,712,5,773,37.4227124524,30-39,643,6,3,8,11,11,3,8,7,2.8778038165,6.8803504275,0.0032446308,0.1545454545,0.29166666,0,66,5.125094007037459E-5,2.396616E-5,2.4277442E-5,140,0,0,199,0,0
37263962,CPCDRE,10,12847,991,921,1,112,44.5315004834,40-49,734,7,1,1,2,2,1,1,1,1,0,7.49471721243357E-5,0,0,353,646,2.9852402567743944E-4,1.198308E-5,1.2138721E-5,362,11,0,200,0,0
37399340,takuarm,10,2114,129,490,0,318,39.4261160263,30-39,561,6,9,30,39,39,9,30,7,2.6648811517,152.7872288681,0.0052692162,0.1309041835,0.28125,0,66,7.415997397075757E-5,5.99154E-5,6.069361E-5,47,2,0,198,0,0
37485362,sjmc19,10,1358,168,111,2,36,36.8458813961,30-39,624,5,3,1,4,4,3,1,9,4.666555072,13.0062374253,9.007840957219749E-4,0,0,0,66,7.921719171680787E-5,2.396616E-5,2.4277442E-5,390,23,0,200,0,0
37491208,CanadasPredsFan,10,1239,256,148,7,8,47.6940263464,40-49,711,7,2,3,5,5,2,3,7,3.0472045531,0,0.0041604996,0.15,1,0,66,5.5238768917226964E-5,1.797462E-5,1.8208082E-5,390,6,0,201,0,0
37513164,financialdude1,10,7708,80,25,0,0,42.3909593416,40-49,552,9,0,0,0,0,0,0,0,0,0,0,0,0,175,332,4.4780486537007367E-5,0,0,169,1,1,201,1,0.0049751244
37515185,RobertAHammer,10,157,54,126,1,0,32.2912834843,30-39,522,4,5,12,17,17,5,12,7,2.8168731168,0.9119672217,0.0056778647,0.1985294118,0.6212121,0,66,5.866446134563014E-5,3.594924E-5,3.6416164E-5,390,13,0,200,0,0
37552089,suestroud,10,8878,559,768,21,97,50.1033505219,50-59,653,8,80,110,190,190,80,110,6,2.3538667559,5939.0294285706,0.0947527756,0.102951824,0.28292605,0,66,2.953683272147043E-4,4.8531473E-4,4.9161824E-4,390,35,2,204,2,0.0098039216
37597963,naomisayers00,10,25874,1727,1588,67,2295,53.6118871798,50-59,774,8,83,85,168,168,83,85,7,2.4603280884,8629.8004889888,0.0905904122,0.0452666096,0.18685693,0,66,4.526811064983569E-4,5.0328934E-4,5.098263E-4,47,42,1,201,1,0.0049751244
37609340,martin_fff,10,1906,298,101,14,2,46.0947636967,40-49,676,5,1,1,2,2,1,1,7,3.1215266153,0,2.95250416930859E-4,0.5,0.5,0,66,4.590057717206838E-5,1.198308E-5,1.2138721E-5,390,0,0,200,0,0
37713606,hydroqueen,10,22973,1156,1107,20,76,41.9604682002,40-49,767,8,53,54,107,107,53,54,6,2.4194844325,9740.1025195791,0.0739778539,0.0447011109,0.29225588,0,66,2.3155442812377005E-4,3.2354315E-4,3.2774548E-4,47,66,2,202,2,0.0099009901
37827784,intelicode,10,1902,793,1704,11,44,36.9163644443,30-39,579,5,3,2,5,5,3,2,2,1.5,0,2.3413472340332503E-4,0.15,1,169,323,3.0742779325956316E-4,2.396616E-5,2.4277442E-5,342,11,0,200,0,0
37912191,japeworthy,10,581,19,35,1,6,18.7029010363,10-19,378,3,4,12,16,16,4,12,7,2.7385336458,1.4368543352,0.0114918679,0.2125,0.54545456,0,66,6.165495409841676E-5,2.99577E-5,3.0346804E-5,390,1,14,200,13,0.07
37915527,KellyReganNS,10,9175,1777,576,84,2,54.031576243,50-59,749,7,75,47,122,122,75,47,7,2.7234683629,2024.0631203971,0.1014385727,0.1089283295,0.28164795,0,66,5.252069277435192E-4,4.5535705E-4,4.612714E-4,140,86,1,201,1,0.0049751244
37961352,retxab03,10,9654,140,377,2,475,39.2369416532,30-39,665,7,28,27,55,55,28,27,6,2.6056243723,75.5110821305,0.0404162248,0.1363636364,0.34756097,0,66,1.0887472532943962E-4,1.7375466E-4,1.7601145E-4,47,3,1,200,1,0.005
37970352,JoeyViezner,10,4812,247,510,1,20,59.8461863431,50-59,644,6,13,53,66,66,13,53,7,2.6337462337,167.3784919086,0.0105817194,0.182983683,0.35027224,0,66,8.989218951059398E-5,8.388156E-5,8.497105E-5,372,28,3,202,3,0.0148514851
38022839,Kabadyundi,10,3851,193,346,1,149,40.11890771,40-49,657,6,3,5,8,8,3,5,2,1.2857142857,0.25,2.404783068471783E-4,0.1607142857,0.75,0,53,1.3119079198735354E-4,2.396616E-5,2.4277442E-5,352,14,0,196,0,0
38038939,Pjhwalsh,10,4306,472,434,8,181,45.7674224607,40-49,727,7,47,38,85,85,47,38,7,2.7987947774,1562.0811796672,0.0418083782,0.1081232493,0.34190533,0,66,3.1862088682472827E-4,2.8759392E-4,2.913293E-4,372,18,5,200,5,0.025
38158508,jeroenu,10,3230,375,279,11,3,38.470726029,30-39,568,5,3,2,5,5,3,2,2,1.3333333333,4,2.264102469579659E-4,0.1,0.33333334,22,95,4.947234369086922E-4,2.396616E-5,2.4277442E-5,182,2,0,199,0,0
38186656,atayoko,10,2330,84,174,3,0,34.9577385657,30-39,561,5,0,0,0,0,0,0,0,0,0,0,0,0,284,532,4.4780486537007367E-5,0,0,281,0,2,200,2,0.01
38278645,chelsea_cameron,10,637,147,173,11,48,47.9357150636,40-49,541,4,2,4,6,6,2,4,6,2.7579511215,0.1216897836,0.00704786,0.1333333333,0.6666667,0,66,5.346355368835059E-5,1.797462E-5,1.8208082E-5,372,4,1,200,1,0.005
38290074,wicary,10,20519,8384,1859,525,0,56.3244815588,50-59,844,8,614,145,759,759,614,145,6,2.3431536659,31174.451428978,0.6693964992,0.0576372883,0.105427235,0,66,0.0034706934,0.003684797,0.003720518,140,125,0,200,0,0
38442445,Jord_EST,10,8274,1117,1351,1,350,56.9636106197,50-59,736,7,4,5,9,9,4,5,7,2.9876129896,12.9777680892,0.0034766453,0.0833333333,0.6,0,66,5.360782222686846E-5,2.99577E-5,3.0346804E-5,47,1,0,201,0,0
38465211,sciencepolicy,10,1333,4682,2479,187,4,52.9064968451,50-59,696,5,43,28,71,71,43,28,6,2.6056243723,9425.8279976733,0.0414179505,0.0378269618,0.15151516,0,66,3.6316366914029597E-4,2.6362776E-4,2.6705186E-4,55,33,0,201,0,0
38481059,megamouthmedia,10,16769,26960,4329,96,895,68.1154054763,60-69,781,8,19,17,36,36,19,17,7,2.8413123535,1196.8876282942,0.0183977416,0.0388888889,0.24269006,0,66,1.3590036511559688E-4,1.198308E-4,1.2138722E-4,55,35,0,200,0,0
38494251,amandawi,10,445,463,563,7,1,36.5909729267,30-39,570,4,35,49,84,84,35,49,7,2.6565115501,879.5513373883,0.0386370673,0.1435742972,0.39726776,0,66,1.90046709769823E-4,2.1569544E-4,2.1849698E-4,390,0,0,200,0,0
38499453,HFX_Lauren,10,9905,808,1091,16,89,50.2086559001,50-59,709,7,38,78,116,116,38,78,6,2.4509541346,1769.9361872572,0.058912531,0.1448275862,0.37890938,0,66,2.107514739194198E-4,2.3367006E-4,2.3670506E-4,390,65,1,201,1,0.0049751244
38639718,lise_latulippe,10,6865,376,852,4,75,34.1525889231,30-39,684,7,92,171,263,263,92,171,6,2.2176096418,1326.8877485341,0.1397645139,0.0978434389,0.35317248,0,66,2.4076607427734592E-4,5.572132E-4,5.644505E-4,47,16,1,205,1,0.0048780488
38744285,Phumbling,10,881,54,130,1,9,40.0028764067,40-49,536,4,8,12,20,20,8,12,7,2.9645128892,24.3895756725,0.0053175801,0.0815789474,0.1952381,0,66,6.347820736001115E-5,5.392386E-5,5.4624245E-5,390,20,1,200,1,0.005
38807340,Bell_Mobility,10,3739,21641,486,284,4,82.0529069086,80-89,827,6,20,4,24,24,20,4,7,3.2537663207,123.8022935645,0.0091673221,0.0163043478,0.03809524,0,66,1.0749836906193662E-4,1.2582233E-4,1.2745657E-4,140,32,0,200,0,0
38949890,Dfildebrandt,10,4857,2847,1809,109,7,61.1916173762,60-69,752,6,177,148,325,325,177,148,6,2.3866755942,28445.9958299449,0.1724798473,0.0527730294,0.16627906,0,66,0.0012663416,0.0010664942,0.0010803462,372,196,4,200,4,0.02
39040737,KnorthernKnight,10,25607,1595,2001,72,142,54.6465695973,50-59,785,8,16,23,39,39,16,23,7,2.7150987613,97.9012144968,0.016773704,0.0931174089,0.2413793,0,66,9.195306060182296E-5,1.0185618E-4,1.0317913E-4,47,3,0,200,0,0
39204895,benfromcanada,10,40133,930,790,64,2547,51.4351360192,50-59,831,9,34,28,62,62,34,28,7,2.6391027787,557.2723183367,0.0386542838,0.1017979905,0.2155102,0,66,1.4337565338964542E-4,2.097039E-4,2.1242762E-4,47,17,0,201,0,0
39234426,gsmardli,10,108,28,96,0,94,40.2981785025,40-49,482,4,3,11,14,14,3,11,7,2.8215600937,91.7741406308,7.138267493565225E-4,0.1428571429,0.34545454,0,66,5.929256147316878E-5,2.396616E-5,2.4277442E-5,390,9,1,200,1,0.005
39499475,ryansparrow,10,8231,1976,796,57,1,49.1511329144,40-49,740,7,184,73,257,257,184,73,6,2.6809507867,2630.7936444716,0.231412197,0.09973857,0.19881523,0,66,0.0016173757,0.0011084349,0.0011167624,372,20,2,200,1,0.01
39532535,MichaelCeci,10,3709,950,613,46,1,45.729818124,40-49,698,6,23,17,40,40,23,17,7,3.0381653833,6775.6793333151,0.0120882157,0.0987179487,0.21370968,0,66,1.3955051456690236E-4,1.4379696E-4,1.4566466E-4,372,37,0,200,0,0
39684793,brianostrander,10,9037,715,1297,11,30,47.8797136188,40-49,697,7,13,48,61,61,13,48,6,2.5999330432,172.3488090729,0.01773351,0.1836065574,0.39372548,0,66,9.27964546865769E-5,8.388156E-5,8.497105E-5,372,15,1,200,1,0.005
39871064,GovernmentDroid,10,359145,3440,2198,120,1,41.7100235614,40-49,760,12,12,3,15,15,12,3,7,2.973886843,19.6770004494,0.008314701,0.0857142857,0.20512821,0,66,7.695065853820674E-5,7.789002E-5,7.8901685E-5,47,0,0,201,0,0
40015876,ChadCowie,10,3345,520,551,22,206,45.9362644518,40-49,687,6,82,79,161,161,82,79,7,2.4974891195,2482.7341745503,0.1100674091,0.0914208075,0.33152485,0,66,4.677634586087626E-4,4.972978E-4,5.037569E-4,140,77,1,200,1,0.005
40121934,ylc_jlc,10,773,2460,1138,118,0,48.7001333098,40-49,723,5,182,80,262,262,182,80,6,2.4733846669,5170.0708116265,0.1926633947,0.0872598052,0.20711604,0,66,9.661355493810615E-4,0.0010964518,0.001110693,140,97,0,199,0,0
40152815,tibiamyfibula,10,7108,249,329,6,890,50.6485047781,50-59,695,7,39,25,64,64,39,25,7,2.6283896887,284.2266673015,0.044535156,0.1351686508,0.25555557,0,66,1.4509854824822636E-4,2.396616E-4,2.4277443E-4,47,28,17,206,14,0.0825242718
40156733,misfit77ca,10,5671,388,682,9,658,48.642325599,40-49,710,7,137,199,336,336,137,199,6,2.2259792434,5992.072001468,0.170566154,0.0776030561,0.2610714,0,66,3.576728443714155E-4,8.268325E-4,8.3757174E-4,47,95,0,213,0,0
40191477,JohnnyJesus,10,45189,1273,665,32,5831,42.3315288536,40-49,783,9,68,86,154,154,68,86,6,2.630063609,4061.8073670066,0.034749537,0.0770732535,0.28454545,0,66,3.0964563190830785E-4,4.1341624E-4,4.1878587E-4,372,122,9,204,9,0.0441176471
40203927,laverty122,10,1519,292,724,0,7,29.1379739724,20-29,600,5,5,9,14,14,5,9,2,1.1,8.3333333333,3.937867471776074E-4,0.1483516484,0.4861111,2,183,1.1142212515795368E-4,3.594924E-5,3.6416164E-5,322,5,0,199,0,0
40359136,jobeth69,10,2138,250,886,2,56,45.5202237405,40-49,642,6,5,8,13,13,5,8,7,2.9648476733,169.6540319652,0.0035564699,0.0961538462,0.22222222,0,66,6.263197561416128E-5,3.594924E-5,3.6416164E-5,47,2,0,200,0,0
40397784,pmoharper,10,23880,5291,1790,301,471,54.3698866203,50-59,820,8,453,244,697,697,453,244,6,2.1700703047,64650.7576879991,0.4735142032,0.0559747027,0.11588165,0,66,0.0019676843,0.0027201592,0.0027372816,47,436,0,202,0,0
40448657,grahamgreer,10,1566,443,193,16,72,43.8528411111,40-49,657,5,1,3,4,4,1,3,8,3.5058587211,3.4261149755,2.2609918765391796E-4,0,0,0,66,4.921887343688777E-5,1.198308E-5,1.2138721E-5,390,0,0,200,0,0
40536415,Lancecote,10,3786,82,231,0,54,41.1473287414,40-49,646,6,3,0,3,3,3,0,0,0,0,0.0024194678,0.1666666667,0.33333334,0,48,5.009564877268508E-5,2.396616E-5,0,47,7,0,200,0,0
40550119,Carolyn_Bennett,10,15281,10906,4575,593,28,68.6008947835,60-69,819,8,730,494,1224,1224,730,494,6,2.0093739538,253854.102888935,0.700158083,0.0290797567,0.08799418,0,66,0.0035244346,0.004379816,0.0044002864,140,624,3,202,3,0.0148514851
40674652,DivoGiulio,10,1807,126,109,2,7,41.1618894203,40-49,639,6,2,1,3,3,2,1,8,4.4245061935,0,2.4756264874053715E-4,0.1666666667,1,0,66,7.659081318217085E-5,1.797462E-5,1.8208082E-5,372,38,0,200,0,0
40697478,JamesJJRyan,10,5319,1192,1976,22,15,51.3618522054,50-59,743,7,88,134,222,222,88,134,7,2.4141278875,21025.2012841907,0.0827041321,0.1009335127,0.20567833,0,66,4.69893691255592E-4,5.332471E-4,5.341037E-4,390,94,0,202,0,0
40756532,StopWarCa,10,2323,1504,1270,83,1,42.7594503628,40-49,705,6,59,70,129,129,59,70,7,2.5058587211,2523.0130967331,0.0868801451,0.1108890504,0.2547525,0,66,3.5371196786851666E-4,3.594924E-4,3.6416165E-4,390,28,0,200,0,0
40804489,Rchlfth,10,857,596,2001,11,274,43.5040651183,40-49,550,5,0,0,0,0,0,0,0,0,0,0,0,0,404,727,4.4780486537007367E-5,0,0,414,1,0,201,0,0
40863827,Jesus_H_Chris,10,3186,5783,265,79,718,57.2495080001,50-59,770,6,22,5,27,27,22,5,7,3.1161700703,4679.0232798375,0.0110339052,0.0384615385,0.06333333,0,66,2.474708602934156E-4,1.3780541E-4,1.2138722E-4,372,39,0,200,0,0
40950257,markymark7717,10,12092,954,2001,26,338,47.6743353185,40-49,742,7,51,70,121,121,51,70,7,2.4543019752,3165.3329069282,0.0672799009,0.0792011019,0.20774032,0,66,1.8837841583252938E-4,3.1156008E-4,3.1560674E-4,47,20,3,203,3,0.0147783251
40952193,hyperman514,10,12966,1045,1513,15,489,59.1805235196,50-59,777,8,17,38,55,55,17,38,6,2.593572146,492.4446363959,0.0179422956,0.1097643098,0.29390243,0,66,1.2393416989118006E-4,1.0784772E-4,1.0924849E-4,390,4,0,200,0,0
41013703,LyndaDW,10,3552,645,1989,22,76,39.016525727,30-39,597,6,16,62,78,78,16,62,7,2.5011717442,6404.5650781238,0.0390610141,0.1846486846,0.4009324,0,66,1.4709142481743754E-4,1.0185618E-4,1.0317913E-4,140,0,1,198,1,0.0050505051
41032055,eaglespirit44,10,4406,325,603,14,75,41.3808518863,40-49,652,5,21,31,52,52,21,31,7,2.7217944426,193.7922893353,0.0183317134,0.1142533937,0.32456142,0,66,1.2161648678160215E-4,1.3181388E-4,1.3352593E-4,47,1,0,200,0,0
41043869,JeffClark1969,10,12363,971,2003,38,31,63.0038594685,60-69,722,8,176,291,467,467,176,291,7,2.1683963843,19528.003232978,0.2197356232,0.0580180313,0.19875251,0,66,6.221107095070318E-4,0.0010605026,0.0010742769,140,87,1,200,1,0.005
41112530,catmommy23,10,243,5,17,0,0,11.7341444214,10-19,15,4,0,0,0,0,0,0,0,0,0,0,0,0,143,285,4.4780486537007367E-5,0,0,139,0,0,200,0,0
41156065,hoenscheid,10,1275,355,244,22,10,39.8768348135,30-39,550,5,0,1,1,1,0,1,1,1,0,0,0,0,50,141,4.4780486537007367E-5,0,6.0693606E-6,41,0,0,200,0,0
41186732,BlueDuPage,10,119592,10521,6408,663,520,60.4679594223,60-69,940,9,59,48,107,107,59,48,7,2.6836290593,54215.5547428982,0.0284118119,0.0203667783,0.104371585,0,66,7.538004146926524E-4,3.594924E-4,3.5809228E-4,47,121,0,213,0,0
41205644,BKJohnstone,10,1703,886,1219,32,90,49.1364628837,40-49,633,6,81,124,205,205,81,124,6,2.3555406763,3535.7535322452,0.1191153859,0.1112147298,0.29038864,0,66,5.334618228738211E-4,4.913063E-4,4.9768755E-4,140,42,5,200,4,0.025
41362246,calfoss,10,3480,123,292,0,0,33.3024146171,30-39,402,5,0,0,0,0,0,0,0,0,0,0,0,0,178,337,4.4780486537007367E-5,0,0,173,0,0,201,0,0
41378883,pfthurley,10,16577,1846,1997,118,107,51.3047861635,50-59,762,8,146,208,354,354,146,208,6,2.2376966856,19581.7958477777,0.2179439892,0.0791360574,0.24099581,0,66,9.622811763025106E-4,8.8075636E-4,8.92196E-4,390,56,0,201,0,0
41514883,ElectDanielle,10,9202,14672,1746,421,58,63.0352358295,60-69,874,7,340,58,398,398,340,58,6,2.6297288249,26920.740641729,0.2565794745,0.0472576991,0.08406058,0,66,0.0022730394,0.0020431152,0.0020514438,372,372,7,200,7,0.035
41532121,aladdintweets,10,2912,231,1108,7,10,46.6700761761,40-49,624,6,10,19,29,29,10,19,7,2.8346166722,386.6912495154,0.0119910277,0.1206896552,0.2536232,0,66,8.865991277304318E-5,6.590694E-5,6.6762965E-5,140,22,0,207,0,0
41706757,tapferkeit,10,55306,2429,2165,54,8734,46.570641239,40-49,790,9,168,166,334,334,168,166,6,2.2457315032,16505.9884848803,0.1752681769,0.0369171567,0.2381341,0,66,4.707151205829053E-4,0.0010125702,0.0010196526,47,179,0,206,0,0
41831995,PoliticalBee,10,79154,4389,4813,338,99156,45.9526913349,40-49,762,10,26,41,67,67,26,41,7,2.6709072648,6079.0431548763,0.0222077521,0.0373134328,0.16260162,0,66,1.7949131680577952E-4,1.6177158E-4,1.6387274E-4,47,4,0,201,0,0
41870206,Momforchoice,10,6506,766,656,44,8,54.6827980084,50-59,715,7,37,50,87,87,37,50,6,2.3843321058,883.0888636382,0.0715249307,0.1011761561,0.33459964,0,66,2.3200496133548893E-4,2.2767852E-4,2.306357E-4,140,4,0,199,0,0
42075969,calgaryrants,10,9700,2601,812,152,56,58.2314909735,50-59,756,7,53,47,100,100,53,47,6,2.6943421493,800.3910433572,0.0381173138,0.1155555556,0.30470195,0,66,3.992640299829495E-4,3.2354315E-4,3.2774548E-4,372,12,0,200,0,0
42198561,TheMarthaChaves,10,1387,522,665,7,250,50.0689091998,50-59,646,6,12,18,30,30,12,18,7,2.6996986943,93.7319165569,0.0134583936,0.0724137931,0.25438598,0,66,7.711571602438854E-5,7.789002E-5,7.8901685E-5,47,18,0,200,0,0
42250627,SarahBestBailey,10,2453,235,219,1,120,30.7860489505,30-39,593,5,3,0,3,3,3,0,0,0,0,2.4057064014301654E-4,0.5,1,264,496,1.4218311404253528E-4,2.396616E-5,0,261,2,0,200,0,0
42376010,siksaapo,10,3870,579,1474,10,139,43.9139622137,40-49,618,6,92,179,271,271,92,179,6,2.2199531302,10241.8143355517,0.0978396106,0.063864972,0.21755679,0,66,3.3558396250107524E-4,5.572132E-4,5.644505E-4,47,10,0,197,0,0
42411129,SierraClubCan,10,1851,5958,79,311,104,58.5561336685,50-59,744,5,187,7,194,194,187,7,7,3.1878138601,1553.0626285605,0.1624323874,0.0631109449,0.0926426,0,66,8.539771287323668E-4,0.0011264095,0.0011228317,47,139,0,200,0,0
42553151,TaniaCameron,10,3449,665,404,30,86,52.2068437526,50-59,725,6,101,63,164,164,101,63,7,2.4770672916,5428.3295430784,0.1102068829,0.0737692653,0.19992997,0,66,4.866936181104308E-4,6.111371E-4,6.190748E-4,47,77,0,199,0,0
42691701,lucyfukushima,10,493,37,243,0,2,22.3547546888,20-29,195,4,1,4,5,5,1,4,7,3.1523267492,0.0382235536,0.0016863791,0.3,0.4,0,66,4.553966086114525E-5,1.198308E-5,1.2138721E-5,55,0,0,200,0,0
42896073,RichardMadan,10,4003,7419,1453,393,0,60.1500805302,60-69,771,6,416,103,519,519,416,103,6,2.432206227,13494.3559965036,0.4941483605,0.0680585623,0.13225803,0,66,0.0029649918,0.002498472,0.0024945072,140,133,7,200,7,0.035
42985494,fawking_riot,10,11475,603,229,11,332,51.8049395696,50-59,743,7,11,5,16,16,11,5,7,2.9795781721,1.4279199129,0.0134969669,0.1708333333,0.6454545,0,66,7.146789757271887E-5,7.189848E-5,7.283233E-5,47,6,0,201,0,0
43005927,imHannanymous,10,14390,312,277,0,1955,48.8665017319,40-49,750,7,0,0,0,0,0,0,0,0,0,0,0,0,156,309,4.4780486537007367E-5,0,0,153,10,0,201,0,0
43047440,kirvine1,10,1946,142,146,5,24,40.0800964432,40-49,636,6,1,1,2,2,1,1,1,1,5.2498593358,3.7095327390540805E-4,0,0,0,30,5.1437291395228235E-5,1.198308E-5,1.2138721E-5,43,6,0,200,0,0
43162451,gavanp,10,1633,227,149,9,3,43.47591539,40-49,588,6,9,17,26,26,9,17,7,2.8269166388,240.7863951672,0.0201497749,0.1584615385,0.41578948,0,66,1.1331583232161412E-4,5.99154E-5,5.4624245E-5,372,14,0,200,0,0
43171180,qualitypunk,10,7460,447,686,13,3608,49.2051714251,40-49,671,6,14,37,51,51,14,37,7,2.5872112487,252.3168339958,0.019407268,0.1709803922,0.3815331,0,66,9.465411764937306E-5,8.98731E-5,9.104041E-5,140,7,0,200,0,0
43331611,Tjminniecon,10,1970,1478,211,24,5,50.7569501454,50-59,717,6,6,2,8,8,6,2,1,1,0,4.729144854588212E-4,0.2678571429,0.6333333,250,478,6.050919732274689E-4,4.194078E-5,4.2485524E-5,248,57,0,199,0,0
43364540,CarlosPaulC,10,8809,630,1084,5,8,48.5964999655,40-49,759,8,0,0,0,0,0,0,0,0,0,0,0,0,107,219,4.4780486537007367E-5,0,0,103,79,0,200,0,0
43568344,loreleemarin,10,325,70,145,0,9,21.219721316,20-29,480,4,3,7,10,10,3,7,6,2.8496819551,0.8317275466,0.0058018142,0.2,0.7619048,0,66,6.042858578572334E-5,2.396616E-5,2.4277442E-5,372,3,1,200,1,0.005
43605411,smilalady,10,5020,365,616,13,79,51.392287193,50-59,714,7,8,12,20,20,8,12,7,3.0013391363,122.9434018391,0.0048589953,0.1131578947,0.2904762,0,66,7.332256387590619E-5,5.392386E-5,5.4624245E-5,47,20,0,196,0,0
43705629,ECJLajoie,10,4276,670,1306,13,392,40.9981994529,40-49,695,6,48,80,128,128,48,80,6,2.3662537663,1375.9899110484,0.0815625322,0.1045152559,0.30014026,0,66,1.9524518382732763E-4,2.9358547E-4,2.9739868E-4,140,14,0,201,0,0
43740286,alisoncrawford5,10,2621,6596,539,371,1,59.7207371679,50-59,733,5,449,65,514,514,449,65,7,2.6002678273,4917.7887745087,0.4990694238,0.0721095865,0.11757993,0,66,0.0026065131,0.002696193,0.0027008655,140,65,3,200,3,0.015
43803995,thisisshelby1,10,7552,865,1631,12,4680,53.6421657828,50-59,703,7,18,32,50,50,18,32,7,2.7837294945,1170.2295355544,0.0065070551,0.0559183673,0.21875,0,66,1.402591819808127E-4,1.1383926E-4,1.1531785E-4,47,22,0,202,0,0
43815505,LiamLahey,10,27945,1537,887,84,39,,,765,8,33,28,61,61,33,28,6,2.5095413458,332.9394972818,0.0680817042,0.0726775956,0.40998217,0,66,1.7958307154997512E-4,2.0371236E-4,2.0635827E-4,47,8,0,200,0,0
43897603,David_Bertschi,10,1852,1459,894,89,9,53.9149350328,50-59,714,5,178,131,309,309,178,131,6,2.3947104118,13695.5775728122,0.1983569063,0.0750640945,0.20302883,0,66,9.077345096716609E-4,0.0010724857,0.0010742769,140,227,0,200,0,0
44060922,b_scheller,10,31390,1038,707,26,16562,55.5696582804,50-59,784,8,57,56,113,113,57,56,6,2.4640107131,2252.2095360789,0.0667167314,0.040534134,0.2872807,0,66,1.9746771198042427E-4,3.475093E-4,3.520229E-4,47,83,0,202,0,0
44126988,gwplex,10,15,7,14,0,0,16.6056782525,10-19,17,0,0,0,0,0,0,0,0,0,0,0,0,0,129,249,4.4780486537007367E-5,0,0,126,1,0,16,0,0
44207086,lynneakin,10,68,166,68,11,0,34.0593789734,30-39,388,2,1,2,3,3,1,2,7,3.1221961835,0,0.003506188,0.1666666667,1,0,66,6.071098789883314E-5,1.198308E-5,1.2138721E-5,390,1,0,68,0,0
44238517,StephHerold,10,26332,9063,5598,620,12,61.4200134097,60-69,889,7,21,18,39,39,21,18,7,2.8001339136,771.5665424966,0.0194647996,0.0506072874,0.18461539,0,66,1.492167290469121E-4,1.3181388E-4,1.3352593E-4,47,21,0,201,0,0
44280511,yardiblack,10,1795,167,482,1,3,40.3416128473,40-49,500,5,0,0,0,0,0,0,0,0,0,0,0,0,195,374,4.4780486537007367E-5,0,0,190,1,0,201,0,0
44316923,MylanTootoosis,10,837,740,248,18,304,46.4324292925,40-49,679,5,49,0,49,49,49,0,0,0,0,0.0290801344,0.1709183673,0.27338436,0,19,2.3757321685406662E-4,2.99577E-4,0,47,4,0,199,0,0
44366939,geckospots,10,2827,71,155,2,19,40.9319231623,40-49,640,6,3,4,7,7,3,4,7,3.0997656512,11.5607160743,0.0053409688,0.0952380952,0.41666666,0,66,6.891229464300549E-5,2.396616E-5,2.4277442E-5,390,39,1,199,1,0.0050251256
44482290,pkyo,10,336,24,70,0,8,17.0376144503,10-19,453,3,0,2,2,2,0,2,8,3.5147255689,0,0,0.5,1,0,586,4.4780486537007367E-5,0,6.0693606E-6,55,0,0,200,0,0
44708852,TVVH,10,8955,256,370,9,326,45.387287025,40-49,683,7,39,48,87,87,39,48,6,2.4111148309,575.7625961157,0.0816611816,0.0892809409,0.3612858,0,66,1.8901333327608685E-4,2.396616E-4,2.4277443E-4,140,19,0,201,0,0
44718864,jamesbezan,10,313,2585,1306,176,2,46.7862238759,40-49,652,3,123,14,137,137,123,14,7,2.776029461,2862.512563759,0.1472844922,0.1189888364,0.19264516,0,66,9.509857657752317E-4,7.4295094E-4,7.40462E-4,372,10,0,200,0,0
44777956,heatherkel,10,82,48,71,7,4,24.1252369731,20-29,203,2,5,12,17,17,5,12,7,3.0666220288,2.9833723715,0.0024248143,0.2352941176,0.510989,0,66,6.160237381881175E-5,3.594924E-5,3.6416164E-5,390,6,0,110,0,0
44946908,DustyMullinax,10,4532,263,273,0,5,28.4160494008,20-29,635,6,0,0,0,0,0,0,0,0,0,0,0,0,354,647,4.4780486537007367E-5,0,0,363,17,0,200,0,0
45029276,simrath,10,1341,248,770,4,4,53.2556603462,50-59,597,6,38,116,154,154,38,116,6,2.2785403415,1600.9479495433,0.0619966146,0.143069349,0.34121394,0,66,1.8495599715798972E-4,2.3367006E-4,2.3670506E-4,140,14,2,199,2,0.0100502513
45113194,Jc_gay,10,1438,78,222,4,28,43.0126742727,40-49,532,5,0,1,1,1,0,1,4,3,0,0,0,0,0,260,4.4780486537007367E-5,0,6.0693606E-6,320,0,0,200,0,0
45129106,SIJAFNET,10,2199,270,481,11,79,38.0491433814,30-39,598,5,0,1,1,1,0,1,1,1,0,0,0,0,203,489,4.4780486537007367E-5,0,6.0693606E-6,212,0,0,200,0,0
45199534,n00b_blogger,10,1640,126,154,2,468,44.5959936342,40-49,560,5,16,32,48,48,16,32,7,2.6364245062,222.3865308724,0.0140885247,0.102393617,0.28655463,0,66,9.508664593647928E-5,1.0185618E-4,1.0317913E-4,140,5,0,199,0,0
45214513,eagle3300,10,5897,648,1155,37,54,42.7085650903,40-49,646,7,16,39,55,55,16,39,7,2.5604285236,1872.8111263493,0.0361508655,0.1595959596,0.34299517,0,66,1.4386358531788147E-4,1.0185618E-4,1.0317913E-4,140,1,0,200,0,0
45418457,Pablitski,10,50852,2609,2517,68,209,52.404884945,50-59,783,9,3,5,8,8,3,5,9,4.6049548042,4573.3166666668,2.685360360470544E-4,0.0892857143,0.35,0,66,1.0539543819392093E-4,2.396616E-5,2.4277442E-5,320,1,0,201,0,0
45627934,leenaminifie,10,1573,692,945,28,345,61.7241605002,60-69,629,6,26,32,58,58,26,32,7,2.817877469,356.8562380218,0.0272229105,0.0989110708,0.3299595,0,66,2.0090446453547266E-4,1.6177158E-4,1.6387274E-4,47,3,0,198,0,0
45637133,Crockatteer,10,10972,3672,1261,122,16,59.7021657772,50-59,782,7,297,119,416,416,297,119,6,2.4409106127,24589.634972516,0.2829864544,0.06177595,0.12713312,0,66,0.002122437,0.0017854789,0.0018026001,372,272,18,200,17,0.09
46213096,dgordonwaters,10,1702,161,443,4,31,38.3644539985,30-39,656,6,38,89,127,127,38,89,6,2.3876799464,1136.6007127629,0.0469331787,0.1146731659,0.2862262,0,66,1.4416919542145916E-4,2.3367006E-4,2.3670506E-4,47,23,0,201,0,0
46286710,punditsguide,10,16496,8752,3881,455,3,64.5097200742,60-69,779,8,808,486,1294,1294,808,486,6,2.0565785069,277364.634753202,0.7705974889,0.0271543001,0.07935808,0,66,0.0048825755,0.004847156,0.00484335,390,712,6,211,5,0.028436019
46381669,CONDESCENDANT,10,15419,1897,2019,33,396,55.7357956035,50-59,783,8,37,57,94,94,37,57,7,2.5600937395,2307.9787758126,0.0354115328,0.0728666209,0.23083025,0,66,2.576829292788284E-4,2.2767852E-4,2.306357E-4,140,117,1,201,1,0.0049751244
46390071,TWIT_ANTHONY,10,408,63,172,2,14,25.3050417182,20-29,435,4,1,4,5,5,1,4,7,3.0997656512,2986,1.0223748261100382E-4,0.15,0.41666666,0,66,1.0554020357834843E-4,1.198308E-5,1.2138721E-5,390,3,0,200,0,0
46396082,chowamis,10,199,1100,1401,10,0,47.3690169264,40-49,491,3,0,0,0,0,0,0,0,0,0,0,0,0,171,327,4.4780486537007367E-5,0,0,165,1,0,200,0,0
46420869,librariantechie,10,554,356,837,9,157,47.0006366989,40-49,535,5,3,4,7,7,3,4,7,3.2125878808,38.1099005362,0.0010619756,0.0952380952,0.41666666,0,66,6.760814706039866E-5,2.396616E-5,2.4277442E-5,47,0,0,201,0,0
46510052,KPCareers,10,1688,1575,590,67,86,45.3917185312,40-49,626,4,1,0,1,1,1,0,0,0,0,7.34391852452689E-5,0,0,400,721,8.284390166388585E-5,1.198308E-5,0,412,2,0,200,0,0
46555511,Alex_Panetta,10,10000,4267,975,175,1,62.6476033738,60-69,776,7,248,56,304,304,248,56,6,2.5540676264,2860.3447608284,0.3545885053,0.1076406983,0.19695574,0,66,0.0021765634,0.0014918934,0.0015052014,140,68,0,200,0,0
46710447,MeganLeslieMP,10,4482,11753,2941,559,1,64.5783251754,60-69,790,6,796,418,1214,1214,796,418,6,2.1215266153,345624.592784765,0.6919169517,0.0268623411,0.07515936,0,66,0.00438787,0.0047752573,0.004709824,390,859,5,200,5,0.025
46714028,EhsanBegloo,10,7636,461,477,20,17,30.7232334576,30-39,708,7,2,2,4,4,2,2,7,3.2895882156,0.5424818738,0.0016451167,0,0,0,66,5.439191684546428E-5,1.797462E-5,1.8208082E-5,390,0,0,200,0,0
46851659,beanjammin,10,1442,126,152,3,6,26.1991817406,20-29,588,5,4,8,12,12,4,8,7,2.9240040174,1.9511239348,0.003261204,0.2196969697,0.41111112,0,66,5.404502749805496E-5,2.99577E-5,3.0346804E-5,140,1,0,200,0,0
46919079,Terrilltf,10,22557,1715,1983,55,1672,58.0165139168,50-59,755,9,125,142,267,267,125,142,6,2.3418145296,10076.8914125713,0.1130028483,0.046774239,0.23125827,0,66,4.8050832980785544E-4,7.5493404E-4,7.6473947E-4,47,87,0,223,0,0
46947111,ondasalmon,10,17557,396,401,1,46,44.3065257962,40-49,746,7,2,2,4,4,2,2,1,1,0,1.529712617250445E-4,0.0833333333,1,325,589,2.985240256774393E-4,1.797462E-5,1.8208082E-5,330,13,0,201,0,0
46956207,paulchislett,10,8817,650,1707,23,7,44.0237642653,40-49,671,7,34,80,114,114,34,80,6,2.3880147305,924.354135863,0.0548568224,0.0967241112,0.275,0,66,1.8125815701167052E-4,2.097039E-4,2.1242762E-4,390,7,0,199,0,0
47022386,juristblog,10,10305,990,928,58,2,47.2874656136,40-49,698,7,186,204,390,390,186,204,6,2.2387010378,24445.1549469108,0.2554908375,0.0709181992,0.22665782,0,66,9.155609540535305E-4,0.001120418,0.0011349705,390,11,4,200,4,0.02
47368707,Sr_Ramirez,10,9638,695,1266,1,2661,42.7697324016,40-49,665,7,2,5,7,7,2,5,9,4.6049548042,0,1.870324059237053E-4,0.2142857143,0.33333334,0,66,8.191306199890774E-5,1.797462E-5,1.8208082E-5,320,2,0,201,0,0
47459386,danlebla,10,12634,16539,647,519,0,65.4215790234,60-69,839,7,301,35,336,336,301,35,7,2.6514897891,2540.5396763961,0.3935346689,0.1011549396,0.16739646,0,66,0.0022407882,0.0018094451,0.0018268776,390,95,0,200,0,0
47501529,hunterccarter,10,2564,332,815,4,2,44.0994325872,40-49,653,6,0,0,0,0,0,0,0,0,0,0,0,0,66,159,4.4780486537007367E-5,0,0,58,14,0,200,0,0
47533676,smithjoanna,10,10266,10125,2230,715,123,61.5953275604,60-69,779,7,576,193,769,769,576,193,6,2.2942751925,32707.2435392015,0.6427304451,0.0548094116,0.11405122,0,66,0.003455826,0.0034571185,0.0034716744,390,85,5,200,5,0.025
47845089,paulbthompson,10,249,93,263,3,3,41.8978333763,40-49,527,4,10,29,39,39,10,29,7,2.755272849,166.1268272415,0.0113741541,0.1761133603,0.31996435,0,66,7.586497261765162E-5,6.590694E-5,6.6762965E-5,390,16,1,199,1,0.0050251256
48066044,MikeMcGill77,10,109,2,74,0,0,18.0788399951,10-19,142,3,0,2,2,2,0,2,7,3.3664658635,0,0,0.5,1,0,424,4.4780486537007367E-5,0,6.0693606E-6,140,3,1,132,1,0.0075757576
48350044,MennoTamming,10,8298,1314,699,29,1,46.0158973922,40-49,724,7,2,2,4,4,2,2,1,1,2,1.4992441991589235E-4,0,0,51,140,4.3582306220354E-4,1.797462E-5,1.8208082E-5,42,21,0,200,0,0
48415266,partialtomusic,10,3610,191,295,14,8,45.3205216193,40-49,684,6,23,45,68,68,23,45,7,2.4907934382,255.5355722654,0.0449506099,0.1567164179,0.39658925,0,66,1.0530694177432656E-4,1.4379696E-4,1.4566466E-4,47,9,0,200,0,0
48457938,cclar104,10,1229,183,293,1,314,41.4579793011,40-49,602,5,10,18,28,28,10,18,6,2.869768999,212.7407427987,0.0082449459,0.1322751323,0.34047619,0,66,8.206220790513926E-5,6.590694E-5,6.6762965E-5,372,12,0,199,0,0
48519675,leftnewsorg,10,5927,634,219,46,1,47.254436787,40-49,637,6,49,23,72,72,49,23,7,2.6652159357,431.2405875149,0.0551548695,0.1054381847,0.2868687,0,66,2.5513113267625645E-4,2.99577E-4,3.0346803E-4,390,25,2,200,2,0.01
48708159,jasonkeays,10,18365,2934,1020,45,126,65.9742026523,60-69,849,8,56,67,123,123,56,67,7,2.5687981252,1848.82917616,0.048996296,0.1044915367,0.25416666,0,66,2.718132407697582E-4,3.4151776E-4,3.4595357E-4,390,87,10,207,10,0.0483091787
48920785,heySMM,10,95131,1644,313,79,16303,57.5518875844,50-59,891,10,8,1,9,9,8,1,8,4.0281218614,5.5306038555,0.0053834339,0.1111111111,0.25,0,66,9.363722422263469E-5,5.392386E-5,5.4624245E-5,47,29,1,203,1,0.0049261084
48931430,umuad,10,14653,659,227,26,2030,,,777,8,9,5,14,14,9,5,7,3.0284566455,3025.8900568027,0.0118098476,0.0604395604,0.20833333,0,66,1.5133793571948123E-4,5.99154E-5,6.069361E-5,47,16,0,200,0,0
49018161,Gottahrdt,10,67932,1760,2001,48,32,43.4783738639,40-49,783,9,12,18,30,30,12,18,6,2.6099765651,224.5160240098,0.0241686083,0.1022988506,0.3547619,0,66,1.3254057670009873E-4,7.789002E-5,7.8901685E-5,372,6,0,200,0,0
49140248,MINOTAURSBAND,10,2917,413,509,10,248,45.6312857176,40-49,665,6,12,12,24,24,12,12,7,2.838299297,120.2507940507,0.0196003125,0.1884057971,0.3868421,0,66,9.917629927786769E-5,7.789002E-5,7.8901685E-5,390,16,0,200,0,0
49336963,dpbaril,10,212,40,61,0,3,33.221335582,30-39,407,3,0,0,0,0,0,0,0,0,0,0,0,0,289,538,4.4780486537007367E-5,0,0,285,9,0,200,0,0
49400099,pugs14,10,5356,218,880,5,545,42.1934464776,40-49,632,7,47,115,162,162,47,115,6,2.3655841982,1013.1835966328,0.063008441,0.1150218542,0.31022742,0,66,1.6954515466113834E-4,2.8759392E-4,2.913293E-4,390,8,1,201,1,0.0049751244
49403072,brit_newsman,10,72303,2939,3125,131,10,55.3278759799,50-59,840,10,82,82,164,164,82,82,6,2.4050887178,2965.0258687005,0.1110213818,0.0550276822,0.34723336,0,66,2.896594134276717E-4,4.972978E-4,5.037569E-4,47,65,0,203,0,0
49687037,marlawd,10,31974,1534,1352,93,615,53.9598242102,50-59,787,9,208,214,422,422,208,214,6,2.1881486441,26946.4701827177,0.2913104056,0.0666377728,0.23210804,0,66,6.989435126836662E-4,0.0012522319,0.0012684964,140,169,1,212,1,0.0047169811
49707617,CarletonPlace,10,5517,532,898,12,594,49.8994469147,40-49,732,7,182,240,422,422,182,240,6,2.1519919652,19244.321582662,0.216627659,0.0652024631,0.25977972,0,66,5.222458465109627E-4,0.0010964518,0.0011046237,47,171,5,209,4,0.023923445
49731022,dydhillier,10,2721,859,157,24,92,47.9259279075,40-49,710,5,7,1,8,8,7,1,2,1.8,15505,6.424488042385511E-4,0.1428571429,0.35714287,0,49,3.7857911319820204E-4,4.793232E-5,4.8554884E-5,27,25,0,201,0,0
49772096,Larhanya,10,1018,78,144,6,14,25.5113266064,20-29,431,5,0,2,2,2,0,2,7,3.2382864793,0,0,0,0,0,384,4.4780486537007367E-5,0,6.0693606E-6,55,0,0,199,0,0
49774237,steelheadtroy,10,102,19,73,0,3,13.0346706108,10-19,31,3,0,1,1,1,0,1,7,3.1208165997,0,0,0,0,0,673,4.4780486537007367E-5,0,6.0693606E-6,390,0,1,114,1,0.0087719298
49989431,NOtoGMOs,10,13157,2608,1738,173,144,53.9457550356,50-59,722,8,25,30,55,55,25,30,6,2.5309675259,547.9330870474,0.0436295712,0.0925925926,0.33412698,0,66,1.2014749909226182E-4,1.5578004E-4,1.5780337E-4,47,11,1,203,1,0.0049261084
50212797,oxy28,10,1333,38,14,0,2,32.6085483778,30-39,608,6,4,1,5,5,4,1,8,3.3896886508,0.5591484467,0.0045860608,0.15,0.2,0,66,5.725650638846476E-5,2.99577E-5,3.0346804E-5,47,9,0,200,0,0
50285275,Tibet_TW,10,63429,2398,2553,93,149,47.3810412447,40-49,803,10,15,22,37,37,15,22,7,2.7947773686,253.4266685906,0.0096024441,0.048048048,0.22727273,0,66,9.289688775323502E-5,9.586464E-5,9.710977E-5,47,89,0,201,0,0
50383438,jenniibeez,10,5570,180,267,6,2,37.9304650968,30-39,664,6,4,7,11,11,4,7,7,2.8326079679,5472.3190019609,0.0091460824,0.0727272727,0.30952382,0,66,9.682408375759195E-5,2.99577E-5,3.0346804E-5,390,7,0,200,0,0
50458600,ArnellTF,10,8742,1008,1376,17,1130,54.9788646908,50-59,741,7,131,146,277,277,131,146,6,2.3602276532,19357.4607001062,0.1141775664,0.0353685973,0.19447331,0,66,5.647554833969324E-4,7.9088326E-4,8.0115563E-4,47,168,0,201,0,0
50656896,amaurass,10,6295,424,521,4,1,48.5955811822,40-49,689,6,0,0,0,0,0,0,0,0,0,0,0,0,49,137,4.4780486537007367E-5,0,0,40,8,0,198,0,0
50664739,HayeseLaw,10,1614,482,182,46,1,48.0144429422,40-49,614,5,3,4,7,7,3,4,7,3.1606963509,3.2256706314,0.0035560294,0.2142857143,0.30952382,0,66,5.918083738294546E-5,2.396616E-5,2.4277442E-5,140,0,0,200,0,0
50672511,bajabreeze2355,10,723,113,553,1,7,36.6408418506,30-39,550,5,15,66,81,81,15,66,7,2.5071978574,1573.7517747971,0.0162708249,0.162191358,0.33333334,0,66,1.0604442951142132E-4,9.586464E-5,9.710977E-5,390,6,1,229,1,0.0043668122
50715881,Gabizinha19,10,2782,22,28,2,0,20.9579187635,20-29,649,6,0,0,0,0,0,0,0,0,0,0,0,0,215,408,4.4780486537007367E-5,0,0,209,0,0,200,0,0
50882624,gqtrilogy,10,47349,839,647,11,91,34.3793591378,30-39,788,9,0,0,0,0,0,0,0,0,0,0,0,0,32,107,4.4780486537007367E-5,0,0,25,0,0,209,0,0
50910154,BeijingReview,10,3445,1654,940,115,0,49.9966623784,40-49,677,4,4,1,5,5,4,1,1,1,3102,5.451811397567902E-4,0,0,0,43,4.888519341250382E-4,2.99577E-5,1.8208082E-5,372,5,0,201,0,0
51039730,Sandenn,10,3500,189,380,1,21,42.9589966254,40-49,730,7,14,28,42,42,14,28,7,2.7311683964,281.2804170007,0.0132543179,0.1056910569,0.3140394,0,66,9.93241345633767E-5,8.98731E-5,9.104041E-5,140,47,0,200,0,0
51099638,James_W_J_Crown,10,652,115,315,1,4,19.5667397122,10-19,482,5,29,69,98,98,29,69,7,2.5684633411,241.6210394338,0.0343988245,0.176730486,0.4913928,0,66,1.5383428877495617E-4,1.797462E-4,1.8208082E-4,390,3,5,200,5,0.025
51156456,scbritton,10,27002,427,291,11,55,37.2869037597,30-39,783,9,45,33,78,78,45,33,6,2.7398727821,738.6167197232,0.0382838556,0.1053946054,0.3331169,0,66,2.372851290638821E-4,2.7561083E-4,2.791906E-4,372,31,0,200,0,0
51158869,smitty_1993,10,666,201,396,1,166,48.2255605435,40-49,537,5,7,8,15,15,7,8,7,2.9695346502,228.3035880393,0.0106967416,0.0857142857,0.2777778,0,66,7.903495067759242E-5,4.793232E-5,4.8554884E-5,372,1,0,198,0,0
51184630,mlinto,10,1126,118,545,2,2,29.6439130504,20-29,512,5,10,57,67,67,10,57,6,2.3300970874,167.6557698271,0.0203620635,0.1956128449,0.40789473,0,66,7.37906159301162E-5,6.590694E-5,6.6762965E-5,47,5,0,200,0,0
51448005,MikeMcD76,10,28543,648,1304,40,28,45.0786759952,40-49,759,8,76,78,154,154,76,78,6,2.4194844325,2246.5664752946,0.1103219344,0.1195144725,0.29943502,0,66,2.625204482817132E-4,4.6134857E-4,4.6734078E-4,47,71,0,204,0,0
51545098,mariebernatchez,10,4070,611,590,31,8,49.9071524648,40-49,680,6,8,10,18,18,8,10,7,2.817877469,39.6683917154,0.0093468568,0.0947712418,0.5777778,0,66,8.699976691162643E-5,5.392386E-5,5.4624245E-5,390,11,0,200,0,0
51743331,philelder,10,614,146,268,4,1,26.463814225,20-29,522,4,21,33,54,54,21,33,7,2.6350853699,175.248448766,0.0163948256,0.0880503145,0.259009,0,66,1.0578508824901917E-4,1.3181388E-4,1.3352593E-4,372,4,0,200,0,0
51822882,hep0010,10,1198,2056,1985,54,11,45.6346255725,40-49,578,5,25,35,60,60,25,35,7,2.5758285906,1971.3648752628,0.0406564692,0.0790960452,0.43109244,0,66,1.2710112978702313E-4,1.5578004E-4,1.5780337E-4,47,0,0,201,0,0
51963464,janellenfrench,10,4039,171,276,6,14,40.4565214959,40-49,494,5,2,7,9,9,2,7,8,3.2336792769,0.1896857528,6.289179954424153E-4,0.2777777778,0.5714286,0,66,5.899959688858322E-5,1.797462E-5,1.8208082E-5,47,4,0,201,0,0
52435593,scott451,10,8995,274,394,3,1073,43.5017813709,40-49,676,7,64,74,138,138,64,74,6,2.3404753934,1372.0150663154,0.1066301915,0.1053633767,0.4082397,0,66,2.0379535728006087E-4,3.8945008E-4,3.9450845E-4,47,27,1,200,1,0.005
52447427,jasbirsandhu,10,363,1614,1412,119,2,48.5888636582,40-49,672,4,190,149,339,339,190,149,6,2.3454971543,14195.3740265233,0.2678090853,0.0766699831,0.2728984,0,66,0.0011968584,0.0011443842,0.0011531785,390,83,19,200,19,0.095
52474769,Icarus2009,10,14512,253,454,6,44,42.1707479806,40-49,648,8,14,10,24,24,14,10,7,2.9082691664,59.406603318,0.0121235379,0.0688405797,0.13947369,0,66,8.308751731456816E-5,8.98731E-5,9.104041E-5,55,2,0,201,0,0
52657832,erik_zennstrom,10,471,53,136,0,892,33.1162888026,30-39,508,5,6,9,15,15,6,9,7,2.9082691664,8.0161501669,0.0046057482,0.1571428571,0.3909091,0,66,5.621141757200825E-5,4.194078E-5,4.2485524E-5,47,3,0,199,0,0
53060913,DaschkoCo,10,1176,66,221,0,105,32.3143979725,30-39,589,5,11,18,29,29,11,18,7,2.7505858721,67.1272265785,0.0177497663,0.1206896552,0.36578947,0,66,7.554373493003814E-5,7.189848E-5,7.283233E-5,140,9,0,198,0,0
53116283,jaredeverett,10,120,63,58,3,1,21.8777814628,20-29,329,2,0,1,1,1,0,1,7,3.1208165997,0,0,0,0,0,627,4.4780486537007367E-5,0,6.0693606E-6,390,0,0,120,0,0
53211399,katrinashannon,10,5386,199,402,4,5,27.5891965263,20-29,593,7,38,62,100,100,38,62,7,2.4646802812,1529.7531586162,0.0462780285,0.0967676768,0.26956183,0,66,1.8888674078732908E-4,2.3367006E-4,2.3670506E-4,47,1,0,200,0,0
53400950,IguanoSinuano,10,6002,286,61,7,15,36.1238513463,30-39,733,7,3,3,6,6,3,3,3,1.6,8,2.2951774304557127E-4,0.0333333333,0.33333334,60,152,4.253425714390234E-4,2.396616E-5,2.4277442E-5,53,5,0,198,0,0
53542320,mbilek,10,1052,246,272,9,6,41.9151376183,40-49,601,5,41,55,96,96,41,55,7,2.4549715434,2300.594916995,0.0437223111,0.1486842105,0.35817683,0,66,1.582988640246337E-4,2.5164467E-4,2.5491315E-4,390,8,0,200,0,0
53698190,_drewski,10,42096,1021,1130,83,96,49.5750289982,40-49,770,9,65,66,131,131,65,66,6,2.4693672581,5008.796337341,0.118559537,0.1326482678,0.38309312,0,66,4.8289504593602956E-4,3.9544163E-4,4.0057782E-4,140,26,1,202,1,0.004950495
53720659,cansciencetwit,10,528,178,264,20,7,31.6227783209,30-39,470,4,5,6,11,11,5,6,7,3.0515567459,14.8449064173,0.0019952667,0.1454545455,0.4642857,0,66,9.04699257297369E-5,3.594924E-5,3.6416164E-5,55,1,0,200,0,0
53913259,gastongourde,10,5953,394,525,22,10,46.0222453197,40-49,643,7,5,7,12,12,5,7,7,2.9514563107,104.4502272989,0.0040750133,0.1060606061,0.42857143,0,66,6.823282508862142E-5,3.594924E-5,3.6416164E-5,390,3,0,200,0,0
54169562,Blaiserboy,10,12983,2077,1953,5,0,51.4724435885,50-59,734,7,68,63,131,131,68,63,6,2.3344492802,1391.1919302083,0.1146081692,0.0548443922,0.34723443,0,66,2.2981908042767204E-4,4.1341624E-4,4.1878587E-4,47,171,1,231,1,0.0043290043
54251346,arlookingbill,10,6033,165,164,0,635,43.0387586087,40-49,668,6,1,1,2,2,1,1,1,1,0,7.49471721243357E-5,0,0,54,144,2.9852402567743944E-4,1.198308E-5,1.2138721E-5,171,18,0,201,0,0
54636481,ladymonton,10,11899,124,237,2,1900,40.5493540879,40-49,723,6,0,1,1,1,0,1,8,3.406291834,0,0,0,0,0,254,4.4780486537007367E-5,0,6.0693606E-6,47,2,0,200,0,0
54766840,MALeclerc_,10,586,228,514,4,0,37.5370761775,30-39,565,3,2,16,18,18,2,16,7,2.9678607298,0.6719992981,0.0029413688,0.2908496732,0.5183824,0,66,5.016466750424932E-5,1.797462E-5,1.8208082E-5,390,0,0,200,0,0
54937843,JohnnieOil,10,30249,1171,1218,52,174,49.0172101756,40-49,771,8,64,66,130,130,64,66,6,2.7224640107,931.8031382404,0.0377963165,0.0772212284,0.38,0,66,3.238750532723047E-4,3.8945008E-4,3.9450845E-4,372,32,0,200,0,0
54993351,ottawaspends,10,3517,1944,1,101,0,40.9037429213,40-49,639,5,199,1,200,200,199,1,7,3.1827920991,15.5000604806,0.2919428539,0.1342713568,0.18996498,0,66,0.0013039561,0.001198308,0.0012138721,140,4,0,200,0,0
55142273,jaywattsiii,10,15211,1296,2001,13,108,63.2003467323,60-69,744,8,31,74,105,105,31,74,7,2.4884499498,790.6699639748,0.0450456232,0.119047619,0.26961505,0,66,1.9381608311030992E-4,1.9172928E-4,1.9421954E-4,47,35,0,202,0,0
55149881,icelos,10,13016,138,115,8,110,41.5459033627,40-49,596,8,5,4,9,9,5,4,7,2.9892869099,0.0741685334,0.0102858199,0.1666666667,0.6666667,0,66,6.361060529596562E-5,3.594924E-5,3.6416164E-5,47,4,0,201,0,0
55468747,RuddKim,10,3303,896,404,47,0,50.0205765799,50-59,725,6,128,79,207,207,128,79,7,2.4506193505,4520.2248548799,0.1644235505,0.1109000516,0.2825312,0,66,5.516105267456696E-4,7.729087E-4,7.7687815E-4,140,92,7,200,7,0.035
55649216,EatThatQuestion,10,992,304,168,13,77,28.1127224491,20-29,525,5,6,9,15,15,6,9,7,2.7740207566,19.4355057091,0.0074241261,0.1333333333,0.51111114,0,66,6.364598128099607E-5,4.194078E-5,4.2485524E-5,47,0,0,200,0,0
55699327,sarahrimmington,10,2798,409,601,11,32,58.1989073323,50-59,591,6,17,51,68,68,17,51,7,2.5075326414,91.4383829067,0.0330438368,0.2129060579,0.49231306,0,66,1.0999580770158353E-4,1.0784772E-4,1.0924849E-4,390,0,1,200,1,0.005
55762792,mitchdeg,10,8021,4204,89,249,33,58.1118283135,50-59,768,7,5,1,6,6,5,1,3,2.25,16,4.031742601524278E-4,0.1,0.3,0,56,3.951518364160162E-4,3.594924E-5,2.4277442E-5,320,14,0,200,0,0
55901461,swissguy5,10,1827,85,168,4,1,40.7293352569,40-49,581,5,11,18,29,29,11,18,6,2.6076330767,82.5200112208,0.020577493,0.1280788177,0.33571428,0,66,8.305000576294658E-5,7.189848E-5,7.283233E-5,390,4,1,200,1,0.005
56065179,S_A_F,10,34293,1470,207,35,245,48.5758847409,40-49,758,7,0,0,0,0,0,0,0,0,0,0,0,0,240,462,4.4780486537007367E-5,0,0,236,1,0,201,0,0
56164159,RandallSHolmes,10,18813,1208,1988,58,21,49.0108132758,40-49,749,8,8,7,15,15,8,7,8,3.515567459,350.8602059029,0.0012746028,0.0523809524,0.21111111,0,66,1.6029963991981823E-4,5.392386E-5,5.4624245E-5,47,1,0,201,0,0
56382876,finklejoe,10,4421,447,624,12,3,46.7403196579,40-49,660,6,13,33,46,46,13,33,6,2.6933377971,1132.8713323928,0.0178211794,0.1507246377,0.42067736,0,66,1.4579203563374504E-4,8.388156E-5,8.497105E-5,372,16,2,200,2,0.01
56399458,1947grandpa,10,1227,27,71,0,5,30.6515532745,30-39,585,5,0,5,5,5,0,5,7,3.1328647925,0,0,0.4,0.5,0,276,4.4780486537007367E-5,0,6.0693606E-6,140,4,0,200,0,0
56515814,JamesAldersley,10,5080,149,220,3,585,48.269805297,40-49,686,7,8,12,20,20,8,12,7,2.8784733847,9.69895199,0.0088655047,0.0763157895,0.23076923,0,66,6.825442221008094E-5,5.392386E-5,5.4624245E-5,140,18,0,200,0,0
56556297,VirtualFellow,10,5479,663,376,27,746,56.0892151996,50-59,685,7,33,32,65,65,33,32,7,2.7171074657,150.6899064636,0.049188692,0.1274038462,0.40750527,0,66,2.1978755522840892E-4,2.0371236E-4,2.0635827E-4,140,14,3,201,3,0.0149253731
56690455,momorycroft,10,559,151,382,3,3,35.2361230438,30-39,521,4,43,61,104,104,43,61,7,2.5838634081,566.8887138785,0.0583209664,0.2095780433,0.51159286,0,66,2.5473603055633327E-4,2.6362776E-4,2.6705186E-4,390,11,4,200,4,0.02
56739067,ShinyGlow,10,1152,70,126,0,158,38.1363345027,30-39,561,5,4,13,17,17,4,13,7,2.6792768664,10.8150870021,0.0029551034,0.1139705882,0.23626374,0,66,5.323740680057107E-5,2.99577E-5,3.0346804E-5,47,6,0,200,0,0
57103588,henryca3,10,1977,505,487,15,57,43.7287879986,40-49,638,6,35,51,86,86,35,51,7,2.5252761969,636.6969522332,0.0595277582,0.1422708618,0.41591752,0,66,2.610742379121372E-4,2.1569544E-4,2.1849698E-4,390,8,1,200,1,0.005
57179067,ChicagoPhotoCtr,10,2060,1076,270,126,2,45.826818994,40-49,665,5,0,0,0,0,0,0,0,0,0,0,0,0,287,536,4.4780486537007367E-5,0,0,283,37,0,200,0,0
57431906,MrGenier,10,4070,448,529,35,10,35.0293412498,30-39,579,6,43,53,96,96,43,53,7,2.5443588885,327.8487205664,0.105840699,0.1765350877,0.4706573,0,66,3.7679909309410017E-4,2.6362776E-4,2.6705186E-4,140,4,0,198,0,0
57568642,WayneFougere,10,3043,156,523,4,4,41.168474751,40-49,665,6,6,38,44,44,6,38,6,2.5667894208,49.4301454508,0.01829747,0.2378435518,0.44551283,0,66,7.570624297740347E-5,4.194078E-5,4.2485524E-5,140,2,0,200,0,0
57750980,WuDisciple36,10,3141,222,473,1,412,38.4026151633,30-39,650,5,1,1,2,2,1,1,7,3.2577837295,0,9.361589144561228E-4,0,0,0,66,4.8517769716958163E-5,1.198308E-5,1.2138721E-5,47,13,0,198,0,0
57771926,depHugoLeal,10,4341,30988,713,188,1,51.4140104091,50-59,754,5,1,0,1,1,1,0,0,0,0,8.096467320928773E-5,0,0,203,387,1.0340065745167209E-4,1.198308E-5,0,212,2,0,201,0,0
57852539,Colettod,10,4242,2051,2161,78,22,60.4586162315,60-69,728,6,178,163,341,341,178,163,6,2.3146970204,20927.6544339596,0.2329169031,0.0716663792,0.20654526,0,66,0.0014276512,0.0010724857,0.0010803462,372,71,1,200,1,0.005
58321430,nickofthenorth,10,2583,426,870,14,4,41.0631087197,40-49,637,6,21,34,55,55,21,34,7,2.6859725477,315.1287544756,0.0259546727,0.1323232323,0.3480769,0,66,1.1784008223778346E-4,1.3181388E-4,1.3352593E-4,390,15,0,175,0,0
58366291,Danielle2671,10,16806,506,751,13,11,46.3806673648,40-49,750,8,117,149,266,266,117,149,6,2.2648141948,4558.1238642664,0.1607184053,0.0845935594,0.26219153,0,66,3.4065199924779814E-4,7.070017E-4,7.1618456E-4,47,14,0,200,0,0
58684655,Adam_Stirling,10,16841,1534,333,80,78,53.1808604601,50-59,775,8,56,17,73,73,56,17,7,2.8935386676,292.2876766998,0.0671106302,0.1531582953,0.25174826,0,66,3.709235122832979E-4,3.4151776E-4,3.4595357E-4,55,45,0,200,0,0
58894431,KarlSonkin,10,359,81,235,9,1,38.4299241092,30-39,382,4,0,1,1,1,0,1,1,1,0,0,0,0,400,725,4.4780486537007367E-5,0,6.0693606E-6,412,0,0,200,0,0
59114494,BoredomCorner,10,7887,122,92,4,638,42.9938394911,40-49,683,7,14,4,18,18,14,4,7,2.9785738199,2.1325722292,0.022737455,0.2189542484,0.45416668,0,66,9.174076127267942E-5,8.98731E-5,9.104041E-5,47,2,0,200,0,0
59604112,Katdraken,10,57572,1222,619,31,7974,50.1436565547,50-59,838,9,1,1,2,2,1,1,1,1,0,7.49471721243357E-5,0,0,355,648,2.9852402567743944E-4,1.198308E-5,1.2138721E-5,364,3,0,201,0,0
59641324,justskp,10,2937,152,655,2,51,35.2329945996,30-39,570,6,0,3,3,3,0,3,7,3.0404953146,0,0,0.3333333333,0.5,0,668,4.4780486537007367E-5,0,6.0693606E-6,390,1,0,200,0,0
59767832,kgallag1,10,7,6,48,0,1,16.5262378324,10-19,15,0,0,0,0,0,0,0,0,0,0,0,0,0,14,86,4.4780486537007367E-5,0,0,10,0,0,8,0,0
59831613,jimotayek,10,180,47,76,0,48,36.8766989287,30-39,568,4,1,2,3,3,1,2,9,4.5277591973,2989,7.49471721243357E-5,0,0,0,447,1.2969692065828504E-4,1.198308E-5,1.2138721E-5,224,25,0,192,0,0
59995883,mysafehomeca,10,1430,42,109,1,140,22.8240235258,20-29,438,5,5,15,20,20,5,15,7,2.6531637094,4.8072682212,0.010971375,0.2342105263,0.4779412,0,66,5.638455240451964E-5,3.594924E-5,3.6416164E-5,47,0,1,198,1,0.0050505051
60116717,KT_Mtjoy,10,110,26,101,0,0,13.1898573515,10-19,176,3,2,5,7,7,2,5,7,3.0632741881,0,0.0013846236,0.3095238095,0.6666667,0,66,5.316088631847294E-5,1.797462E-5,1.8208082E-5,55,0,0,118,0,0
60468248,midwifek,10,3242,262,246,21,22,53.3064740389,50-59,656,6,19,26,45,45,19,26,7,2.6119852695,440.4914616005,0.0274156675,0.1883838384,0.41666666,0,66,1.278825801597065E-4,1.198308E-4,1.1531785E-4,390,50,0,200,0,0
60500762,peterbtriassi,10,320,78,298,1,25,26.7176481197,20-29,455,3,1,1,2,2,1,1,7,3.2902577837,0.1461782692,5.611746121003873E-4,0,0,0,66,4.724175670871345E-5,1.198308E-5,1.2138721E-5,55,1,0,200,0,0
60637549,althiaraj,10,14906,9113,2137,444,2,63.0602518529,60-69,788,7,680,242,922,922,680,242,6,2.2584532976,65040.1909449835,0.7275674031,0.0461761124,0.09911221,0,66,0.0042229476,0.0040802388,0.0040664715,140,352,6,201,6,0.0298507463
60916234,CarolHughesMP,10,772,1110,198,102,0,46.976874279,40-49,649,2,184,37,221,221,184,37,7,2.6447941078,2422.4653596298,0.2281995317,0.1356232003,0.2674372,0,66,9.562295613189161E-4,0.0011084349,0.001110693,390,51,3,200,3,0.015
61011254,ToryLineDuJour,10,4692,530,1708,13,1,43.5391600432,40-49,679,6,46,114,160,160,46,114,6,2.4917977904,2683.0840116945,0.0449545058,0.1084119497,0.2172471,0,66,2.3901872046424314E-4,2.8160238E-4,2.8525994E-4,372,11,0,200,0,0
61213720,CTVW5,10,1349,3276,140,139,1,59.0320144225,50-59,741,5,57,3,60,60,57,3,7,3.0857047205,90.7420582686,0.0493374226,0.05,0.071428575,0,66,3.936290420858129E-4,3.475093E-4,3.398842E-4,372,229,0,198,0,0
61248597,rikkismeltzer,10,3207,85,25,2,122,23.1044544767,20-29,534,6,6,6,12,12,6,6,7,3.0287914295,2.2127036866,0.009262194,0.1893939394,0.42222223,0,66,7.277699223695472E-5,4.194078E-5,4.2485524E-5,140,1,0,200,0,0
61472094,Curlyisrunning,10,7402,451,398,21,0,44.7297731512,40-49,729,7,0,0,0,0,0,0,0,0,0,0,0,0,109,223,4.4780486537007367E-5,0,0,105,5,0,200,0,0
61509014,TheLawofWork,10,3630,1656,797,65,1,54.7397298624,50-59,736,6,96,40,136,136,96,40,7,2.6642115835,3056.6954076802,0.0693135148,0.0824074074,0.15266725,0,66,4.579519656721564E-4,5.811794E-4,5.826586E-4,390,75,0,200,0,0
61542328,Tony_Tracy,10,23945,9158,7201,351,13,62.0367144616,60-69,848,8,434,594,1028,1028,434,594,6,1.9665215936,197683.611461219,0.4320325279,0.0291175234,0.11226484,0,66,0.0015907043,0.00260632,0.002640172,390,300,14,200,13,0.07
61562192,LPCBC,10,1795,1287,811,57,2,50.5234969771,50-59,693,5,122,101,223,223,122,101,6,2.4208235688,3546.2447492284,0.1434823621,0.0916252575,0.27404296,0,66,6.190492040859572E-4,7.369594E-4,7.4653135E-4,140,49,2,200,2,0.01
61583209,couturerm,10,14,3,15,0,0,15.6708586376,10-19,3,1,2,4,6,6,2,4,7,3.3625711416,0.5757043862,7.085999437623865E-4,0.1666666667,0.8333333,0,66,5.5696286266009436E-5,1.797462E-5,1.8208082E-5,55,0,0,14,0,0
61619217,muribepmontt,10,8219,1065,2001,7,138,45.7511333481,40-49,724,7,4,6,10,10,4,6,9,4.604285236,14138.8833333333,3.4319539798188505E-4,0.0666666667,0.16666667,0,66,2.056508393604276E-4,2.99577E-5,3.0346804E-5,320,2,0,196,0,0
61853352,phillip5150,10,1430,110,633,0,32,35.1602218636,30-39,596,5,0,0,0,0,0,0,0,0,0,0,0,0,343,618,4.4780486537007367E-5,0,0,350,1,0,199,0,0
62139614,JDarwin,10,2225,102,464,2,640,34.1282650481,30-39,536,6,16,29,45,45,16,29,7,2.5279544694,68.8416720865,0.024572064,0.1267676768,0.37310606,0,66,8.54820800754223E-5,1.0185618E-4,1.0317913E-4,47,4,1,205,1,0.0048780488
62979039,JeromeDowney,10,4743,1058,985,15,885,52.1195004676,50-59,682,6,19,29,48,48,19,29,7,2.6528289253,412.1657519732,0.032335017,0.0984042553,0.28877005,0,66,2.1372690333126048E-4,1.198308E-4,1.2138722E-4,140,3,0,200,0,0
63050686,ryanrutley,10,7208,419,410,18,298,48.6647260607,40-49,698,7,11,12,23,23,11,12,7,2.9102778708,94.8835753016,0.009064199,0.0790513834,0.21323529,0,66,8.76957159777991E-5,7.189848E-5,7.283233E-5,47,7,0,200,0,0
63198527,sandstonelass,10,16644,452,266,22,53,49.1969301801,40-49,755,8,56,27,83,83,56,27,7,2.5456980248,573.5092567877,0.0949023944,0.1400235087,0.3715278,0,66,1.8790431744774162E-4,3.4151776E-4,3.4595357E-4,47,16,0,203,0,0
63258578,miaaculpa,10,71012,3213,2932,128,476,52.8333457953,50-59,869,10,18,17,35,35,18,17,7,2.8319383997,3238.0254992385,0.0171540597,0.0302521008,0.21895425,0,66,1.3805773549335895E-4,1.1383926E-4,1.1531785E-4,47,12,0,201,0,0
63371371,adamharris09,10,3088,344,555,14,20,42.799321264,40-49,628,6,7,7,14,14,7,7,7,2.9832607968,8.1529226096,0.0102207431,0.1703296703,0.25641027,0,66,6.114998096653483E-5,4.793232E-5,4.8554884E-5,47,3,0,200,0,0
63542749,SusanRab,10,838,260,386,6,4,39.352089533,30-39,609,5,17,26,43,43,17,26,7,2.7418814864,2436.5527552247,0.0126183453,0.1024363234,0.25,0,66,1.1510137792610677E-4,1.0784772E-4,1.0924849E-4,390,1,0,200,0,0
63631693,CanMNews,10,13533,1200,350,38,74,47.0379675261,40-49,682,7,7,2,9,9,7,2,8,3.8423167057,9.5897783211,0.0083425089,0.0555555556,0.10714286,0,66,1.613548256113426E-4,4.793232E-5,4.8554884E-5,372,3,0,200,0,0
63674633,DelisNACKandRUN,10,46456,849,529,5,103,44.466867973,40-49,799,9,0,0,0,0,0,0,0,0,0,0,0,0,17,90,4.4780486537007367E-5,0,0,13,1,0,1,0,0
63795844,Shawn_J_Martin,10,1153,77,186,0,42,34.7969206942,30-39,547,5,11,28,39,39,11,28,7,2.5845329762,420.0338120115,0.0187098536,0.1437246964,0.3344086,0,66,9.132978202808077E-5,7.189848E-5,7.283233E-5,390,14,2,200,2,0.01
63805938,DFinanciero,10,50301,42464,139,939,7,69.7948431764,60-69,897,6,21,0,21,21,21,0,0,0,0,0.0017056527,0.0428571429,0.06428572,0,21,5.275711142305934E-4,1.3181388E-4,0,320,67,0,208,0,0
63826204,fotoGnique,10,8294,529,1677,22,1736,44.4232073862,40-49,574,7,10,46,56,56,10,46,7,2.5664546368,1008.6987638817,0.0100884951,0.1425324675,0.25346938,0,66,8.848861123656026E-5,6.590694E-5,6.6762965E-5,390,0,1,200,1,0.005
63966763,CAWCommunicate,10,2651,4079,2213,132,10,52.976103927,50-59,739,6,250,232,482,482,250,232,6,2.2363575494,43528.537867553,0.2634916165,0.0583673364,0.16287991,0,66,0.0011178751,0.0015038765,0.0015173402,390,133,1,200,1,0.005
64129314,_Aditya_,10,4033,136,140,0,1,12.2285441559,10-19,683,6,0,0,0,0,0,0,0,0,0,0,0,0,269,508,4.4780486537007367E-5,0,0,267,1,0,200,0,0
64190875,OMSAG,10,20687,369,95,23,43,46.571280645,40-49,655,5,0,0,0,0,0,0,0,0,0,0,0,0,389,706,4.4780486537007367E-5,0,0,400,0,0,200,0,0
64545499,Jenn_McCreath,10,21818,755,1677,12,3275,53.2603122827,50-59,744,8,32,51,83,83,32,51,7,2.5423501841,1443.4592276349,0.0315180612,0.0880105789,0.20461309,0,66,1.4915441703848852E-4,1.9772082E-4,2.0028891E-4,390,44,1,204,1,0.0049019608
64611995,SaarahAndSons,10,3023,594,319,2,3522,47.8282070785,40-49,759,7,0,2,2,2,0,2,7,3.1987951807,0,0,0.5,0.5,0,253,4.4780486537007367E-5,0,6.0693606E-6,390,14,0,200,0,0
64846289,ptboscienceguy,10,361,64,132,0,2,53.251696074,50-59,502,4,7,17,24,24,7,17,7,2.6658855039,19.4339264375,0.0102174642,0.1920289855,0.44152048,0,66,5.925786714009379E-5,4.793232E-5,4.8554884E-5,390,5,1,200,1,0.005
64946383,BenjaminMangold,10,215,68,74,0,0,50.0241420153,50-59,532,4,0,0,0,0,0,0,0,0,0,0,0,0,38,122,4.4780486537007367E-5,0,0,30,1,0,200,0,0
65111698,socialist_ca,10,1683,961,482,56,19,49.2462363103,40-49,698,5,44,27,71,71,44,27,7,2.7281553398,405.4505685992,0.0448693921,0.109054326,0.23276836,0,66,1.7548862483596664E-4,2.696193E-4,2.7312123E-4,390,61,19,200,18,0.095
65137576,AirynJ,10,1687,765,619,24,9,52.6946063711,50-59,639,6,174,138,312,312,174,138,7,2.3947104118,4116.9265655682,0.2432381382,0.1062226894,0.3283909,0,66,0.0010836862,0.0010485195,0.0010560688,390,28,9,200,8,0.045
65254420,supposedly_fun,10,1351,293,610,9,0,44.6071869586,40-49,597,5,64,129,193,193,64,129,7,2.4047539337,1342.8950023497,0.1054350236,0.1404630829,0.3911854,0,66,4.228109080549221E-4,3.8945008E-4,3.9450845E-4,390,51,11,200,11,0.055
65254904,KiavashNajafi,10,114,98,273,1,0,41.4397167619,40-49,507,3,47,53,100,100,47,53,7,2.6692333445,380.0574734837,0.0664484747,0.1755555556,0.39857596,0,66,3.1713265311310746E-4,2.8759392E-4,2.913293E-4,390,60,7,166,7,0.0421686747
65308877,wherebdangels,10,2288,302,981,16,3708,34.9026377167,30-39,457,5,6,21,27,27,6,21,7,2.6749246736,207.809923213,0.0135378872,0.1267806268,0.3116883,0,66,7.922392516728299E-5,4.194078E-5,4.2485524E-5,47,0,0,199,0,0
65418383,DianaIdibe,10,4026,257,250,1,482,41.7742106958,40-49,619,5,0,1,1,1,0,1,8,3.452476573,0,0,0,0,0,680,4.4780486537007367E-5,0,6.0693606E-6,47,24,0,200,0,0
65491605,cfhorgan,10,22490,4357,998,233,1,59.4016492349,50-59,809,8,470,94,564,564,470,94,6,2.46869769,8165.2395766857,0.5309422433,0.0736461207,0.12802394,0,66,0.0028260478,0.0028220152,0.0028465302,140,375,5,201,5,0.0248756219
65535533,carolaik,10,26077,1367,461,128,29,50.4208732006,50-59,793,9,72,43,115,115,72,43,7,2.4881151657,1846.9780287671,0.1204137836,0.0958810069,0.3499658,0,66,3.0538121976572306E-4,4.373824E-4,4.3699396E-4,47,54,0,200,0,0
65624152,WayneEaster,10,2097,3864,2037,256,13,54.4479987761,50-59,737,5,282,137,419,419,282,137,6,2.3685972548,12351.7476641053,0.328034739,0.0847883432,0.16856767,0,66,0.0014198765,0.0016956058,0.0017054903,140,118,5,200,5,0.025
65917423,deancorda,10,694,28,66,2,6,26.2628129049,20-29,392,5,6,3,9,9,6,3,7,3.2169400737,4.5700240848,0.0085978721,0.1944444444,0.54761904,0,66,7.02489926296932E-5,4.194078E-5,4.2485524E-5,390,4,2,200,2,0.01
66066925,ritgup,10,1758,152,46,5,1,45.940149925,40-49,564,5,0,0,0,0,0,0,0,0,0,0,0,0,165,319,4.4780486537007367E-5,0,0,162,1,0,200,0,0
66076712,acimowin,10,7365,1330,1183,32,2948,52.1184519216,50-59,730,7,120,102,222,222,120,102,7,2.4409106127,11796.017879864,0.100345399,0.0511393747,0.20232509,0,66,5.530246128740039E-4,7.2497636E-4,7.343926E-4,47,52,1,199,1,0.0050251256
66112820,Calculator60,10,8571,298,229,4,3,44.0315198733,40-49,661,7,12,16,28,28,12,16,7,2.7797120857,97.0182094921,0.0127192398,0.1547619048,0.3201581,0,66,8.920680992051467E-5,7.789002E-5,7.8901685E-5,372,23,0,200,0,0
66140247,jeffgalbraith,10,650,59,127,3,79,27.9629047885,20-29,594,5,6,12,18,18,6,12,7,2.9671911617,7.1837364789,0.008038231,0.2647058824,0.43014705,0,66,6.541187114185215E-5,4.194078E-5,4.2485524E-5,140,2,0,200,0,0
66268665,LucilleRoss,10,440,10,13,0,5,33.2239565625,30-39,435,4,0,1,1,1,0,1,8,3.406291834,0,0,0,0,0,258,4.4780486537007367E-5,0,6.0693606E-6,47,7,0,200,0,0
66349240,theCIOB,10,1312,8035,1713,151,105,53.3831101615,50-59,727,5,5,2,7,7,5,2,1,1,6208,3.937214323338306E-4,0.0238095238,0.1,0,32,6.284099721566414E-4,3.594924E-5,2.4277442E-5,338,93,0,200,0,0
66387685,bistoule,10,775,897,239,68,5,41.3485289645,40-49,547,4,1,1,2,2,1,1,3,2,0,8.908733458828234E-5,0,0,0,56,1.5094792967029218E-4,1.198308E-5,1.2138721E-5,320,5,0,200,0,0
66766337,culberthealth,10,498,404,1147,17,2,40.9855992517,40-49,536,4,2,3,5,5,2,3,2,1.25,0,1.5760327845143975E-4,0.15,1,169,323,2.3955451062393376E-4,1.797462E-5,1.8208082E-5,342,1,0,200,0,0
66871543,hayer432,10,14531,1036,914,36,172,49.264247849,40-49,736,7,1,1,2,2,1,1,10,5.6026113157,6196,1.1057485856814353E-4,0.5,0.5,0,66,6.79464955354548E-5,1.198308E-5,1.2138721E-5,320,0,0,200,0,0
66895826,Bcoox,10,909,108,156,4,37,30.2003080366,30-39,549,5,0,1,1,1,0,1,7,3.3216198126,0,0,0,0,0,344,4.4780486537007367E-5,0,6.0693606E-6,140,1,0,199,0,0
67171013,AstuteCitizen,10,8252,146,175,3,5108,49.451259403,40-49,597,8,11,14,25,25,11,14,7,2.7643120187,112.7158899927,0.0133676912,0.085,0.24632353,0,66,7.427968957442685E-5,7.189848E-5,7.283233E-5,140,12,0,205,0,0
67254536,WhatTheTWEEEET,10,4888,515,1472,24,69,43.7679225106,40-49,628,6,11,42,53,53,11,42,6,2.4730498828,75.375573828,0.0196963166,0.1465892598,0.34030196,0,66,7.137072850920514E-5,7.189848E-5,7.283233E-5,47,0,0,200,0,0
67341240,ValGervais,10,247,64,236,1,2,42.4583258336,40-49,420,4,8,30,38,38,8,30,7,2.6451288919,3226.709880486,0.0073818911,0.1806543385,0.35080644,0,66,7.252119680406032E-5,5.392386E-5,5.4624245E-5,140,6,1,200,1,0.005
67486555,NurseJayJay,10,1297,159,1980,0,3,16.8321937144,10-19,472,4,0,0,0,0,0,0,0,0,0,0,0,0,332,598,4.4780486537007367E-5,0,0,337,1,0,200,0,0
67516139,ACNACanada,10,903,358,569,9,7,28.684939049,20-29,572,5,11,31,42,42,11,31,6,2.5647807164,29.0542794127,0.0264227957,0.218931475,0.51426023,0,66,1.003990383863659E-4,7.189848E-5,7.283233E-5,390,3,0,199,0,0
67605782,Canadian_Flyboy,10,473,411,1093,7,58,39.6069522196,30-39,534,4,35,83,118,118,35,83,7,2.5339805825,369.0455782649,0.058289351,0.1715920614,0.44828907,0,66,2.584433140134754E-4,2.1569544E-4,2.1849698E-4,140,8,1,200,1,0.005
67949754,Hillintl,10,448,833,87,35,1,42.5891914779,40-49,607,3,2,2,4,4,2,2,1,1,0,1.5762601949607043E-4,0.0833333333,1,0,32,5.423447363973633E-4,1.797462E-5,1.8208082E-5,338,36,0,200,0,0
68274372,jimfreeman301,10,2814,143,252,1,10,43.7301611528,40-49,573,6,31,45,76,76,31,45,7,2.6752594576,1051.128070029,0.0205385572,0.0563157895,0.23043478,0,66,1.417547405408201E-4,1.9172928E-4,1.9421954E-4,390,13,1,201,1,0.0049751244
68561255,sol_chrom,10,24020,1370,929,116,4513,54.0862746812,50-59,781,9,91,72,163,163,91,72,7,2.5249414128,2800.0733378464,0.1463803152,0.100621071,0.27403504,0,66,4.3880930401963707E-4,5.5122166E-4,5.583812E-4,47,43,0,201,0,0
68844282,jomac1867,10,2089,557,1200,21,440,42.7868713119,40-49,596,6,15,31,46,46,15,31,7,2.7867425511,1247.3109862004,0.0115529844,0.0869565217,0.23011364,0,66,1.838629897108053E-4,9.586464E-5,9.710977E-5,140,2,0,200,0,0
68888806,ninesnowboots,10,12242,713,1977,16,645,,,727,8,16,36,52,52,16,36,7,2.5229327084,1801.5397453686,0.0250758125,0.0897435897,0.25675675,0,66,1.015071959881682E-4,1.0185618E-4,1.0317913E-4,55,4,0,200,0,0
68966030,CamHolmstrom,10,11917,962,1876,35,7,53.4759314128,50-59,695,8,203,259,462,462,203,259,6,2.2119183127,22512.1550261171,0.2730117252,0.0701843348,0.2346412,0,66,9.860737618772868E-4,0.0012222741,0.0012381496,390,23,5,200,5,0.025
69002150,StealthFlyBy,10,1035,36,8,1,1,42.0909084703,40-49,608,5,3,1,4,4,3,1,8,3.7931034483,0,0.0028408715,0.1666666667,0.33333334,0,66,6.61751925386398E-5,2.396616E-5,2.4277442E-5,390,8,0,200,0,0
69233373,SuzakiTheAmazon,10,1266,190,394,1,30,40.7003182665,40-49,586,5,17,35,52,52,17,35,6,2.7997991296,71.954168075,0.0109572828,0.1101055807,0.3563492,0,66,1.0192867065833268E-4,1.0784772E-4,1.0924849E-4,372,0,1,200,1,0.005
69479599,CNTtabulating,10,812,229,360,3,2,33.9749349864,30-39,557,5,7,15,22,22,7,15,7,2.9049213257,21.5348839854,0.0045358151,0.1363636364,0.39166668,0,66,7.21679718319933E-5,4.793232E-5,4.8554884E-5,47,3,2,200,2,0.01
69505975,ctjn,10,48,47,95,0,0,16.3608738954,10-19,232,2,0,1,1,1,0,1,8,3.6345381526,0,0,0,0,0,290,4.4780486537007367E-5,0,6.0693606E-6,140,2,0,51,0,0
69671596,hoangmai_npd,10,974,1961,1272,160,0,49.4978721079,40-49,694,5,215,166,381,381,215,166,6,2.3779712086,7887.0052859689,0.2851166964,0.08238707,0.25071436,0,66,0.0013518236,0.0012941726,0.0013049125,390,62,0,200,0,0
69856537,caroldunk,10,4994,336,657,8,48,47.5471473206,40-49,639,7,56,124,180,180,56,124,7,2.3009708738,920.562186261,0.0929884408,0.121166977,0.32053378,0,66,1.8181093162787372E-4,3.4151776E-4,3.4595357E-4,47,15,2,200,2,0.01
70016558,SaySandra,10,49948,2202,1792,162,97,57.5158684714,50-59,832,9,110,114,224,224,110,114,6,2.2879142953,10460.4481526406,0.1445986213,0.0507286996,0.27642277,0,66,3.730288720868879E-4,6.6506094E-4,6.73699E-4,47,114,0,203,0,0
70184896,jessisninja,10,4171,136,292,0,115,32.8830788405,30-39,637,6,3,5,8,8,3,5,1,1,1,2.3735479204474417E-4,0.1428571429,0.65,0,49,2.45417510099266E-4,2.396616E-5,2.4277442E-5,27,26,0,200,0,0
70215225,cbeak,10,1504,544,1109,6,351,44.4145023764,40-49,660,6,100,173,273,273,100,173,6,2.2936056244,10046.5713695867,0.1019946891,0.0525479423,0.20962062,0,66,3.3026032813747815E-4,6.051455E-4,6.130054E-4,47,6,0,198,0,0
70377745,dalegkirby,10,4702,4718,2348,95,0,60.8347873758,60-69,761,6,91,120,211,211,91,120,6,2.3886842986,5860.2795615858,0.1155651763,0.1181448883,0.3379866,0,66,4.909614631395449E-4,5.5122166E-4,5.583812E-4,390,92,0,200,0,0
70445552,BigShoey,10,5934,358,126,13,76,32.0401202995,30-39,715,7,17,23,40,40,17,23,6,2.8024774021,174.4111908828,0.012750156,0.1602564103,0.3921371,0,66,1.0730046987661283E-4,1.0784772E-4,1.0924849E-4,372,5,1,199,1,0.0050251256
70500181,kristenleal,10,7518,299,296,12,139,59.5924449878,50-59,718,6,4,6,10,10,4,6,7,2.9866086374,3.124809281,0.0113608003,0.2333333333,0.60714287,0,66,7.368437722831566E-5,2.99577E-5,3.0346804E-5,372,2,0,199,0,0
70531121,omat_king14,10,1055,98,280,1,7,31.5663951614,30-39,504,5,0,0,0,0,0,0,0,0,0,0,0,0,237,458,4.4780486537007367E-5,0,0,233,2,0,200,0,0
70693316,terrylo_calgary,10,20484,644,592,19,1143,63.8279857241,60-69,738,8,2,3,5,5,2,3,7,3.2387010378,0.0288461538,0.0011209259,0.1,0.5,0,66,5.145321836955657E-5,1.797462E-5,1.8208082E-5,372,8,0,201,0,0
70761385,a_elgueta,10,1785,202,542,0,7,32.21331575,30-39,559,6,1,5,6,6,1,5,9,4.6049548042,2236.85,9.652838824279372E-5,0.1333333333,0.25,0,66,1.122103523552837E-4,1.198308E-5,1.2138721E-5,320,0,0,201,0,0
70789275,cheapgordo,10,2205,517,1827,7,19,40.4584007411,40-49,541,6,6,32,38,38,6,32,7,2.6940073652,92.3995239695,0.0109473634,0.2183499289,0.44602272,0,66,6.751635751276948E-5,4.194078E-5,4.2485524E-5,140,0,0,200,0,0
70973856,phomme,10,6935,212,205,12,5,29.2020554118,20-29,563,6,0,1,1,1,0,1,7,3.5254350736,0,0,0,0,0,685,4.4780486537007367E-5,0,6.0693606E-6,372,0,0,199,0,0
71001729,Rob_Clarke_MP,10,680,1415,121,128,3,49.3053749277,40-49,691,4,125,32,157,157,125,32,7,2.6608637429,2673.8136671574,0.1366988882,0.1012575535,0.1822001,0,66,8.755523581309405E-4,7.5493404E-4,7.586701E-4,372,62,7,201,7,0.0348258706
71139897,yo_bell,10,42732,895,761,2,56,42.5528959947,40-49,779,8,1,1,2,2,1,1,1,1,0,7.49471721243357E-5,0,0,141,282,2.9852402567743944E-4,1.198308E-5,1.2138721E-5,317,26,0,201,0,0
71358586,MartinGratton,10,200,14,84,0,2,23.3466910443,20-29,388,5,0,23,23,23,0,23,7,2.7670682731,0,0,0.3418972332,0.52964425,0,610,4.4780486537007367E-5,0,6.0693606E-6,140,11,0,201,0,0
71390388,AlbertaAltruist,10,17596,1027,139,41,0,58.2887737382,50-59,774,8,66,22,88,88,66,22,6,2.7338466689,355.865665324,0.042414277,0.1353187043,0.31651017,0,66,3.877024434850623E-4,4.0143318E-4,4.0664716E-4,372,256,3,202,3,0.0148514851
71425364,Buster_86,10,1545,118,336,1,20,23.7467263128,20-29,616,5,0,0,0,0,0,0,0,0,0,0,0,0,241,463,4.4780486537007367E-5,0,0,237,2,0,200,0,0
71446721,meganclendining,10,1336,94,83,0,77,29.6391636501,20-29,547,4,3,4,7,7,3,4,2,1.2,0,2.3735479204474417E-4,0.1428571429,0.8333333,0,49,2.3681532511563334E-4,2.396616E-5,2.4277442E-5,27,13,0,200,0,0
71611873,sez_i,10,2589,131,233,6,200,41.2013728651,40-49,533,6,27,46,73,73,27,46,7,2.4911282223,178.3932478132,0.0471421586,0.1385083714,0.41101056,0,66,1.1176377141559852E-4,1.6776312E-4,1.699421E-4,47,12,3,200,3,0.015
71703535,Sincerely_Hubbs,10,10227,613,711,0,64,43.9411240992,40-49,704,6,0,0,0,0,0,0,0,0,0,0,0,0,204,389,4.4780486537007367E-5,0,0,199,3,0,202,0,0
72182988,Mayssia,10,47576,1083,1984,29,1040,44.3421850398,40-49,767,9,10,59,69,69,10,59,6,2.463675929,946.0161003061,0.0203004826,0.1589940324,0.29781422,0,66,8.025403719879295E-5,6.590694E-5,6.6762965E-5,140,11,0,199,0,0
72506180,royhunter2009,10,5498,80,367,2,74,30.8988073502,30-39,587,6,0,1,1,1,0,1,7,3.0873493976,0,0,0,0,0,338,4.4780486537007367E-5,0,6.0693606E-6,140,1,0,200,0,0
72663989,irenemathyssen,10,2113,2791,198,231,2,53.4112294804,50-59,733,5,273,38,311,311,273,38,7,2.6528289253,6897.5701083508,0.2950874052,0.1100923141,0.18632436,0,66,0.0013732006,0.001641682,0.0016508661,390,229,3,200,3,0.015
72884615,timhowl,10,537,181,92,2,1,28.6453769096,20-29,547,4,50,26,76,76,50,26,7,2.8326079679,117.8211022752,0.0819617897,0.2145614035,0.520765,0,66,3.134650902213542E-4,3.0556854E-4,3.095374E-4,390,13,20,200,19,0.1
72966878,w_izzard,10,7278,5117,5070,41,180,56.8610118006,50-59,729,7,48,77,125,125,48,77,6,2.3789755608,10159.3221308854,0.0472723917,0.0584516129,0.19343366,0,66,2.7341824768415735E-4,2.9358547E-4,2.9739868E-4,372,8,0,200,0,0
72987186,MitchCaseSSM,10,200,24,40,0,0,26.479399812,20-29,306,4,5,3,8,8,5,3,8,3.3324405758,3.4438827036,0.0035800134,0.1428571429,0.7,0,66,7.86121056638761E-5,3.594924E-5,3.6416164E-5,47,9,0,200,0,0
73128904,caperspark,10,17746,583,1100,29,4,36.8947602264,30-39,761,8,6,13,19,19,6,13,7,2.8359558085,1498.0238789432,0.0058717051,0.1608187135,0.29583332,0,66,6.762175091373535E-5,4.194078E-5,4.2485524E-5,47,2,0,199,0,0
73197511,Jess_TFA,10,6885,375,167,22,1,50.4276277638,50-59,696,6,9,3,12,12,9,3,7,3.3039839304,2.0232945368,0.0129402781,0.1590909091,0.33333334,0,66,9.259801539157543E-5,5.99154E-5,6.069361E-5,372,10,0,200,0,0
73202035,MarcLaferriere,10,13872,2626,1827,95,962,70.3486434136,70-79,765,8,221,210,431,431,221,210,6,2.2326749247,33433.8328872713,0.2586967167,0.0452705984,0.21224692,0,66,0.0010598495,0.0013301219,0.001347398,390,119,0,200,0,0
73430683,scottsancton,10,1699,121,414,1,9,26.9525508965,20-29,529,6,0,17,17,17,0,17,7,2.8450468541,0,0,0.3676470588,0.6213235,0,636,4.4780486537007367E-5,0,6.0693606E-6,140,2,3,200,3,0.015
73500803,PostmediaNews,10,54263,4861,116,311,11,48.3277957352,40-49,784,7,221,9,230,230,221,9,7,3.0475393371,239.5715186429,0.290493093,0.1105562939,0.15953621,0,66,0.0017011612,0.0013301219,0.0013413287,372,160,0,201,0,0
73651314,dwalshmedia,10,22347,1059,2004,50,5,43.9473982889,40-49,768,9,23,33,56,56,23,33,7,2.6755942417,1388.4717860056,0.0301493049,0.125974026,0.2691952,0,66,1.731047390121907E-4,1.4379696E-4,1.4566466E-4,55,7,0,200,0,0
74179953,SimcoeNorthNDP,10,618,245,595,9,27,45.6035811163,40-49,616,5,54,120,174,174,54,120,6,2.3702711751,1540.9853254898,0.0595683897,0.1549398711,0.3646514,0,66,2.0460027523627115E-4,3.295347E-4,3.3381482E-4,390,42,7,201,7,0.0348258706
74227540,johnnyfriesen,10,10597,978,1107,41,2,49.4526762489,40-49,748,7,51,53,104,104,51,53,7,2.6581854704,312.9166659697,0.0605028986,0.1563666916,0.34175727,0,66,2.172284828778054E-4,3.1156008E-4,3.095374E-4,140,22,0,201,0,0
74387981,axenetwit,10,8092,5316,745,557,0,63.1356073652,60-69,792,7,9,6,15,15,9,6,2,1.25,3127.2,7.160319321302602E-4,0.0714285714,0.30555555,0,56,7.572970809269562E-4,5.99154E-5,5.4624245E-5,320,26,0,200,0,0
74660931,keithjs,10,9009,213,181,8,726,53.3031107818,50-59,728,8,38,32,70,70,38,32,6,2.6324070974,2559.1484832034,0.0480822369,0.049689441,0.17829457,0,66,2.982480909883669E-4,2.3367006E-4,2.3670506E-4,140,36,0,201,0,0
74888261,LiamTheSaint,10,2570,168,196,4,44,44.1026870425,40-49,671,6,20,22,42,42,20,22,7,2.8162035487,53.8479590954,0.03598627,0.1852497096,0.48084676,0,66,1.2542404099251275E-4,1.2582233E-4,1.2745657E-4,140,12,0,200,0,0
75016616,Stephen_Yardy,10,1873,510,536,15,10,56.2263349206,50-59,687,5,112,106,218,218,112,106,7,2.4924673586,5985.2455587979,0.1269825732,0.1296875661,0.2999715,0,66,4.6745060463320863E-4,6.7704404E-4,6.797684E-4,390,119,10,200,9,0.05
75073306,karenscian,10,9086,1400,548,64,21,56.6186221625,50-59,748,7,20,7,27,27,20,7,7,3.0354871108,165.8005674681,0.0132689696,0.0498575499,0.15526316,0,66,1.2333572016521842E-4,1.2582233E-4,1.2745657E-4,140,43,0,200,0,0
75335389,Ken_Donnelly,10,27094,1716,1910,82,459,52.650931033,50-59,778,8,121,193,314,314,121,193,7,2.2541011048,8936.0801161849,0.1790298906,0.0771453572,0.25287542,0,66,4.53656049458388E-4,7.3096785E-4,7.40462E-4,140,34,0,201,0,0
75368511,KarlBelanger,10,7116,4476,500,166,0,62.2156398784,60-69,767,7,412,77,489,489,412,77,7,2.6079678607,6385.7908141234,0.4808955572,0.0829645647,0.15274861,0,66,0.0026595016,0.002474506,0.0024762992,390,230,5,203,5,0.0246305419
75436573,MoreTo_Discover,10,3990,232,435,3,2616,44.6628136121,40-49,639,6,48,89,137,137,48,89,6,2.2949447606,896.7934278954,0.0811828745,0.097520395,0.33110368,0,66,1.7152065388314138E-4,2.9358547E-4,2.913293E-4,47,11,0,209,0,0
75928120,ScottAndrewsMP,10,496,2796,316,172,5,48.2676871115,40-49,686,4,197,34,231,231,197,34,7,2.7984599933,658.1842657916,0.2460224248,0.1218897045,0.19972917,0,66,0.0010407453,0.0011863249,0.001195664,140,38,18,200,15,0.09
76114077,CommonSenseSoc,10,83975,1642,1184,100,41,46.3238433142,40-49,862,10,83,75,158,158,83,75,6,2.3602276532,24218.2568903876,0.0913056688,0.0384987503,0.18656899,0,66,3.8007862848041203E-4,5.0328934E-4,5.098263E-4,372,66,0,202,0,0
76764120,stuartwilks,10,19290,566,688,16,132,56.7292808872,50-59,769,8,2,2,4,4,2,2,1,1,0,1.5762601949607043E-4,0.0833333333,1,0,32,5.423447363973633E-4,1.797462E-5,1.8208082E-5,338,6,0,200,0,0
76919759,Bergg69,10,32704,1484,2001,28,1510,47.7170476552,40-49,783,8,287,401,688,688,287,401,6,2.093739538,59776.6928133088,0.306019783,0.046346603,0.1521249,0,66,7.839452630549468E-4,0.0017255635,0.0017419065,47,1176,1,314,1,0.0031847134
76977981,craddo,10,7595,1778,1790,70,567,61.2346693216,60-69,737,7,20,37,57,57,20,37,7,2.5795112153,571.6252762243,0.0239400372,0.1557017544,0.32845744,0,66,1.226074619505962E-4,1.2582233E-4,1.2745657E-4,140,15,0,200,0,0
77251447,JoaoPauloLF_,10,3248,226,120,1,10,28.8455092933,20-29,661,6,0,0,0,0,0,0,0,0,0,0,0,0,322,582,4.4780486537007367E-5,0,0,325,3,0,200,0,0
77254498,deepgreendesign,10,77003,4456,3520,281,1834,55.1262342228,50-59,851,10,296,258,554,554,296,258,6,2.1801138266,61933.4444295275,0.3256633211,0.0362708169,0.16519356,0,66,0.0012087249,0.0017794874,0.0018026001,47,492,0,251,0,0
77298060,Cash4TO,10,1356,4092,829,213,2,59.754158122,50-59,740,5,362,121,483,483,362,121,7,2.3458319384,27871.9506315673,0.3880099322,0.0798347122,0.15447007,0,66,0.0018747432,0.002174929,0.0021728312,390,225,7,200,7,0.035
77302546,DLynxleg,10,4426,94,311,2,577,44.2160730464,40-49,656,6,6,12,18,18,6,12,7,2.9253431537,15.5747074023,0.0054043294,0.1437908497,0.49242425,0,66,7.193178053675125E-5,4.194078E-5,4.2485524E-5,47,4,1,200,1,0.005
78317432,mbo108,10,255,35,136,1,5,20.2435715129,20-29,429,4,0,1,1,1,0,1,1,1,0,0,0,0,0,222,4.4780486537007367E-5,0,6.0693606E-6,43,0,0,198,0,0
78596808,wellsdavid,10,104,138,319,2,1,29.5996929599,20-29,456,3,6,29,35,35,6,29,6,2.7689989956,1439.638519627,0.0055050416,0.2025210084,0.4815271,0,66,1.1576106272541317E-4,4.194078E-5,4.2485524E-5,372,4,0,111,0,0
78627903,ChristianConsrv,10,3195,352,76,16,7,51.9629449642,50-59,697,6,52,10,62,62,52,10,6,2.7248074992,240.9627396191,0.0702376765,0.1359069276,0.22869675,0,66,3.714934460030873E-4,3.175516E-4,3.216761E-4,372,88,0,200,0,0
78641250,G_Soule,10,5724,1998,1113,77,1,52.3241250229,50-59,729,7,307,195,502,502,307,195,6,2.2905925678,15651.6466697798,0.4135501428,0.0723453491,0.20768453,0,66,0.0021001856,0.0018453943,0.0018632937,390,160,33,200,31,0.165
78812863,avdhuman,10,59476,1946,1434,10,5,45.7346448154,40-49,649,9,5,1,6,6,5,1,7,3.5554067626,2995.983616285,0.0035492339,0.0333333333,0.05,0,66,9.287224043364554E-5,3.594924E-5,3.0346804E-5,47,0,0,206,0,0
78898625,7PinkPanther7,10,195629,1264,884,44,2,47.997087501,40-49,880,11,14,14,28,28,14,14,7,2.5915634416,475.3382128799,0.0204049543,0.0555555556,0.36190477,0,66,1.0885644024749717E-4,8.98731E-5,9.104041E-5,390,26,0,200,0,0
78998799,LisaKirbie,10,2702,766,1184,23,5,54.6920275673,50-59,708,6,91,129,220,220,91,129,6,2.3374623368,3679.3759353041,0.1288263975,0.1011830635,0.25413895,0,66,5.419240484736298E-4,5.5122166E-4,5.583812E-4,140,98,4,200,4,0.02
79015001,colinmckone,10,587,121,205,3,6,23.5460606736,20-29,479,4,12,28,40,40,12,28,7,2.9233344493,9.6671116978,0.0152176036,0.2371794872,0.5534274,0,66,1.0967556323178658E-4,7.789002E-5,7.8901685E-5,140,1,0,200,0,0
79184926,AndresMusta,10,845,77,158,1,72,35.5684633706,30-39,538,5,8,12,20,20,8,12,7,2.9300301306,83.4057209387,0.0069064545,0.0947368421,0.1952381,0,66,7.570739520808636E-5,5.392386E-5,5.4624245E-5,390,1,0,201,0,0
79187514,hrhsar,10,113819,1398,1663,93,29530,45.9668798452,40-49,780,9,2,1,3,3,2,1,8,3.6829594911,6.5282137383,8.378300588456506E-4,0.1666666667,0.33333334,0,66,4.876509097327154E-5,1.797462E-5,1.8208082E-5,47,3,0,201,0,0
79229494,Abu4arsenal,10,1363,109,343,2,8,40.5285725728,40-49,582,5,0,0,0,0,0,0,0,0,0,0,0,0,78,176,4.4780486537007367E-5,0,0,70,7,0,198,0,0
79263310,itsluncht1me,10,7016,407,653,11,106,43.2398607968,40-49,681,7,13,24,37,37,13,24,7,2.6307331771,372.4784894741,0.0243095788,0.1531531532,0.3235887,0,66,7.973565450583735E-5,8.388156E-5,8.497105E-5,47,11,0,200,0,0
79746968,GroovyGrapesTWT,10,1018,726,339,46,1,43.698892173,40-49,602,5,2,2,4,4,2,2,7,3.2822229662,0.7999140761,0.0013534341,0,0,0,66,5.337915539511025E-5,1.797462E-5,1.8208082E-5,140,10,0,200,0,0
79889696,victorhernand,10,20996,973,2000,4,298,47.4774241961,40-49,659,8,6,11,17,17,6,11,7,2.6290592568,245448.170703475,0.0127438344,0.0367647059,0.13636364,0,66,1.3500596123575283E-4,4.194078E-5,4.2485524E-5,320,10,0,201,0,0
80027957,TweetJewels,10,2664,257,393,16,25,47.0284300127,40-49,579,6,31,42,73,73,31,42,7,2.620020087,407.0019447343,0.0373900729,0.121194825,0.44680852,0,66,1.5982295327107127E-4,1.9172928E-4,1.9421954E-4,390,13,2,200,2,0.01
80063918,Al_Goodhall,10,1804,349,304,14,6,42.1823231528,40-49,615,5,2,11,13,13,2,11,7,2.7532641446,0.1261052996,0.0073612582,0.2628205128,0.6727273,0,66,5.180732819647899E-5,1.797462E-5,1.8208082E-5,140,4,0,200,0,0
80155484,RuralBC,10,22856,800,1042,32,344,44.9633991036,40-49,735,8,84,111,195,195,84,111,6,2.2303314362,2504.0851568569,0.1296934472,0.0878139043,0.31163877,0,66,2.721551419166532E-4,5.092809E-4,5.1589566E-4,47,38,0,222,0,0
80292014,gliverpool9966,10,22180,438,546,10,72,44.5784550966,40-49,744,8,5,11,16,16,5,11,7,2.8024774021,83.4018247438,0.0058305132,0.2375,0.46153846,0,66,7.433876980588307E-5,3.594924E-5,3.6416164E-5,140,8,2,201,2,0.0099502488
80474440,Frankie0331,10,14196,880,605,36,1163,51.6690687439,50-59,734,8,82,88,170,170,82,88,6,2.3367927687,6422.1003383851,0.1086684427,0.0839888618,0.2925095,0,66,3.2875839834979457E-4,4.972978E-4,5.037569E-4,47,48,1,212,1,0.0047169811
80475670,WaiYoung,10,1103,1197,360,98,3,49.3777480087,40-49,665,5,99,35,134,134,99,35,6,2.703381319,1505.5698625632,0.1046304226,0.1110425317,0.21670762,0,66,6.858018434930347E-4,5.99154E-4,6.008667E-4,372,32,1,200,1,0.005
80945516,TheWpgChamber,10,5846,3846,944,146,28,56.3165053737,50-59,754,7,14,9,23,23,14,9,7,3.1633746234,556.6838100228,0.0074065965,0.0948616601,0.15,0,66,1.5325385957764266E-4,8.98731E-5,9.104041E-5,372,73,0,200,0,0
81050260,GoldHome,10,520,118,280,0,6,31.5175300995,30-39,459,4,15,23,38,38,15,23,7,2.5333110144,76.5673319909,0.0188191568,0.0746799431,0.32806325,0,66,8.000312153371382E-5,9.586464E-5,9.710977E-5,47,7,0,200,0,0
81220155,stribe39,10,21456,690,398,79,3,49.1653635949,40-49,756,8,137,69,206,206,137,69,7,2.5031804486,1897.6872667764,0.1954983673,0.0982476912,0.25312108,0,66,6.753042631280303E-4,8.268325E-4,8.3757174E-4,140,126,2,200,2,0.01
81290051,louisa_faux,10,233,9,33,1,19,15.74156519,10-19,150,3,1,1,2,2,1,1,7,3.3398058252,0,0.0011224705,0,0,0,66,4.851922726889002E-5,1.198308E-5,1.2138721E-5,390,0,0,199,0,0
81793090,andreas_rieger,10,414,250,738,3,1,32.1182507606,30-39,395,4,0,2,2,2,0,2,8,4.4161927066,0,0,0,0,0,653,4.4780486537007367E-5,0,6.0693606E-6,320,0,0,200,0,0
81855161,mdavid6,10,149,9,51,0,0,13.4620039902,10-19,50,3,0,1,1,1,0,1,7,3.250669344,0,0,0,0,0,459,4.4780486537007367E-5,0,6.0693606E-6,47,2,0,161,0,0
81871292,davidmossey,10,1633,300,1999,4,11,28.9736952873,20-29,524,6,0,15,15,15,0,15,7,2.9712182062,0,0,0.2476190476,0.4,0,510,4.4780486537007367E-5,0,6.0693606E-6,140,3,0,200,0,0
82261964,sergiobc1300,10,8220,2482,355,60,10,48.4423368553,40-49,754,7,3,2,5,5,3,2,2,1.5,1,2.2784304369982564E-4,0.2,0.33333334,203,412,1.2877626753625776E-4,2.396616E-5,1.2138721E-5,212,18,0,198,0,0
82461587,robertquickert,10,9905,160,204,4,18,43.2527425513,40-49,614,8,4,5,9,9,4,5,7,3.317710077,101.4243044632,0.0050913841,0.0972222222,0.17857143,0,66,5.515798218195908E-5,2.99577E-5,3.0346804E-5,140,13,0,201,0,0
82494649,datatect,10,22836,624,170,17,293,54.1904465487,50-59,776,8,147,35,182,182,147,35,7,2.5336457985,1040.102941761,0.1932117598,0.138759031,0.26880255,0,66,4.7870521280215866E-4,8.867479E-4,8.982654E-4,47,159,4,216,4,0.0185185185
82907020,anandpkrishnan,10,7306,204,431,4,11,39.7584491294,30-39,595,7,1,1,2,2,1,1,1,1,0,8.078233437699056E-5,0,0,0,43,4.599496116192142E-4,1.198308E-5,1.2138721E-5,372,0,0,205,0,0
83028162,duanenicol,10,2532,371,469,15,18,42.4840762436,40-49,659,6,11,19,30,30,11,19,7,2.8289253432,66.8058454039,0.0156763951,0.1540229885,0.36363637,0,66,1.0190552187406414E-4,7.189848E-5,7.283233E-5,390,6,0,200,0,0
83180342,shawnwlewis,10,4250,325,336,10,44,45.3904046444,40-49,680,7,51,70,121,121,51,70,6,2.4861064613,2246.8094253862,0.0549001937,0.1486225895,0.3422149,0,66,2.1543844639368336E-4,3.1156008E-4,3.095374E-4,390,18,1,200,1,0.005
83304354,JackCanada1,10,4224,794,1963,39,1928,38.0475607603,30-39,571,6,5,39,44,44,5,39,6,2.5918982256,336.7236528655,0.0080803455,0.1738900634,0.32523617,0,66,6.959903722121656E-5,3.594924E-5,3.6416164E-5,47,1,0,200,0,0
83491633,hsvirk,10,458,34,37,5,2,26.6808797692,20-29,362,4,5,7,12,12,5,7,7,3.0545698025,6.3370665116,0.0062079826,0.0984848485,0.3392857,0,66,5.72839684876865E-5,3.594924E-5,3.6416164E-5,140,1,0,200,0,0
83496033,GregJohannson,10,4666,1457,1019,49,211,50.7467886538,50-59,715,7,135,102,237,237,135,102,6,2.3367927687,5604.0428293135,0.1871692006,0.0531359508,0.20100544,0,66,4.7772948609663303E-4,8.1484945E-4,8.2543306E-4,47,21,0,200,0,0
83689327,tawanlima,10,5460,1244,155,1,15,47.3552618025,40-49,713,6,1,1,2,2,1,1,1,1,0,7.49471721243357E-5,0,0,123,240,2.9852402567743944E-4,1.198308E-5,1.2138721E-5,121,26,0,201,0,0
83748727,FaithGoldy,10,12450,1398,724,29,4,65.0085594158,60-69,761,7,107,68,175,175,107,68,6,2.5085369936,9195.3361692831,0.1046561467,0.0769458128,0.17864923,0,66,6.70843595722529E-4,6.470863E-4,6.5549096E-4,372,195,0,201,0,0
84207565,DESicnarF,10,1747,386,418,8,334,45.6344514806,40-49,667,6,39,65,104,104,39,65,6,2.6491463006,657.5836005675,0.0203128459,0.0925130695,0.38557693,0,66,1.891238280304813E-4,2.396616E-4,2.4277443E-4,372,31,3,201,3,0.0149253731
84368341,madinuk,10,31746,2151,885,89,11,61.138383242,60-69,787,8,79,24,103,103,79,24,7,2.7770338132,1496.0511040111,0.0812499151,0.0760517799,0.13711844,0,66,4.028197768524307E-4,4.793232E-4,4.8554887E-4,140,67,0,199,0,0
84401415,BillKingLanark,10,1557,414,1020,3,72,54.0506751173,50-59,627,6,18,79,97,97,18,79,6,2.5031804486,367.4872251272,0.0239223485,0.1694587629,0.36835444,0,66,1.6379679343393857E-4,1.1383926E-4,1.1531785E-4,372,18,1,200,1,0.005
84407151,ballantynedj,10,7741,691,573,50,46,47.5187058432,40-49,730,7,12,26,38,38,12,26,7,2.5718111818,395.9163217566,0.0244519209,0.1934566145,0.44367817,0,66,1.0072763102725351E-4,7.789002E-5,7.8901685E-5,140,3,0,200,0,0
84600728,Dagy_92,10,22991,206,217,2,82,44.2537291788,40-49,731,8,0,0,0,0,0,0,0,0,0,0,0,0,225,440,4.4780486537007367E-5,0,0,220,1,0,201,0,0
84853717,DavidSotoR,10,498,93,188,0,0,16.83973041,10-19,486,4,1,4,5,5,1,4,9,4.6056243723,2233.85,9.652838824279372E-5,0.15,0.25,0,66,1.122103523552837E-4,1.198308E-5,1.2138721E-5,320,2,0,200,0,0
84969179,wjoates,10,16951,1008,1408,66,14,57.5355071655,50-59,781,8,267,336,603,603,267,336,6,2.104117844,27605.7816797644,0.329408538,0.0510404787,0.18989724,0,66,8.294438457425358E-4,0.0016057327,0.0016265886,47,198,2,202,2,0.0099009901
85094715,kplasterer,10,1238,84,370,1,20,26.6701313996,20-29,543,5,2,6,8,8,2,6,7,3.166722464,19.8845906656,8.92005056125279E-4,0.0357142857,0.13333334,0,66,5.852280859427298E-5,1.797462E-5,1.8208082E-5,47,0,0,198,0,0
85118235,qubit_i,10,367,11,13,1,1,19.5123110538,10-19,289,3,0,2,2,2,0,2,7,3.2001338688,0,0,0.5,1,0,148,4.4780486537007367E-5,0,6.0693606E-6,140,1,0,200,0,0
85146999,Albertagirl46,10,6920,1104,1477,33,11,45.2964810307,40-49,719,7,152,220,372,372,152,220,6,2.1536658855,29927.9383062322,0.182011102,0.039511057,0.17490791,0,66,5.490268417103099E-4,9.167056E-4,9.286122E-4,47,26,0,200,0,0
85229508,rileysmithphoto,10,5609,1047,735,25,44,47.6990105415,40-49,707,7,6,3,9,9,6,3,7,3.1121526615,3376.4882016251,0.0073933577,0.1527777778,0.6333333,0,66,1.0157216431284551E-4,4.194078E-5,4.2485524E-5,390,15,0,200,0,0
85446321,FancieTweets,10,4924,923,1132,19,62,61.4772182234,60-69,702,7,145,166,311,311,145,166,6,2.2982926013,12072.6999689296,0.1878522212,0.0819209626,0.2763903,0,66,8.230811719454015E-4,8.747648E-4,8.800573E-4,390,88,1,200,1,0.005
85606463,teacherace,10,2740,87,324,3,142,34.335487177,30-39,606,6,3,19,22,22,3,19,7,2.7703381319,2.718016174,0.0073778201,0.3354978355,0.6789474,0,66,7.860789615630293E-5,2.396616E-5,2.4277442E-5,140,6,0,200,0,0
85612633,ValckeNDP,10,23798,1528,1476,57,231,55.3537882959,50-59,773,8,331,294,625,625,331,294,6,2.1881486441,34242.7241105767,0.4012652056,0.0597897436,0.16402803,0,66,0.0015066252,0.0019891912,0.0020089585,390,663,87,338,87,0.2573964497
85640352,reshminair,10,4031,3608,836,130,2,56.1429324103,50-59,751,7,125,33,158,158,125,33,7,2.635420154,11489.3664992123,0.1596625219,0.1104168346,0.17516512,0,66,9.90169230846341E-4,7.5493404E-4,7.343926E-4,140,157,2,200,2,0.01
85647456,NotSoLogical,10,35148,79,135,2,666,34.2176598278,30-39,768,7,0,0,0,0,0,0,0,0,0,0,0,0,293,544,4.4780486537007367E-5,0,0,290,1,0,200,0,0
85994989,fleurdefibre,10,428,42,116,3,5,52.7414081937,50-59,382,4,4,13,17,17,4,13,6,2.6856377636,3.0258483917,0.0093241087,0.2058823529,0.525641,0,66,5.6878449065646525E-5,2.99577E-5,3.0346804E-5,47,3,0,199,0,0
85999942,pmc85,10,3718,223,642,1,259,35.5737991693,30-39,643,6,5,33,38,38,5,33,7,2.6776029461,114.5527901157,0.011801025,0.2169274538,0.37815127,0,66,7.229382047225548E-5,3.594924E-5,3.6416164E-5,140,0,0,200,0,0
86110985,BZMWillemsen,10,3783,178,291,6,19,56.2916076288,50-59,641,6,9,20,29,29,9,20,6,2.6849681955,72.2328118131,0.0122286581,0.1514778325,0.317029,0,66,7.229426208438379E-5,5.99154E-5,6.069361E-5,140,3,0,200,0,0
86124232,Joseph_Kouvelas,10,1728,169,363,2,0,22.9674646624,20-29,518,5,3,18,21,21,3,18,6,2.6886508202,8.1439991878,0.0071429693,0.2738095238,0.59150326,0,66,6.161209660612117E-5,2.396616E-5,2.4277442E-5,140,0,0,199,0,0
86182834,Anudda,10,10020,632,777,23,119,49.122215486,40-49,748,8,162,211,373,373,162,211,6,2.1975225979,5992.2702351208,0.2406731885,0.0637810257,0.2790004,0,66,4.6569258337997874E-4,9.76621E-4,9.893058E-4,47,52,4,199,4,0.0201005025
86203783,happydaze11,10,9946,1074,168,4,1488,53.9061370752,50-59,751,7,5,2,7,7,5,2,3,2,1.2166666667,4.1971064641618035E-4,0.1428571429,0.55,26,99,2.486126067467458E-4,3.594924E-5,3.6416164E-5,49,17,0,201,0,0
86216486,RSN_Godot,10,12413,2091,241,134,0,52.4680944997,50-59,748,3,7,1,8,8,7,1,8,4.104117844,14.2002894824,0.0024991985,0.0714285714,0.08928572,0,66,7.127811861386601E-5,4.793232E-5,4.8554884E-5,47,0,0,200,0,0
86344211,YukonGale,10,32196,1445,1296,92,1515,52.6573750421,50-59,796,8,308,298,606,606,308,298,6,2.1432875795,30499.4605700004,0.3968261848,0.0510160107,0.20614642,0,66,0.0010135278,0.0018513858,0.0018754324,47,589,3,212,3,0.0141509434
86378138,JuliaKinsman,10,2279,156,403,8,677,41.3844809787,40-49,601,5,2,2,4,4,2,2,8,4.1111483093,8.4731444147,1.5602155753351548E-4,0,0,0,66,1.3005179785308656E-4,1.797462E-5,1.8208082E-5,390,4,0,200,0,0
86392520,seotweetz,10,279248,4414,1,419,0,56.244837431,50-59,794,12,6,0,6,6,6,0,0,0,0,0.0012286951,0,0,0,20,2.3965233577394795E-4,4.194078E-5,0,320,15,0,202,0,0
86553574,ashleypiscuc,10,456,70,55,1,111,32.3059555865,30-39,545,4,0,0,0,0,0,0,0,0,0,0,0,0,223,423,4.4780486537007367E-5,0,0,217,3,0,199,0,0
86614774,Grahamashby1953,10,1142,19,39,0,10,15.4936000924,10-19,443,5,0,8,8,8,0,8,7,2.8617804552,0,0,0.4464285714,0.78571427,0,639,4.4780486537007367E-5,0,6.0693606E-6,140,1,2,200,2,0.01
86874273,guinnessgenius,10,4736,83,178,1,49,40.7477596556,40-49,657,6,20,18,38,38,20,18,7,2.7254770673,54.6015541158,0.0251691689,0.1977240398,0.29444444,0,66,8.906441951787533E-5,1.2582233E-4,1.2745657E-4,55,11,1,199,1,0.0050251256
87152213,MediaclickSMM,10,2163,1875,953,179,1,51.8221918814,50-59,692,5,4,2,6,6,4,2,9,5.2279879478,70.7087802386,3.125047703857651E-4,0,0,0,66,2.2844050929918215E-4,2.99577E-5,2.4277442E-5,320,8,0,200,0,0
87247412,CanadianPeace,10,649,959,821,38,1,43.6412867162,40-49,688,5,66,63,129,129,66,63,6,2.463675929,1607.1177565432,0.0817675219,0.1223958333,0.2602564,0,66,2.776050782364583E-4,4.0143318E-4,4.0664716E-4,390,46,15,200,15,0.075
87287009,MarcosKachy,10,46784,294,215,21,191,40.8403394778,40-49,779,8,3,4,7,7,3,4,2,1.2,1,2.38829015668079E-4,0.1428571429,0.8333333,317,575,2.9932567423617847E-4,2.396616E-5,2.4277442E-5,318,10,0,201,0,0
87561702,Athapeese,10,983,157,209,4,36,43.4993616872,40-49,593,5,33,38,71,71,33,38,7,2.7080682959,454.4722086059,0.023617262,0.0770623742,0.31976745,0,66,1.854916296706174E-4,2.0371236E-4,2.0635827E-4,47,16,0,200,0,0
87769317,La_Segunda,10,32330,209884,2493,2265,3,68.4461381654,60-69,951,6,20,3,23,23,20,3,9,4.6066287245,10613.1,0.0016316315,0.0395256917,0.07380953,0,66,4.1772689945595383E-4,1.2582233E-4,9.710977E-5,320,22,0,201,0,0
88240141,LeoFugazza,10,6934,519,768,12,212,60.9165695789,60-69,730,7,41,74,115,115,41,74,7,2.5547371945,1194.5431635235,0.0461261245,0.1421052632,0.35188967,0,66,2.122266464024297E-4,2.5164467E-4,2.5491315E-4,390,37,1,200,1,0.005
88316342,KevinBourassa,10,1374,580,587,10,66,48.2283417222,40-49,707,5,225,224,449,449,225,224,6,2.1871442919,17601.2815518019,0.2519655146,0.0348393255,0.21801761,0,66,5.98145173371278E-4,0.0013540881,0.0013716755,47,71,5,199,5,0.0251256281
89018343,ygjb,10,938,360,410,20,7,,,610,5,1,6,7,7,1,6,7,3.2296618681,2.4589926572,0.0014283118,0.2380952381,0.35714287,0,66,5.067037150417671E-5,1.198308E-5,1.2138721E-5,140,3,0,200,0,0
89052154,CaiMedics,10,1561,248,774,4,16,43.262369403,40-49,633,6,5,25,30,30,5,25,7,2.6534984935,28.4455593191,0.0064410283,0.1459770115,0.23789173,0,66,7.022058752493005E-5,3.594924E-5,3.6416164E-5,55,11,0,200,0,0
89155640,tRPShow,10,21307,1199,1309,60,315,55.0354230467,50-59,769,8,255,292,547,547,255,292,6,2.1359223301,22990.3697604909,0.3457924123,0.065495443,0.18817994,0,66,9.163509668647729E-4,0.0015338343,0.001547687,390,67,4,201,4,0.0199004975
89553250,hakeem092,10,4636,542,1977,0,140,44.3260997973,40-49,638,7,2,6,8,8,2,6,7,3.5340681363,5986,1.4992441991589235E-4,0,0,0,505,1.5926321123805478E-4,1.797462E-5,1.8208082E-5,55,8,0,200,0,0
89704537,bonezmtl,10,2642,177,426,3,21,46.6496878522,40-49,675,6,55,106,161,161,55,106,6,2.2741881486,4187.442863826,0.0838275529,0.0897127329,0.3024158,0,66,1.9536832428461095E-4,3.3552625E-4,3.398842E-4,47,59,0,207,0,0
89715294,OntNewsWatch,10,4267,6956,674,288,4,50.353318021,50-59,733,5,214,28,242,242,214,28,7,2.8195513894,4909.3624565754,0.2046960391,0.0826617743,0.120049365,0,66,0.0010923095,0.001288181,0.0012867044,140,10,0,200,0,0
89812685,ea_p,10,3932,450,643,16,11,60.1258936818,60-69,670,6,31,78,109,109,31,78,7,2.4733846669,747.8901667177,0.0487598898,0.1673462453,0.3885841,0,66,2.0350773915686713E-4,1.9172928E-4,1.9421954E-4,390,33,6,201,6,0.0298507463
90173213,ex3Tory,10,15077,860,1294,21,7134,41.6437179469,40-49,732,8,234,298,532,532,234,298,6,2.1124874456,16406.0504187664,0.3033316417,0.0513218073,0.25121516,0,66,6.385658137262989E-4,0.0014080119,0.0014262998,47,36,0,214,0,0
90179903,clclyne,10,259,84,329,8,148,43.9701400343,40-49,517,4,2,10,12,12,2,10,7,2.8928690994,23.4770361904,6.500226887099181E-4,0.1287878788,0.2888889,0,66,5.346314274193987E-5,1.797462E-5,1.8208082E-5,47,4,0,200,0,0
90221203,fjmoranm,10,1463,83,130,2,10,26.9367826331,20-29,523,5,0,1,1,1,0,1,1,1,0,0,0,0,0,467,4.4780486537007367E-5,0,6.0693606E-6,320,2,0,200,0,0
90227660,24HorasTVN,10,90371,883441,183,5631,15,78.2272691363,70-79,990,8,25,0,25,25,25,0,0,0,0,0.0020155608,0.0416666667,0.065,0,22,5.474016130327693E-4,1.5578004E-4,0,320,142,0,201,0,0
90445427,loostende,10,319,171,152,7,2,48.9618632104,40-49,478,4,2,1,3,3,2,1,3,2,0,1.5295592626290988E-4,0.1666666667,1,22,95,3.2729608963202894E-4,1.797462E-5,1.8208082E-5,182,0,0,200,0,0
90511247,jeanjean3,10,62921,825,782,19,3651,42.5198086111,40-49,760,10,12,11,23,23,12,11,7,2.8975560763,170.8017717227,0.0137028302,0.1383399209,0.5,0,66,9.664207547104569E-5,7.789002E-5,7.8901685E-5,390,4,0,201,0,0
90552383,Jeffsariot,10,1709,66,225,0,1,33.9864666489,30-39,523,5,6,25,31,31,6,25,7,2.6521593572,18.6595568471,0.013259557,0.2709677419,0.5277778,0,66,6.40526743977623E-5,4.194078E-5,4.2485524E-5,140,0,1,200,1,0.005
90606540,naomiduguid,10,6627,1315,175,70,564,55.0231806768,50-59,733,7,1,1,2,2,1,1,7,3.0569132909,3.5719139761,1.0362119087892367E-4,0,0,0,66,4.71873769653818E-5,1.198308E-5,1.2138721E-5,140,6,0,200,0,0
90776169,50shadesofTGO,10,3440,153,597,1,307,41.4285232736,40-49,661,6,0,3,3,3,0,3,7,3.2858099063,0,0,0,0,0,695,4.4780486537007367E-5,0,6.0693606E-6,390,19,0,198,0,0
90783594,jbierm02,10,8905,415,370,7,37,47.8195178531,40-49,688,7,126,140,266,266,126,140,6,2.2380314697,4003.9717663021,0.1825485665,0.0600936303,0.34256023,0,66,3.697919444570773E-4,7.609256E-4,7.708088E-4,47,96,2,204,2,0.0098039216
90996160,Stroppy_Girl,10,29435,254,249,7,6866,38.8663923856,30-39,784,8,5,5,10,10,5,5,7,3.1101439571,13.6091565806,0.002994512,0.0333333333,0.2,0,66,6.208026226128624E-5,3.594924E-5,3.6416164E-5,140,4,0,201,0,0
91017612,jcat111,10,1922,175,836,0,236,44.8366705453,40-49,551,6,44,160,204,204,44,160,7,2.2735185805,3758.5295429477,0.0644275778,0.1140490679,0.27672955,0,66,1.827445312518521E-4,2.696193E-4,2.7312123E-4,47,23,0,202,0,0
91035609,sassa26_ca2003,10,2533,521,985,9,16,45.9829604239,40-49,660,6,79,139,218,218,79,139,7,2.3297623033,12597.3529692136,0.1000174556,0.0833298102,0.24552245,0,66,3.014008254129403E-4,4.793232E-4,4.8554887E-4,390,30,0,200,0,0
91090291,NTPServicesltd,10,962,237,531,1,0,33.6871449387,30-39,509,4,0,0,0,0,0,0,0,0,0,0,0,0,334,601,4.4780486537007367E-5,0,0,340,3,0,200,0,0
91158266,snowlions,10,37921,9897,10007,111,2,47.077183073,40-49,804,9,41,42,83,83,41,42,7,2.6699029126,3881.4235154023,0.0301091481,0.0251248898,0.18350755,0,66,2.2587638839713823E-4,2.5164467E-4,2.5491315E-4,47,51,0,201,0,0
91369352,phunphunphun,10,15282,1340,1385,26,10369,,,768,8,61,73,134,134,61,73,6,2.317710077,4666.3900828441,0.067217401,0.0463472113,0.23441441,0,66,2.3201991928887026E-4,3.7147547E-4,3.7630036E-4,47,17,0,201,0,0
91404588,MarkCRobins,10,29128,1111,1084,57,59,44.7375466475,40-49,760,9,71,95,166,166,71,95,6,2.3528624037,5533.8318835012,0.109506497,0.0792990142,0.28329936,0,66,2.527947376138168E-4,4.313909E-4,4.3699396E-4,140,49,0,210,0,0
91846036,Bait_and_Switch,10,937,122,634,3,0,38.5055397108,30-39,539,5,9,9,18,18,9,9,7,3.1637094074,68.060547698,0.0059346719,0.1111111111,0.54545456,0,66,8.2165963740436E-5,5.99154E-5,6.069361E-5,55,17,2,200,2,0.01
91892348,KhanYEG,10,4608,4542,1538,25,410,55.0345100531,50-59,695,7,70,159,229,229,70,159,7,2.3300970874,27351.5780329557,0.0693378362,0.0749061518,0.20671777,0,66,2.885093371189174E-4,4.2539934E-4,4.309246E-4,140,14,1,200,1,0.005
92091739,PeggyNashNDP,10,2411,9353,778,439,3,60.4882006779,60-69,828,6,683,103,786,786,683,103,7,2.432541011,34842.7450970318,0.5754981678,0.045996013,0.07758525,0,66,0.0032874104,0.0040982133,0.0040786103,390,631,6,200,5,0.03
92152246,sharongenest,10,776,49,175,1,35,32.7841169821,30-39,488,5,0,2,2,2,0,2,7,3.1107764391,0,0,0,0,0,620,4.4780486537007367E-5,0,6.0693606E-6,390,1,0,200,0,0
92579695,Herbert_Pimlott,10,26843,1113,1793,53,5,44.9291398853,40-49,736,9,134,131,265,265,134,131,6,2.317710077,7780.0081057181,0.1905656187,0.0800028588,0.23204435,0,66,4.727281867395196E-4,8.088579E-4,8.193637E-4,47,39,2,209,2,0.009569378
92607766,JusticeLawDev,10,9672,849,1739,36,514,49.0116070107,40-49,720,7,67,138,205,205,67,138,7,2.3347840643,6966.8703102805,0.0966514133,0.0700860832,0.21880782,0,66,2.7286692944812586E-4,4.0742473E-4,4.1271653E-4,47,12,0,201,0,0
92620044,kiranrhines,10,1554,171,189,14,1,35.4144921324,30-39,507,6,21,19,40,40,21,19,7,2.8399732173,25.3869927075,0.0521236312,0.2121794872,0.47064394,0,66,2.316986616379611E-4,1.3181388E-4,1.3352593E-4,140,4,3,200,3,0.015
92651574,RathikaS,10,2167,3936,302,196,2,55.3228400635,50-59,744,6,329,46,375,375,329,46,7,2.5805155675,4902.2142859051,0.3657339425,0.0993226381,0.16977389,0,66,0.0017749359,0.001977208,0.0019725421,390,148,7,200,7,0.035
92674567,rrhondarat,10,462,30,131,0,12,25.602456193,20-29,457,4,0,3,3,3,0,3,7,3.2483266399,0,0,0.1666666667,0.16666667,0,271,4.4780486537007367E-5,0,6.0693606E-6,55,1,0,200,0,0
92783808,ben_burnett,10,547,93,460,6,3,28.3551976905,20-29,469,4,3,3,6,6,3,3,7,3.109139605,0.8030586502,0.0018186443,0.1666666667,0.23333333,0,66,5.0437083015298484E-5,2.396616E-5,2.4277442E-5,47,7,3,199,3,0.0150753769
92834029,Ken_Sanderson,10,4560,438,507,16,18,40.86303541,40-49,677,6,31,31,62,62,31,31,7,2.7191161701,987.4311729708,0.0245082054,0.0544685352,0.23333333,0,66,3.6001585277843276E-4,1.9172928E-4,1.9421954E-4,47,2,0,200,0,0
92854317,marianneWvK,10,9039,588,1133,7,36,42.9181650495,40-49,715,7,0,0,0,0,0,0,0,0,0,0,0,0,81,180,4.4780486537007367E-5,0,0,73,26,0,198,0,0
92864379,Albertaardvark,10,8428,1108,1056,40,119,53.0776175168,50-59,764,7,112,120,232,232,112,120,6,2.4439236692,7317.1486417177,0.0703694895,0.0558105687,0.22250524,0,66,6.034326325784743E-4,6.7704404E-4,6.8583776E-4,372,96,4,200,4,0.02
92937067,healnigeria,10,2376,1031,384,10,5,52.5164512392,50-59,702,5,1,1,2,2,1,1,8,4.5337341349,0,7.645535613750089E-5,0,0,0,505,6.734277591528606E-5,1.198308E-5,1.2138721E-5,55,7,0,201,0,0
93006802,luckhardtjason,10,5714,98,121,0,25,18.7021484552,10-19,625,7,14,13,27,27,14,13,7,2.7559424171,8.418818772,0.022892474,0.2136752137,0.42094862,0,66,8.518037585736659E-5,8.98731E-5,9.104041E-5,47,0,0,200,0,0
93212217,roysmolinski,10,248,67,211,1,74,23.0113596883,20-29,466,3,9,22,31,31,9,22,7,2.6963508537,32.5578124141,0.0092022642,0.1462365591,0.3460145,0,66,6.125186625963274E-5,5.99154E-5,6.069361E-5,47,1,1,198,1,0.0050505051
93649345,_nuotio_,10,3272,1189,2001,40,75,46.1665505751,40-49,668,7,15,34,49,49,15,34,7,2.630063609,439.9127825995,0.0274594211,0.1653911565,0.3820513,0,66,1.194319524528949E-4,9.586464E-5,9.710977E-5,390,5,6,200,6,0.03
93663580,APOVMentarch,10,23193,1203,1632,74,60,37.8472120185,30-39,766,8,80,97,177,177,80,97,7,2.4194844325,3237.944515707,0.1251061289,0.0777157165,0.32721713,0,66,3.274639858401494E-4,4.8531473E-4,4.9161824E-4,47,11,0,200,0,0
93675048,ValLali,10,3155,312,852,4,23,46.2052995878,40-49,623,6,19,49,68,68,19,49,7,2.5949112822,49.6480957578,0.026682823,0.1861281826,0.544898,0,66,1.151248803676207E-4,1.198308E-4,1.2138722E-4,390,6,1,201,1,0.0049751244
93964759,ToulasTake,10,22774,1463,2000,62,293,50.3198799428,50-59,773,8,21,38,59,59,21,38,7,2.5838634081,339.9991810687,0.0441272856,0.1373465809,0.37209302,0,66,1.861294202434326E-4,1.3181388E-4,1.3352593E-4,390,10,0,201,0,0
94020511,dcourtens,10,2937,307,804,4,0,36.0487563383,30-39,530,6,11,36,47,47,11,36,6,2.5356545028,75.2901419677,0.0204641391,0.144773358,0.384127,0,66,8.902377201986122E-5,7.189848E-5,7.283233E-5,390,8,0,200,0,0
94021685,bcbluecon,10,44010,1428,45,63,7,56.2309645415,50-59,844,9,116,8,124,124,116,8,6,2.932038835,282.6414638206,0.0759788029,0.1086414896,0.18845578,0,66,7.482421233865777E-4,7.0101017E-4,7.101152E-4,372,713,1,206,1,0.0048543689
94031113,AbadKhanNS,10,15430,961,1274,31,191,50.8732212916,50-59,769,8,49,78,127,127,49,78,7,2.4466019417,3226.309877181,0.0631178576,0.1001749781,0.3233926,0,66,3.049427045540274E-4,2.99577E-4,2.9739868E-4,390,29,0,200,0,0
94125725,kellypatrickxox,10,11956,393,775,11,51,47.3405552739,40-49,702,7,58,90,148,148,58,90,6,2.3987278206,5251.1782048584,0.0911225198,0.1035116749,0.3017177,0,66,2.7995992720090127E-4,3.5350086E-4,3.5809228E-4,140,59,0,200,0,0
94162094,claysuddaby,10,3494,634,977,21,122,43.2986443914,40-49,662,7,42,43,85,85,42,43,7,2.6344158018,501.2024196109,0.0451956958,0.1295518207,0.2932401,0,66,2.5726586223731313E-4,2.5763622E-4,2.6098252E-4,390,7,0,198,0,0
94165248,chrisc0ttingham,10,1666,12948,12776,86,38,48.6207966209,40-49,740,7,11,11,22,22,11,11,7,2.7080682959,345.9671819766,0.0143318046,0.0649350649,0.24175824,0,66,9.100706218358824E-5,7.189848E-5,7.283233E-5,372,7,0,36,0,0
94229756,Terence_Johnson,10,549,307,118,3,4,38.0321482938,30-39,467,4,1,3,4,4,1,3,7,2.9474389019,0.0494867757,0.0021329317,0.3333333333,0.5,0,66,4.7596287865126745E-5,1.198308E-5,1.2138721E-5,140,0,0,199,0,0
94234643,DCEJennings,10,1785,139,253,0,321,39.0757126296,30-39,619,6,7,16,23,23,7,16,7,2.8791429528,33.4329540129,0.0038553713,0.1640316206,0.43014705,0,66,6.568444299035607E-5,4.793232E-5,4.8554884E-5,140,14,2,197,2,0.0101522843
94352593,GameBreakersCan,10,5238,115,260,1,512,42.8580234936,40-49,577,6,5,19,24,24,5,19,7,2.7408771342,41.7146709709,0.0079590115,0.115942029,0.28947368,0,66,5.408727822725234E-5,3.594924E-5,3.6416164E-5,47,9,0,201,0,0
94451943,Erethizon,10,2853,136,214,0,77,46.3024163381,40-49,687,7,13,14,27,27,13,14,7,2.9306996987,426.9264404309,0.0080627406,0.0270655271,0.1,0,66,1.0635134389692763E-4,8.388156E-5,8.497105E-5,390,17,1,200,1,0.005
94669804,KeenanAylwin,10,981,202,597,2,492,53.590730012,50-59,590,5,15,72,87,87,15,72,7,2.4941412789,410.4164758288,0.0176507017,0.1590483828,0.3108108,0,66,9.84671623754109E-5,9.586464E-5,9.710977E-5,140,17,12,200,12,0.06
94732370,SpecBurns,10,886,237,937,3,3,40.1009818041,40-49,570,5,8,36,44,44,8,36,7,2.5637763642,145.4819322447,0.0131426607,0.1136363636,0.2484127,0,66,7.067307355277904E-5,5.392386E-5,5.4624245E-5,390,0,0,200,0,0
94760350,DonABassey,10,1441,116,396,0,2,26.1113061928,20-29,516,5,0,0,0,0,0,0,0,0,0,0,0,0,105,215,4.4780486537007367E-5,0,0,100,7,0,200,0,0
94900143,NatalieLanovill,10,23772,538,738,30,1490,45.4758589296,40-49,744,8,30,35,65,65,30,35,7,2.6052895882,1051.0918114207,0.0438230604,0.0721153846,0.23975636,0,66,1.5095941481691117E-4,1.8573774E-4,1.8815018E-4,47,51,0,201,0,0
95105815,jess_mccrae,10,39721,247,349,12,1138,44.7367602786,40-49,771,8,19,26,45,45,19,26,7,2.6913290927,1371.1139467704,0.0210550932,0.0994949495,0.26310483,0,66,1.5105326313462876E-4,1.198308E-4,1.2138722E-4,47,69,0,203,0,0
95268418,SocialDows,10,19789,357,416,0,503,44.633177411,40-49,772,8,6,7,13,13,6,7,1,1,0,4.977388905364672E-4,0.1346153846,0.85714287,46,134,1.6498109788469208E-4,4.194078E-5,4.2485524E-5,102,163,0,209,0,0
95462457,stwoball,10,1678,67,71,5,13,42.5169831783,40-49,564,6,4,6,10,10,4,6,7,3.0448610646,0.8958481965,0.003635769,0.2,0.48214287,0,66,6.049550339329925E-5,2.99577E-5,3.0346804E-5,55,4,0,199,0,0
95539607,ottawa_jen,10,2179,156,777,3,22,42.7112371744,40-49,618,6,32,94,126,126,32,94,6,2.4680281219,341.665123342,0.0564250562,0.1845079365,0.38772893,0,66,2.0753548837144524E-4,1.9772082E-4,2.0028891E-4,390,24,5,201,5,0.0248756219
95672811,noleftandright,10,4396,409,571,19,115,42.1716401996,40-49,683,6,33,46,79,79,33,46,7,2.5691329093,720.916456763,0.0405204449,0.1040246673,0.25762713,0,66,1.842472607573073E-4,2.0371236E-4,2.0635827E-4,372,14,1,200,1,0.005
95934473,FrustratdFarmer,10,138,29,20,3,3,20.9477207116,20-29,418,3,3,4,7,7,3,4,7,3.2246401071,0,0.0018711549,0.3571428571,0.9,0,66,5.987115237318379E-5,2.396616E-5,2.4277442E-5,372,1,0,138,0,0
96074076,MatthewLou,10,460,186,320,3,6,32.6956053306,30-39,522,5,6,10,16,16,6,10,7,3.0077000335,165.5282672461,0.0060813241,0.0916666667,0.17948718,0,66,8.11512412993586E-5,4.194078E-5,4.2485524E-5,55,2,0,200,0,0
96502773,Zia68,10,24624,674,2001,7,39,45.5782251206,40-49,679,7,0,1,1,1,0,1,8,4.5542168675,0,0,0,0,0,614,4.4780486537007367E-5,0,6.0693606E-6,47,0,0,201,0,0
96799205,Eastportorganic,10,13182,868,1996,17,270,49.9540921551,40-49,756,8,84,137,221,221,84,137,6,2.2905925678,6333.0780213701,0.1136095577,0.0844714109,0.24846981,0,66,2.9364846838959445E-4,5.092809E-4,5.1589566E-4,47,51,0,200,0,0
96874375,michaelhaack,10,37769,1245,1379,74,216,55.5482342783,50-59,788,9,73,105,178,178,73,105,6,2.3130231001,4643.8651623908,0.0968729902,0.0847775027,0.23041146,0,66,2.999060824120359E-4,4.4337395E-4,4.491327E-4,55,41,0,204,0,0
96889124,SteveDesroches,10,2245,1666,264,88,4,52.8192923687,50-59,724,6,16,3,19,19,16,3,7,3.3053230666,13.6550915604,0.0089130169,0.1081871345,0.15686275,0,66,1.1316185739020715E-4,1.0185618E-4,1.0317913E-4,372,15,0,200,0,0
96909650,meganseason,10,2563,557,666,5,1104,63.7972092185,60-69,686,6,43,0,43,43,43,0,0,0,0,0.0349105338,0.119047619,0.18660022,0,34,2.2038588899398221E-4,2.6362776E-4,0,47,16,1,200,1,0.005
96918349,memaxmarz,10,4787,143,395,6,1231,39.0717695951,30-39,652,6,8,16,24,24,8,16,7,2.7037161031,713.4533907871,0.0094297757,0.1394927536,0.32105264,0,66,9.169192441275386E-5,5.392386E-5,5.4624245E-5,55,1,1,199,1,0.0050251256
97175858,MarleneRivier,10,444,226,111,19,0,56.8464492345,50-59,563,3,30,24,54,54,30,24,7,2.6986943421,73.9181635985,0.0404778128,0.1708595388,0.40650406,0,66,1.390632460358615E-4,1.8573774E-4,1.8815018E-4,390,33,0,200,0,0
97474079,susannakelley,10,4921,972,1003,31,53,48.9026989072,40-49,705,7,88,84,172,172,88,84,6,2.3294275193,6099.5393365754,0.1231257179,0.1008091935,0.26283872,0,66,5.498870638108676E-4,5.332471E-4,5.401731E-4,140,34,0,200,0,0
97782957,CanadianOwl92,10,1331,28,88,0,18,29.8203950883,20-29,582,5,3,8,11,11,3,8,7,2.9169735521,0.4923180479,0.0064569558,0.3181818182,0.62222224,0,66,5.884376685910263E-5,2.396616E-5,2.4277442E-5,140,1,0,200,0,0
97820008,TaleFinn,10,6160,994,1714,7,1625,44.3582455127,40-49,618,7,70,113,183,183,70,113,6,2.3003013057,868.1025161422,0.0992858796,0.090674353,0.353973,0,66,2.0758118389505682E-4,4.2539934E-4,4.309246E-4,47,8,0,205,0,0
97839765,Northern_Clips,10,45035,1337,21,111,548,50.4797532689,50-59,755,9,26,2,28,28,26,2,7,3.2152661533,76.2481336297,0.0341831516,0.1164021164,0.2008547,0,66,1.909254307461222E-4,1.6177158E-4,1.5780337E-4,47,8,0,202,0,0
97931967,DelroyDyer,10,4478,921,1993,22,14,43.7275296334,40-49,674,6,37,102,139,139,37,102,6,2.3913625711,4931.5664087787,0.0463930137,0.1142737984,0.27843413,0,66,2.1257532448591427E-4,2.2767852E-4,2.306357E-4,372,8,1,200,1,0.005
98162037,sweetmonst3r,10,17360,643,1237,8,256,43.3418119252,40-49,729,8,1,1,2,2,1,1,1,1,0,7.49471721243357E-5,0,0,166,320,2.9852402567743944E-4,1.198308E-5,1.2138721E-5,175,10,0,200,0,0
98248395,PaigeKezima,10,6821,622,593,13,67,51.2943840151,50-59,741,7,96,78,174,174,96,78,7,2.4275192501,4647.9012694226,0.1051310297,0.0858746927,0.20822078,0,66,3.984687624553292E-4,5.811794E-4,5.88728E-4,390,181,0,200,0,0
98314052,MakeEmSay_Oww,10,37037,536,378,1,49,33.5787166801,30-39,774,8,2,2,4,4,2,2,1,1,0,1.529712617250445E-4,0.0833333333,1,181,343,2.985240256774393E-4,1.797462E-5,1.8208082E-5,296,4,0,200,0,0
98471835,foxdickerson,10,8118,550,496,18,60,47.9234072575,40-49,705,7,129,85,214,214,129,85,7,2.5651155005,2239.7860674591,0.1671200414,0.1195208635,0.34137428,0,66,6.717322982813822E-4,7.7890017E-4,7.890169E-4,390,102,2,201,2,0.0099502488
98507630,mrperki,10,1802,70,191,0,337,32.0326042556,30-39,599,5,1,2,3,3,1,2,7,3.2618011383,1.068736466,1.4037255243147518E-4,0,0,0,66,4.956356489926546E-5,1.198308E-5,1.2138721E-5,55,3,0,200,0,0
99116591,WindsorFellow,10,5203,2959,258,8,399,45.6503401656,40-49,704,7,0,0,0,0,0,0,0,0,0,0,0,0,230,449,4.4780486537007367E-5,0,0,226,2,0,200,0,0
99491292,AmZo89,10,296,199,257,0,11,31.2608280352,30-39,568,4,0,0,0,0,0,0,0,0,0,0,0,0,387,704,4.4780486537007367E-5,0,0,398,6,0,198,0,0
99802405,Dan_ONeail,10,10788,518,778,20,58,48.0067359405,40-49,737,7,80,68,148,148,80,68,6,2.3521928356,2689.7042039841,0.1101409378,0.1125666483,0.2882883,0,66,2.84752318778341E-4,4.8531473E-4,4.9161824E-4,47,15,2,200,2,0.01
99856389,KatyaMoussatova,10,329,162,327,1,38,36.1828361826,30-39,451,4,10,12,22,22,10,12,7,2.8798125209,72.0146180837,0.0082168511,0.0909090909,0.33516484,0,66,7.860676478847484E-5,6.590694E-5,6.6762965E-5,372,7,1,194,1,0.0051546392
99879869,KelseyCMS,10,2795,116,189,4,12,36.7498561089,30-39,647,6,0,2,2,2,0,2,7,3.1204819277,0,0,0.5,0.5,0,623,4.4780486537007367E-5,0,6.0693606E-6,390,0,0,199,0,0
100033160,NewWestBC,10,22146,5025,5527,126,0,44.2758857475,40-49,681,9,25,48,73,73,25,48,6,2.807499163,4475.2432766607,0.0299988586,0.1023592085,0.18181819,0,66,1.9317019153022839E-4,1.5578004E-4,1.5780337E-4,372,2,0,201,0,0
100078080,Daniivm,10,4042,142,199,1,22,31.3938335919,30-39,633,6,0,3,3,3,0,3,7,3.0605756359,0,0,0.3333333333,0.33333334,0,588,4.4780486537007367E-5,0,6.0693606E-6,47,4,0,194,0,0
100235515,rbatherson,10,6121,1647,2001,36,8,50.8475497556,50-59,736,7,42,79,121,121,42,79,6,2.4211583529,2653.2561195994,0.0530086645,0.1129476584,0.34409064,0,66,3.9572248221882655E-4,2.5763622E-4,2.6098252E-4,140,27,0,201,0,0
100300239,JonWiseman,10,23564,430,327,2,307,56.8678703194,50-59,763,8,3,7,10,10,3,7,7,2.9625041848,7.8230838928,0.0017918886,0.1888888889,0.4642857,0,66,5.1198429434679196E-5,2.396616E-5,2.4277442E-5,140,10,0,201,0,0
100531055,knoxkp,10,15742,2125,2033,111,20,57.8886987338,50-59,765,7,90,115,205,205,90,115,6,2.2815533981,14059.8744133745,0.1185313925,0.0529411765,0.25437972,0,66,3.355503754301182E-4,5.452301E-4,5.5231183E-4,47,44,0,202,0,0
100597465,CometsMum,10,35758,910,175,50,56,44.4141929396,40-49,780,8,228,28,256,256,228,28,7,2.515567459,927.0539188771,0.2578842756,0.1261029412,0.2175029,0,66,6.53445375742204E-4,0.0013720626,0.0013838143,47,135,1,202,1,0.004950495
100689906,Chan_ing,10,12740,189,141,8,1,44.813418309,40-49,739,8,6,11,17,17,6,11,7,2.989621694,26.1332920014,0.0087198316,0.1654411765,0.45054945,0,66,8.695176381149584E-5,4.194078E-5,4.2485524E-5,140,5,0,202,0,0
100893562,5gatos,10,10094,392,945,9,400,46.2939882981,40-49,721,7,15,53,68,68,15,53,6,2.4797455641,1981.7288124326,0.0148443155,0.1189640035,0.26936027,0,66,1.2293877534008804E-4,9.586464E-5,9.710977E-5,372,10,0,200,0,0
101146132,LegionJJ,10,111239,26718,283,298,529,65.6508760638,60-69,965,10,12,1,13,13,12,1,1,1,3.6550445159,0.0051966405,0.0897435897,0.12878788,0,28,8.849326779477698E-4,7.789002E-5,6.6762965E-5,47,33,0,201,0,0
101309108,Vade_maaR,10,10108,644,323,33,85,47.5115558699,40-49,749,7,0,0,0,0,0,0,0,0,0,0,0,0,338,611,4.4780486537007367E-5,0,0,346,0,0,200,0,0
101646864,RicMahoney,10,760,889,639,24,6,44.1695794623,40-49,615,5,73,51,124,124,73,51,6,2.5600937395,502.9971620016,0.1568262158,0.1509965906,0.37542897,0,66,8.249282512681006E-4,4.4337395E-4,4.491327E-4,140,5,0,199,0,0
101918538,ennovis,10,1404,161,302,1,0,40.2681767886,40-49,594,4,0,0,0,0,0,0,0,0,0,0,0,0,226,442,4.4780486537007367E-5,0,0,221,26,0,200,0,0
102119892,jamesaaronsnow,10,17122,388,510,14,0,45.9463637823,40-49,712,7,0,0,0,0,0,0,0,0,0,0,0,0,31,105,4.4780486537007367E-5,0,0,24,2,0,203,0,0
102282810,PopeShakey,10,57346,1904,2041,98,3254,56.3723473427,50-59,842,9,174,187,361,361,174,187,6,2.2303314362,18910.0612417747,0.2338086888,0.0731917513,0.2125447,0,66,6.423458432185658E-4,0.0010485195,0.0010621381,47,170,0,208,0,0
102570249,michaeltbutler,10,11201,511,1773,14,168,48.039535538,40-49,681,8,28,131,159,159,28,131,6,2.2905925678,4652.3044908631,0.037962775,0.1132075472,0.23033772,0,66,1.4990822382742112E-4,1.7375466E-4,1.7601145E-4,372,7,0,199,0,0
102716123,SLangeneggerCBC,10,10772,2706,753,105,4,62.5345799688,60-69,771,8,96,49,145,145,96,49,7,2.5530632742,4561.8551574302,0.1067996513,0.0858237548,0.1884058,0,66,6.754058163234933E-4,5.811794E-4,5.826586E-4,390,186,51,201,51,0.2537313433
102867308,GeorgeNDP,10,700,590,624,10,15,47.3003158369,40-49,622,5,172,154,326,326,172,154,6,2.3535319719,5374.7520902792,0.2270209826,0.1017461067,0.28968623,0,66,0.0010437904,0.0010365364,0.0010439301,390,40,10,200,10,0.05
102927420,ZachDeRitis,10,6192,274,475,1,74,37.2814026847,30-39,650,6,0,0,0,0,0,0,0,0,0,0,0,0,122,239,4.4780486537007367E-5,0,0,118,6,0,199,0,0
103413969,justcaty,10,30842,393,401,9,18,38.2413968686,30-39,742,8,1,1,2,2,1,1,1,1,0,7.49471721243357E-5,0,0,348,635,2.9852402567743944E-4,1.198308E-5,1.2138721E-5,357,12,0,200,0,0
103594620,uswjamie,10,607,119,170,2,25,24.688176552,20-29,493,4,8,17,25,25,8,17,7,2.8182122531,13.2820498087,0.0134311346,0.1583333333,0.5294118,0,66,8.581151004047627E-5,5.392386E-5,5.4624245E-5,390,0,1,200,1,0.005
103735808,curtismarta,10,758,108,529,0,35,25.7523898908,20-29,523,4,2,14,16,16,2,14,7,2.8068295949,3.1682142444,0.0035743675,0.2583333333,0.44761905,0,66,5.0401915707389886E-5,1.797462E-5,1.8208082E-5,390,4,1,199,1,0.0050251256
103772503,brucehyer,10,525,1642,129,141,4,48.4516596333,40-49,700,3,196,32,228,228,196,32,7,2.6478071644,1770.3835508826,0.2612029632,0.1265940181,0.21798183,0,66,0.00105311,0.0011803333,0.0011895947,390,62,6,200,6,0.03
103950335,officialtellem_,10,11638,498,475,1,177,55.3457853135,50-59,726,8,2,2,4,4,2,2,2,1.3333333333,0,1.560489793243037E-4,0.0833333333,1,168,322,2.4453587828285984E-4,1.797462E-5,1.8208082E-5,163,30,0,203,0,0
104476989,frgetit,10,2253,196,553,2,7,43.9779808325,40-49,630,6,52,121,173,173,52,121,6,2.30231001,3186.2483434459,0.0762633354,0.0910740691,0.23033772,0,66,1.8024373889948933E-4,3.175516E-4,3.216761E-4,47,19,9,203,9,0.0443349754
104531604,Jpudoba,10,1337,364,1993,1,137,25.7502441067,20-29,482,5,0,2,2,2,0,2,8,3.5399799264,0,0,0,0,0,607,4.4780486537007367E-5,0,6.0693606E-6,55,3,0,200,0,0
104595491,sheilagervais,10,3595,702,594,26,1,47.9668180303,40-49,688,6,125,120,245,245,125,120,6,2.3454971543,3438.2735944715,0.197941388,0.0965205754,0.29212454,0,66,7.427730302668306E-4,7.5493404E-4,7.6473947E-4,140,82,6,200,6,0.03
104644390,codyincalgary,10,11812,6149,4841,97,1618,72.4287142569,70-79,786,8,167,182,349,349,167,182,6,2.3408101774,70514.5048160121,0.1146895766,0.0262325857,0.12785213,0,66,0.0010065817,0.0010065787,0.0010196526,372,275,0,201,0,0
104811358,LorelMarketing,10,4919,2000,1751,43,0,44.9959969465,40-49,664,6,1,1,2,2,1,1,2,1.5,0,7.49471721243357E-5,0,0,0,528,9.990168110805797E-5,1.198308E-5,1.2138721E-5,320,7,0,200,0,0
105208870,phpndp,10,2766,439,426,12,1,48.1632634886,40-49,661,6,76,56,132,132,76,56,7,2.6618680951,1541.3640694439,0.0756055566,0.1513994911,0.30460367,0,66,3.2336526554269546E-4,4.6134857E-4,4.612714E-4,390,95,4,212,4,0.0188679245
105306151,SusanGapka,10,15851,1794,1022,104,26,53.9655217683,50-59,736,8,100,84,184,184,100,84,6,2.4469367258,5839.7114830922,0.12808147,0.1220598717,0.26480868,0,66,4.991153044463998E-4,6.051455E-4,6.0693605E-4,390,42,2,200,2,0.01
105358446,Heer_preet,10,928,99,199,0,10,21.8368517848,20-29,460,5,4,7,11,11,4,7,7,2.9527954469,6.425747164,0.0030760012,0.0636363636,0.30952382,0,66,5.60834955445222E-5,2.99577E-5,3.0346804E-5,47,1,0,199,0,0
105391738,ppilarski,10,12917,1425,1131,36,5,50.0609394808,50-59,779,8,72,57,129,129,72,57,6,2.5661198527,2552.5649279559,0.0505364392,0.0749757752,0.24124566,0,66,4.920528901957132E-4,4.373824E-4,4.4306333E-4,372,63,1,200,1,0.005
105485447,habbe79,10,8362,197,507,0,58,27.55799542,20-29,622,7,5,15,20,20,5,15,7,2.6986943421,44.2531770572,0.0069421945,0.1263157895,0.31904763,0,66,5.3770945474676254E-5,3.594924E-5,3.6416164E-5,47,1,0,197,0,0
105785852,Jnaveg,10,11359,231,322,1,14,41.8885306336,40-49,716,7,1,3,4,4,1,3,9,4.6069635085,0,1.1057485856814353E-4,0.1666666667,0.33333334,0,66,6.79464955354548E-5,1.198308E-5,1.2138721E-5,320,5,0,200,0,0
105832299,TBoog06,10,473,99,470,2,28,27.6624142406,20-29,483,4,3,12,15,15,3,12,7,2.7951121527,3.1373314823,0.0057132743,0.280952381,0.510989,0,66,6.0621492879642734E-5,2.396616E-5,2.4277442E-5,140,0,0,198,0,0
105907906,vdufourNPD,10,3297,1559,882,50,10,48.950521979,40-49,673,6,84,87,171,171,84,87,6,2.4392366923,559.1249446907,0.1310980316,0.1762985896,0.42680565,0,66,6.323639478418453E-4,5.092809E-4,5.1589566E-4,390,25,7,200,7,0.035
105911241,goingprorogue,10,4093,929,2001,39,77,51.0575025049,50-59,691,7,202,407,609,609,202,407,6,2.0555741547,51499.5891470491,0.2342104303,0.0474191945,0.1398293,0,66,6.293511293830657E-4,0.0012162826,0.0012260108,47,80,0,242,0,0
106285121,Belgraves,10,16316,534,539,17,551,53.7103242453,50-59,763,8,146,123,269,269,146,123,6,2.322731838,3833.476488744,0.1996555329,0.0896077235,0.29847476,0,66,3.945845118472419E-4,8.8075636E-4,8.92196E-4,47,131,0,213,0,0
106790430,__CCE,10,17819,1230,1796,28,34,51.2347292153,50-59,732,8,66,90,156,156,66,90,6,2.4238366254,2889.4932718495,0.0871108409,0.1076509512,0.27048334,0,66,3.1690602636329825E-4,4.0143318E-4,4.0664716E-4,140,28,0,205,0,0
107120252,LinCee3,10,1705,136,211,1,14,40.5623498858,40-49,596,6,0,2,2,2,0,2,7,3.1147925033,0,0,0.5,0.5,0,622,4.4780486537007367E-5,0,6.0693606E-6,390,1,0,198,0,0
107236815,ocyl_jloc,10,910,631,361,24,0,40.5029899298,40-49,616,5,87,58,145,145,87,58,7,2.7020421828,780.756041444,0.0955654353,0.1284482759,0.32883352,0,66,3.9882050061647897E-4,5.272555E-4,5.341037E-4,140,8,1,198,1,0.0050505051
107296416,amanda0852,10,12351,945,1951,60,749,44.7672052417,40-49,681,8,41,81,122,122,41,81,7,2.3719450954,2553.7079259067,0.0515216478,0.0724834033,0.24507788,0,66,1.5762998131062827E-4,2.5164467E-4,2.5491315E-4,47,1,0,198,0,0
107312325,Myhasle,10,18326,652,856,19,2076,40.1406351451,40-49,747,8,140,197,337,337,140,197,6,2.1868095079,11914.0416481185,0.1788381543,0.058455207,0.24072215,0,66,3.981525291811039E-4,8.4480713E-4,8.5577986E-4,47,98,1,200,1,0.005
107516300,mtlunasea,10,6038,1200,1542,45,1294,46.7813777577,40-49,761,8,12,17,29,29,12,17,7,2.9152996317,94.981772569,0.0090887529,0.0935960591,0.45424837,0,66,1.1257868643882019E-4,7.789002E-5,7.8901685E-5,47,4,0,200,0,0
107534282,anti_rogue,10,3220,306,258,10,11,46.4085411966,40-49,664,6,53,33,86,86,53,33,6,2.5162370271,245.9759982696,0.0763756446,0.179753762,0.3342447,0,66,1.7628261406198777E-4,3.2354315E-4,3.2774548E-4,47,25,1,200,1,0.005
107794362,RunnertheFirst,10,19386,828,467,23,2,48.1379640052,40-49,755,8,64,93,157,157,64,93,6,2.4499497824,5592.5208478596,0.0925641659,0.0785562633,0.28079194,0,66,4.089068123913106E-4,3.8945008E-4,3.9450845E-4,372,137,0,204,0,0
107886768,barb_hill,10,34196,588,906,22,3310,45.4159966092,40-49,768,9,66,72,138,138,66,72,7,2.442584533,2150.5573904209,0.1081847217,0.0951549773,0.34561127,0,66,2.525843419178017E-4,4.0143318E-4,4.0664716E-4,47,51,0,202,0,0
108743813,Monctonsnowman,10,26789,1066,1404,41,100,48.3847955892,40-49,782,9,168,218,386,386,168,218,6,2.1473049883,19978.9524628372,0.2254550511,0.0600834399,0.23319386,0,66,5.426126893213662E-4,0.0010125702,0.0010257219,47,96,11,217,10,0.0506912442
108909795,LM_Campbell,10,2463,390,378,36,20,49.3558280243,40-49,672,6,17,16,33,33,17,16,7,2.8871777703,357.3904752987,0.0116078839,0.1022727273,0.50292397,0,66,1.615643440336059E-4,1.0784772E-4,1.0924849E-4,55,37,0,199,0,0
109065918,QMInews,10,11320,2371,387,106,3,57.775777474,50-59,770,7,63,14,77,77,63,14,7,2.9256779377,1503.030883885,0.0612872321,0.0933014354,0.14876385,0,66,4.880584992996704E-4,3.8345857E-4,3.8843908E-4,372,24,0,200,0,0
109299182,jhodson79,10,5710,627,665,22,55,49.6258731547,40-49,677,7,9,20,29,29,9,20,7,2.6652159357,3208.5993705424,0.0108142232,0.118226601,0.33333334,0,66,7.006067560199914E-5,5.99154E-5,6.069361E-5,47,10,0,201,0,0
109608296,Beverly_Akerman,10,13704,1899,1679,98,422,66.0960928161,60-69,751,8,27,45,72,72,27,45,6,2.4599933043,119.3405978156,0.0526142676,0.1394757433,0.42117646,0,66,1.3320588166374482E-4,1.6776312E-4,1.699421E-4,140,12,0,200,0,0
109749152,THShorn92,10,646,146,286,0,165,33.9859282695,30-39,565,4,0,0,0,0,0,0,0,0,0,0,0,0,279,526,4.4780486537007367E-5,0,0,276,0,0,199,0,0
109926974,canadianeast,10,72054,511,427,54,46,41.5452999121,40-49,721,9,9,11,20,20,9,11,7,2.8453297623,74.7212813294,0.0180904001,0.1157894737,0.27916667,0,66,8.081571878142604E-5,5.99154E-5,6.069361E-5,47,10,0,201,0,0
110099532,hsmelday,10,96,173,1132,0,34,21.7876623334,20-29,330,4,12,104,116,116,12,104,6,2.3665885504,297.9939143951,0.0159662379,0.2122188906,0.38545558,0,66,7.905197523437141E-5,7.789002E-5,7.8901685E-5,390,2,0,104,0,0
110587321,NMSUWSP,10,11553,413,544,18,403,46.4105927857,40-49,587,8,1,1,2,2,1,1,8,3.406427854,0,0.0021342629,0.5,1,0,66,4.884407411694686E-5,1.198308E-5,1.2138721E-5,47,0,0,201,0,0
111088978,SpaTimeEdmonton,10,69,38,229,2,0,37.4310141073,30-39,409,4,1,3,4,4,1,3,7,3.2962838969,0,8.01519626856622E-5,0.1666666667,0.5,0,66,5.5813821265702704E-5,1.198308E-5,1.2138721E-5,372,15,0,119,0,0
111096950,MichaelSona,10,1873,538,629,15,0,57.3102862285,50-59,706,6,122,112,234,234,122,112,6,2.390693003,9386.7809675063,0.1557592197,0.0795458714,0.19787607,0,66,7.129448869251915E-4,7.369594E-4,7.40462E-4,372,84,4,199,4,0.0201005025
111120328,pautefacil,10,345,614,477,10,3,37.3822406806,30-39,585,3,0,0,0,0,0,0,0,0,0,0,0,0,172,328,4.4780486537007367E-5,0,0,166,4,0,200,0,0
111127530,JakeAReid,10,11534,1162,1098,36,7,57.4073868645,50-59,757,7,57,90,147,147,57,90,6,2.3451623703,3352.7850156825,0.087065515,0.0857329233,0.29209623,0,66,3.17700737438791E-4,3.475093E-4,3.520229E-4,140,44,0,201,0,0
111146102,novosada,10,4011,271,625,1,5,31.7528712235,30-39,604,6,3,18,21,21,3,18,7,2.6883160362,9.4703995179,0.0079245338,0.2333333333,0.5,0,66,5.504239042477541E-5,2.396616E-5,2.4277442E-5,140,9,0,199,0,0
111624312,hill_chris,10,1456,169,467,1,5,49.0680221491,40-49,594,5,1,9,10,10,1,9,7,2.9939738868,0.4807258613,6.110270894785525E-4,0.2777777778,0.5694444,0,66,4.760600506570529E-5,1.198308E-5,1.2138721E-5,140,0,0,200,0,0
111715724,lawrencecanuck,10,8466,126,1081,0,4,25.2693703672,20-29,526,7,5,31,36,36,5,31,6,2.6163374623,352.619094988,0.0084415212,0.1984126984,0.35227272,0,66,6.955298766005884E-5,3.594924E-5,3.6416164E-5,140,1,0,201,0,0
112119151,jlhumblet,10,6365,255,308,17,12,47.7202348102,40-49,622,7,0,2,2,2,0,2,3,2,0,0,0.5,1,0,262,4.4780486537007367E-5,0,6.0693606E-6,320,1,0,200,0,0
112327585,lifeinanorthern,10,3950,111,333,0,35,38.4560407897,30-39,535,6,62,178,240,240,62,178,7,2.2952795447,1673.7800438666,0.0915542425,0.1271617852,0.3305417,0,66,1.9104581206686762E-4,3.7746702E-4,3.8236973E-4,47,0,5,198,5,0.0252525253
112372171,timothy_chu,10,4545,582,374,26,1,48.0594044398,40-49,703,6,65,47,112,112,65,47,6,2.6002678273,1260.7283142949,0.0789027498,0.1065797941,0.29539296,0,66,2.944098286149595E-4,3.9544163E-4,4.0057782E-4,390,32,1,200,1,0.005
112755355,_capps,10,3595,193,242,6,204,45.1329220047,40-49,654,6,20,28,48,48,20,28,7,2.6327418815,546.5906926648,0.038985726,0.1759751773,0.45021337,0,66,1.5913156934990153E-4,1.2582233E-4,1.2745657E-4,140,53,5,200,5,0.025
112944623,albertarabbit,10,6336,342,385,11,9,46.8720698847,40-49,785,9,140,127,267,267,140,127,6,2.3059926348,5168.3859241195,0.1944089559,0.0812565121,0.2941215,0,66,4.139569470498108E-4,8.4480713E-4,8.5577986E-4,47,517,1,206,1,0.0048543689
113208652,VanBoders,10,4962,512,624,30,10,47.8517509841,40-49,711,7,23,70,93,93,23,70,7,2.4840977569,538.3452977649,0.0281800296,0.1182795699,0.25385964,0,66,1.4112013191297818E-4,1.4379696E-4,1.4566466E-4,47,11,0,200,0,0
113243765,chrisjmcclure,10,11254,738,739,35,26,50.8786239674,50-59,729,7,42,61,103,103,42,61,6,2.3769668564,1447.9123811427,0.0544334845,0.0632971635,0.28469944,0,66,2.0379000558218003E-4,2.5763622E-4,2.6098252E-4,372,24,0,206,0,0
113387174,abtthecause,10,5561,1519,1972,62,1,59.4322491057,50-59,674,7,20,49,69,69,20,49,6,2.3913625711,333.8003014274,0.0411720559,0.1359761296,0.40367347,0,66,1.2315710091380033E-4,1.2582233E-4,1.2745657E-4,140,8,1,199,1,0.0050251256
113690283,LaBergman_,10,53920,1621,703,45,5528,46.1376015781,40-49,810,9,3,3,6,6,3,3,2,1.4,12,2.310109877994733E-4,0.0333333333,0.33333334,60,152,4.205976348642071E-4,2.396616E-5,2.4277442E-5,53,32,0,201,0,0
114595836,LuckyJaxson,10,153,55,91,1,2,21.0202724751,20-29,307,3,8,8,16,16,8,8,7,2.989621694,1.2775229403,0.0063322147,0.3125,0.53809524,0,66,6.245087378797679E-5,5.392386E-5,5.4624245E-5,390,1,1,164,1,0.006097561
115034238,PeggyMacKinnon,10,3333,640,1096,24,122,48.4310542396,40-49,674,6,16,21,37,37,16,21,7,2.8051556746,4665.9464484455,0.0090338001,0.0518018018,0.22727273,0,66,1.3450888221662512E-4,1.0185618E-4,1.0317913E-4,140,17,0,202,0,0
115491361,patriciapresti,10,4147,348,833,17,105,41.1601996141,40-49,604,6,7,5,12,12,7,5,7,3.1750920656,2297.8242729492,0.0062224232,0.0833333333,0.30357143,0,66,1.0576167137317363E-4,4.793232E-5,4.8554884E-5,372,3,0,200,0,0
115663035,uwemspeaks,10,24735,565,339,4,14,57.3437679116,50-59,753,8,0,0,0,0,0,0,0,0,0,0,0,0,229,448,4.4780486537007367E-5,0,0,225,13,0,201,0,0
115797743,ArtisteNow,10,5577,165,1075,0,1,40.1978473108,40-49,559,6,3,23,26,26,3,23,7,2.864412454,51.9331428141,0.0020868966,0.0923076923,0.18774703,0,66,5.646948725713735E-5,2.396616E-5,2.4277442E-5,47,2,0,201,0,0
115886031,2010redmittens,10,2646,251,364,5,97,33.0799685055,30-39,647,6,86,108,194,194,86,108,6,2.3096752595,6365.7881797118,0.107792197,0.0808984563,0.32542017,0,66,2.3005049733743242E-4,5.21264E-4,5.280344E-4,47,11,0,199,0,0
116228737,MurrayDBcom,10,163,36,151,1,24,15.8666134137,10-19,246,3,1,2,3,3,1,2,8,3.7756946769,1.6816440265,1.329670594014518E-4,0,0,0,66,5.653769893325286E-5,1.198308E-5,1.2138721E-5,372,0,0,161,0,0
116282012,LawyerToronto,10,1042,445,300,17,3,52.7665546222,50-59,639,4,8,7,15,15,8,7,7,3.1469702042,43.0676824715,0.0032446849,0.0619047619,0.13636364,0,66,6.778323348232385E-5,5.392386E-5,5.4624245E-5,140,7,0,200,0,0
116294029,johncolincraig,10,1364,416,1045,13,65,47.8841618595,40-49,601,6,7,29,36,36,7,29,6,2.614328758,45.6764140916,0.0226794421,0.2325396825,0.6009852,0,66,8.961194459539177E-5,4.793232E-5,4.8554884E-5,372,1,0,200,0,0
116476946,JamesatLFPress,10,6340,1532,241,76,19,49.3800088743,40-49,706,7,7,2,9,9,7,2,7,3.5018413124,45.6905248737,0.0081883323,0.1805555556,0.47619048,0,66,1.0952355637538767E-4,4.793232E-5,4.8554884E-5,140,6,1,200,1,0.005
116667710,eltaria,10,6729,67,59,6,6,23.4520760882,20-29,610,5,3,3,6,6,3,3,7,3.0719785738,6.5720604847,0.0024042643,0.0666666667,0.25,0,66,5.401149005111516E-5,2.396616E-5,2.4277442E-5,55,0,0,200,0,0
116841782,1000daysoframen,10,24486,1563,1537,43,1143,57.4523262292,50-59,766,8,9,12,21,21,9,12,7,3.0940743221,260.1594840914,0.0024147464,0.0357142857,0.1969697,0,66,1.084889248416545E-4,5.99154E-5,6.069361E-5,47,35,0,201,0,0
117247943,jafroese,10,58,9,25,0,2,16.7576971628,10-19,100,2,0,0,0,0,0,0,0,0,0,0,0,0,151,303,4.4780486537007367E-5,0,0,148,5,0,61,0,0
117482770,johnluton,10,1140,161,113,4,3,40.8193096627,40-49,543,4,7,5,12,12,7,5,8,3.3675929026,6.2903488211,0.0028362718,0.196969697,0.3090909,0,66,7.166100728945432E-5,4.793232E-5,4.8554884E-5,55,5,2,200,2,0.01
118484087,Maxim_Brock_U,10,712,107,189,7,1,30.1963611331,30-39,437,4,2,5,7,7,2,5,7,2.8235687981,0,0.0046891127,0.2380952381,0.8,0,66,4.923690682129442E-5,1.797462E-5,1.8208082E-5,47,2,0,200,0,0
118743846,CTV_PowerPlay,10,6580,6485,624,308,3,60.6423430689,60-69,766,7,445,104,549,549,445,104,6,2.4214931369,12366.2116366352,0.4909662898,0.0651649316,0.120352894,0,66,0.0030807459,0.0026722269,0.002676588,372,265,2,200,2,0.01
119149614,curiousceramics,10,2954,154,372,8,3,50.4943252142,50-59,598,6,25,65,90,90,25,65,7,2.5075326414,408.3420284795,0.0411623245,0.1877652934,0.46190476,0,66,1.8439811566571383E-4,1.5578004E-4,1.5780337E-4,390,6,1,199,1,0.0050251256
119220499,sabinechidiac,10,2248,248,613,3,5,47.2657618024,40-49,623,6,20,33,53,53,20,33,6,2.8275862069,200.0230480119,0.012686757,0.1139332366,0.3213213,0,66,1.1211862958865434E-4,1.2582233E-4,1.2745657E-4,372,9,2,200,2,0.01
119711865,dexterchaos,10,2503,185,441,2,796,47.4612988274,40-49,651,6,55,129,184,184,55,129,6,2.2979578172,829.3581387168,0.0796967619,0.1137146591,0.34394753,0,66,1.582919237356544E-4,3.3552625E-4,3.398842E-4,47,21,1,201,1,0.0049751244
119769483,aka_Pooch,10,392,167,351,7,21,40.3009863664,40-49,630,6,38,47,85,85,38,47,7,2.6960160696,776.0612054929,0.0354902566,0.1098039216,0.32759562,0,66,1.9900205172584083E-4,2.3367006E-4,2.3670506E-4,372,7,0,200,0,0
119827702,Dleebosh,10,6213,628,1106,15,3,54.7018320864,50-59,749,7,144,222,366,366,144,222,6,2.2376966856,9148.3952814719,0.2030772359,0.0800209597,0.2324644,0,66,8.154201928550136E-4,8.687733E-4,8.800573E-4,390,150,0,201,0,0
120482978,jdeq,10,5009,406,576,14,16,55.9010803203,50-59,685,7,15,21,36,36,15,21,7,2.7884164714,3300.8240771462,0.0099626072,0.0682539683,0.2228261,0,66,1.521035511104695E-4,9.586464E-5,9.104041E-5,390,16,1,199,1,0.0050251256
120919393,Badger_Janzen,10,1911,134,174,1,124,49.2586712102,40-49,689,6,48,56,104,104,48,56,7,2.5225979243,1197.0006308475,0.0587998399,0.0669342793,0.20931143,0,66,1.7341810786321855E-4,2.9358547E-4,2.9739868E-4,47,105,0,200,0,0
121291378,smithlkk,10,4817,97,427,0,448,39.7499681812,30-39,573,7,4,15,19,19,4,15,7,2.7073987278,34.2897680231,0.0096564375,0.134502924,0.30476192,0,66,5.556670175316308E-5,2.99577E-5,3.0346804E-5,47,2,0,197,0,0
121651119,pavlosky4,10,24379,934,1033,7,664,52.350402209,50-59,778,8,3,5,8,8,3,5,11,6.5925677938,5551.2499999999,2.4258233070653678E-4,0.0178571429,0.05,0,66,2.1360904807522066E-4,2.396616E-5,2.4277442E-5,320,15,0,198,0,0
121742777,tadlouni,10,1000,267,358,8,22,43.3210020993,40-49,606,5,27,45,72,72,27,45,7,2.7489119518,665.3765789552,0.0206120949,0.1349765258,0.3714178,0,66,1.6404333321469775E-4,1.6776312E-4,1.699421E-4,140,23,0,198,0,0
121785205,RonnieNDP,10,1953,149,374,4,451,44.0573048505,40-49,600,6,35,67,102,102,35,67,7,2.5764981587,526.5605743861,0.042818465,0.1506503592,0.29973552,0,66,1.3044458560397039E-4,2.1569544E-4,2.1849698E-4,390,42,1,200,1,0.005
121853848,KikkiPlanet,10,88423,9210,8165,301,8611,63.9543795024,60-69,925,10,182,227,409,409,182,227,6,2.1901573485,70208.1036828761,0.1308036811,0.0261577736,0.098289385,0,66,8.118772121107116E-4,0.0010964518,0.001110693,372,644,0,207,0,0
122053347,JustplainCarrie,10,26519,758,840,28,10,50.3182707675,50-59,778,9,158,188,346,346,158,188,7,2.2266488115,9587.1962469945,0.2176781176,0.0673536064,0.22138153,0,66,5.02441504339096E-4,9.5265487E-4,9.6502836E-4,47,74,1,201,1,0.0049751244
122067786,WestSideTory,10,4255,473,467,21,77,37.5898263523,30-39,648,6,26,28,54,54,26,28,7,2.8717777034,603.6264484023,0.0197162926,0.1198462614,0.2513843,0,66,1.584739300973663E-4,1.6177158E-4,1.6387274E-4,372,3,10,200,10,0.05
122176481,JuiceGniposky,10,1712,354,349,4,1,42.7905884862,40-49,655,6,94,72,166,166,94,72,7,2.6722464011,1057.4181830978,0.1078222695,0.0954362906,0.36785713,0,66,4.5813500077686125E-4,5.691963E-4,5.7658926E-4,390,37,1,200,1,0.005
122422343,DavidPatersonca,10,4024,160,106,5,26,45.881825754,40-49,720,7,72,36,108,108,72,36,7,2.53130231,309.180233331,0.0970636152,0.1443406023,0.33333334,0,66,2.0304183454784074E-4,4.373824E-4,4.4306333E-4,47,145,0,207,0,0
122780332,brodiesovereign,10,4533,878,2001,18,17,46.6613686126,40-49,680,7,20,53,73,73,20,53,7,2.6006026113,443.3780621438,0.0251363644,0.1095890411,0.28451177,0,66,1.3847494662369247E-4,1.2582233E-4,1.2745657E-4,55,5,0,200,0,0
122961376,GladstoneCFRE,10,4018,512,646,27,12,59.0081553492,50-59,638,7,46,57,103,103,46,57,7,2.6096417811,273.6721242357,0.065407368,0.1503902532,0.418018,0,66,2.877995864791577E-4,2.8160238E-4,2.8525994E-4,140,24,9,199,7,0.0452261307
123035624,WaffleWolfer,10,1446,22,23,2,31,24.7533441756,20-29,584,5,0,0,0,0,0,0,0,0,0,0,0,0,154,307,4.4780486537007367E-5,0,0,151,0,0,199,0,0
123151726,EsmirMilavic,10,33741,1206,1626,50,395,59.7453049586,50-59,769,9,39,69,108,108,39,69,6,2.4656846334,1242.4377424676,0.0581627763,0.1172551056,0.32197338,0,66,2.542663629083082E-4,2.396616E-4,2.4277443E-4,140,14,0,200,0,0
123164736,huyoa,10,101895,2546,2581,83,1371,52.7261417599,50-59,842,9,3,5,8,8,3,5,9,4.6046200201,3017.55,2.685360360470544E-4,0.0892857143,0.4,0,66,1.0539543819392093E-4,2.396616E-5,2.4277442E-5,320,1,0,201,0,0
123279913,WrightRyan,10,13689,275,146,16,28,54.4010103912,50-59,743,8,29,16,45,45,29,16,7,2.8302644794,24.9343424563,0.0405102401,0.203030303,0.40469417,0,66,1.381850445723015E-4,1.797462E-4,1.8208082E-4,140,31,2,204,2,0.0098039216
123662862,ItsMeMarisol,10,43662,779,621,29,518,38.7249537725,30-39,727,9,5,2,7,7,5,2,8,3.6812855708,237.4589935488,0.0061938001,0.0952380952,0.2,0,66,6.570566793854326E-5,3.594924E-5,3.6416164E-5,47,1,0,201,0,0
124236594,SNoutreach,10,125,176,50,12,0,34.8541698834,30-39,433,2,1,1,2,2,1,1,8,3.5075326414,0,0.0023346768,0,0,0,66,6.077903169553801E-5,1.198308E-5,1.2138721E-5,390,1,0,135,0,0
124295860,MakinsonAQ,10,2383,660,903,16,22,42.2224166373,40-49,681,6,95,110,205,205,95,110,6,2.4395714764,8409.3524156637,0.1021901651,0.0979196557,0.28113025,0,66,4.260041473464425E-4,5.7518785E-4,5.826586E-4,390,39,15,199,15,0.0753768844
124302756,VassyKapelos,10,19517,6623,3950,182,793,60.7044600613,60-69,799,8,165,151,316,316,165,151,6,2.3260796786,35707.9803336428,0.1363907851,0.0433494073,0.13974823,0,66,0.0013958834,9.945956E-4,0.0010075138,372,118,2,200,2,0.01
124799936,jsaxberg,10,682,218,404,5,63,39.3555632344,30-39,580,4,25,39,64,64,25,39,7,2.7368597255,551.1113914956,0.0243947775,0.0947420635,0.30509412,0,66,1.5179096093547538E-4,1.5578004E-4,1.5780337E-4,390,12,3,200,3,0.015
125282905,RobDChambers,10,1521,289,266,17,4,43.5510552128,40-49,591,5,0,0,0,0,0,0,0,0,0,0,0,0,213,406,4.4780486537007367E-5,0,0,208,0,0,200,0,0
125417632,Chris_Gorman,10,4367,27830,22124,147,24,63.7776223883,60-69,742,7,142,157,299,299,142,157,6,2.2859055909,45696.4754668842,0.0834945198,0.0193486117,0.09246895,0,66,6.465753098357272E-4,8.567902E-4,8.679186E-4,372,25,0,202,0,0
125476267,emilysnake3,10,1322,17,54,1,9,,,443,5,0,2,2,2,0,2,7,3.1529451138,0,0,0.5,1,0,581,4.4780486537007367E-5,0,6.0693606E-6,47,0,0,200,0,0
125848560,stevem20,10,7903,528,179,30,340,40.6551522358,40-49,732,7,4,3,7,7,4,3,7,3.0190826917,88.3094615974,0.0045581979,0.0476190476,0.25,0,66,8.823139047763924E-5,2.99577E-5,3.0346804E-5,55,2,0,200,0,0
125875248,ericdemers_mtl,10,3208,9302,9232,211,6,62.8802322948,60-69,739,7,472,510,982,982,472,510,6,1.9959825912,281071.0933766,0.4408750598,0.0182157531,0.08961726,0,66,0.0018737369,0.0028339983,0.0028708077,390,46,8,200,8,0.04
126325261,the_problematic,10,10077,287,268,13,21,42.6768527797,40-49,711,7,22,19,41,41,22,19,7,2.7043856712,94.2867817063,0.0339003456,0.0823170732,0.38333333,0,66,1.0318003279310136E-4,1.3780541E-4,1.395953E-4,47,4,0,200,0,0
126408925,Infiniclick,10,8555,1047,154,57,87,57.379565223,50-59,771,7,5,3,8,8,5,3,2,1.625,1.45,4.235863526084145E-4,0.1607142857,0.85,0,56,5.913982947396527E-4,3.594924E-5,3.6416164E-5,320,13,0,200,0,0
126571380,AlexDolbec,10,8531,363,1997,5,177,45.6835498134,40-49,655,6,1,3,4,4,1,3,7,2.9862738534,9.8654270895,0.0031315666,0.0833333333,0.33333334,0,66,4.790338355077782E-5,1.198308E-5,1.2138721E-5,390,3,0,202,0,0
127551326,packermanno,10,13,5,109,0,0,16.2021988767,10-19,25,1,0,0,0,0,0,0,0,0,0,0,0,0,1,2,4.4780486537007367E-5,0,0,0,0,0,15,0,0
127895254,heroicseas,10,28732,1113,55,85,0,42.5695345684,40-49,767,8,3,0,3,3,3,0,0,0,0,0.0019417981,0,0,0,35,5.386422510199382E-5,2.396616E-5,0,47,1,0,200,0,0
127901611,Rambojks,10,1741,64,160,0,16,31.933791127,30-39,626,6,3,3,6,6,3,3,7,3.0127217944,0,0.0043451584,0.1,1,0,66,5.1256865458305944E-5,2.396616E-5,2.4277442E-5,47,6,0,199,0,0
128028442,dohRG,10,19422,946,1091,52,12,48.9336825511,40-49,759,8,15,27,42,42,15,27,6,2.5701372615,185.4854711376,0.0230962194,0.0743321719,0.28062677,0,66,1.0478051106949752E-4,9.586464E-5,9.710977E-5,47,4,0,201,0,0
128287465,youssefamane,10,757,402,657,9,0,42.6383807085,40-49,617,4,83,85,168,168,83,85,7,2.5450284566,275.1340984354,0.1333086041,0.1744724836,0.48087433,0,66,6.260482512614055E-4,5.0328934E-4,5.098263E-4,390,41,7,200,7,0.035
128490244,krisMCFC,10,3868,728,516,12,26,46.997304526,40-49,698,7,1,1,2,2,1,1,1,1,0,7.49471721243357E-5,0,0,114,228,2.9852402567743944E-4,1.198308E-5,1.2138721E-5,110,6,0,200,0,0
128514866,erubio0,10,5172,201,90,18,3,45.4088400805,40-49,713,7,0,1,1,1,0,1,3,2,0,0,0,0,45,132,4.4780486537007367E-5,0,6.0693606E-6,75,5,0,200,0,0
128676402,natcampbell92,10,849,89,158,1,160,37.4595841457,30-39,552,5,3,5,8,8,3,5,7,2.8516906595,20.9790862503,0.0043453015,0.1964285714,0.6,0,66,5.173822998173059E-5,2.396616E-5,2.4277442E-5,47,3,0,201,0,0
128712259,idesofjulius,10,32512,666,1345,8,2106,65.2214274689,60-69,774,9,23,39,62,62,23,39,6,2.7304988283,770.4414240463,0.0160642501,0.0975674246,0.32520324,0,66,1.6015136373942953E-4,1.4379696E-4,1.4566466E-4,372,96,0,203,0,0
128908662,ChanginJen,10,5698,557,573,17,2,46.240383962,40-49,716,7,10,22,32,32,10,22,7,2.7184466019,90.7107978825,0.007286732,0.122983871,0.28333333,0,66,8.088035874082407E-5,6.590694E-5,6.6762965E-5,372,1,0,200,0,0
129389158,cloud_stream,10,44403,527,216,7,962,33.8531979914,30-39,703,9,0,0,0,0,0,0,0,0,0,0,0,0,77,175,4.4780486537007367E-5,0,0,69,1,0,202,0,0
129812924,camilorestrepoh,10,723,40,64,1,10,32.713761224,30-39,521,4,0,0,0,0,0,0,0,0,0,0,0,0,75,173,4.4780486537007367E-5,0,0,67,0,0,200,0,0
130000271,ChristopherPam,10,1331,45,137,1,3,49.7464172301,40-49,577,5,0,1,1,1,0,1,7,3.4605087015,0,0,0,0,0,585,4.4780486537007367E-5,0,6.0693606E-6,140,0,0,200,0,0
130341846,MichaelVStewart,10,3191,489,1999,5,6,28.3163095508,20-29,535,6,4,26,30,30,4,26,7,2.770672916,33.8234787034,0.0014706963,0.191954023,0.38746437,0,66,5.646314826951256E-5,2.99577E-5,3.0346804E-5,372,1,0,200,0,0
130571649,IvanVizcaino,10,5637,287,335,7,2321,44.972028134,40-49,724,7,6,7,13,13,6,7,1,1,22.5,4.640975495339639E-4,0.0448717949,0.30952382,52,142,5.455534883039043E-4,4.194078E-5,4.2485524E-5,316,110,0,202,0,0
131171499,MKlwr,10,5395,169,453,9,174,46.2122387331,40-49,646,7,39,91,130,130,39,91,7,2.4660194175,386.8837930151,0.0610788367,0.1711389386,0.50629145,0,66,2.158984618460459E-4,2.396616E-4,2.4277443E-4,390,0,2,200,2,0.01
131175096,billmilliken,10,10420,1000,1383,34,411,50.4124748804,50-59,720,8,37,43,80,80,37,43,7,2.6270505524,2963.7274922748,0.0748871016,0.139556962,0.352459,0,66,2.743478963408278E-4,2.2767852E-4,2.306357E-4,140,27,1,203,1,0.0049261084
131195984,ATory01,10,1396,928,693,32,7,48.5052379759,40-49,629,5,104,95,199,199,104,95,6,2.4499497824,2311.711330863,0.1725332173,0.1191310086,0.2680352,0,66,9.496228827586365E-4,6.291117E-4,6.3728285E-4,372,5,2,200,2,0.01
131265901,cahschucman,10,19009,519,435,1,14,39.8010545189,30-39,761,7,3,4,7,7,3,4,2,1.2,1,2.3729054730155783E-4,0.1428571429,0.8333333,317,575,2.8147502897192647E-4,2.396616E-5,2.4277442E-5,318,17,0,198,0,0
131589912,alnbrookes,10,9425,2007,243,87,8,54.0296886548,50-59,741,7,1,1,2,2,1,1,8,3.6461332441,0,9.316411673684244E-4,0.5,0.5,0,66,4.983106171350255E-5,1.198308E-5,1.2138721E-5,390,15,0,200,0,0
131859786,Sandy1Canada,10,5315,195,489,5,497,47.5716448647,40-49,634,7,27,53,80,80,27,53,6,2.3950451958,849.8926513575,0.0345360377,0.1120253165,0.29764065,0,66,1.1026857282508185E-4,1.6776312E-4,1.699421E-4,47,8,1,205,1,0.0048780488
131986093,bradrichert,10,5802,747,1190,38,62,55.110978716,50-59,696,7,18,31,49,49,18,31,7,2.7094074322,2478.9733161228,0.0081778241,0.068452381,0.21875,0,66,1.1601465882937168E-4,1.1383926E-4,1.1531785E-4,55,22,0,200,0,0
132021619,djsteverapson,10,335,113,346,3,14,36.182151148,30-39,534,4,5,10,15,15,5,10,7,2.6755942417,272.4175539791,0.010405524,0.0952380952,0.37777779,0,66,5.812548216460455E-5,3.594924E-5,3.6416164E-5,372,14,1,200,1,0.005
132171287,midgelambert,10,3677,550,592,14,15,46.1223672723,40-49,709,6,51,71,122,122,51,71,7,2.463341145,3389.4334557875,0.043616162,0.0583254302,0.21228771,0,66,2.2456685835670238E-4,3.1156008E-4,3.095374E-4,372,29,4,199,4,0.0201005025
132231788,dgardner,10,37549,11366,738,602,9,62.1437315319,60-69,929,8,786,59,845,845,786,59,6,2.489789086,24425.7364380717,0.7265800133,0.0510418127,0.07788603,0,66,0.0038762515,0.004715342,0.0047219624,140,1321,0,201,0,0
132264502,sarah_harmer,10,1515,9231,69,393,3,80.2343221101,80-89,766,5,131,2,133,133,131,2,7,3.1309005691,6230.258705637,0.1282048424,0.0793460925,0.11080268,0,66,8.136101294553814E-4,7.9088326E-4,7.708088E-4,390,45,0,200,0,0
132294267,jmbryden,10,569,4192,224,197,1,56.1563047616,50-59,716,4,376,70,446,446,376,70,6,2.5132239705,6524.7835783297,0.4834447196,0.0842747015,0.15049772,0,66,0.002811303,0.0022588104,0.0022820795,140,71,0,200,0,0
132344472,JulieEY,10,4185,262,427,5,61,43.3317541098,40-49,677,6,12,24,36,36,12,24,7,2.7144291932,177.9482096066,0.0110895317,0.146031746,0.31878307,0,66,8.680864499575615E-5,7.789002E-5,7.8901685E-5,372,12,0,201,0,0
132378897,realyst2k,10,2285,43,90,0,49,31.3264580929,30-39,552,6,1,4,5,5,1,4,7,3.2360227653,0.0279262404,0.0019997229,0.35,0.5,0,66,4.6617225370003676E-5,1.198308E-5,1.2138721E-5,140,2,2,200,2,0.01
132407522,hoopstarscanada,10,5093,2320,483,40,3,56.5005328249,50-59,753,6,5,4,9,9,5,4,2,1.4285714286,15521.8166666667,4.076725453014538E-4,0.1527777778,0.56666666,0,53,2.4297069527246773E-4,3.594924E-5,3.6416164E-5,352,2,0,200,0,0
132575271,LouArab,10,4150,1289,830,49,7,61.201539977,60-69,747,7,144,81,225,225,144,81,7,2.567458989,7234.374960079,0.1437866866,0.0640873016,0.17119387,0,66,7.985316600515237E-4,8.687733E-4,8.800573E-4,372,168,4,204,4,0.0196078431
132646082,fpaisdigital,10,1790,2680,1371,105,13,51.2525973623,50-59,660,5,2,7,9,9,2,7,9,4.6032808838,6087,1.5026044040863658E-4,0.1805555556,0.26785713,0,66,1.1501876722346492E-4,1.797462E-5,1.8208082E-5,320,55,0,201,0,0
132950661,gmohamed111,10,8232,690,2002,14,1438,50.8553196886,50-59,663,7,9,39,48,48,9,39,6,2.567793773,269.9524849987,0.011895467,0.2007978723,0.33686867,0,66,1.1298622789189193E-4,5.99154E-5,6.069361E-5,140,9,0,201,0,0
132993708,DavidJGagnon,10,7036,475,1966,8,319,43.3539491923,40-49,668,7,40,158,198,198,40,158,6,2.3083361232,3524.2836332072,0.0914381233,0.122083782,0.26529503,0,66,2.206356751191683E-4,2.4565315E-4,2.4884377E-4,140,12,1,202,1,0.004950495
133170079,mash_nica,10,7764,382,533,1,1133,45.8544425039,40-49,739,7,0,1,1,1,0,1,2,1.5,0,0,0,0,0,211,4.4780486537007367E-5,0,6.0693606E-6,47,0,0,201,0,0
133425731,ru4peace2,10,18216,912,1473,18,411,60.4541773948,60-69,752,8,20,15,35,35,20,15,7,2.7475728155,1658.8293208966,0.0100488997,0.1033613445,0.21494253,0,66,1.5140913876864848E-4,1.2582233E-4,1.2745657E-4,47,46,0,201,0,0
133752834,SDCC_unknown,10,230,19,24,0,0,16.9474539834,10-19,314,3,2,2,4,4,2,2,7,3.0579176431,0.8979672648,0.0017452689,0,0,0,66,4.9086537551101265E-5,1.797462E-5,1.8208082E-5,372,0,0,200,0,0
134511670,d_joue,10,29654,1222,870,25,119,56.7879380013,50-59,786,8,14,13,27,27,14,13,7,2.8550385002,61.96207504,0.0068933323,0.1153846154,0.3394737,0,66,9.293141483815619E-5,8.98731E-5,9.104041E-5,390,8,0,201,0,0
134889456,tbest8118,10,1627,767,837,3,4,26.9040716481,20-29,608,5,7,8,15,15,7,8,7,2.8553732842,13.5584050254,0.0081082579,0.0666666667,0.42857143,0,66,7.241632509801687E-5,4.793232E-5,4.8554884E-5,372,1,0,199,0,0
134993381,rob_beiko,10,1896,296,325,18,19,42.4886950189,40-49,639,5,5,8,13,13,5,8,7,3.0907264814,2407.826658142,0.002924181,0.1025641026,0.3888889,0,66,1.2111719371669611E-4,3.594924E-5,3.6416164E-5,55,10,0,200,0,0
135257089,richardlevangie,10,9260,806,630,47,169,50.8094328765,50-59,741,7,10,7,17,17,10,7,7,2.6722464011,3137.5198789566,0.0188047227,0.0404411765,0.22222222,0,66,1.2309289080969906E-4,6.590694E-5,6.069361E-5,47,13,0,200,0,0
135292251,RitchieTrev,10,2454,452,731,15,17,41.0860837465,40-49,640,6,34,67,101,101,34,67,7,2.4978239036,924.8297681614,0.0383865516,0.1135643564,0.36253196,0,66,1.8965473135727597E-4,2.097039E-4,2.1242762E-4,390,2,0,200,0,0
135823693,HVerduM,10,962,290,698,10,17,45.4627804119,40-49,567,5,0,0,0,0,0,0,0,0,0,0,0,0,222,422,4.4780486537007367E-5,0,0,216,2,0,200,0,0
136255383,Jeff_May,10,938,728,823,19,1,47.7752583477,40-49,625,5,128,153,281,281,128,153,7,2.2976230331,8317.2784657732,0.1448782778,0.0553126589,0.2535228,0,66,4.591727888431175E-4,7.729087E-4,7.829475E-4,140,45,2,199,2,0.0100502513
136598338,DyPeaks,10,3480,177,205,2,38,34.790741974,30-39,626,6,13,16,29,29,13,16,7,2.7803816538,14.6925339476,0.0159428554,0.1834975369,0.46536797,0,66,9.253437484835208E-5,8.388156E-5,8.497105E-5,140,8,7,200,6,0.035
136735423,mistressmel,10,9644,287,565,8,82,36.9887630406,30-39,685,7,1,1,2,2,1,1,1,1,0,7.49471721243357E-5,0,0,285,534,2.9852402567743944E-4,1.198308E-5,1.2138721E-5,284,1,0,200,0,0
137444494,drdanymorin,10,2136,1476,587,118,1,48.2084867198,40-49,693,6,154,112,266,266,154,112,7,2.4807499163,4992.5575828591,0.1915920407,0.0986097319,0.2959444,0,66,7.504919851709933E-4,9.286887E-4,9.3468156E-4,390,50,4,200,4,0.02
137471172,d_gatto,10,1221,563,973,22,0,39.1181687434,30-39,558,5,44,79,123,123,44,79,6,2.4914630064,782.7497592133,0.0560797244,0.1399440224,0.4079123,0,66,2.3822885577380238E-4,2.696193E-4,2.7312123E-4,140,9,0,200,0,0
137508424,DeesNutz83,10,2757,277,188,0,1154,42.0902668789,40-49,686,6,0,0,0,0,0,0,0,0,0,0,0,0,41,125,4.4780486537007367E-5,0,0,33,8,0,200,0,0
137567832,cambridgelibs,10,1499,509,552,20,0,43.7935557557,40-49,653,5,58,80,138,138,58,80,7,2.5236022765,1002.7136036065,0.0737220762,0.1376282662,0.40378007,0,66,2.894146043461061E-4,3.5350086E-4,3.5809228E-4,140,14,3,200,3,0.015
137778787,matt_bowes,10,8022,590,999,19,36,56.2439894285,50-59,742,7,11,26,37,37,11,26,7,2.7204553063,247.552047115,0.0070325953,0.0660660661,0.2,0,66,8.74258549639821E-5,7.189848E-5,7.283233E-5,372,1,0,200,0,0
138121045,JP3Magalhaes,10,3031,113,245,2,158,35.2710248784,30-39,663,6,0,0,0,0,0,0,0,0,0,0,0,0,153,305,4.4780486537007367E-5,0,0,150,11,0,199,0,0
138313976,FatherTheo,10,5792,1450,1739,26,5,41.4739455203,40-49,661,6,12,14,26,26,12,14,7,2.6930030131,80.5008849166,0.0176163354,0.0553846154,0.32417583,0,66,8.08464395744577E-5,7.789002E-5,7.8901685E-5,47,3,0,200,0,0
138585158,Bill5250,10,25348,959,1031,46,439,47.9843824689,40-49,785,9,4,5,9,9,4,5,7,3.453297623,14.2075681932,4.582631576164877E-4,0.0277777778,0.1,0,66,6.029327137003068E-5,2.99577E-5,3.0346804E-5,372,26,0,201,0,0
138616596,windspeakernews,10,7370,5537,148,142,1,59.9325209134,50-59,771,6,192,12,204,204,192,12,7,2.7904251758,7861.1561292027,0.1266597609,0.0736742973,0.12080017,0,66,0.0011190499,0.0011563672,0.0011713866,47,207,0,204,0,0
138745077,ZenaHaddad,10,2504,255,198,4,42,43.4892036506,40-49,652,7,1,1,2,2,1,1,10,5.5274247492,0,7.49471721243357E-5,0,0,0,447,9.990168110805797E-5,1.198308E-5,1.2138721E-5,224,26,0,200,0,0
138956534,NDPmc33,10,3553,291,561,2,171,43.4562103666,40-49,682,6,43,63,106,106,43,63,6,2.4767325075,257.169438285,0.0634758427,0.1900269542,0.3661013,0,66,1.636267753712627E-4,2.6362776E-4,2.6705186E-4,390,21,11,200,11,0.055
139732486,PersianWanderer,10,1722,112,79,9,2,40.7354364454,40-49,628,5,0,0,0,0,0,0,0,0,0,0,0,0,118,234,4.4780486537007367E-5,0,0,115,3,0,199,0,0
139880319,RyanMason95,10,6843,183,140,0,780,42.3859576018,40-49,732,7,6,7,13,13,6,7,1,1,0,4.977388905364672E-4,0.1346153846,0.85714287,46,134,1.6498109788469208E-4,4.194078E-5,4.2485524E-5,102,24,0,199,0,0
140129979,alinnyprado,10,4787,843,1047,27,4,31.696387206,30-39,717,6,0,0,0,0,0,0,0,0,0,0,0,0,71,168,4.4780486537007367E-5,0,0,63,1,0,200,0,0
140186605,Canada_1867,10,117,106,219,4,0,22.175018001,20-29,495,1,21,39,60,60,21,39,7,2.5721459659,388.6910999717,0.0304768896,0.1008474576,0.35560054,0,66,1.2829841814826699E-4,1.3181388E-4,1.3352593E-4,140,0,2,117,2,0.0170940171
140899011,ShorterNet,10,591,41,109,0,0,34.58851713,30-39,480,4,23,57,80,80,23,57,6,2.3629059257,297.2293343299,0.0418292073,0.1431962025,0.42635885,0,66,1.0610740272601857E-4,1.4379696E-4,1.4566466E-4,47,12,6,200,6,0.03
141246833,brendajeans,10,1753,171,270,5,34,38.8824744136,30-39,588,6,30,40,70,70,30,40,7,2.5671242049,309.4790766618,0.0435315823,0.1248447205,0.3032844,0,66,1.6601853152719824E-4,1.8573774E-4,1.8815018E-4,390,5,0,200,0,0
141702501,kevdsmith,10,1619,282,1022,5,32,52.1956566518,50-59,595,5,19,58,77,77,19,58,6,2.374958152,765.2557163723,0.0374814637,0.1360218729,0.3169399,0,66,1.4058059271023266E-4,1.198308E-4,1.2138722E-4,140,13,1,200,1,0.005
142039570,tetecarrerouge,10,2303,136,77,2,164,40.9074134391,40-49,663,5,9,8,17,17,9,8,7,2.8844994978,14.4686391977,0.0170535102,0.1176470588,0.4909091,0,66,7.592899470596356E-5,5.99154E-5,6.069361E-5,47,23,0,200,0,0
142271252,Samuel_Lum,10,1437,599,562,21,19,45.3267793393,40-49,632,5,0,0,0,0,0,0,0,0,0,0,0,0,246,474,4.4780486537007367E-5,0,0,242,5,0,200,0,0
142408161,CelesteCote,10,6890,847,652,31,151,63.4004776639,60-69,719,7,64,73,137,137,64,73,7,2.4904586542,3280.6508609581,0.086623395,0.1069665092,0.24896675,0,66,4.252055921048456E-4,3.8945008E-4,3.9450845E-4,390,60,0,201,0,0
142699843,MlleAuroreB,10,29684,388,348,21,615,,,768,8,5,14,19,19,5,14,7,2.8563776364,9.6807138447,0.004312568,0.1754385965,0.45238096,0,66,7.046748824431264E-5,3.594924E-5,3.6416164E-5,140,2,0,200,0,0
142860040,rchavarri,10,7824,618,1463,2,627,43.8661685537,40-49,687,7,2,7,9,9,2,7,9,4.6036156679,5087.6,1.9551587194602748E-4,0.0694444444,0.14285715,0,66,1.1648178928206347E-4,1.797462E-5,1.8208082E-5,320,22,0,200,0,0
143188147,NickyP1979,10,2182,138,793,0,24,38.57186495,30-39,587,6,29,72,101,101,29,72,6,2.4027452293,318.6422752462,0.0507556019,0.1156435644,0.32115677,0,66,1.1888438297526975E-4,1.797462E-4,1.8208082E-4,47,17,3,201,3,0.0149253731
143241913,Arifin17,10,779,144,403,2,1,34.0622998252,30-39,545,5,17,63,80,80,17,63,7,2.4757281553,972.7307175491,0.0273039445,0.1340189873,0.27716348,0,66,1.0729921521000364E-4,1.0784772E-4,1.0924849E-4,55,7,0,200,0,0
143255693,ohmyhog,10,142,7,26,0,0,25.7709321099,20-29,283,3,1,1,2,2,1,1,8,3.7900903917,0,0.0010295587,0,0,0,66,1.2404656393735715E-4,1.198308E-5,1.2138721E-5,47,1,0,191,0,0
143514132,FCM_online,10,15883,6103,4955,199,1,62.4093685138,60-69,790,8,230,224,454,454,230,224,6,2.1600267827,65940.4379776475,0.2784687734,0.0252064066,0.14683881,0,66,0.0013175289,0.0013840457,0.0014020223,390,141,3,200,3,0.015
143723226,kylemmorrow,10,3900,6202,6233,96,996,54.5630468605,50-59,736,7,226,226,452,452,226,226,6,2.1777703381,81751.7441797704,0.2213731664,0.027156957,0.13411964,0,66,9.449454018554185E-4,0.0013600796,0.0013777448,140,42,3,200,3,0.015
143923047,hoplesstwit,10,11534,1243,1535,10,565,54.0757406933,50-59,738,8,33,46,79,79,33,46,6,2.4563106796,1615.3913365029,0.0467348399,0.0420318079,0.21111111,0,66,1.3963173544850259E-4,2.0371236E-4,2.0635827E-4,47,12,0,201,0,0
144598107,_miguel_cabrera,10,6389,427,407,0,133,31.0481722369,30-39,685,7,0,0,0,0,0,0,0,0,0,0,0,0,128,247,4.4780486537007367E-5,0,0,125,4,0,197,0,0
144876537,BigJMcC,10,10345,1189,1820,31,16,52.2218365532,50-59,734,7,129,196,325,325,129,196,6,2.2390358219,22416.8549017171,0.1358844444,0.0567331434,0.16134222,0,66,4.934441698614534E-4,7.7890017E-4,7.890169E-4,390,98,0,210,0,0
145480842,DeronBilous,10,2052,801,749,42,1,49.0204142626,40-49,725,6,82,86,168,168,82,86,7,2.4710411784,9999.0606175447,0.0866734606,0.0674365555,0.2324159,0,66,4.4799795657140233E-4,4.972978E-4,5.037569E-4,390,86,3,201,3,0.0149253731
145524578,KayleHatt,10,8496,721,582,32,13,61.3641491672,60-69,731,7,129,123,252,252,129,123,6,2.4027452293,4992.6253159315,0.1498254455,0.1022892557,0.27202356,0,66,5.408370452545676E-4,7.7890017E-4,7.829475E-4,390,69,3,202,3,0.0148514851
145647271,telfordk,10,2366,1289,806,21,4,51.4931715302,50-59,684,6,156,95,251,251,156,95,6,2.4603280884,3712.9005294807,0.2155663928,0.1140557769,0.25126904,0,66,0.0012574758,9.406718E-4,9.528896E-4,140,96,1,200,1,0.005
145677570,IoannaBD,10,3566,54,195,0,17,29.4403385633,20-29,567,6,2,3,5,5,2,3,7,3.2835621024,0.9576688144,0.001758236,0.2,0.2,0,66,4.939201657807553E-5,1.797462E-5,1.8208082E-5,140,0,1,200,1,0.005
145703064,M_Snopes,10,1346,494,787,6,41,51.9789600724,50-59,638,5,30,57,87,87,30,57,6,2.5219283562,1754.7491579829,0.0303478311,0.1329858327,0.33426574,0,66,1.8128206254523584E-4,1.8573774E-4,1.8815018E-4,390,3,1,167,1,0.005988024
145935577,jkoblovsky,10,6345,1313,1308,82,6,47.4702218896,40-49,714,7,42,49,91,91,42,49,6,2.4707063944,4436.442621448,0.0417640478,0.042979243,0.19607843,0,66,1.82469265202969E-4,2.5763622E-4,2.5491315E-4,140,23,1,200,1,0.005
146060152,wcgirl1,10,93428,4467,3320,164,14,56.2016253055,50-59,908,10,29,28,57,57,29,28,7,2.7941078005,11952.8884606997,0.0105891473,0.0288220551,0.17096774,0,66,2.556012578403604E-4,1.797462E-4,1.8208082E-4,47,74,0,204,0,0
146087611,Emol,10,51010,401026,161655,3556,96,73.9669536832,70-79,986,8,24,22,46,46,24,22,8,3.6079678607,181197.099999994,0.0019330637,0.0381642512,0.09677419,0,66,5.995906336035045E-4,1.497885E-4,1.2745657E-4,320,19,0,201,0,0
146530868,ashedletzky,10,185,135,101,10,0,40.4545180985,40-49,495,3,15,11,26,26,15,11,7,2.9387345162,46.4078307766,0.0144353703,0.1384615385,0.26623377,0,66,1.1885145163168427E-4,9.586464E-5,9.710977E-5,140,13,1,200,1,0.005
146532434,Julio_JDR,10,3881,186,652,0,32,54.0947521194,50-59,551,6,1,1,2,2,1,1,9,4.5952460663,0,8.76646441857328E-5,0,0,0,66,9.677607339940816E-5,1.198308E-5,1.2138721E-5,320,1,0,201,0,0
146643118,DonJonescu,10,4395,199,455,2,7,42.8592237031,40-49,665,6,0,0,0,0,0,0,0,0,0,0,0,0,263,494,4.4780486537007367E-5,0,0,260,0,0,200,0,0
146792452,Rashiid9,10,40770,681,669,2,291,45.0986178334,40-49,778,9,0,0,0,0,0,0,0,0,0,0,0,0,108,220,4.4780486537007367E-5,0,0,104,12,0,201,0,0
146972021,KellyMacFarlane,10,1460,139,282,11,1,41.3445250662,40-49,583,5,2,4,6,6,2,4,7,3.2835621024,2.054508469,7.900039663906572E-4,0.0666666667,0.25,0,66,6.280611075274792E-5,1.797462E-5,1.8208082E-5,372,7,0,200,0,0
147190097,aminumuky,10,4381,123,115,1,108,29.5034044423,20-29,543,6,0,0,0,0,0,0,0,0,0,0,0,0,184,348,4.4780486537007367E-5,0,0,179,0,0,200,0,0
147394203,zachchurchill,10,5138,1406,370,45,62,51.4108180016,50-59,731,7,50,28,78,78,50,28,6,2.7268162035,1118.3122818305,0.0574797026,0.1223776224,0.26676908,0,66,3.3921997953755153E-4,3.0556854E-4,3.095374E-4,140,56,0,200,0,0
147774520,agthsmkt,10,6475,311,182,13,152,55.9122697792,50-59,743,7,33,0,33,33,33,0,0,0,0,0.0191351041,0.2320075758,0.4185606,0,12,1.5450380672230054E-4,2.0371236E-4,0,372,74,0,207,0,0
147934725,DisturbedeMerde,10,4416,235,385,8,8,43.7562616221,40-49,674,6,15,32,47,47,15,32,7,2.5825242718,766.1715381292,0.0215100823,0.0841813136,0.24147727,0,66,1.7479882304739515E-4,9.586464E-5,9.710977E-5,47,6,0,201,0,0
147981741,vickyatclc,10,4488,833,665,36,39,49.2460487525,40-49,680,6,121,87,208,208,121,87,6,2.3860060261,6924.8171524153,0.1522893056,0.084262356,0.24558337,0,66,5.576930435780799E-4,7.3096785E-4,7.40462E-4,390,34,0,200,0,0
148752523,moviereviewsbyd,10,4491,73,74,4,172,40.4144609914,40-49,617,7,4,3,7,7,4,3,7,3.0693003013,11.1425530964,0.0101323139,0.119047619,0.4,0,66,6.254493076115392E-5,2.99577E-5,3.0346804E-5,390,6,4,200,3,0.02
148821315,cstocovaz,10,312,11,38,0,0,41.2339975169,40-49,281,4,0,6,6,6,0,6,7,2.8875502008,0,0,0.5,0.8333333,0,300,4.4780486537007367E-5,0,6.0693606E-6,140,0,0,200,0,0
149120710,GeekMasque,10,560,116,355,0,1,26.4629712234,20-29,455,4,0,1,1,1,0,1,2,1.5,0,0,0,0,0,351,4.4780486537007367E-5,0,6.0693606E-6,320,1,0,200,0,0
149196780,mballism,10,1288,245,431,7,185,57.5330726311,50-59,558,5,13,15,28,28,13,15,7,2.8202209575,109.2792083846,0.0088509345,0.1084656085,0.37908497,0,66,8.174168803187132E-5,8.388156E-5,8.497105E-5,390,11,0,200,0,0
149317195,PeggyatHome,10,24362,1573,1040,33,626,49.474413103,40-49,777,9,106,105,211,211,106,105,6,2.5390023435,6816.1249777141,0.050808946,0.0380952381,0.19569702,0,66,4.2152534542915193E-4,6.4109475E-4,6.494216E-4,372,69,2,202,2,0.0099009901
149543873,alcaleitor1988,10,422,95,227,0,2,24.3016482329,20-29,552,4,1,1,2,2,1,1,1,1,0,7.49471721243357E-5,0,0,116,232,2.9852402567743944E-4,1.198308E-5,1.2138721E-5,113,3,0,196,0,0
149852919,offroadartist,10,335,116,506,2,5,21.2591849544,20-29,448,4,10,68,78,78,10,68,7,2.4887847338,49.0759477557,0.0183163852,0.1801531802,0.36742756,0,66,7.595997128293864E-5,6.590694E-5,6.6762965E-5,140,0,0,200,0,0
150121687,attaboymort,10,2368,156,334,4,1,28.8277262518,20-29,627,5,11,18,29,29,11,18,7,2.8222296619,29.1815038382,0.0090464165,0.1588669951,0.47619048,0,66,7.828631485037794E-5,7.189848E-5,7.283233E-5,140,4,6,200,6,0.03
150289143,acorduroystain,10,2259,188,145,1,16,32.5640502721,30-39,593,5,2,2,4,4,2,2,1,1,2,1.4992441991589235E-4,0,0,316,574,4.3582306220354E-4,1.797462E-5,1.8208082E-5,328,3,0,200,0,0
150289374,UFCW1000A,10,1307,631,830,19,6,46.6412443748,40-49,630,5,49,86,135,135,49,86,6,2.4091061265,2537.8270807187,0.05397794,0.0906025428,0.2912088,0,66,2.1136184563872777E-4,2.99577E-4,3.0346803E-4,390,29,0,199,0,0
150293439,gaufredus,10,865,152,252,7,46,39.230371378,30-39,584,5,3,6,9,9,3,6,7,3.3528624037,22.04816107,3.7653026509053294E-4,0.0972222222,0.4,0,66,9.346057989983634E-5,2.396616E-5,2.4277442E-5,372,5,0,200,0,0
150419399,aballinga,10,2851,464,805,16,8,46.5955788822,40-49,631,6,11,29,40,40,11,29,7,2.9119517911,68.3837091022,0.0208467485,0.2307692308,0.43492064,0,66,1.315293335027093E-4,7.189848E-5,7.283233E-5,140,5,0,200,0,0
150631980,PaddMann10,10,897,178,151,0,102,32.7209741564,30-39,555,4,1,1,2,2,1,1,1,1,0,7.49471721243357E-5,0,0,259,490,2.9852402567743944E-4,1.198308E-5,1.2138721E-5,255,6,0,192,0,0
150779362,Unicycling4life,10,4776,568,1864,9,27,39.5790801821,30-39,637,7,57,156,213,213,57,156,6,2.1858051557,4457.4405279321,0.0890932099,0.1010718398,0.27255502,0,66,1.8989335269886982E-4,3.475093E-4,3.520229E-4,47,3,1,196,1,0.0051020408
150829276,nathanegrundy,10,985,259,479,3,24,43.6472924326,40-49,576,5,40,38,78,78,40,38,6,2.5517241379,749.2700119154,0.0462237796,0.1167166167,0.34208754,0,66,1.8768271796288125E-4,2.4565315E-4,2.4884377E-4,140,23,0,200,0,0
151348519,Wesby_,10,21905,647,500,7,49,41.0440115212,40-49,744,8,1,1,2,2,1,1,1,1,0,7.644022021228885E-5,0,0,401,722,4.1496852829177067E-4,1.198308E-5,1.2138721E-5,413,16,0,200,0,0
151579206,justinreist,10,1214,334,688,13,57,51.4910131467,50-59,589,5,22,46,68,68,22,46,7,2.5182457315,1320.6346662952,0.0292311615,0.1106233538,0.28745097,0,66,1.6302880695218198E-4,1.3780541E-4,1.395953E-4,140,2,1,200,1,0.005
152498426,TheLeftPopulist,10,4435,230,467,7,5,51.6224581176,50-59,708,6,58,110,168,168,58,110,6,2.2976230331,4297.7238625877,0.0844139729,0.0914955803,0.30167508,0,66,2.1086782716526098E-4,3.5350086E-4,3.5809228E-4,47,12,2,204,2,0.0098039216
152625640,MayRaap1,10,4478,204,260,1,365,36.8639586224,30-39,671,7,28,34,62,62,28,34,7,2.4968195514,214.1447970606,0.0445676214,0.1023268112,0.39423078,0,66,1.1089505128775855E-4,1.7375466E-4,1.7601145E-4,47,4,0,201,0,0
152687100,JdoubleL,10,606,36,162,1,229,28.3990053863,20-29,531,3,1,1,2,2,1,1,2,1.75,0,7.954831160852805E-5,0,0,169,323,1.428353307999102E-4,1.198308E-5,1.2138721E-5,342,7,0,199,0,0
153225560,novascotiarasta,10,91767,1308,352,70,6218,58.394095341,50-59,865,10,31,9,40,40,31,9,7,3.1195179109,323.3022193979,0.0271542584,0.0692307692,0.16935484,0,66,1.4029473298220736E-4,1.9172928E-4,1.8815018E-4,47,54,0,201,0,0
153668307,keykey_13,10,1765,65,127,0,31,34.7047191985,30-39,654,5,0,1,1,1,0,1,1,1,0,0,0,0,130,251,4.4780486537007367E-5,0,6.0693606E-6,127,1,0,200,0,0
154136730,JDignum,10,11923,261,376,7,7448,43.9207482062,40-49,663,8,40,52,92,92,40,52,6,2.520924004,187.6880050292,0.0660916582,0.1118012422,0.35639882,0,66,1.4738792377125062E-4,2.4565315E-4,2.4884377E-4,47,9,0,202,0,0
154240814,GertHoogendoorn,10,62,20,52,0,1,14.6882160989,10-19,210,1,1,1,2,2,1,1,1,1,0,7.49471721243357E-5,0,0,220,417,2.9852402567743944E-4,1.198308E-5,1.2138721E-5,219,3,0,67,0,0
154571151,mihaychuk,10,5111,828,1963,33,42,47.3081976259,40-49,676,7,52,112,164,164,52,112,7,2.3739537998,4733.9790854026,0.0759622958,0.0762382164,0.22784135,0,66,2.6316868452012763E-4,3.175516E-4,3.216761E-4,47,16,1,200,1,0.005
154592265,CoryJudson,10,14394,797,999,18,9,48.3566110163,40-49,744,8,103,131,234,234,103,131,6,2.4332105792,6021.5001447472,0.1249308247,0.1179890686,0.30460957,0,66,4.578309689529179E-4,6.2312017E-4,6.312135E-4,390,67,2,201,2,0.0099502488
155631208,kylejhutton,10,4493,168,145,9,0,46.1225676785,40-49,664,6,41,34,75,75,41,34,7,2.6129896217,279.78508463,0.0579741252,0.1320720721,0.37239057,0,66,1.8575986001487328E-4,2.5164467E-4,2.5491315E-4,140,81,0,201,0,0
155792555,patimbeau,10,1859,383,336,13,4,32.1709928628,30-39,626,5,48,51,99,99,48,51,7,2.7174422497,376.3046261319,0.0557457337,0.1405895692,0.39925665,0,66,2.3697333037329046E-4,2.9358547E-4,2.9739868E-4,390,2,4,200,4,0.02
155932739,amolpomane,10,9926,1959,1616,34,207,59.8818310999,50-59,696,6,9,9,18,18,9,9,8,4.3588885169,7574.5047765246,7.160932405611151E-4,0.0065359477,0.055555556,0,66,5.13998092168868E-4,5.99154E-5,6.069361E-5,320,1,0,200,0,0
155944229,javiervegac,10,5764,131,510,3,42,34.3899965974,30-39,485,7,1,4,5,5,1,4,9,4.6056243723,2233.85,9.652838824279372E-5,0.15,0.25,0,66,1.122103523552837E-4,1.198308E-5,1.2138721E-5,320,0,0,201,0,0
156040251,kelseymech,10,531,165,163,6,1,38.8546457848,30-39,566,4,12,14,26,26,12,14,7,2.8188818212,126.1287226646,0.0201541076,0.1646153846,0.44152048,0,66,1.4939488342576113E-4,7.789002E-5,7.8901685E-5,55,5,0,200,0,0
156210748,jerradtyson,10,2097,1533,131,25,55,53.1193395116,50-59,744,6,6,2,8,8,6,2,1,1,0,4.729144854588212E-4,0.2678571429,0.6333333,250,478,6.05091973227469E-4,4.194078E-5,4.2485524E-5,248,115,0,198,0,0
156280432,OppoGuy,10,960,230,458,6,0,41.0896751893,40-49,612,4,75,143,218,218,75,143,7,2.2842316706,3674.8803854025,0.1243532601,0.1149114277,0.36264285,0,66,4.007132789555016E-4,4.5535705E-4,4.612714E-4,390,28,2,200,2,0.01
156447298,Wendelovermats,10,1604,56,271,0,16,24.8030285295,20-29,534,4,2,7,9,9,2,7,7,2.8235687981,0.6151987118,0.0039650064,0.1805555556,0.52380955,0,66,4.872426036140957E-5,1.797462E-5,1.8208082E-5,47,2,0,200,0,0
156462489,whilewalking,10,431,22,98,1,87,15.4064772372,10-19,311,3,0,1,1,1,0,1,1,1,0,0,0,0,342,630,4.4780486537007367E-5,0,6.0693606E-6,353,0,0,193,0,0
158532249,atomiccentre,10,2041,267,442,8,52,44.2536453516,40-49,610,6,12,23,35,35,12,23,7,2.6441245397,139.774762945,0.0222107403,0.1403361345,0.38,0,66,9.316731375909023E-5,7.789002E-5,7.8901685E-5,47,10,0,199,0,0
158766748,uOConservatives,10,694,545,580,23,23,45.2436374126,40-49,632,5,64,73,137,137,64,73,6,2.5219283562,5466.1359138795,0.0509277802,0.0970910262,0.23329526,0,66,3.445778929634435E-4,3.8945008E-4,3.9450845E-4,372,29,3,200,3,0.015
158852785,Mental_Radio,10,2190,330,210,12,2,46.5546882216,40-49,674,6,24,15,39,39,24,15,7,2.8326079679,445.9379128729,0.0227607337,0.0944669366,0.24630542,0,66,1.5679014951435296E-4,1.497885E-4,1.5173401E-4,390,67,0,200,0,0
158923470,PatrickDavis55,10,662,136,634,2,16,40.6441083026,40-49,495,5,9,31,40,40,9,31,6,2.5065282893,123.790504708,0.0093369313,0.1512820513,0.36290324,0,66,7.331429786853097E-5,5.99154E-5,6.069361E-5,372,3,0,200,0,0
158937744,deantiquate,10,4908,444,362,26,242,48.4339806807,40-49,695,7,18,11,29,29,18,11,7,3.0033478406,3498.2551617294,0.0121416785,0.0517241379,0.16842106,0,66,2.1687229140637603E-4,1.1383926E-4,1.1531785E-4,372,39,0,201,0,0
159255994,TheHillTimes,10,1970,16196,837,705,13,59.6482335993,50-59,765,5,873,138,1011,1011,873,138,6,2.3535319719,57326.4582196407,0.7284899774,0.0420669663,0.06755851,0,66,0.0045562734,0.005236606,0.005213581,140,128,0,200,0,0
159282071,rezboi39,10,16009,433,1176,5,42,44.5939224101,40-49,685,8,19,58,77,77,19,58,6,2.4137931034,1497.1486413669,0.0248152056,0.0818523582,0.21657592,0,66,1.0000598410940957E-4,1.198308E-4,1.2138722E-4,372,26,4,204,4,0.0196078431
159342666,krystalline_k,10,10977,1668,113,79,80,54.4305169541,50-59,773,7,161,11,172,172,161,11,7,2.7860729829,579.8695545864,0.1702982174,0.0973072215,0.1634844,0,66,6.414210199489918E-4,9.7062945E-4,9.77167E-4,47,72,0,200,0,0
159578935,KristofTO,10,8124,383,659,16,4,49.333199444,40-49,725,7,31,50,81,81,31,50,7,2.5169065952,2039.5848857151,0.0342325235,0.0663580247,0.18609023,0,66,1.4687094783952226E-4,1.9172928E-4,1.9421954E-4,140,25,0,201,0,0
159845237,wypbell,10,121,61,201,0,0,18.8203429392,10-19,401,3,5,15,20,20,5,15,7,2.7793773016,58.617003996,0.0070516992,0.2,0.47916666,0,66,6.422983815457917E-5,3.594924E-5,3.6416164E-5,390,0,0,119,0,0
159923573,ilaminstrutt,10,415,135,341,4,35,48.8881314632,40-49,468,4,5,4,9,9,5,4,7,3.124874456,6102.8140726668,0.0040033027,0,0,0,66,1.1883799808473999E-4,3.594924E-5,3.6416164E-5,390,3,0,201,0,0
160027610,LakeBass,10,318,261,55,6,12,50.2950043474,50-59,735,7,121,17,138,138,121,17,7,2.7164378976,383.5604229567,0.1277237357,0.1423357664,0.24456841,0,66,2.980028249614423E-4,7.3096785E-4,7.40462E-4,47,147,15,362,15,0.0414364641
160073664,rjmjanes,10,3898,401,564,21,4,55.8156679742,50-59,642,6,22,42,64,64,22,42,7,2.5764981587,479.2411942218,0.029089568,0.1078869048,0.24857143,0,66,1.3987522583810532E-4,1.3780541E-4,1.395953E-4,47,2,0,197,0,0
160190953,Lead_Sta,10,8786,300,444,11,35,43.2362194489,40-49,652,7,24,30,54,54,24,30,6,2.5189152996,497.2022063936,0.038632552,0.1097134871,0.2820513,0,66,1.7500759922728886E-4,1.497885E-4,1.5173401E-4,47,11,4,202,3,0.0198019802
160339209,MorgAn_maRiE003,10,14192,315,619,1,568,40.4918172145,40-49,740,7,0,0,0,0,0,0,0,0,0,0,0,0,205,393,4.4780486537007367E-5,0,0,200,6,0,200,0,0
160356798,finnheather,10,306,219,414,5,0,34.1281016394,30-39,494,4,57,79,136,136,57,79,7,2.546702377,606.1141936546,0.0786851355,0.1656862745,0.5039474,0,66,3.165738410195178E-4,3.475093E-4,3.520229E-4,390,14,11,199,10,0.0552763819
160432735,Sonny_Resist,10,2887,153,137,11,8,38.1779453281,30-39,650,6,4,7,11,11,4,7,7,3.0984265149,12.2646053196,0.0026672915,0.2,0.3888889,0,66,6.0300103330744E-5,2.99577E-5,3.0346804E-5,47,5,0,200,0,0
160576237,CFOAB,10,5875,23178,60,321,0,59.8983607357,50-59,798,4,7,0,7,7,7,0,0,0,0,5.20196274100714E-4,0.0476190476,0.04761905,203,411,2.830215405035728E-4,4.793232E-5,0,212,12,0,200,0,0
161107042,sindark,10,2606,236,469,15,460,,,600,6,6,23,29,29,6,23,7,2.7546032809,167.1799844917,0.0067833479,0.1145320197,0.25889328,0,66,7.631267999826884E-5,4.194078E-5,4.2485524E-5,55,3,0,200,0,0
161475722,akaKaiser,10,2219,150,327,1,10,26.7653204274,20-29,602,6,4,18,22,22,4,18,6,2.6712420489,68.8520537769,0.0108776283,0.1341991342,0.2908497,0,66,7.35134068438375E-5,2.99577E-5,3.0346804E-5,372,8,1,200,1,0.005
161783335,Newswriter22,10,28800,1237,600,83,36,44.9762682044,40-49,797,9,19,8,27,27,19,8,7,3.0602611316,3150.5465203437,0.0108720517,0.1068376068,0.23376623,0,66,1.1156293650330947E-4,1.198308E-4,1.2138722E-4,140,24,0,201,0,0
161797179,ScottAWolfe,10,5083,1131,2000,43,41,46.1487117284,40-49,678,7,27,94,121,121,27,94,7,2.500167392,3020.7210076343,0.0457289463,0.1814049587,0.3425876,0,66,1.723094959331848E-4,1.6776312E-4,1.699421E-4,390,6,0,200,0,0
161849864,neilredknap,10,2997,224,90,8,0,43.1069026606,40-49,670,6,46,28,74,74,46,28,7,2.6936725812,618.0519484697,0.0526256464,0.1369863014,0.35521886,0,66,2.080993570452044E-4,2.8160238E-4,2.8525994E-4,390,39,3,200,3,0.015
162230121,BentheGood,10,2715,269,124,7,5,46.7971947608,40-49,628,5,28,15,43,43,28,15,7,2.9648476733,58.52069305,0.0352103228,0.1290143965,0.46305418,0,66,1.8973377737929349E-4,1.7375466E-4,1.7601145E-4,390,4,0,200,0,0
162494640,WathenPF,10,831,44,130,1,2,30.5602171062,30-39,584,5,0,0,0,0,0,0,0,0,0,0,0,0,345,631,4.4780486537007367E-5,0,0,354,2,0,198,0,0
162606435,vancitydan,10,22518,603,1218,23,283,40.291488634,40-49,761,8,9,15,24,24,9,15,7,2.7432206227,45.545863236,0.0136055607,0.1576086957,0.32163742,0,66,9.79617133634775E-5,5.99154E-5,6.069361E-5,47,1,0,202,0,0
163217488,webwildink,10,51954,3209,2968,66,646,46.872170157,40-49,785,9,216,249,465,465,216,249,6,2.1894877804,29931.1940486252,0.2309832437,0.0356646274,0.18503937,0,66,5.998464572816555E-4,0.0013001641,0.0013170512,47,288,0,213,0,0
163298152,JJVenky,10,5537,138,357,6,332,49.8540675257,40-49,695,7,23,39,62,62,23,39,7,2.6156678942,4292.7355773873,0.0188169098,0.1316763617,0.3,0,66,1.9491894540595616E-4,1.4379696E-4,1.4566466E-4,55,47,0,200,0,0
163405115,amsterdamremco,10,1395,183,689,2,5,33.991769598,30-39,534,5,0,0,0,0,0,0,0,0,0,0,0,0,360,654,4.4780486537007367E-5,0,0,369,2,0,200,0,0
163861697,S_EFortin,10,12419,1807,886,49,7,57.5103130308,50-59,784,7,27,23,50,50,27,23,7,2.7348510211,653.5837245842,0.0262697915,0.06,0.3346561,0,66,1.4807191396048954E-4,1.6776312E-4,1.699421E-4,390,41,0,200,0,0
164075542,josh_wingrove,10,11978,4829,931,188,3,63.1567092465,60-69,784,7,187,51,238,238,187,51,7,2.692668229,5855.4833072963,0.1892101604,0.0727404886,0.14057215,0,66,0.0012765829,0.0011264095,0.0011410398,372,204,0,201,0,0
164324862,flemingjude,10,32529,462,1281,22,8959,41.015995368,40-49,716,9,36,60,96,96,36,60,6,2.3461667225,2530.5852933728,0.0499583888,0.1213815789,0.26623377,0,66,1.7571966844842524E-4,2.2168698E-4,2.2456635E-4,47,13,0,207,0,0
164451662,UpThePitt,10,4858,553,533,20,121,48.4316258005,40-49,708,7,17,30,47,47,17,30,7,2.7418814864,108.5064341483,0.0232118806,0.111933395,0.2764706,0,66,1.2004909795229816E-4,1.0784772E-4,1.0924849E-4,140,8,0,200,0,0
165245722,AleeFariii,10,10791,232,492,0,7,36.3105695788,30-39,587,5,2,2,4,4,2,2,1,1,0,1.529712617250445E-4,0.0833333333,1,325,589,2.985240256774393E-4,1.797462E-5,1.8208082E-5,330,13,0,202,0,0
165286708,catscortex,10,17937,454,304,17,121,44.6856436362,40-49,761,8,26,41,67,67,26,41,6,2.5584198192,313.1827481039,0.0496743134,0.1259611036,0.40483093,0,66,3.0209904437571454E-4,1.6177158E-4,1.6387274E-4,140,6,0,200,0,0
165493994,Proud_Libtard,10,15905,803,757,16,982,51.3540118242,50-59,770,8,178,180,358,358,178,180,6,2.1710746568,13496.2427784166,0.2111117903,0.0401389606,0.255019,0,66,4.7216062526518393E-4,0.0010724857,0.0010864156,47,133,0,201,0,0
165514010,Twin_Sanity,10,5821,61,140,0,193,29.6425390007,20-29,662,7,0,0,0,0,0,0,0,0,0,0,0,0,266,500,4.4780486537007367E-5,0,0,263,1,0,200,0,0
165516074,RaymondAMenard,10,2790,407,465,4,172,49.0370560346,40-49,663,6,49,63,112,112,49,63,6,2.4007365249,3334.1476839822,0.0566184852,0.0452059202,0.21453373,0,66,1.9369719464454183E-4,2.99577E-4,3.0346803E-4,47,36,0,204,0,0
165533527,kriegercartoons,10,2073,784,798,30,6,47.0099406124,40-49,697,6,23,29,52,52,23,29,7,2.6183461667,734.5167066038,0.0155819861,0.1266968326,0.29959515,0,66,1.639998323135567E-4,1.4379696E-4,1.4566466E-4,55,23,1,200,1,0.005
166161682,DiditSEM,10,1054,358,330,17,1,42.3837725722,40-49,580,4,0,0,0,0,0,0,0,0,0,0,0,0,318,577,4.4780486537007367E-5,0,0,319,17,0,200,0,0
166398809,Clarkie1977,10,1334,186,233,5,0,40.003983711,40-49,623,6,4,6,10,10,4,6,8,4.6598593907,4.289379085,3.5296538574855463E-4,0.1111111111,0.6333333,0,66,1.966218888355149E-4,2.99577E-5,3.0346804E-5,31,35,0,199,0,0
166638826,tenzinster,10,683,252,696,4,305,47.0990208643,40-49,605,5,32,74,106,106,32,74,6,2.4144626716,5663.3966652532,0.0414768021,0.1189577718,0.33766234,0,66,2.0269000873196166E-4,1.9772082E-4,2.0028891E-4,390,29,1,200,1,0.005
166642906,gjgijsbert,10,2720,319,323,4,25,45.2999047042,40-49,633,5,0,0,0,0,0,0,0,0,0,0,0,0,198,379,4.4780486537007367E-5,0,0,192,8,0,200,0,0
166811593,davipaws,10,106,9,6,0,0,19.1597621605,10-19,269,2,1,0,1,1,1,0,0,0,0,1.2838023297553504E-4,0,0,0,61,4.747046245370493E-5,1.198308E-5,0,140,2,0,110,0,0
167132271,Estrategiacl,10,41303,20589,8642,505,8,55.7277089819,50-59,882,6,15,5,20,20,15,5,10,5.6019417476,15275.3,0.0011731985,0.0368421053,0.0952381,0,66,3.9664615074059856E-4,9.586464E-5,8.497105E-5,320,19,0,203,0,0
167156495,maggie172,10,2879,47,75,2,91,41.2771575148,40-49,633,6,6,3,9,9,6,3,8,3.2015400067,2.8356667269,0.0066298881,0.0972222222,0.21428572,0,66,5.9633837560943835E-5,4.194078E-5,4.2485524E-5,47,2,1,201,1,0.0049751244
167990608,superbugfighter,10,159,64,41,2,1,41.0508644318,40-49,444,3,2,1,3,3,2,1,9,4.3277535989,0,1.8392925399437875E-4,0.1666666667,1,0,66,7.836824587099387E-5,1.797462E-5,1.8208082E-5,55,1,0,180,0,0
168504027,RandySRoberts,10,2161,270,912,5,75,55.7214621808,50-59,649,6,2,8,10,10,2,8,7,2.9876129896,2.9977665146,0.0023438055,0.1111111111,0.23214285,0,66,5.2067636063267745E-5,1.797462E-5,1.8208082E-5,390,15,0,201,0,0
168798900,dreahouston,10,16137,3105,1195,180,91,59.9197184776,50-59,798,8,127,63,190,190,127,63,7,2.5319718781,4838.6413744135,0.156606196,0.0929546087,0.20532438,0,66,6.750918159824693E-4,7.6691713E-4,7.708088E-4,390,82,0,200,0,0
169125181,jasongariepy,10,1036,601,541,17,55,46.6654028293,40-49,668,5,17,35,52,52,17,35,7,2.6919986609,226.8792019724,0.0136984004,0.1180241327,0.31376517,0,66,1.327987577834377E-4,1.0784772E-4,1.0924849E-4,372,11,0,200,0,0
169236244,drstoopid,10,361,12,65,0,3,33.3091590163,30-39,510,4,3,13,16,16,3,13,7,2.7669902913,17.0632600198,0.0026850193,0.1708333333,0.32692307,0,66,5.493152628345022E-5,2.396616E-5,2.4277442E-5,47,2,3,200,3,0.015
169259398,JamesWoodHerald,10,4829,1984,602,98,0,58.752691781,50-59,735,6,103,46,149,149,103,46,7,2.7582859056,1751.8309286097,0.1061529432,0.1110103392,0.2298414,0,66,8.716294091971283E-4,6.2312017E-4,6.312135E-4,372,33,4,200,4,0.02
169631777,Spoogicus,10,487,31,111,0,5,17.1299232928,10-19,468,3,0,0,0,0,0,0,0,0,0,0,0,0,370,676,4.4780486537007367E-5,0,0,380,0,0,200,0,0
169637331,poyannah,10,2892,567,1495,3,119,39.5960875504,30-39,707,6,171,351,522,522,171,351,6,2.0790090392,23192.0146251789,0.2083668632,0.0633691472,0.20072861,0,66,4.3994267994620575E-4,0.0010305449,0.0010439301,47,7,0,162,0,0
169657063,RebeccaFaustina,10,196,207,422,10,0,41.4428393352,40-49,478,4,14,31,45,45,14,31,7,2.7746903247,585.8464057811,0.0029545527,0.1202020202,0.35282257,0,66,1.3995946569923923E-4,8.98731E-5,9.104041E-5,372,28,1,200,1,0.005
169670184,rk70534,10,33932,671,2002,26,41,57.3380450313,50-59,735,9,23,25,48,48,23,25,7,2.6514897891,274.1328789661,0.0246674762,0.0518617021,0.31196582,0,66,1.0703296631379449E-4,1.4379696E-4,1.4566466E-4,47,1,0,201,0,0
169986395,ClaireYYZ,10,2965,677,344,26,42,56.0362608762,50-59,712,6,28,18,46,46,28,18,7,2.8443254101,111.8464908199,0.0247026439,0.1101449275,0.2825312,0,66,1.4558492656813014E-4,1.7375466E-4,1.7601145E-4,140,21,0,199,0,0
170041767,FraIsgaRcoN,10,33278,948,917,1,61,48.7480120255,40-49,790,8,3,3,6,6,3,3,1,1,1,2.3105670282982523E-4,0.0666666667,0.6666667,168,322,3.525121730720189E-4,2.396616E-5,2.4277442E-5,163,107,0,201,0,0
170361954,Jason_Heisler,10,3121,1002,962,15,17,45.2546593339,40-49,693,6,5,7,12,12,5,7,6,2.9196518246,61.0094927193,0.0058302151,0.1212121212,0.53571427,0,66,7.163257272580966E-5,3.594924E-5,3.6416164E-5,372,0,0,201,0,0
170774815,MikePMoffatt,10,54675,3746,510,165,1,63.3786035418,60-69,883,9,264,45,309,309,264,45,7,2.6789420824,3255.3696691973,0.2824621584,0.0695372589,0.123511024,0,66,0.0016329029,0.0015877581,0.0015901725,140,597,0,201,0,0
171102859,daly_beauty,10,50487,6807,1795,125,972,65.437592723,60-69,842,9,89,67,156,156,89,67,6,2.4261801138,6976.9420783261,0.1218448195,0.0495037221,0.21880342,0,66,6.419528173092301E-4,5.392386E-4,5.4624246E-4,140,139,0,201,0,0
171236379,LW709,10,2490,149,181,0,1964,33.3251716379,30-39,571,6,2,2,4,4,2,2,7,3.656176766,0,8.995764020896007E-4,0.0833333333,1,0,66,6.925294332108141E-5,1.797462E-5,1.8208082E-5,372,15,0,199,0,0
171606833,LindaFrum,10,85,264,401,3,3,45.6144407072,40-49,539,3,28,45,73,73,28,45,6,2.6799464345,216.2651641803,0.0589104516,0.1641933029,0.3881579,0,66,4.442526512430273E-4,1.7375466E-4,1.7601145E-4,372,16,0,125,0,0
171805432,JasonCossette,10,2843,947,1174,31,11,,,641,6,6,9,15,15,6,9,7,2.8151991965,65.0725622249,0.0084788449,0.119047619,0.42222223,0,66,6.623224142224856E-5,4.194078E-5,4.2485524E-5,390,0,0,200,0,0
172487387,agdconstruccion,10,3557,1685,1540,29,1,44.7425118069,40-49,650,4,2,5,7,7,2,5,9,4.6049548042,2236.85,2.0710324681093756E-4,0.0952380952,0.25,0,66,1.3537636135373113E-4,1.797462E-5,1.8208082E-5,320,1,0,200,0,0
173137904,vancouver_rt,10,658817,5845,0,226,0,41.5176094738,40-49,870,12,14,0,14,14,14,0,0,0,0,0.018354493,0.1758241758,0.26373628,0,18,1.1060776637877542E-4,8.98731E-5,0,47,0,0,205,0,0
173465009,joeyarchibald,10,3731,637,1997,7,9,56.2883115802,50-59,682,6,35,102,137,137,35,102,6,2.2909273519,2799.0684760801,0.0544403631,0.120330614,0.2776079,0,66,1.4245868317654773E-4,2.1569544E-4,2.1849698E-4,140,19,0,200,0,0
173469798,Earth_NewsRT,10,146152,4229,0,395,0,47.1934241172,40-49,861,10,35,0,35,35,35,0,0,0,0,0.0331469827,0.1193277311,0.19579832,0,17,1.63418566556158E-4,2.1569544E-4,0,47,14,0,203,0,0
173496568,jenaleighb,10,1070,222,284,0,2,35.393430851,30-39,598,5,4,5,9,9,4,5,2,1.1666666667,0.6666666667,3.217667102775563E-4,0.1111111111,0.7,264,497,1.8798441438917248E-4,2.99577E-5,3.0346804E-5,261,2,0,200,0,0
173580066,toronto_rt,10,720860,4327,0,189,0,41.1737993773,40-49,885,11,10,0,10,10,10,0,0,0,0,0.0131633022,0.1,0.17777778,0,16,6.974314190004015E-5,6.590694E-5,0,140,2,0,191,0,0
174036746,theEARLofSWIRL,10,1592,264,638,16,1644,36.2438862539,30-39,533,5,15,40,55,55,15,40,7,2.5199196518,32.1887885124,0.0348655755,0.1569023569,0.46346155,0,66,1.0147102881638967E-4,9.586464E-5,9.710977E-5,47,2,1,200,1,0.005
174137795,WoodfordCKNW980,10,17277,3504,1710,155,2,54.1346034958,50-59,784,8,113,101,214,214,113,101,6,2.4442584533,4245.2755236658,0.1233347796,0.0932166206,0.19333915,0,66,5.968548944695687E-4,6.830355E-4,6.9190713E-4,55,131,0,203,0,0
174285518,Crommunist,10,21071,3108,292,117,38,62.6031363067,60-69,797,8,62,27,89,89,62,27,7,2.5949112822,8687.5078002124,0.0693330591,0.0923135853,0.16983017,0,66,3.4390539436466775E-4,3.7746702E-4,3.8236973E-4,47,67,0,202,0,0
174416040,jonathoncomfort,10,1750,399,267,22,75,62.3575660827,60-69,664,6,57,67,124,124,57,67,7,2.453297623,4714.5155045698,0.0704116211,0.0902832415,0.25093502,0,66,2.1239004800677032E-4,3.475093E-4,3.398842E-4,47,44,2,201,2,0.0099502488
174420405,MATOSCBA,10,16230,1002,645,12,353,46.2450453337,40-49,768,8,1,1,2,2,1,1,1,1,0,7.49471721243357E-5,0,0,315,570,2.9852402567743944E-4,1.198308E-5,1.2138721E-5,314,7,0,200,0,0
175121830,laurablanke,10,2426,134,118,0,313,37.0552080119,30-39,632,5,3,4,7,7,3,4,2,1.2,0,2.3735479204474417E-4,0.1428571429,0.8333333,0,49,2.3681532511563334E-4,2.396616E-5,2.4277442E-5,27,0,0,198,0,0
175392647,SpartanVTyranny,10,10890,511,800,21,216,52.5575763033,50-59,730,7,94,109,203,203,94,109,6,2.4070974222,7914.4013062247,0.1454625506,0.133687753,0.3201406,0,66,4.7767453674370464E-4,5.691963E-4,5.7658926E-4,140,66,0,200,0,0
175481424,3mendous,10,7436,1420,996,58,156,53.0342921089,50-59,752,7,210,113,323,323,210,113,7,2.3608972213,11628.5447875151,0.3157326409,0.0809184086,0.22532189,0,66,0.001099259,0.001264215,0.0012806351,47,90,2,200,2,0.01
175925311,dougalgodfrey,10,21011,338,765,19,24,43.6526473053,40-49,770,8,10,21,31,31,10,21,6,2.6514897891,48.4227681337,0.0173237745,0.1344086022,0.4199134,0,66,8.333580953540106E-5,6.590694E-5,6.6762965E-5,140,0,0,200,0,0
176207343,bobzimmermp,10,3465,1079,172,99,2,51.047259234,50-59,729,6,76,19,95,95,76,19,6,2.8650820221,219.9646022684,0.0954122054,0.163493841,0.27438325,0,66,6.876171293973286E-4,4.6134857E-4,4.612714E-4,372,47,15,200,12,0.075
176306039,WOComoxValley,10,463,26,88,0,1,21.1081886256,20-29,457,4,5,10,15,15,5,10,7,2.8788081687,1.9075651372,0.006859831,0.3095238095,0.4047619,0,66,5.334115557421492E-5,3.594924E-5,3.6416164E-5,47,2,0,199,0,0
176398351,Wascally7Wabbit,10,15960,310,453,4,223,33.7766159102,30-39,680,8,52,84,136,136,52,84,6,2.3381319049,698.2390737129,0.1028227351,0.1047385621,0.37461695,0,66,2.2082079926862908E-4,3.175516E-4,3.216761E-4,47,6,0,200,0,0
176548558,calmecam,10,1333,30,71,0,20,27.5663302404,20-29,526,5,5,11,16,16,5,11,7,2.7964512889,3.8888103675,0.0094711706,0.3125,0.4952381,0,66,5.598209415982681E-5,3.594924E-5,3.6416164E-5,140,8,0,200,0,0
176548718,mtremblay2010,10,4205,257,270,5,14,34.7571428255,30-39,607,6,0,2,2,2,0,2,7,2.9601740295,0,0,0.5,1,0,637,4.4780486537007367E-5,0,6.0693606E-6,390,4,0,200,0,0
176614741,mrklvngstn,10,245,135,249,3,3,40.0923645773,40-49,574,4,9,14,23,23,9,14,7,3.041848008,52.944901635,0.0050361211,0.1324110672,0.32352942,0,66,7.579474893230007E-5,5.99154E-5,6.069361E-5,140,12,2,197,2,0.0101522843
176801189,HowardSternBot,10,36807,3301,19,55,8,36.7154685563,30-39,733,9,0,0,0,0,0,0,0,0,0,0,0,0,321,580,4.4780486537007367E-5,0,0,324,13,3,203,3,0.0147783251
177303552,KendallMade,10,562,71,23,2,7,29.0385761834,20-29,477,4,1,3,4,4,1,3,7,3.2483266399,4.6100915646,7.34391852452689E-5,0.0833333333,0.083333336,0,279,5.1124389058153783E-5,1.198308E-5,6.0693606E-6,47,1,0,200,0,0
177416004,nojgr,10,5605,104,388,2,51,43.2579397063,40-49,594,7,34,68,102,102,34,68,6,2.3234014061,739.2446354569,0.0478019571,0.1273539119,0.32245386,0,66,1.3014060840474179E-4,2.097039E-4,2.1242762E-4,47,16,3,201,3,0.0149253731
177602450,jodypercy,10,1929,476,1039,14,1,44.2799169578,40-49,668,6,53,111,164,164,53,111,6,2.3528624037,2752.9674797108,0.072348155,0.1027607362,0.31000644,0,66,2.2195050611954282E-4,3.2354315E-4,3.2774548E-4,390,44,0,200,0,0
177671430,MissFIoyd,10,1959,281,260,16,22,37.4505868575,30-39,652,5,1,1,2,2,1,1,9,4.5952460663,0,8.76646441857328E-5,0,0,0,66,9.677607339940816E-5,1.198308E-5,1.2138721E-5,320,2,0,200,0,0
178097164,auntbeulah,10,7899,106,122,6,26,41.2746062797,40-49,619,7,13,18,31,31,13,18,7,2.6869768999,24.2694792115,0.0231442412,0.1892473118,0.45166665,0,66,7.761429055637068E-5,8.388156E-5,8.497105E-5,140,2,0,200,0,0
178196480,joshyfraser,10,4371,514,482,19,390,52.4174054928,50-59,680,6,45,45,90,90,45,45,7,2.6344158018,1004.7747394555,0.0484502032,0.1232209738,0.24666667,0,66,2.1608833889551085E-4,2.7561083E-4,2.791906E-4,140,16,0,199,0,0
178287743,CH_Cartoon,10,1442,2889,749,112,104,50.2746663342,50-59,718,5,61,31,92,92,61,31,7,2.8520254436,10804.9366433925,0.0699962075,0.0930482561,0.19596492,0,66,5.360555077382388E-4,3.7147547E-4,3.520229E-4,140,93,1,200,1,0.005
178401121,theultimateaven,10,16960,633,2001,9,1,32.1064718404,30-39,625,8,17,15,32,32,17,15,7,2.7556076331,58.1696386123,0.0246685783,0.1703629032,0.3004926,0,66,8.767701599636053E-5,1.0784772E-4,1.0924849E-4,47,1,0,198,0,0
178540278,silviustd,10,2886,36,359,0,39,46.9516125166,40-49,437,5,1,9,10,10,1,9,7,2.8366253766,0.6187966608,0.0039162934,0.2333333333,0.4722222,0,66,5.034065667458013E-5,1.198308E-5,1.2138721E-5,372,0,0,201,0,0
178794231,jonnyenviro,10,2996,138,583,0,16,25.2173236751,20-29,577,6,12,22,34,34,12,22,7,2.6153331101,189.3620708767,0.015799338,0.1212121212,0.33076924,0,66,8.092495415327165E-5,7.789002E-5,7.8901685E-5,47,0,1,200,1,0.005
178824088,Fitter660,10,736,40,161,2,7,17.3294859927,10-19,309,5,7,18,25,25,7,18,7,2.8048208905,42.9745781102,0.0098782286,0.16,0.2952381,0,66,5.949591905771517E-5,4.793232E-5,4.8554884E-5,140,0,0,199,0,0
178879310,tweetingLew,10,829,48,97,0,4,31.3192489175,30-39,563,5,3,9,12,12,3,9,7,2.8848342819,12.4765614184,0.0017301645,0.1363636364,0.21818182,0,66,5.278534900575554E-5,2.396616E-5,2.4277442E-5,372,2,1,200,1,0.005
179316969,orwellsbastard,10,2799,743,374,52,217,47.1735121332,40-49,715,6,143,69,212,212,143,69,7,2.5061935052,1816.4697753349,0.1998719882,0.1039524278,0.27651396,0,66,5.063224551995151E-4,8.627818E-4,8.739879E-4,47,11,2,199,2,0.0100502513
180005108,JKennethY,10,5383,837,2001,12,33,52.4317431114,50-59,730,7,181,447,628,628,181,447,6,2.0659524607,26294.2717632901,0.2416167077,0.0630999909,0.16897105,0,66,5.251752455747843E-4,0.0010904602,0.0011046237,47,17,1,200,1,0.005
180093728,mallorydaley,10,2612,220,648,4,187,41.0335545904,40-49,661,6,34,83,117,117,34,83,7,2.5065282893,3095.9654448428,0.0426852832,0.1397730622,0.3675488,0,66,1.9738937140427486E-4,2.097039E-4,2.1242762E-4,390,90,1,200,1,0.005
180377030,dorineeee_,10,4140,132,136,0,0,40.838875276,40-49,715,5,0,0,0,0,0,0,0,0,0,0,0,0,188,361,4.4780486537007367E-5,0,0,184,2,0,200,0,0
180443064,Heading_West,10,6452,194,353,11,113,46.3201295062,40-49,714,7,35,37,72,72,35,37,7,2.6062939404,435.7498165006,0.0590370373,0.1036776213,0.296003,0,66,1.7050840908691984E-4,2.1569544E-4,2.1849698E-4,47,8,0,200,0,0
180715429,CritReviews,10,3875,105,478,1,54,41.0437938908,40-49,625,6,2,17,19,19,2,17,7,2.6996986943,2.3716859715,0.005580256,0.1608187135,0.30514705,0,66,5.102484312353722E-5,1.797462E-5,1.8208082E-5,47,3,1,200,1,0.005
180981592,KiaraJabib,10,46936,334,191,7,122,42.1225744469,40-49,813,9,2,2,4,4,2,2,3,1.8,8,1.5298659959555013E-4,0,0,60,152,3.162593808625975E-4,1.797462E-5,1.8208082E-5,53,78,0,201,0,0
181043440,mdelow,10,54,25,29,1,0,38.0549015583,30-39,377,3,2,6,8,8,2,6,7,3.2142618011,4.2505271265,3.148948445886456E-4,0.1785714286,0.6,0,66,6.279690178321874E-5,1.797462E-5,1.8208082E-5,55,16,2,93,2,0.0215053763
181176786,cyberrat46,10,81,5,37,0,1,11.7341444214,10-19,4,3,0,1,1,1,0,1,7,3.250669344,0,0,0,0,0,289,4.4780486537007367E-5,0,6.0693606E-6,47,0,0,112,0,0
182055360,sfullofbs,10,1055,41,88,0,1194,28.7132900028,20-29,597,5,0,0,0,0,0,0,0,0,0,0,0,0,84,184,4.4780486537007367E-5,0,0,78,4,0,200,0,0
182865739,Eviann_J,10,8522,177,261,0,382,47.5986377612,40-49,715,7,0,0,0,0,0,0,0,0,0,0,0,0,131,252,4.4780486537007367E-5,0,0,128,3,0,201,0,0
182995976,tersestuff,10,35061,708,361,17,454,40.401803896,40-49,785,9,192,127,319,319,192,127,7,2.3428188818,9122.0626053855,0.2045740649,0.0770390962,0.22882096,0,66,5.983888678236426E-4,0.0011563672,0.0011713866,47,144,2,214,2,0.0093457944
183076776,Prespssp,10,102,28,18,1,0,34.4028037001,30-39,434,3,2,0,2,2,2,0,0,0,0,3.1089209653900585E-4,0.5,1,0,38,5.2589004262889535E-5,1.797462E-5,0,390,2,0,120,0,0
183114838,C_onfessor,10,65723,1862,869,129,115,,,889,9,228,153,381,381,228,153,6,2.3046534985,9541.3536997051,0.2821308606,0.0686351706,0.23322582,0,66,7.095577487798624E-4,0.0013720626,0.0013898836,47,377,0,201,0,0
184164307,Tsiehta,10,1957,46,118,4,11,26.8102670672,20-29,622,6,5,13,18,18,5,13,7,2.8640776699,1708.497795743,0.0072350569,0.1830065359,0.42380953,0,66,9.274803935764659E-5,3.594924E-5,3.6416164E-5,140,1,1,199,1,0.0050251256
184862799,diamond_d2,10,1458,60,164,1,970,27.8272005115,20-29,570,5,1,1,2,2,1,1,8,4.4204887847,0,8.270926887873718E-5,0,0,0,66,1.0207987623313145E-4,1.198308E-5,1.2138721E-5,320,0,0,199,0,0
184931005,natgdulz,10,5549,136,193,0,815,41.5953633057,40-49,613,3,6,9,15,15,6,9,7,3.3153665886,6.1567205777,0.0010699572,0.1380952381,0.53333336,0,66,7.529397448048785E-5,4.194078E-5,4.2485524E-5,372,20,1,200,1,0.005
185290543,gordperks,10,2438,3970,526,211,5,60.7003464856,60-69,768,6,125,39,164,164,125,39,7,2.7197857382,4316.4334872894,0.1185181941,0.0735448152,0.15076871,0,66,5.872606951183577E-4,7.5493404E-4,7.526007E-4,390,52,0,200,0,0
185459722,rosielefaive,10,95,39,62,1,1,24.8004526536,20-29,342,2,0,1,1,1,0,1,7,3.3741633199,0,0,0,0,0,507,4.4780486537007367E-5,0,6.0693606E-6,390,0,0,98,0,0
185472553,KAL301,10,62964,1364,767,15,12316,47.3356817618,40-49,779,9,60,42,102,102,60,42,6,2.4382323401,4245.7707025159,0.0690680595,0.0589205979,0.20805065,0,66,3.53615047781283E-4,3.6548392E-4,3.70231E-4,47,58,0,201,0,0
185630556,votelau,10,6401,422,607,19,1347,49.2129955931,40-49,707,7,63,94,157,157,63,94,6,2.3424840978,7199.3655774089,0.0691309327,0.049281398,0.15764415,0,66,2.7326180681607246E-4,3.8345857E-4,3.8843908E-4,390,65,0,200,0,0
185777196,_E_And,10,6360,1007,634,24,117,52.4800000271,50-59,738,7,169,76,245,245,169,76,7,2.7164378976,5565.8824963221,0.2048851014,0.0985613918,0.24010462,0,66,8.538788424331902E-4,0.0010185618,0.0010317913,390,60,3,200,3,0.015
185815993,coatesdavid,10,324,372,278,27,0,36.0436878212,30-39,540,2,2,2,4,4,2,2,7,3.229327084,9.0564559841,0.0019657966,0.0833333333,0.33333334,0,66,5.000827508008745E-5,1.797462E-5,1.8208082E-5,47,0,0,200,0,0
185852300,SinAspen,10,7671,533,930,11,1040,45.7868885756,40-49,726,7,101,188,289,289,101,188,6,2.2544358889,10315.299060289,0.1242076403,0.0633169935,0.20517015,0,66,4.534490285917001E-4,6.111371E-4,6.190748E-4,390,72,1,200,1,0.005
185947193,MVLibertas,10,55807,660,611,18,3,45.4887664419,40-49,785,9,38,50,88,88,38,50,6,2.6598593907,1712.4221395427,0.0514015139,0.1082810867,0.27317956,0,66,3.9431414507479386E-4,2.3367006E-4,2.3670506E-4,372,42,2,203,2,0.0098522167
186273990,miltonlaura,10,8149,387,228,18,5,56.3618137576,50-59,699,7,8,8,16,16,8,8,7,2.8362905926,21.347409195,0.0153280936,0.2333333333,0.4010989,0,66,7.501379720011946E-5,5.392386E-5,5.4624245E-5,140,10,0,201,0,0
186285606,pettyrivergirl,10,7733,332,301,5,28,51.7292474458,50-59,722,8,59,32,91,91,59,32,7,2.5925677938,337.4947232684,0.0736503677,0.1294261294,0.32575452,0,66,1.7232839716526787E-4,3.594924E-4,3.6416165E-4,47,49,1,207,1,0.0048309179
186307153,karenatsharon,10,914,55,71,5,33,46.2196251622,40-49,613,5,1,1,2,2,1,1,7,3.4067626381,0,0.0010217293,0,0,0,66,4.850547416264142E-5,1.198308E-5,1.2138721E-5,140,2,0,200,0,0
186483691,Jahlys_FAMOUS,10,2984,132,145,1,6,46.1119320733,40-49,694,6,2,5,7,7,2,5,7,3.2121212121,1.075,1.7737628939211656E-4,0.119047619,0.45,30,104,1.233561932973685E-4,1.797462E-5,1.8208082E-5,315,31,0,201,0,0
186500600,msewen,10,2778,843,1115,57,39,49.0858645693,40-49,698,7,29,36,65,65,29,36,7,2.6534984935,1143.4100940503,0.0234571943,0.040625,0.20555556,0,66,1.358155682713901E-4,1.797462E-4,1.8208082E-4,55,12,0,200,0,0
186602385,0_Canada,10,29339,665,1225,27,16,43.010850405,40-49,772,9,166,230,396,396,166,230,6,2.2152661533,8920.5764589247,0.2414233503,0.0793248945,0.20916234,0,66,6.143340026591125E-4,0.0010005871,0.0010135833,47,24,8,200,7,0.04
186907090,Val_M_Diaz,10,2405,34,32,0,309,23.5767551679,20-29,475,5,0,0,0,0,0,0,0,0,0,0,0,0,274,519,4.4780486537007367E-5,0,0,272,0,0,200,0,0
187140926,daniela_aum,10,46104,1388,2001,47,3928,55.6112888602,50-59,753,9,67,81,148,148,67,81,7,2.3836625377,3526.3781447365,0.1138274584,0.1133940063,0.30640504,0,66,3.4128745126938955E-4,4.0742473E-4,4.1271653E-4,47,10,0,205,0,0
187214966,DaisyLouMae,10,3502,552,1634,10,90,41.7455656873,40-49,595,6,9,42,51,51,9,42,6,2.4301975226,403.4132494274,0.0132068087,0.1396078431,0.26374206,0,66,7.266583416365452E-5,5.99154E-5,6.069361E-5,140,0,0,200,0,0
187654680,AWC_Calgary,10,5432,267,365,11,637,45.2519723659,40-49,535,6,45,39,84,84,45,39,7,2.6016069635,576.491922136,0.0400308387,0.0880665519,0.32457912,0,66,2.061372008161741E-4,2.7561083E-4,2.791906E-4,47,5,0,199,0,0
187805921,canadianglen,10,24070,1723,1999,44,28,54.9226385866,50-59,838,9,235,269,504,504,235,269,6,2.1683963843,50111.4624953618,0.2850242482,0.0399862728,0.20753968,0,66,9.261503483397553E-4,0.0014140034,0.0014323691,47,374,0,212,0,0
187997748,Jamloops,10,6454,1106,713,39,18,48.2346493561,40-49,739,7,14,15,29,29,14,15,7,2.9139604955,22.034218302,0.0152698414,0.2019704433,0.37666667,0,66,1.262352281389274E-4,8.98731E-5,9.104041E-5,55,6,0,200,0,0
188007231,NDP_HQ,10,445,10207,0,238,0,59.2940426989,50-59,747,4,492,0,492,492,492,0,0,0,0,0.400180794,0.0600069544,0.08410743,0,0,0.0023475529,0.0029538292,0,390,415,7,201,6,0.0348258706
188379252,MattSchein,10,2893,521,2001,9,61,42.702804128,40-49,630,6,37,135,172,172,37,135,6,2.3364579846,1591.2905596649,0.0659089336,0.1494288046,0.3103147,0,66,1.9464011441228812E-4,2.2767852E-4,2.306357E-4,390,24,1,200,1,0.005
188733067,chartrandm,10,7876,953,1347,15,40,41.5573696428,40-49,723,7,43,65,108,108,43,65,6,2.452962839,1207.3376756435,0.0629612961,0.0820353063,0.29362285,0,66,1.6267121616481684E-4,2.6362776E-4,2.6705186E-4,47,53,3,202,3,0.0148514851
188916172,4squareviews,10,4532,529,866,8,1,44.836197539,40-49,651,6,1,1,2,2,1,1,8,3.5390023435,0,4.340938659049779E-4,0,0,0,66,4.8369062644149766E-5,1.198308E-5,1.2138721E-5,47,1,0,200,0,0
188983641,KatieBrist,10,27660,232,1067,6,525,34.6196007346,30-39,729,8,16,46,62,62,16,46,7,2.6103113492,122.3780430494,0.0311925539,0.2379693284,0.44915825,0,66,1.1042616265785733E-4,1.0185618E-4,1.0317913E-4,140,7,3,203,3,0.0147783251
189004642,kristruelsen,10,58,37,40,0,3,17.2096651077,10-19,227,3,0,0,0,0,0,0,0,0,0,0,0,0,155,308,4.4780486537007367E-5,0,0,152,0,0,58,0,0
189619402,EugeneHaslam,10,4955,1090,324,50,5,45.870062076,40-49,691,7,20,21,41,41,20,21,7,2.8878473385,94.235420031,0.0327318734,0.2140243902,0.37237236,0,66,1.7938486755095134E-4,1.2582233E-4,1.2745657E-4,140,7,0,200,0,0
189622949,coplancreative,10,1935,252,198,1,0,41.2343563986,40-49,561,3,1,2,3,3,1,2,8,4.8550385002,19.5762513484,8.422120682784922E-5,0,0,0,66,7.927442740923612E-5,1.198308E-5,1.2138721E-5,320,0,0,200,0,0
190012537,journo_dale,10,20812,2877,371,171,3,58.7383922849,50-59,788,8,337,53,390,390,337,53,6,2.5634415802,2819.7609548067,0.4330829367,0.0934809835,0.15813497,0,66,0.0020010138,0.0020251404,0.0020514438,140,414,54,201,32,0.2686567164
190057663,JaviBCordova,10,1939,147,174,0,82,39.0621108928,30-39,627,5,2,2,4,4,2,2,1,1,0,1.529712617250445E-4,0.0833333333,1,325,589,2.985240256774393E-4,1.797462E-5,1.8208082E-5,330,15,0,201,0,0
190224295,BradCabana,10,17714,1075,498,34,75,46.3158653332,40-49,785,8,60,33,93,93,60,33,6,2.494810847,1310.4646991598,0.0904863827,0.0922159888,0.2526339,0,66,2.739223730733615E-4,3.6548392E-4,3.70231E-4,47,73,0,201,0,0
190240891,amdrobinson,10,7020,724,1295,14,65,61.2164756492,60-69,699,6,13,26,39,39,13,26,7,2.604285236,233.8413426013,0.0139331611,0.1585695007,0.3908046,0,66,7.739805913289625E-5,8.388156E-5,8.497105E-5,140,6,0,200,0,0
190251799,D_a_r_i_y_a,10,126,9,98,0,1,20.4574105692,20-29,366,3,0,1,1,1,0,1,8,3.6422356091,0,0,0,0,0,395,4.4780486537007367E-5,0,6.0693606E-6,55,1,0,166,0,0
190386166,miz_keight,10,356,141,143,1,305,41.3348191596,40-49,538,4,1,4,5,5,1,4,7,3.067961165,8.0730678729,1.1102825612447136E-4,0.15,0.2,0,66,5.01614109539121E-5,1.198308E-5,1.2138721E-5,47,0,0,200,0,0
191017430,RyanMLake,10,3483,376,599,18,0,39.9539290242,30-39,650,6,48,67,115,115,48,67,6,2.364579846,2043.7191286894,0.077091328,0.0751334859,0.29166666,0,66,2.530139474924751E-4,2.9358547E-4,2.9739868E-4,140,7,2,200,2,0.01
191054889,marciemcphee,10,351,215,272,0,5,27.1269181026,20-29,562,4,5,5,10,10,5,5,2,1.1666666667,3,3.968362010061254E-4,0.0777777778,0.7,264,497,2.3065899025587807E-4,3.594924E-5,3.6416164E-5,261,9,0,199,0,0
191422128,BeverlyTaft,10,593,129,124,0,81,35.7331646183,30-39,554,5,14,10,24,24,14,10,7,2.9678607298,42.1908218933,0.0111333715,0.1268115942,0.3970588,0,66,1.071302556110171E-4,8.98731E-5,9.104041E-5,390,9,1,200,1,0.005
192302852,AnnSwayze,10,14,51,287,0,20,19.3747043564,10-19,131,2,13,88,101,101,13,88,7,2.4362236358,211.6212738434,0.0215212759,0.2088118812,0.3455767,0,66,7.631603019112512E-5,8.388156E-5,8.497105E-5,47,0,0,15,0,0
192321697,karenmccrimmon,10,693,831,274,53,9,52.2606034478,50-59,679,4,138,60,198,198,138,60,7,2.5426849682,6643.5145615416,0.1638286678,0.1185715018,0.25990567,0,66,6.697425802175455E-4,8.3282404E-4,8.3757174E-4,140,157,0,199,0,0
192427701,Stephen_G_Moore,10,2821,361,254,16,1,,,661,5,40,39,79,79,40,39,7,2.6729159692,350.5362780759,0.0470174444,0.1499513145,0.3521858,0,66,1.892295652562066E-4,2.4565315E-4,2.4884377E-4,390,12,4,185,4,0.0216216216
192583618,Planetintel,10,205,139,230,2,0,22.8943865767,20-29,325,3,0,1,1,1,0,1,7,3.250669344,0,0,0,0,0,542,4.4780486537007367E-5,0,6.0693606E-6,47,2,0,200,0,0
192659552,AnnaAnthro,10,17440,632,1282,39,38,42.421023696,40-49,680,8,35,76,111,111,35,76,6,2.4573150318,1599.5064189913,0.066288341,0.1596232596,0.34395605,0,66,2.192631322305013E-4,2.1569544E-4,2.1849698E-4,140,6,0,201,0,0
192814611,lynneheal,10,5992,161,2002,2,5973,41.0902734014,40-49,556,6,1,2,3,3,1,2,8,3.7417196387,0,7.793326830024201E-5,0.1666666667,0.5,0,106,8.972493312360835E-5,1.198308E-5,1.2138721E-5,140,17,0,201,0,0
192922494,toronto_red,10,3132,86,142,0,13,35.8488474279,30-39,599,6,10,20,30,30,10,20,7,2.6859725477,57.2023837213,0.0113133628,0.1344827586,0.32806325,0,66,6.788265517191482E-5,6.590694E-5,6.6762965E-5,140,11,0,200,0,0
193013796,JMACL3AN,10,2188,437,621,19,29,42.5771765742,40-49,663,6,22,36,58,58,22,36,7,2.5711416137,305.2433169324,0.0302824726,0.0934664247,0.34384385,0,66,1.2590261158325263E-4,1.3780541E-4,1.395953E-4,390,24,0,200,0,0
193154698,dollhouseyyc,10,13500,1265,496,49,35,41.5209498994,40-49,775,8,59,36,95,95,59,36,7,2.8493471711,1836.7306549979,0.0501998136,0.0823068309,0.20321931,0,66,3.8985719150866344E-4,3.594924E-4,3.6416165E-4,372,59,1,200,1,0.005
193156404,Prospero37,10,20714,172,109,8,41,36.8292573529,30-39,709,8,40,12,52,52,40,12,7,2.6966856378,76.1498794198,0.0495988921,0.1349924585,0.39423078,0,66,1.2374705550018505E-4,2.4565315E-4,2.4884377E-4,47,20,0,208,0,0
193309305,PhilOllenberg,10,5490,309,312,9,17,44.9951035955,40-49,703,7,8,8,16,16,8,8,7,3.0033478406,3112.3290657626,0.0069717099,0.2,0.3846154,0,66,7.440549459754054E-5,5.392386E-5,5.4624245E-5,390,18,0,200,0,0
193714026,LeasideBuzz,10,10724,1093,1995,28,108,31.0632646459,30-39,679,7,5,14,19,19,5,14,7,2.6745898895,16.0816204102,0.0193294104,0.1461988304,0.46703297,0,66,7.5406549513933E-5,3.594924E-5,3.6416164E-5,47,0,0,200,0,0
193986339,kingskam,10,11197,859,281,8,444,36.2670216641,30-39,751,7,50,48,98,98,50,48,7,2.463675929,1253.2037989381,0.0658628465,0.0518619819,0.26298702,0,66,1.7708909973378998E-4,3.0556854E-4,3.095374E-4,47,10,0,199,0,0
194222922,TheLeftCall,10,4263,1068,1999,29,5,45.0317042418,40-49,714,6,3,4,7,7,3,4,7,3.2259792434,4.1104905572,0.0014432377,0.119047619,0.75,0,66,6.892800422079857E-5,2.396616E-5,2.4277442E-5,47,79,1,200,1,0.005
194490269,arcticyaks,10,2642,24,47,0,119,34.5852066472,30-39,513,5,3,6,9,9,3,6,7,2.8701037831,5.8656760585,0.0064980902,0.1388888889,0.35714287,0,66,5.3867110428161445E-5,2.396616E-5,2.4277442E-5,47,7,2,200,2,0.01
194641299,vandongene,10,24628,1149,1146,10,5368,46.4086240063,40-49,733,8,31,36,67,67,31,36,6,2.7897556076,873.2406008648,0.021216805,0.1019900498,0.3052729,0,66,1.9612553353813577E-4,1.9172928E-4,1.9421954E-4,372,50,7,200,6,0.035
194741356,Sam_fitts,10,134,44,122,0,1,21.8191360718,20-29,470,3,0,0,0,0,0,0,0,0,0,0,0,0,258,488,4.4780486537007367E-5,0,0,254,0,0,136,0,0
195000753,NKumarBritten,10,3866,383,555,10,132,48.6517839834,40-49,671,7,35,59,94,94,35,59,7,2.4666889856,807.0911470388,0.050521518,0.1654083734,0.33607596,0,66,2.4136635535766752E-4,2.1569544E-4,2.1849698E-4,140,45,3,201,3,0.0149253731
195164291,AllPopGuy,10,9887,728,1796,15,498,59.7722598272,50-59,691,8,97,143,240,240,97,143,6,2.3086709073,3951.2942394994,0.1169052322,0.0885460251,0.27917898,0,66,3.5065486613559195E-4,5.8717094E-4,5.9479737E-4,140,45,1,200,1,0.005
195419614,nickthemack,10,1429,65,158,1,328,28.5589735938,20-29,523,6,14,23,37,37,14,23,7,2.6210244392,4017.4633902026,0.0156770128,0.2237237237,0.35918003,0,66,8.84924610294801E-5,8.98731E-5,9.104041E-5,47,6,0,202,0,0
195455988,OperationMaple,10,5101,1398,1034,66,11,52.2335743843,50-59,733,7,193,143,336,336,193,143,6,2.2460662872,17082.234475955,0.2328024447,0.0713486141,0.19899818,0,66,7.377281752552501E-4,0.0011623588,0.0011713866,47,75,0,200,0,0
195886865,HAPNOC,10,1032,81,126,7,12,32.9831937027,30-39,523,5,6,11,17,17,6,11,7,2.6849681955,1.8768057826,0.0176278146,0.2169117647,0.6217949,0,66,7.050683007128545E-5,4.194078E-5,4.2485524E-5,140,7,0,200,0,0
195903035,BCheadle,10,2732,2336,375,104,19,62.3221956363,60-69,757,6,273,69,342,342,273,69,6,2.515567459,6516.5503083574,0.3945164847,0.0979918026,0.18384756,0,66,0.0020054143,0.001641682,0.0016508661,140,219,2,200,2,0.01
195978878,Lucianaazevedo7,10,851,112,284,1,0,25.9090785793,20-29,451,4,0,0,0,0,0,0,0,0,0,0,0,0,44,129,4.4780486537007367E-5,0,0,37,0,0,201,0,0
196218449,tprcrdr,10,7857,274,610,4,34,43.7578431757,40-49,700,7,10,20,30,30,10,20,7,2.614663542,103.2883561406,0.0161248603,0.1413793103,0.48333332,0,66,7.449682956695953E-5,6.590694E-5,6.6762965E-5,47,8,0,200,0,0
196340725,ott_pol,10,1744,154,874,4,56,37.9356363145,30-39,611,6,7,34,41,41,7,34,6,2.6762638098,21.9666948404,0.0096564743,0.2396341463,0.44594595,0,66,7.040744979896159E-5,4.793232E-5,4.8554884E-5,140,1,0,200,0,0
196349957,Carol_n_Gabe,10,549,33,167,2,81,21.5387522323,20-29,490,4,0,4,4,4,0,4,7,2.984939759,0,0,0.5,0.6666667,0,591,4.4780486537007367E-5,0,6.0693606E-6,140,1,0,200,0,0
196717787,alexboulerice,10,4533,14334,11876,448,8,65.8110203938,60-69,776,6,591,538,1129,1129,591,538,6,1.9755607633,379116.686420783,0.5700195773,0.0179864815,0.08761026,0,66,0.0028156364,0.0035469916,0.0035869922,390,262,39,200,39,0.195
196737461,CatBar63,10,516,29,71,0,40,28.93304913,20-29,478,5,1,1,2,2,1,1,8,4.661533311,0,1.0519277545607168E-4,0,0,0,66,8.333600227631969E-5,1.198308E-5,1.2138721E-5,31,8,0,200,0,0
196819240,oldmcdonaldbear,10,5576,106,364,0,27,26.9354347721,20-29,541,7,1,5,6,6,1,5,7,3.0344827586,0.3428534265,6.029102385012865E-4,0.1333333333,0.3,0,66,4.7321570694625844E-5,1.198308E-5,1.2138721E-5,47,1,0,200,0,0
196978441,gappersonnel,10,458,316,262,0,0,46.9115544038,40-49,603,4,0,0,0,0,0,0,0,0,0,0,0,0,384,698,4.4780486537007367E-5,0,0,394,13,0,200,0,0
197113002,anilainyyc,10,4197,656,304,18,19,40.9849371457,40-49,692,7,16,13,29,29,16,13,7,3.0184131235,32.9316624097,0.0124813143,0.1231527094,0.5261438,0,66,1.8329920676616007E-4,1.0185618E-4,1.0317913E-4,372,4,0,199,0,0
197131222,SahraMaclean,10,1701,422,472,10,11,41.0761368299,40-49,648,6,37,53,90,90,37,53,7,2.5309675259,662.4580609807,0.0339663183,0.1061173533,0.2983631,0,66,1.7415869377610335E-4,2.2767852E-4,2.306357E-4,390,6,0,199,0,0
197176188,CdnPolitico,10,23879,1845,457,82,1052,48.7467504858,40-49,770,8,231,70,301,301,231,70,7,2.5309675259,14116.9809970864,0.2648861088,0.0934994463,0.17896752,0,66,0.0011497871,0.0013900372,0.0014020223,140,173,2,206,2,0.0097087379
197650075,NothingworksDan,10,367,48,196,0,21,15.1642347214,10-19,422,4,6,16,22,22,6,16,6,2.7057248075,33.0059377517,0.0076211501,0.1471861472,0.38235295,0,66,6.626106924262083E-5,4.194078E-5,4.2485524E-5,372,2,0,199,0,0
197672377,chris_p_cream,10,1791,58,128,1,1,35.228356967,30-39,656,6,14,31,45,45,14,31,7,2.6069635085,124.6732510771,0.0249202425,0.1272727273,0.34848484,0,66,8.011464376184005E-5,8.98731E-5,9.104041E-5,47,4,2,200,2,0.01
197891853,calindab,10,208,146,369,1,9,29.487255568,20-29,472,3,26,57,83,83,26,57,7,2.5393371276,718.8469844672,0.0329220378,0.138701146,0.32237762,0,66,1.4519393072647493E-4,1.6177158E-4,1.6387274E-4,390,3,3,200,3,0.015
198122317,WilliamsGarethE,10,2318,324,732,13,9,43.66200233,40-49,619,6,27,72,99,99,27,72,7,2.5386675594,694.6905278399,0.04109922,0.1218305504,0.25679013,0,66,1.285557716039825E-4,1.6776312E-4,1.699421E-4,140,19,3,200,2,0.015
198291682,tcd_news,10,17134,917,112,23,9,44.9444634776,40-49,725,7,6,5,11,11,6,5,7,3.1653833278,156.5839195563,0.0021602166,0.1090909091,0.16666667,0,66,7.263513177241664E-5,4.194078E-5,4.2485524E-5,140,11,0,200,0,0
198405522,Jesse_DeTienne,10,7448,684,1313,10,421,47.4109206334,40-49,724,7,1,1,2,2,1,1,2,1.5,0,7.645535613750089E-5,0,0,197,378,2.29874507414389E-4,1.198308E-5,1.2138721E-5,197,16,0,200,0,0
198674651,kreynolds118,10,1939,444,421,16,31,47.2852212509,40-49,647,5,44,35,79,79,44,35,7,2.6344158018,463.9436645987,0.043146614,0.1212268744,0.2983051,0,66,2.2645368823385434E-4,2.696193E-4,2.7312123E-4,390,21,1,200,1,0.005
198722685,MBolero,10,3158,110,278,1,1774,41.6986727686,40-49,603,6,29,53,82,82,29,53,7,2.5138935387,190.9741640862,0.0481628242,0.127973502,0.35141242,0,66,1.4514056137902525E-4,1.797462E-4,1.8208082E-4,47,7,1,199,1,0.0050251256
198756416,venividitweety,10,9095,588,558,25,170,56.1580971752,50-59,727,7,60,65,125,125,60,65,7,2.4298627385,914.5613325926,0.099158193,0.1058064516,0.3627907,0,66,1.9802317708472655E-4,3.6548392E-4,3.70231E-4,47,7,0,200,0,0
198943825,Resedico,10,7187,461,517,14,2,49.8890540713,40-49,740,7,54,76,130,130,54,76,6,2.5038500167,2040.8186545842,0.0413774638,0.0742397138,0.27366608,0,66,2.7325067970091204E-4,3.295347E-4,3.3381482E-4,372,68,0,201,0,0
199030841,_KelseyIngram,10,1009,435,818,23,2,41.7665715789,40-49,592,5,16,52,68,68,16,52,6,2.4928021426,65.648955033,0.0287680395,0.176690079,0.4231307,0,66,1.0690691030954398E-4,1.0185618E-4,1.0317913E-4,140,1,1,198,1,0.0050505051
199354634,MovingBoxesca,10,15234,810,642,23,174,55.7186678304,50-59,734,7,2,3,5,5,2,3,7,2.9812520924,11.4313117733,0.0040387965,0.05,0.33333334,0,66,5.4864947830897145E-5,1.797462E-5,1.8208082E-5,372,31,0,212,0,0
199457885,MALTEAZERCARM,10,1103,30,78,0,11,19.9709156332,10-19,453,5,0,1,1,1,0,1,7,3.4605087015,0,0,0,0,0,429,4.4780486537007367E-5,0,6.0693606E-6,140,6,1,200,1,0.005
199833381,AlChwk,10,862,67,120,1,1,33.3640282859,30-39,573,5,4,6,10,10,4,6,7,3.3180448611,3.8713997161,0.0046047038,0.2222222222,0.3472222,0,66,6.211685471956512E-5,2.99577E-5,3.0346804E-5,372,2,1,199,1,0.0050251256
200037786,ygwebdesign,10,23298,9628,10590,95,2,46.1231972823,40-49,716,6,4,3,7,7,4,3,7,3.6468028122,14217.5321290723,5.604761953168449E-4,0,0,0,66,1.3101984556750944E-4,2.99577E-5,3.0346804E-5,320,0,0,251,0,0
200140108,aliceedunn,10,10961,1053,725,1,17,46.4300366664,40-49,764,7,7,0,7,7,7,0,0,0,0,5.806953722925451E-4,0.5,1,46,133,1.8501453310930619E-4,4.793232E-5,0,102,5,0,201,0,0
200187558,NorthPoleHoops,10,19350,4143,196,39,177,47.919214206,40-49,846,8,8,2,10,10,8,2,3,2.1428571429,21719.8666666667,0.0011927961,0.1,0.18055555,0,53,2.1053505689164125E-4,5.392386E-5,5.4624245E-5,352,76,0,200,0,0
200231908,battisctv,10,1618,1812,194,67,4,55.4536432081,50-59,733,5,37,12,49,49,37,12,7,3.0642785403,288.1703601037,0.0489700366,0.143707483,0.25581396,0,66,3.430873399177211E-4,2.2767852E-4,2.2456635E-4,140,6,0,200,0,0
200883695,WScott_Steele,10,20423,1438,2000,47,807,56.345807179,50-59,742,8,70,106,176,176,70,106,6,2.2795446937,2373.2516565456,0.1263352627,0.0968506494,0.3019608,0,66,3.055565790281384E-4,4.2539934E-4,4.309246E-4,140,37,0,201,0,0
201070049,ZeBaloo,10,11196,554,940,14,197,48.5793616744,40-49,741,7,3,3,6,6,3,3,7,2.9119517911,4.6612125202,0.0065154806,0.0666666667,0.6666667,0,66,6.022123260896187E-5,2.396616E-5,2.4277442E-5,390,1,0,200,0,0
201265978,DoubleTAP49,10,11841,687,1363,25,710,39.1322171008,30-39,744,7,6,11,17,17,6,11,7,2.9752259792,50.3053984569,0.0042809411,0.1139705882,0.3939394,0,66,6.875277591563347E-5,4.194078E-5,4.2485524E-5,372,5,0,199,0,0
201407405,deepak_minhas,10,30491,587,1031,12,278,37.5295402415,30-39,712,8,7,17,24,24,7,17,7,2.7890860395,2496.1676842382,0.0176929946,0.1213768116,0.32352942,0,66,1.638577685420462E-4,4.793232E-5,4.8554884E-5,140,2,0,201,0,0
201487651,mabastarache,10,112,152,162,3,4,30.0724490833,30-39,505,3,9,10,19,19,9,10,7,2.8804820891,139.3575825762,0.0096115912,0.1432748538,0.36263737,0,66,7.115677231148063E-5,5.99154E-5,6.069361E-5,140,2,2,115,2,0.0173913043
201747020,ArjanSmilde,10,3031,230,280,4,2,41.0101550639,40-49,664,6,1,1,2,2,1,1,2,1.5,0,7.645535613750089E-5,0,0,51,140,2.29874507414389E-4,1.198308E-5,1.2138721E-5,42,7,0,200,0,0
201785220,JGBourgeois,10,2922,583,1244,8,2,49.410668954,40-49,674,6,51,98,149,149,51,98,6,2.3903582189,7995.8000713069,0.067166273,0.0948213314,0.2501699,0,66,2.764398031088233E-4,3.1156008E-4,3.1560674E-4,390,12,1,200,1,0.005
203057848,NappyCP,10,33479,1647,589,2,135,35.9641697303,30-39,798,8,1,1,2,2,1,1,1,1,0,7.49471721243357E-5,0,0,353,646,2.9852402567743944E-4,1.198308E-5,1.2138721E-5,362,4,0,200,0,0
203559806,lucmenard,10,4547,133,93,2,19,29.1787435678,20-29,630,7,22,17,39,39,22,17,7,2.6283896887,73.1001870138,0.0342295313,0.1268556005,0.33103448,0,66,1.0771092169981953E-4,1.3780541E-4,1.395953E-4,47,3,0,200,0,0
203600449,rpilgrimdesigns,10,740,164,420,2,195,33.8769612965,30-39,478,4,0,0,0,0,0,0,0,0,0,0,0,0,76,174,4.4780486537007367E-5,0,0,68,2,0,200,0,0
203646071,donnlovett,10,1910,325,551,7,1,45.5086370204,40-49,628,6,31,70,101,101,31,70,7,2.6103113492,724.6556251374,0.0298370124,0.1412871287,0.34696528,0,66,2.0075655507421398E-4,1.9172928E-4,1.9421954E-4,372,48,0,210,0,0
203949424,adrianteoyc,10,182,87,349,1,1,41.1372218726,40-49,352,3,0,0,0,0,0,0,0,0,0,0,0,0,157,310,4.4780486537007367E-5,0,0,154,1,0,188,0,0
204027188,Staytrue2theBLU,10,346,60,45,0,13,15.948941595,10-19,442,3,0,0,0,0,0,0,0,0,0,0,0,0,267,501,4.4780486537007367E-5,0,0,264,0,0,200,0,0
204584481,KarenRegis,10,63405,1012,858,47,146,41.5990287817,40-49,736,10,6,8,14,14,6,8,7,3.021091396,218.0379664311,0.0037954817,0.0384615385,0.10909091,0,66,7.095309690278279E-5,4.194078E-5,4.2485524E-5,47,3,0,201,0,0
204844864,DHamamdjian,10,1366,4422,1040,136,3,58.1551140627,50-59,743,5,219,77,296,296,219,77,6,2.5005021761,5621.8459346595,0.303572921,0.1024507558,0.19806787,0,66,0.0016730546,0.0013181388,0.00132919,140,67,1,200,1,0.005
205431257,MusekalTweet,10,4701,116,99,6,24,40.561963423,40-49,680,6,3,1,4,4,3,1,8,4.0994308671,3099,0.0043628444,0.0833333333,0.33333334,0,66,7.148201222578987E-5,2.396616E-5,2.4277442E-5,390,0,0,200,0,0
205463662,1001cjd,10,6442,233,466,9,1680,43.21157561,40-49,693,7,2,13,15,15,2,13,6,2.9096083026,15.1811025023,0.0044239584,0.2142857143,0.47435898,0,66,5.821878056691204E-5,1.797462E-5,1.8208082E-5,372,1,0,200,0,0
205834289,emeka_efidi,10,15029,1002,946,1,6,60.0762141272,60-69,763,8,3,3,6,6,3,3,1,1,1,2.3105670282982523E-4,0.0666666667,0.6666667,168,322,3.525121730720189E-4,2.396616E-5,2.4277442E-5,163,84,0,201,0,0
205988930,SteveFilipovic,10,9383,666,1083,31,1948,54.1117633219,50-59,740,8,105,152,257,257,105,152,6,2.3257448945,8155.9516549325,0.1095660452,0.0512068337,0.18772894,0,66,2.9651220422218015E-4,6.351032E-4,6.433522E-4,47,165,0,201,0,0
206220968,TheresaLubowitz,10,6101,737,374,25,11,67.0966345716,60-69,720,7,111,51,162,162,111,51,7,2.6380984265,670.0421356213,0.1194953991,0.1307415076,0.31164855,0,66,3.9827937746830577E-4,6.710525E-4,6.797684E-4,140,56,3,200,3,0.015
206255781,jleclair_Btfd,10,3241,308,268,8,69,46.3243881947,40-49,663,6,2,3,5,5,2,3,7,3.0857047205,9.2471045702,0.0032982212,0,0,0,66,5.2088774069150574E-5,1.797462E-5,1.8208082E-5,47,2,2,201,2,0.0099502488
206340892,rrrwong,10,3871,478,477,28,73,43.740946651,40-49,656,6,17,25,42,42,17,25,7,2.781386006,1283.3300435319,0.0275879728,0.1080139373,0.33990148,0,66,1.7259534298611645E-4,1.0784772E-4,1.0924849E-4,55,7,1,200,1,0.005
206457337,pdeppisch,10,3918,237,361,2,70,43.6681925803,40-49,670,7,36,53,89,89,36,53,6,2.3916973552,588.8716226258,0.058566253,0.0727783453,0.34796807,0,66,1.3059785606330887E-4,2.2168698E-4,2.2456635E-4,47,12,0,201,0,0
207612347,StrategicThghts,10,22397,2593,513,109,1,56.7178954362,50-59,796,8,159,32,191,191,159,32,7,2.7355205892,2962.9440865709,0.1221676778,0.0684210526,0.12686674,0,66,7.069973874780995E-4,9.586464E-4,9.7109773E-4,55,252,0,202,0,0
207745397,ProgressivePort,10,16895,149,259,3,11,28.2081978137,20-29,491,8,0,2,2,2,0,2,8,3.6649933066,0,0,0,0,0,195,4.4780486537007367E-5,0,6.0693606E-6,47,0,0,202,0,0
207800925,clarevsa,10,3702,333,751,10,9,45.0844024641,40-49,667,6,34,72,106,106,34,72,6,2.6993639103,1381.5655827377,0.0157864456,0.0964959569,0.27929986,0,66,1.5995563574211873E-4,2.097039E-4,2.1242762E-4,372,40,1,200,1,0.005
207864860,ButterBrained,10,614,73,165,3,2,31.5130305395,30-39,536,5,14,25,39,39,14,25,7,2.7231335788,95.8153121871,0.0130938801,0.1349527665,0.45726496,0,66,9.310859558253036E-5,8.98731E-5,9.104041E-5,372,8,18,200,18,0.09
208104339,YorktonThisWeek,10,1216,313,30,5,0,42.2786395224,40-49,518,2,2,1,3,3,2,1,7,3.2470706394,3.459638805,0.0018503086,0.1666666667,0.16666667,0,66,5.642797875698315E-5,1.797462E-5,1.8208082E-5,372,3,0,200,0,0
208467742,PhilSoubliere,10,2170,150,313,1,0,38.4621959902,30-39,553,5,25,53,78,78,25,53,6,2.3287579511,291.4359904047,0.0472281716,0.133033633,0.42243186,0,66,1.1494873086043063E-4,1.5578004E-4,1.5780337E-4,390,3,1,200,1,0.005
208672074,McKayInc,10,411,24,112,0,0,32.0903731699,30-39,537,4,6,7,13,13,6,7,7,3.0177435554,7.1997789748,0.0091070837,0.2243589744,0.40151516,0,66,6.467849063915386E-5,4.194078E-5,4.2485524E-5,140,27,0,200,0,0
208678180,kcthegood,10,204,87,132,1,0,34.4287895607,30-39,457,4,6,12,18,18,6,12,7,2.9119517911,235.0759711296,0.0037495219,0.1895424837,0.37916666,0,66,8.211340399685854E-5,4.194078E-5,4.2485524E-5,372,15,11,200,11,0.055
208706267,jairogalvan,10,1539,83,97,1,289,35.1135900474,30-39,628,5,1,1,2,2,1,1,4,2.4,0,7.800925131503405E-5,0,0,60,152,1.652932312661057E-4,1.198308E-5,1.2138721E-5,53,8,0,198,0,0
209609597,PeebsY0,10,1862,79,370,0,97,27.5949842372,20-29,552,6,1,8,9,9,1,8,7,3.0267827251,0.351462931,7.9480323929195E-4,0.2083333333,0.375,0,66,4.6591070128343536E-5,1.198308E-5,1.2138721E-5,140,2,0,199,0,0
209693045,Clapperdudgeon,10,5025,1498,1943,7,35,45.7740013799,40-49,691,7,26,56,82,82,26,56,6,2.3762972882,7536.7133508187,0.0239592352,0.0776874435,0.2529221,0,66,1.395058157275535E-4,1.6177158E-4,1.6387274E-4,372,32,3,207,3,0.0144927536
210138966,stewart_mcgilli,10,732,764,770,23,9,45.1415744325,40-49,633,5,86,127,213,213,86,127,6,2.3679276866,3595.9822077922,0.1093961137,0.0962441315,0.30244756,0,66,3.854332546919235E-4,5.21264E-4,5.280344E-4,140,7,3,200,3,0.015
210146775,dcostello48,10,227,46,157,0,0,13.7263439094,10-19,116,4,6,20,26,26,6,20,7,2.677268162,52.4548633951,0.0067304846,0.2,0.47368422,0,66,6.390672596584317E-5,4.194078E-5,4.2485524E-5,390,2,1,200,1,0.005
210840159,djgreeens,10,1657,408,918,7,3,46.9163717276,40-49,606,6,26,95,121,121,26,95,6,2.29159692,1260.2637817201,0.0397192848,0.101584022,0.25405702,0,66,1.1947904915440278E-4,1.6177158E-4,1.6387274E-4,47,44,1,200,1,0.005
211130293,nlguy65,10,1405,132,679,4,44,33.2394898009,30-39,573,6,14,49,63,63,14,49,7,2.526280549,94.2860044236,0.0234268222,0.1789554531,0.39058822,0,66,8.612257345159711E-5,8.98731E-5,9.104041E-5,140,3,1,199,1,0.0050251256
211223603,kerrymurraynl,10,918,256,474,6,5,43.7383950139,40-49,596,4,22,40,62,62,22,40,7,2.6454636759,189.0650432445,0.0196539811,0.1385510312,0.42414173,0,66,1.1522485126335708E-4,1.3780541E-4,1.395953E-4,390,8,0,200,0,0
211550181,chrissanislo,10,5171,289,273,21,6,46.8301142328,40-49,700,7,5,2,7,7,5,2,8,3.2909273519,3.4854208148,0.002616243,0.119047619,0.26666668,0,66,5.974611646844029E-5,3.594924E-5,3.6416164E-5,140,16,0,200,0,0
211700224,NSMoggsy,10,1789,182,318,6,14,42.8992037949,40-49,631,6,22,38,60,60,22,38,7,2.5530632742,338.2217928414,0.0266832557,0.1392655367,0.3661616,0,66,1.0803224075724113E-4,1.3780541E-4,1.395953E-4,140,16,0,200,0,0
211915045,ACTSAthlete,10,1284,275,224,4,7,44.6040080225,40-49,646,5,4,0,4,4,4,0,0,0,0,3.249834096085943E-4,0.3333333333,0.5,0,52,2.4226137248048603E-4,2.99577E-5,0,352,15,0,200,0,0
212467098,brock_hamley,10,936,447,467,4,6,50.3715894338,50-59,615,5,49,0,49,49,49,0,0,0,0,0.0305868234,0.1488095238,0.26190478,0,40,2.1854922608418445E-4,2.99577E-4,0,372,20,2,200,2,0.01
212483779,SuraiaSahar,10,961,276,492,4,37,40.2730188476,40-49,631,5,13,24,37,37,13,24,7,2.7679946435,124.1583036494,0.0109302718,0.0930930931,0.21825397,0,66,8.957992096753307E-5,8.388156E-5,8.497105E-5,47,7,0,200,0,0
212621119,gmbutts,10,7527,2801,590,46,38,65.8129931494,60-69,769,7,302,66,368,368,302,66,7,2.593572146,6482.8886355293,0.3636396583,0.0789450302,0.15109323,0,66,0.0023540876,0.0018154366,0.0018329469,140,446,1,203,1,0.0049261084
212942917,JeanAProulx,10,1987,332,579,12,50,46.8524625555,40-49,611,5,64,115,179,179,64,115,6,2.3665885504,2995.8804140381,0.0829730164,0.0970748854,0.2554316,0,66,3.044189734318188E-4,3.8945008E-4,3.9450845E-4,140,57,0,200,0,0
213023643,Calgary62,10,5096,133,70,8,26,32.6845261001,30-39,632,6,15,15,30,30,15,15,7,3.0080348175,118.5135307751,0.0081969144,0.1045977011,0.49346405,0,66,1.0017536579996571E-4,9.586464E-5,9.710977E-5,372,8,0,200,0,0
213064124,DKoppin,10,308,58,116,1,33,19.3692871952,10-19,342,4,1,3,4,4,1,3,7,3.0793438232,0.1443591813,0.0019504994,0.0833333333,0.16666667,0,66,4.9780041976527344E-5,1.198308E-5,1.2138721E-5,47,0,0,200,0,0
213296469,msamaroden,10,304,93,55,8,1,32.6780234793,30-39,506,4,8,5,13,13,8,5,7,3.156009374,1.5216681947,0.0053990664,0.2371794872,0.67777777,0,66,8.196721386883055E-5,5.392386E-5,5.4624245E-5,390,9,1,198,1,0.0050505051
213751216,cameronsgray,10,1400,856,1802,32,82,63.2714161617,60-69,637,6,39,82,121,121,39,82,7,2.4673585537,2113.9418182275,0.0527303419,0.1009641873,0.26608783,0,66,2.4705849635713105E-4,2.396616E-4,2.4277443E-4,390,13,4,200,4,0.02
213861177,judebg,10,59,18,153,0,7,21.3703590807,20-29,187,3,0,3,3,3,0,3,8,3.4283801874,0,0,0.1666666667,0.33333334,0,513,4.4780486537007367E-5,0,6.0693606E-6,140,1,0,86,0,0
213863609,GhostProf,10,7601,750,322,37,19,50.6315666794,50-59,743,7,10,4,14,14,10,4,7,3.1084700368,51.8982610401,0.0087608909,0.0769230769,0.19090909,0,66,1.2131823834935034E-4,6.590694E-5,6.6762965E-5,47,2,0,200,0,0
214164173,DrJaneChi,10,6872,1222,554,25,231,63.3363438391,60-69,765,7,6,3,9,9,6,3,7,3.2591228658,2995.8056917951,0.0022519615,0.0277777778,0.1,0,66,1.0485689443648995E-4,4.194078E-5,3.6416164E-5,47,26,0,202,0,0
214324469,tfalcone86,10,9170,374,483,9,0,57.5567771868,50-59,722,7,41,42,83,83,41,42,6,2.5687981252,2163.6449769194,0.04646017,0.1724948575,0.33983904,0,66,2.0657019740089616E-4,2.5164467E-4,2.5491315E-4,140,20,0,205,0,0
214494357,DartmouthDerek,10,7181,1149,1501,22,653,59.4624759833,50-59,755,7,63,74,137,137,63,74,6,2.3160361567,10964.4742890789,0.0795786879,0.0624731644,0.21037851,0,66,2.4598618084809096E-4,3.8345857E-4,3.8843908E-4,140,45,0,200,0,0
214613340,KathrynB_FSJ,10,14072,428,434,37,89,38.5396269115,30-39,739,8,18,19,37,37,18,19,7,2.6869768999,1463.4159206654,0.0278915871,0.1531531532,0.44871795,0,66,1.1177538630648499E-4,1.1383926E-4,1.1531785E-4,47,8,0,200,0,0
214946558,LibConcordia,10,112,156,47,5,0,41.7051578767,40-49,519,4,32,55,87,87,32,55,7,2.5805155675,1256.0647118782,0.046327851,0.1732157177,0.45697117,0,66,2.8751594261259373E-4,1.9772082E-4,2.0028891E-4,140,21,1,187,1,0.0053475936
215108502,GGeorgieGirl,10,3921,208,273,13,4,34.6344681808,30-39,659,6,40,53,93,93,40,53,7,2.4690324741,227.0805289507,0.0729669658,0.1104488079,0.54781145,0,66,1.528045623139866E-4,2.4565315E-4,2.4884377E-4,47,4,0,200,0,0
215406950,BrettMineer,10,10765,1788,1530,68,24,60.3818015566,60-69,758,7,72,57,129,129,72,57,7,2.5383327754,2106.8719769012,0.0805620895,0.0923570736,0.22575589,0,66,4.0655098136158037E-4,4.373824E-4,4.4306333E-4,55,21,0,200,0,0
215501705,Matthew_Barlow,10,45051,966,765,43,43,50.6182049199,50-59,806,9,86,86,172,172,86,86,6,2.3598928691,2085.7403613619,0.1269426163,0.0574255406,0.37078652,0,66,2.598383624879752E-4,5.21264E-4,5.280344E-4,47,92,0,201,0,0
215503616,CanonFan007D,10,1017,70,424,2,5,24.0741449052,20-29,398,5,7,19,26,26,7,19,6,2.8292601272,102.9489196526,0.0087176511,0.2184615385,0.41897234,0,66,6.761457480317765E-5,4.793232E-5,4.8554884E-5,372,0,0,201,0,0
215987838,Nedifeora,10,8117,156,111,1,17,33.8719295976,30-39,669,7,0,0,0,0,0,0,0,0,0,0,0,0,94,201,4.4780486537007367E-5,0,0,89,0,0,202,0,0
216054973,teteualvarado,10,27475,936,187,107,140,38.6996649426,30-39,785,8,4,3,7,7,4,3,2,1.4,1,3.153764967647999E-4,0.1428571429,0.8333333,317,575,3.4128802820314753E-4,2.99577E-5,3.0346804E-5,318,15,0,200,0,0
216243608,yolkregion,10,1264,493,308,5,61,38.9800930489,30-39,613,5,7,13,20,20,7,13,7,2.8453297623,30.7481432827,0.0065724538,0.1263157895,0.2875,0,66,6.58794290110219E-5,4.793232E-5,4.8554884E-5,47,8,0,200,0,0
216311666,small_affair,10,30840,1889,1628,81,2917,55.07160663,50-59,791,9,18,20,38,38,18,20,7,2.8449949782,3347.5961795048,0.0142735499,0.0910384068,0.34,0,66,1.2916446577156961E-4,1.1383926E-4,1.1531785E-4,47,41,0,201,0,0
216475552,darrenhill1,10,4313,1523,847,72,5,52.1885978924,50-59,731,7,38,38,76,76,38,38,6,2.5560763308,1014.0293906264,0.0403117242,0.1240350877,0.30625364,0,66,1.9221800087561476E-4,2.3367006E-4,2.3670506E-4,140,31,0,200,0,0
216554278,kosmovinylHAF,10,38,29,35,1,0,24.2740429206,20-29,89,1,15,0,15,15,15,0,0,0,0,0.0236943604,0.4571428571,0.8047619,0,27,1.1397761251963253E-4,9.586464E-5,0,390,4,0,40,0,0
216609343,hpliszka,10,7314,450,913,12,16,60.1004120314,60-69,704,7,42,35,77,77,42,35,7,2.5266153331,2549.7663650824,0.0481783906,0.0811688312,0.20251314,0,66,2.2193750072884916E-4,2.5763622E-4,2.6098252E-4,47,95,0,230,0,0
216732503,caw_kaikit,10,5048,210,163,6,2,47.0277327722,40-49,644,7,29,23,52,52,29,23,7,2.7244727151,256.0004615186,0.0352706464,0.1221719457,0.31848854,0,66,2.1885441213646514E-4,1.797462E-4,1.8208082E-4,390,31,1,200,1,0.005
216790519,BlueShoes55,10,21885,552,589,28,978,40.7535860426,40-49,757,8,40,33,73,73,40,33,7,2.6223635755,321.5871567227,0.0729901716,0.1436453577,0.30946815,0,66,2.1131167662768994E-4,2.4565315E-4,2.4884377E-4,47,9,0,200,0,0
216822870,JBSmokyday,10,1106,1115,1033,33,140,44.3095561462,40-49,627,5,54,63,117,117,54,63,7,2.5286240375,1853.533068855,0.045343939,0.0552608311,0.24701619,0,66,2.3209490075428937E-4,3.295347E-4,3.3381482E-4,47,15,1,200,1,0.005
216940188,True_Tory,10,6201,455,956,14,599,47.8381795405,40-49,689,6,61,104,165,165,61,104,7,2.3893538668,7285.9363810492,0.0807351111,0.0902808574,0.2093629,0,66,2.421526999630329E-4,3.7147547E-4,3.7630036E-4,47,29,5,201,5,0.0248756219
217084212,myargeau,10,2430,157,212,4,20,26.1056162092,20-29,637,6,9,13,22,22,9,13,7,2.9762303314,41.4588712868,0.006095977,0.1666666667,0.5208333,0,66,8.937376787994363E-5,5.99154E-5,6.069361E-5,372,3,0,200,0,0
217164328,Ilango74,10,472,111,409,3,3,41.8713242603,40-49,559,4,0,9,9,9,0,9,7,2.8460508701,0,0,0.2638888889,0.41666666,0,436,4.4780486537007367E-5,0,6.0693606E-6,390,0,0,200,0,0
217251219,iiibooo,10,12061,1704,1787,70,5,43.4392133723,40-49,770,7,26,26,52,52,26,26,6,2.6123200536,523.6061349112,0.0339035471,0.0629713424,0.36640212,0,66,1.6928923726516296E-4,1.6177158E-4,1.6387274E-4,390,3,0,199,0,0
217254311,cathylenair,10,238,27,88,2,92,23.2097914173,20-29,404,3,1,9,10,10,1,9,7,2.8754603281,6.6900176791,0.0029131139,0.2,0.375,0,66,4.839308717829337E-5,1.198308E-5,1.2138721E-5,140,3,0,200,0,0
217583369,CommieZombies,10,4191,437,618,13,52,45.54653021,40-49,731,6,25,47,72,72,25,47,6,2.4037495815,4369.1931403605,0.0192409276,0.0596635368,0.16219158,0,66,1.3582603322648276E-4,1.5578004E-4,1.5173401E-4,372,56,0,200,0,0
217606140,youwishme2,10,17024,7207,7692,52,34,38.0138719412,30-39,735,9,25,46,71,71,25,46,6,2.4070974222,1134.4400562209,0.0456434371,0.1006036217,0.39565217,0,66,1.4013858989242624E-4,1.5578004E-4,1.5780337E-4,47,2,1,201,1,0.0049751244
217872058,EricOntario,10,4584,847,898,26,228,46.4741377325,40-49,693,7,39,29,68,68,39,29,7,2.6498158688,1085.0065347583,0.0478765266,0.1051360843,0.30204082,0,66,1.6531079659928589E-4,2.396616E-4,2.4277443E-4,140,17,0,200,0,0
218232928,fernhilldammit,10,22348,838,546,46,1,47.4787873613,40-49,792,8,186,131,317,317,186,131,7,2.3471710747,6138.0848825804,0.2225805286,0.069690133,0.22517228,0,66,5.181413932592351E-4,0.001120418,0.0011349705,47,282,0,206,0,0
218285658,john_delgrande,10,2803,392,147,19,1,44.7432783884,40-49,685,5,15,6,21,21,15,6,7,3.1074656846,229.6420096042,0.0084050098,0.0547619048,0.1125,0,66,1.1957085890453972E-4,9.586464E-5,9.710977E-5,372,5,0,200,0,0
218671021,johnalanashton,10,4734,499,1098,17,23,56.9175635195,50-59,678,7,67,110,177,177,67,110,6,2.4526280549,4979.0461224406,0.0842662695,0.1178736518,0.35006452,0,66,3.0556931635134974E-4,4.0742473E-4,4.1271653E-4,390,44,0,200,0,0
218748524,magnamoreira_,10,35056,728,673,4,1183,46.4959841483,40-49,776,9,1,2,3,3,1,2,2,1.5,1,8.096467320928773E-5,0,0,203,412,1.0340065745167209E-4,1.198308E-5,1.2138721E-5,212,1,0,201,0,0
218789119,Lucasdiaz_1,10,4380,195,456,6,27,43.5255800884,40-49,702,7,3,3,6,6,3,3,2,1.5714285714,0.5,2.419396189930435E-4,0.1,0.8333333,52,142,2.8690815099642256E-4,2.396616E-5,2.4277442E-5,316,136,0,201,0,0
218987872,canonkevy,10,7030,373,1247,8,351,46.2879698851,40-49,688,7,10,48,58,58,10,48,7,2.5929025778,261.6016993444,0.0226714722,0.1963097399,0.4260204,0,66,1.269850265958822E-4,6.590694E-5,6.6762965E-5,140,19,0,200,0,0
219007676,NeilJEdmondson,10,31112,1867,1456,59,64,52.5981577771,50-59,818,8,116,116,232,232,116,116,6,2.4884499498,10895.0591781464,0.0738392972,0.0407710106,0.18471552,0,66,6.642610827161915E-4,7.0101017E-4,7.101152E-4,372,211,0,202,0,0
220191842,Asekible,10,2650,391,607,3,176,49.9650177107,40-49,644,6,1,0,1,1,1,0,0,0,0,8.422120682784922E-5,0,0,0,55,7.927442740923612E-5,1.198308E-5,0,320,5,0,199,0,0
220223791,truththrust,10,7555,436,556,8,359,46.4965373541,40-49,746,7,137,96,233,233,137,96,7,2.3967191162,2934.521099354,0.1767598106,0.1102375314,0.27194288,0,66,3.7666822331680464E-4,8.268325E-4,8.3757174E-4,47,81,0,200,0,0
220421513,theamazon1,10,8942,455,737,4,976,49.7315559254,40-49,696,7,56,81,137,137,56,81,6,2.4121191831,2814.6330620757,0.0702694503,0.0661764706,0.27005583,0,66,2.3058768314231196E-4,3.4151776E-4,3.4595357E-4,47,61,0,201,0,0
220518078,johnndp,10,213,7,30,0,3,17.7974754862,10-19,317,3,0,6,6,6,0,6,7,3.1325301205,0,0,0.4666666667,0.6666667,0,291,4.4780486537007367E-5,0,6.0693606E-6,390,0,0,200,0,0
220576066,yeepoa,10,2179,192,420,3,365,45.3423840381,40-49,640,6,24,44,68,68,24,44,6,2.6089722129,627.1509217645,0.0228873945,0.0869183494,0.25085035,0,66,1.2967792297280292E-4,1.497885E-4,1.5173401E-4,47,49,0,199,0,0
220778300,cupedoll_500,10,25507,850,880,47,269,40.9639252092,40-49,772,9,87,91,178,178,87,91,6,2.3582189488,1499.9337424447,0.1275641638,0.0770964261,0.33272758,0,66,2.740291865357947E-4,5.272555E-4,5.341037E-4,47,19,3,202,3,0.0148514851
220851657,deetee128,10,5483,683,1228,18,325,44.167492812,40-49,706,7,2,5,7,7,2,5,7,3.1764312019,41.1728123463,0.0015257354,0.0714285714,0.3,0,66,6.151372717866791E-5,1.797462E-5,1.8208082E-5,47,2,0,200,0,0
221019842,SchumannD,10,2787,216,528,3,1216,39.8394394235,30-39,650,6,13,31,44,44,13,31,6,2.6434549715,193.2194513251,0.0134555895,0.1390063425,0.4405242,0,66,1.290734366443107E-4,8.388156E-5,8.497105E-5,372,7,0,200,0,0
221250086,reidrraymond,10,544,49,86,0,11,26.2657801497,20-29,476,4,0,9,9,9,0,9,7,2.9762382865,0,0,0.4861111111,0.9027778,0,352,4.4780486537007367E-5,0,6.0693606E-6,140,1,0,200,0,0
221250191,barachoix,10,2991,213,730,5,19,28.3316593821,20-29,588,6,18,49,67,67,18,49,6,2.5276196853,1240.5504247196,0.025180945,0.0843509724,0.2082353,0,66,1.0844198977529937E-4,1.1383926E-4,1.1531785E-4,140,2,1,200,1,0.005
221303153,logik36,10,5014,144,297,5,636,36.8386758177,30-39,698,7,5,13,18,18,5,13,7,2.9156344158,269.9270785331,0.0070952814,0.1993464052,0.46190476,0,66,6.98278520700103E-5,3.594924E-5,3.6416164E-5,140,4,1,201,1,0.0049751244
221355278,LJNor,10,1734,219,700,2,63,42.4411485911,40-49,526,6,14,41,55,55,14,41,6,2.4984934717,460.9572722419,0.0248619432,0.1053872054,0.2804878,0,66,8.676892603523139E-5,8.98731E-5,9.104041E-5,55,10,1,202,1,0.004950495
221414237,kris_purdy,10,461,120,279,1,0,20.8617597695,20-29,405,4,0,14,14,14,0,14,7,2.9819277108,0,0,0.1813186813,0.21978022,0,193,4.4780486537007367E-5,0,6.0693606E-6,390,1,0,200,0,0
221481261,infam0usap,10,9605,412,227,0,2450,42.8352952878,40-49,716,7,0,0,0,0,0,0,0,0,0,0,0,0,245,472,4.4780486537007367E-5,0,0,241,8,0,198,0,0
221565757,abitofgrit,10,5021,648,1731,7,11,48.1752586346,40-49,693,6,80,212,292,292,80,212,6,2.2269835956,3898.9971485666,0.1204035189,0.1049992939,0.24616975,0,66,3.754486730582337E-4,4.8531473E-4,4.9161824E-4,140,41,1,200,1,0.005
221577386,parhamfarmgirl,10,2694,75,280,0,16,23.8684134116,20-29,602,6,0,2,2,2,0,2,7,3.3781793842,0,0,0,0,0,419,4.4780486537007367E-5,0,6.0693606E-6,390,0,1,200,1,0.005
221579366,NSValley,10,3759,149,301,4,3,44.2114159339,40-49,634,7,50,77,127,127,50,77,6,2.3860060261,567.7293691039,0.0676275446,0.1263592051,0.36554307,0,66,1.8553007071288872E-4,3.0556854E-4,3.095374E-4,47,29,1,206,1,0.0048543689
221613684,Soylent81,10,405,14,74,0,69,20.259453202,20-29,537,4,5,9,14,14,5,9,7,2.8024774021,4.3686531244,0.0048202378,0.1868131868,0.45454547,0,66,5.601185586577928E-5,3.594924E-5,3.6416164E-5,47,1,0,200,0,0
222039393,ad6media,10,1025,857,1486,22,11,42.2857926155,40-49,593,5,0,2,2,2,0,2,7,3.6904283802,0,0,0,0,0,261,4.4780486537007367E-5,0,6.0693606E-6,320,2,0,200,0,0
222178281,GeorgeOz4,10,4985,246,561,0,290,42.5522363191,40-49,727,6,6,7,13,13,6,7,1,1,0,4.977388905364672E-4,0.1346153846,0.85714287,46,134,1.6498109788469208E-4,4.194078E-5,4.2485524E-5,102,38,0,202,0,0
222819990,SocialDemoMatty,10,797,127,487,2,4,38.0133163228,30-39,543,5,25,89,114,114,25,89,6,2.2979578172,7001.9456223805,0.02666834,0.1045645086,0.23558052,0,66,1.3364348412176397E-4,1.5578004E-4,1.5780337E-4,390,3,0,200,0,0
222901117,j_moreiraa,10,18021,734,1774,190,441,34.6159590384,30-39,680,7,0,0,0,0,0,0,0,0,0,0,0,0,242,466,4.4780486537007367E-5,0,0,238,3,0,200,0,0
222987791,deBeauxOs1,10,75841,1891,999,68,47,48.112539572,40-49,818,10,284,215,499,499,284,215,6,2.1958486776,25639.7737327894,0.3419076838,0.0478185286,0.19038257,0,66,9.098957026710591E-4,0.0017075889,0.0017297678,47,290,0,246,0,0
222995401,pearcen44,10,2346,57,145,0,72,41.4440111688,40-49,582,6,24,28,52,52,24,28,7,2.6755942417,243.1694348244,0.0311919643,0.0837104072,0.27983195,0,66,1.2154030109635254E-4,1.497885E-4,1.5173401E-4,47,36,2,200,2,0.01
223320350,susankim6722,10,2632,228,463,9,50,35.6992518573,30-39,631,5,32,52,84,84,32,52,7,2.5711416137,425.3010586779,0.0446090899,0.1173264487,0.34815487,0,66,1.6659040118826521E-4,1.9772082E-4,2.0028891E-4,390,6,0,200,0,0
223368263,blairbateson,10,245,28,47,0,1,14.4330443475,10-19,289,3,0,0,0,0,0,0,0,0,0,0,0,0,344,624,4.4780486537007367E-5,0,0,351,0,0,200,0,0
223516060,Mister_Twitt,10,2473,72,543,0,9,20.7035990189,20-29,572,6,14,77,91,91,14,77,6,2.4753933713,310.4413959226,0.0263124134,0.1882783883,0.332493,0,66,1.1548323849738451E-4,8.98731E-5,9.104041E-5,390,9,1,200,1,0.005
223626848,kilnclown,10,51,12,95,0,0,17.0026185131,10-19,42,2,0,3,3,3,0,3,7,3.0348058902,0,0,0.5,0.6666667,0,625,4.4780486537007367E-5,0,6.0693606E-6,140,0,0,55,0,0
224142741,Robert_MacKay_,10,2847,53,23,1,75,47.6481354145,40-49,686,7,10,2,12,12,10,2,8,3.5229327084,3.1278850169,0.0128599003,0.1515151515,0.23484848,0,66,6.533189204672669E-5,6.590694E-5,6.6762965E-5,55,70,0,209,0,0
224339579,plrstweet,10,20261,936,1169,15,1660,42.4833764809,40-49,765,8,187,227,414,414,187,227,6,2.208235688,15212.0310354134,0.2292126391,0.0671532676,0.23183872,0,66,5.376313880133561E-4,0.0011264095,0.0011410398,47,81,2,202,2,0.0099009901
224366663,ItsRyanClayton,10,8355,1655,1890,74,12,65.8833786466,60-69,759,7,75,112,187,187,75,112,6,2.3254101105,5608.581995224,0.0947662647,0.0816514289,0.21506011,0,66,3.4925038064918454E-4,4.5535705E-4,4.612714E-4,55,154,0,201,0,0
224400947,pinkolefty,10,3463,250,413,5,95,47.6989197388,40-49,696,7,37,63,100,100,37,63,7,2.4576498159,790.8128495299,0.0432849466,0.1011111111,0.27853882,0,66,1.3814160644698835E-4,2.2767852E-4,2.306357E-4,47,36,1,200,1,0.005
224922810,successfor2011,10,161,19,56,0,1,17.1610429148,10-19,327,3,0,0,0,0,0,0,0,0,0,0,0,0,42,127,4.4780486537007367E-5,0,0,35,1,0,162,0,0
224934239,JLggM,10,1856,269,362,18,117,43.3590453985,40-49,633,6,2,4,6,6,2,4,7,3.4365584198,3.2306858513,6.873870915822653E-4,0.1,0.41666666,0,66,6.38984152674799E-5,1.797462E-5,1.8208082E-5,55,33,0,200,0,0
224935028,jaglister,10,5764,328,386,6,31,45.2062045167,40-49,704,7,50,53,103,103,50,53,6,2.4606628724,402.9613665908,0.0759425665,0.0607272035,0.38181818,0,66,1.6551461665067672E-4,3.0556854E-4,3.095374E-4,47,111,0,200,0,0
225141669,WaterPortal,10,2134,876,618,46,16,50.9863102246,50-59,667,5,14,13,27,27,14,13,7,2.8051556746,371.6802504212,0.0112913969,0.0398860399,0.18333334,0,66,1.1241291786200411E-4,8.98731E-5,9.104041E-5,55,25,0,200,0,0
225438673,peaceterry,10,363,37,154,0,0,26.5747335921,20-29,404,4,11,34,45,45,11,34,7,2.557080683,140.6795384041,0.0110835522,0.2585858586,0.51956815,0,66,7.856982322897865E-5,7.189848E-5,7.283233E-5,390,6,0,200,0,0
225811778,Netghost88,10,1650,95,17,0,12,22.5211378319,20-29,689,6,16,3,19,19,16,3,7,3.2681620355,36.8777328158,0.0110239761,0.2426900585,0.5036765,0,66,1.0895127368611395E-4,1.0185618E-4,1.0317913E-4,372,4,0,200,0,0
226022534,Lavender_Blume,10,4740,907,1988,8,119,49.4412281479,40-49,677,7,47,105,152,152,47,105,6,2.3354536324,1710.3809226361,0.0636696418,0.1066573719,0.28394467,0,66,1.743608516942945E-4,2.8759392E-4,2.913293E-4,47,9,0,200,0,0
226376868,maddysteves,10,3342,199,588,2,35,43.8671700826,40-49,644,6,20,27,47,47,20,27,6,2.8707733512,378.7279973811,0.0114827805,0.1341350601,0.3600713,0,66,1.1504075922224366E-4,1.2582233E-4,1.2745657E-4,372,58,2,200,2,0.01
226512656,stop1984,10,41218,596,376,11,678,40.8804956761,40-49,751,9,7,6,13,13,7,6,7,2.9059256779,6.0364026497,0.0083644106,0.1153846154,0.2777778,0,66,6.200648957368956E-5,4.793232E-5,4.8554884E-5,47,1,0,201,0,0
226710176,jessecrowecpga,10,6279,889,1413,15,13,46.2921968771,40-49,732,7,1,1,2,2,1,1,5,3.4444444444,0,7.49471721243357E-5,0,0,0,546,7.569917912644684E-5,1.198308E-5,1.2138721E-5,352,0,0,200,0,0
226717858,ChristoYoung,10,1613,389,373,12,2,42.9672116675,40-49,629,6,90,80,170,170,90,80,7,2.5339805825,784.016871128,0.1268662252,0.1240515141,0.42575613,0,66,4.8194594956356933E-4,5.452301E-4,5.5231183E-4,390,32,9,200,9,0.045
227114507,DemProg,10,1102,68,193,4,1,35.1637080394,30-39,599,5,17,41,58,58,17,41,7,2.6514897891,47.5357316977,0.0332462071,0.2259528131,0.5989899,0,66,1.0194581453377162E-4,1.0784772E-4,1.0924849E-4,140,31,1,200,1,0.005
227143079,PrairieTweeter,10,5399,172,101,6,38,45.0292824574,40-49,664,7,14,4,18,18,14,4,7,2.9383997322,37.4298047832,0.0187608012,0.1274509804,0.25714287,0,66,9.964640937465303E-5,8.98731E-5,9.104041E-5,47,14,0,200,0,0
227150191,seemetrolling,10,9582,358,1376,4,3999,45.4357715207,40-49,701,8,4,11,15,15,4,11,7,2.864747238,8.1352993955,0.0049766173,0.1142857143,0.28181818,0,66,5.603373621892101E-5,2.99577E-5,3.0346804E-5,140,7,0,200,0,0
227169236,LandrevilleRRP,10,4309,765,862,15,8,46.0376282356,40-49,696,6,50,59,109,109,50,59,6,2.5905590894,1588.741145374,0.0277176535,0.0746687054,0.38530466,0,66,2.4356338369466903E-4,3.0556854E-4,3.095374E-4,372,25,0,199,0,0
227245275,JeffreyGriese,10,1226,399,736,15,721,53.318127839,50-59,608,5,18,29,47,47,18,29,7,2.7482423837,94.6637598692,0.0154334992,0.1225716929,0.3252101,0,66,1.128087314855337E-4,1.1383926E-4,1.1531785E-4,372,0,50,200,50,0.25
227291265,PROGREWAYNA,10,1891,323,531,6,7,41.6695834247,40-49,637,6,3,1,4,4,3,1,10,5.603950452,0,2.3446235651838765E-4,0.25,0.6666667,0,66,1.1438848076226887E-4,2.396616E-5,2.4277442E-5,320,0,0,200,0,0
227464980,NEweatherHQ,10,26854,1722,946,97,278,49.376774529,40-49,766,8,4,0,4,4,4,0,0,0,0,2.937567409810756E-4,0,0,37,118,1.9703414704452132E-4,2.99577E-5,0,34,30,0,200,0,0
227763857,KimberleeTaylor,10,9812,147,407,0,6,43.7565849077,40-49,709,7,13,41,54,54,13,41,6,2.4931369267,296.3590648542,0.0242237376,0.1446540881,0.3847561,0,66,1.148838603110239E-4,8.388156E-5,8.497105E-5,140,22,1,202,1,0.004950495
228232989,ianwrighting,10,8885,112,131,9,0,30.0283773553,30-39,616,7,3,2,5,5,3,2,7,3.0324740542,1.7732346172,0.005863488,0.1,0.6666667,0,66,5.373821004258761E-5,2.396616E-5,2.4277442E-5,140,0,0,200,0,0
228394456,traceyram,10,494,81,132,0,0,18.7177943834,10-19,455,4,11,18,29,29,11,18,7,2.7750251088,28.8123472193,0.0092366982,0.145320197,0.4763158,0,66,7.488329651661368E-5,7.189848E-5,7.283233E-5,390,4,2,200,1,0.01
228707979,o5carpapa,10,533,60,141,0,45,41.5983327078,40-49,646,6,38,79,117,117,38,79,7,2.4405758286,3048.5500535071,0.0428400698,0.0751547303,0.25158226,0,66,1.5891552321504662E-4,2.3367006E-4,2.3670506E-4,47,120,0,202,0,0
228846881,BRAFB,10,531,380,399,28,2,43.9881901009,40-49,569,4,1,0,1,1,1,0,0,0,0,7.34391852452689E-5,0,0,342,616,8.284390166388585E-5,1.198308E-5,0,353,23,0,200,0,0
229067990,KasTwits,10,1446,34,60,0,1,28.8900686218,20-29,574,5,4,3,7,7,4,3,7,3.1185135588,204.0734359061,0.0064504952,0.0714285714,0.41666666,0,66,1.0141933259075513E-4,2.99577E-5,3.0346804E-5,390,0,0,200,0,0
229204006,craggy7,10,45,27,107,0,38,26.465407566,20-29,383,3,1,1,2,2,1,1,1,1,0,7.49471721243357E-5,0,0,259,490,2.9852402567743944E-4,1.198308E-5,1.2138721E-5,255,13,0,96,0,0
229545816,cluimes,10,1941,963,1095,10,24,56.6694369413,50-59,685,6,46,47,93,93,46,47,6,2.7438901908,1094.9127953589,0.0322739673,0.1153576438,0.3160667,0,66,3.8110748815959434E-4,2.8160238E-4,2.8525994E-4,372,5,1,200,1,0.005
229682182,c_kenn,10,3370,252,278,3,59,44.2370581211,40-49,654,6,42,55,97,97,42,55,6,2.4288583863,1293.9938368236,0.0608780952,0.0527276632,0.28181818,0,66,1.3659652205893523E-4,2.5763622E-4,2.6098252E-4,47,22,0,202,0,0
229765277,Taleeb,10,2159,1552,1859,73,18,50.436027075,50-59,709,5,152,193,345,345,152,193,6,2.2567793773,18593.6751709706,0.18370802,0.0730535895,0.24881832,0,66,7.480536259865747E-4,9.167056E-4,9.286122E-4,140,36,0,200,0,0
230220287,Coteter,10,6008,217,298,10,1843,46.641993125,40-49,671,7,68,75,143,143,68,75,6,2.3297623033,2444.1643925022,0.0932853156,0.0658426081,0.35645932,0,66,2.2258480800374332E-4,4.1341624E-4,4.1878587E-4,47,23,4,201,4,0.0199004975
230404096,pulistbook,10,477330,3560,0,105,0,49.4031909553,40-49,750,4,0,0,0,0,0,0,0,0,0,0,0,0,73,170,4.4780486537007367E-5,0,0,65,0,0,201,0,0
231211484,OrtizLeiris,10,8074,328,1430,3,12,41.4884137428,40-49,660,6,0,0,0,0,0,0,0,0,0,0,0,0,95,202,4.4780486537007367E-5,0,0,90,9,0,200,0,0
232012377,KarenPao18,10,20666,177,156,1,91,42.3329716075,40-49,782,8,1,1,2,2,1,1,4,2.6,0,7.648573087786583E-5,0,0,60,152,1.7918963213425684E-4,1.198308E-5,1.2138721E-5,53,46,0,201,0,0
232519990,nspector4,10,42316,8750,113,394,5,59.8151410174,50-59,882,8,583,24,607,607,583,24,7,2.6173418145,7752.7494684105,0.5201785304,0.0522343832,0.07573762,0,66,0.0031367605,0.0034990592,0.0035202291,372,1093,2,244,2,0.0081967213
232683104,CoastEmergency,10,1945,739,2001,35,26,40.7334995726,40-49,586,6,3,13,16,16,3,13,7,2.9517910947,28.4481600939,0.0025124485,0.1916666667,0.31904763,0,66,5.449043069387584E-5,2.396616E-5,2.4277442E-5,55,0,0,200,0,0
233303806,aquiottawa,10,2147,31,109,0,17,29.1376394847,20-29,458,5,6,19,25,25,6,19,7,2.6622028791,11.6793863093,0.0148845703,0.1533333333,0.39181286,0,66,6.457456782847143E-5,4.194078E-5,4.2485524E-5,47,5,0,200,0,0
233356796,DavidMerner,10,132,198,18,13,0,33.3842319236,30-39,558,2,45,3,48,48,45,3,7,3.0277870773,19.6294374656,0.0526646029,0.1843971631,0.30989826,0,66,2.494349337810145E-4,2.7561083E-4,2.791906E-4,140,8,0,137,0,0
233426838,SaskNDPYouth,10,842,378,262,13,31,46.2476343275,40-49,646,5,61,57,118,118,61,57,6,2.5092065618,1886.8208314306,0.0571115733,0.1109662466,0.29507524,0,66,2.610692730594748E-4,3.7147547E-4,3.7630036E-4,390,75,0,199,0,0
233749323,MaggiePriceless,10,90758,10585,9485,439,25,72.0509208238,70-79,899,10,140,146,286,286,140,146,6,2.2420488785,51879.3303854296,0.1716767509,0.0355784566,0.2309248,0,66,5.813698218115827E-4,8.4480713E-4,8.5577986E-4,47,46,0,201,0,0
234140065,lucky774,10,1472,108,281,1,38,30.7254390778,30-39,501,5,18,34,52,52,18,34,6,2.4395714764,282.792490355,0.034076777,0.0889894419,0.3,0,66,9.831952807224186E-5,1.1383926E-4,1.1531785E-4,47,3,1,200,1,0.005
234632458,Marconomics,10,4898,1456,1482,27,11,61.1276685768,60-69,685,7,104,139,243,243,104,139,6,2.2872447272,10811.7492577925,0.1202154368,0.0482263715,0.2194586,0,66,4.240479621017952E-4,6.291117E-4,6.3728285E-4,390,28,6,205,6,0.0292682927
234909466,opticverve,10,11626,264,307,3,828,45.6540875309,40-49,692,7,23,22,45,45,23,22,7,2.7750251088,533.6565344566,0.0330799352,0.0717171717,0.24252874,0,66,2.379894382373353E-4,1.4379696E-4,1.4566466E-4,47,6,0,198,0,0
234910661,spencersi,10,777,33,27,1,1,28.496994591,20-29,491,5,3,0,3,3,3,0,0,0,0,0.0015178058,0,0,0,37,5.793308537418196E-5,2.396616E-5,0,47,0,0,199,0,0
234952524,RaiBecca,10,17403,308,188,2,106,47.440636062,40-49,739,7,4,5,9,9,4,5,6,2.8181818182,255.8666666667,3.289171872842554E-4,0.0277777778,0.2,30,104,2.650977820496736E-4,2.99577E-5,3.0346804E-5,315,17,0,200,0,0
234985641,Moerockin,10,1565,145,172,4,0,38.3755697529,30-39,584,5,12,16,28,28,12,16,7,2.7700033478,101.1589184884,0.010408259,0.205026455,0.38586956,0,66,8.63575326921867E-5,7.789002E-5,7.8901685E-5,390,5,1,200,1,0.005
235031427,mycatsheds,10,10066,485,500,24,78,51.0022830966,50-59,743,7,145,146,291,291,145,146,6,2.2838968865,4144.0169483191,0.2126266928,0.0845834815,0.29768533,0,66,4.565053080837521E-4,8.747648E-4,8.8612665E-4,47,94,0,200,0,0
235122381,GarnettGenuis,10,747,585,516,23,0,45.0169603224,40-49,623,4,33,39,72,72,33,39,7,2.8824907934,535.8929305118,0.0226705676,0.1128716745,0.37967688,0,66,2.3280147745283777E-4,2.0371236E-4,2.0635827E-4,372,16,2,200,2,0.01
235425236,Colettestweeter,10,9467,1339,1994,48,29,50.1471219894,50-59,726,7,343,483,826,826,343,483,6,1.9852695012,71302.6057054571,0.3709332783,0.0448470174,0.15234049,0,66,9.364196009211283E-4,0.0020610897,0.0020878601,47,48,3,201,3,0.0149253731
235741775,74suited,10,406,101,472,0,5,20.3499977596,20-29,420,4,4,7,11,11,4,7,7,2.8828255775,0.7903945716,0.0055398289,0.2090909091,0.6785714,0,66,6.223728746255741E-5,2.99577E-5,3.0346804E-5,372,1,0,200,0,0
235783992,_ilpo_,10,17680,1269,1970,60,1022,41.1608069241,40-49,743,8,44,46,90,90,44,46,7,2.5071978574,2184.6098075604,0.0721553734,0.0801498127,0.3734007,0,66,1.924543823075427E-4,2.696193E-4,2.7312123E-4,47,20,0,204,0,0
235907534,coalitionmtl,10,1053,232,714,1,49,25.0610917062,20-29,533,5,4,9,13,13,4,9,7,2.6776029461,1.9536352363,0.0095621493,0.1538461538,0.6111111,0,66,6.119276681341064E-5,2.99577E-5,3.0346804E-5,390,1,0,200,0,0
236130596,HerstoriesCafe,10,1068,217,206,6,9,37.5994797918,30-39,550,5,5,13,18,18,5,13,7,2.6488115166,527.3031350351,0.0030352077,0.137254902,0.30769232,0,66,7.763884157219165E-5,3.594924E-5,3.6416164E-5,55,3,0,200,0,0
236363669,EveGasse,10,1208,850,1525,30,3,40.735916651,40-49,587,5,150,200,350,350,150,200,6,2.2768664212,5097.7494925978,0.2316645589,0.101285305,0.28331852,0,66,8.652277945727321E-4,9.0472255E-4,9.1647345E-4,390,9,6,200,6,0.03
237052663,holtom2000,10,2721,76,147,1,16,31.814438919,30-39,624,6,5,7,12,12,5,7,7,2.9303649146,1.5685539934,0.005334214,0.1590909091,0.5714286,0,66,6.13473964023051E-5,3.594924E-5,3.6416164E-5,372,3,0,200,0,0
237103462,Mike_EH_52,10,36280,451,261,15,1,39.1752175985,30-39,744,8,34,18,52,52,34,18,7,2.6752594576,860.0222802055,0.0605160464,0.1576168929,0.33668077,0,66,1.6694457312926847E-4,2.097039E-4,2.0635827E-4,47,10,0,199,0,0
237404095,dardsa,10,1447,25,231,0,20,27.6692733765,20-29,442,5,1,17,18,18,1,17,7,2.7880816873,1.7843014903,3.884835328176669E-4,0.3267973856,0.58455884,0,66,4.7678199958129156E-5,1.198308E-5,1.2138721E-5,140,3,1,200,1,0.005
237842283,TondaMacC,10,2289,4078,899,153,0,59.3727343631,50-59,729,5,370,103,473,473,370,103,6,2.4050887178,16663.6213635874,0.4552035176,0.07705504,0.14312163,0,66,0.0024157607,0.0022228614,0.0022335248,140,73,6,200,6,0.03
237901118,Robert_Johnston,10,348,223,468,12,1,34.270300744,30-39,552,3,18,10,28,28,18,10,7,2.9303649146,52.8163073272,0.0204260348,0.1216931217,0.24456522,0,66,1.1702051979021944E-4,1.1383926E-4,1.1531785E-4,47,2,20,200,15,0.1
237908767,davecoles48,10,3770,1513,1905,27,7,52.3517781982,50-59,732,6,194,230,424,424,194,230,6,2.2494141279,25532.4444321392,0.2053591088,0.0626477541,0.16393094,0,66,8.241819941667472E-4,0.0011683503,0.0011835253,390,124,3,202,2,0.0148514851
237973831,JasonRondeau,10,3649,293,272,5,551,44.7979399572,40-49,684,6,10,12,22,22,10,12,7,2.8443254101,151.6671860478,0.0111987665,0.1017316017,0.25,0,66,9.130125263969044E-5,6.590694E-5,6.6762965E-5,140,9,0,200,0,0
238220689,stephenlautens,10,10763,3352,745,137,39,62.5799585554,60-69,873,7,658,261,919,919,658,261,7,2.2005356545,93137.5743190253,0.5907693326,0.0386111645,0.09582637,0,66,0.0024187006,0.003948425,0.0039815004,47,1095,1,200,1,0.005
238248595,CanadianCBR,10,1688,479,253,25,2,42.0047912377,40-49,697,6,22,17,39,39,22,17,7,2.9564780716,4166.6183887224,0.0035636149,0.0958164642,0.2046371,0,66,2.049412571919608E-4,1.3780541E-4,1.395953E-4,372,60,0,200,0,0
238413434,SameerP93,10,67,39,56,0,5,28.5079401915,20-29,438,3,0,1,1,1,0,1,8,3.936746988,0,0,0,0,0,457,4.4780486537007367E-5,0,6.0693606E-6,55,2,0,73,0,0
239032386,M2thaCo,10,3137,57,261,0,291,22.7605800607,20-29,398,5,1,12,13,13,1,12,7,2.9226648812,12.5999665913,0.0039162934,0.2756410256,0.3846154,0,66,5.034065667458013E-5,1.198308E-5,1.2138721E-5,140,0,1,200,1,0.005
239378797,bigpicguy,10,28002,1239,732,32,210,52.4949231984,50-59,790,9,275,183,458,458,275,183,7,2.2544358889,18336.3018835532,0.3248409274,0.0712879707,0.21168476,0,66,7.956312475468257E-4,0.001653665,0.0016751435,47,221,0,208,0,0
239388939,RobertNDP,10,783,2725,137,169,5,51.7908324452,50-59,726,4,300,24,324,324,300,24,7,2.6645463676,1956.6036710156,0.3376312569,0.1100600084,0.17292924,0,66,0.001457532,0.0018034535,0.0018086694,390,54,1,199,1,0.0050251256
239478762,barrick36,10,2752,644,188,13,527,47.9230114912,40-49,702,6,4,3,7,7,4,3,8,4.6608637429,46.5035717469,3.4885139730257946E-4,0.0714285714,0.5,0,66,1.5339927233024548E-4,2.99577E-5,3.0346804E-5,31,19,0,200,0,0
239489739,SirLoinn,10,15592,103,90,4,7737,37.2378453381,30-39,701,8,14,1,15,15,14,1,7,3.4606628724,7.6289724208,0.0196390153,0.2047619048,0.34285715,0,66,8.951657890471662E-5,8.98731E-5,9.104041E-5,47,26,0,250,0,0
239540543,jackooloosie,10,4244,317,303,8,2,43.8076319849,40-49,633,7,16,12,28,28,16,12,7,2.7495815199,71.1151643251,0.0274818532,0.1256613757,0.3051948,0,66,1.224422970105559E-4,1.0185618E-4,1.0317913E-4,140,4,0,200,0,0
239993455,taylornoakes,10,5180,270,373,10,9,46.8901991964,40-49,675,6,11,12,23,23,11,12,7,2.7773685973,34.490814691,0.0160809243,0.1818181818,0.4239766,0,66,8.330404343847313E-5,7.189848E-5,7.283233E-5,390,8,3,204,3,0.0147058824
240318436,bmyska,10,6708,1502,1799,21,5655,53.372587411,50-59,751,7,70,89,159,159,70,89,6,2.4757281553,4362.6299638502,0.0349345587,0.0554494069,0.28651685,0,66,3.115104004890227E-4,4.2539934E-4,4.309246E-4,372,161,0,201,0,0
240679098,mclennonld,10,74,13,51,0,5,12.5541969358,10-19,123,2,1,5,6,6,1,5,7,3.1600267827,0.0789527448,0.0017602992,0.2333333333,0.4,0,66,4.859532679030867E-5,1.198308E-5,1.2138721E-5,390,1,1,77,1,0.012987013
240707282,nocomment84,10,89,58,175,1,1,20.6432112834,20-29,375,3,21,43,64,64,21,43,7,2.7361901573,125.4523181536,0.0304072625,0.2123015873,0.5228571,0,66,1.6258955038267765E-4,1.3181388E-4,1.3352593E-4,390,3,4,90,4,0.0444444444
240760525,JoelWWood,10,12719,821,789,42,2243,55.3175322659,50-59,753,8,35,30,65,65,35,30,7,2.7890860395,1349.8965494144,0.044122559,0.0997596154,0.20739065,0,66,3.5390538004330564E-4,2.1569544E-4,2.1849698E-4,372,38,0,200,0,0
240778312,DaveYona,10,1341,192,470,3,210,53.2840115092,50-59,578,5,0,0,0,0,0,0,0,0,0,0,0,0,239,461,4.4780486537007367E-5,0,0,235,3,0,200,0,0
240911396,Gnomelita,10,235,29,100,1,10,20.2532183246,20-29,437,3,5,30,35,35,5,30,7,2.7080682959,6.2463444205,0.0045243653,0.2621848739,0.50574714,0,66,6.082606018413667E-5,3.594924E-5,3.6416164E-5,390,2,4,200,4,0.02
240988612,MisturrPants,10,2338,293,669,4,693,42.0698518598,40-49,652,6,31,68,99,99,31,68,7,2.4891195179,708.6330836742,0.0380245735,0.1039991754,0.32769975,0,66,1.1235836114169225E-4,1.9172928E-4,1.9421954E-4,47,0,0,201,0,0
241222972,Kluvsja,10,14999,433,703,12,219,43.6146721052,40-49,786,8,0,5,5,5,0,5,7,3.109103079,0,0,0.45,0.65,0,420,4.4780486537007367E-5,0,6.0693606E-6,140,0,1,201,1,0.0049751244
241226103,EmmMacfarlane,10,42266,5236,425,242,87,61.8963567736,60-69,898,9,474,43,517,517,474,43,7,2.7207900904,5271.4619492731,0.4589788445,0.0605760725,0.09494607,0,66,0.002289455,0.0028459814,0.0028404607,140,754,0,201,0,0
241355995,Schmungle,10,42031,217,419,7,5,47.4223668968,40-49,684,5,0,0,0,0,0,0,0,0,0,0,0,0,27,100,4.4780486537007367E-5,0,0,21,2,0,202,0,0
241625640,MarinSteph,10,2588,857,477,33,3,49.552340761,40-49,679,5,67,60,127,127,67,60,7,2.5450284566,458.3966476703,0.1382518579,0.170416198,0.4635095,0,66,7.586346862659117E-4,4.0742473E-4,4.1271653E-4,390,46,4,200,3,0.02
241630348,joe1scott1,10,486,10,8,1,7,19.5453400169,10-19,379,4,2,2,4,4,2,2,7,3.3973886843,1.3788855927,7.250592875314536E-4,0,0,0,66,5.1683332907338564E-5,1.797462E-5,1.8208082E-5,372,4,0,197,0,0
241797395,rustygreen59,10,13275,4040,4340,62,274,57.3023584694,50-59,774,8,193,244,437,437,193,244,6,2.1606963509,62511.2649917612,0.207211235,0.0394474419,0.20350131,0,66,5.546869079525122E-4,0.0011623588,0.001177456,47,77,0,200,0,0
242038643,tammyrobert,10,6338,1638,930,76,11,54.8007209915,50-59,760,7,23,25,48,48,23,25,6,2.6936725812,3358.3302044566,0.0215128737,0.1050531915,0.23613086,0,66,1.8742196607068906E-4,1.4379696E-4,1.395953E-4,390,109,0,201,0,0
242051914,netminnow,10,89699,1182,1133,59,8405,46.837431753,40-49,769,10,17,9,26,26,17,9,7,2.8523602277,250.7568470051,0.0104968541,0.0676923077,0.20175439,0,66,1.1251052873624112E-4,1.0784772E-4,1.0924849E-4,47,3,0,202,0,0
242093891,axelneitor13,10,1001,113,206,0,32,38.3453705938,30-39,624,5,0,0,0,0,0,0,0,0,0,0,0,0,351,642,4.4780486537007367E-5,0,0,360,11,0,200,0,0
242123168,PhotogShawn,10,2595,207,522,0,11,43.8948207972,40-49,640,6,51,132,183,183,51,132,6,2.2601272179,4857.1179503859,0.0681208329,0.0752416982,0.2142031,0,66,1.6967404647315462E-4,3.1156008E-4,3.1560674E-4,47,19,0,200,0,0
242205201,DrJudyBarrett,10,1879,317,758,1,55,32.0615479429,30-39,571,5,0,0,0,0,0,0,0,0,0,0,0,0,117,233,4.4780486537007367E-5,0,0,114,2,0,200,0,0
242394505,ChrisQuines,10,9356,351,684,13,1478,54.0124904298,50-59,744,7,39,75,114,114,39,75,6,2.5192500837,1306.1947482865,0.0326138081,0.1048750194,0.2780112,0,66,1.96049044686548E-4,2.396616E-4,2.4277443E-4,372,35,0,200,0,0
242477265,_brigitteee,10,10409,247,196,0,929,35.0692115294,30-39,716,7,1,1,2,2,1,1,1,1,0,7.49471721243357E-5,0,0,180,342,2.9852402567743944E-4,1.198308E-5,1.2138721E-5,176,13,0,200,0,0
242506891,tuxforpm,10,4532,91,89,4,1,38.2545878799,30-39,722,6,23,16,39,39,23,16,7,2.8115165718,17.190850002,0.043148168,0.2381916329,0.41092438,0,66,1.1242397491965304E-4,1.4379696E-4,1.4566466E-4,140,19,1,200,1,0.005
242566644,Izzy_Queen,10,1017,179,88,0,4,33.0679103457,30-39,625,5,0,0,0,0,0,0,0,0,0,0,0,0,406,730,4.4780486537007367E-5,0,0,417,17,0,196,0,0
242571362,fowlerkp,10,884,48,279,0,10,20.5307614406,20-29,513,5,3,14,17,17,3,14,7,2.7214596585,4.2290549356,0.0088851609,0.2389705882,0.5769231,0,66,6.124636716836655E-5,2.396616E-5,2.4277442E-5,390,6,0,199,0,0
242808527,Zorpheous,10,5020,251,450,7,277,50.7798177184,50-59,726,7,72,93,165,165,72,93,6,2.3418145296,1901.2848255563,0.1137417346,0.0774575018,0.3221782,0,66,2.644044269044486E-4,4.373824E-4,4.4306333E-4,47,21,1,199,1,0.0050251256
242846644,Cherylstad,10,711,225,117,12,2,43.3844433517,40-49,562,5,32,21,53,53,32,21,7,2.7492467359,585.7950980414,0.0301118349,0.0888969521,0.26726726,0,66,1.8847958729077867E-4,1.9772082E-4,2.0028891E-4,390,18,3,200,3,0.015
242975599,jeanoudy,10,4698,299,682,4,28,43.4090228885,40-49,694,7,73,129,202,202,73,129,6,2.2514228323,2443.9344400796,0.1215081439,0.1029259642,0.32566988,0,66,2.4476979618367166E-4,4.4337395E-4,4.491327E-4,47,28,0,198,0,0
243033466,CanadaZack,10,18249,1137,2000,41,4783,39.3042158097,30-39,775,8,136,236,372,372,136,236,6,2.1901573485,18627.0095698634,0.1860045886,0.0693417964,0.19831182,0,66,5.612796844724338E-4,8.20841E-4,8.3150243E-4,140,15,2,200,2,0.01
243225102,UFCW401,10,765,269,184,3,0,46.7080863238,40-49,596,5,37,33,70,70,37,33,7,2.7110813525,1668.0360520173,0.0388406341,0.0896480331,0.23095737,0,66,1.8909147420313277E-4,2.2767852E-4,2.306357E-4,390,37,10,203,10,0.0492610837
243244761,JeffParadis,10,3815,492,632,24,100,57.9092660877,50-59,659,6,86,95,181,181,86,95,7,2.5028456645,1020.3737301166,0.1255773348,0.1339472069,0.42363054,0,66,4.3634015935874583E-4,5.21264E-4,5.280344E-4,390,10,1,200,1,0.005
243346390,garrattguy,10,1186,42,125,0,4,34.8511336283,30-39,542,6,4,19,23,23,4,19,7,2.7469032474,2.3746571852,0.0041564416,0.3083003953,0.53571427,0,66,5.451580419495961E-5,2.99577E-5,3.0346804E-5,140,3,2,200,2,0.01
243655326,CSAFEUK,10,225,308,199,8,5,40.0804065443,40-49,540,4,0,1,1,1,0,1,2,1.6666666667,0,0,0,0,0,599,4.4780486537007367E-5,0,6.0693606E-6,338,9,0,200,0,0
243730839,CoachB_WFtitans,10,612,144,112,1,8,31.1361339217,30-39,565,4,3,3,6,6,3,3,2,1.25,3,2.3256498589093082E-4,0.1,0.6666667,80,179,4.601340226831424E-4,2.396616E-5,2.4277442E-5,74,4,0,199,0,0
244085908,LizzyM_TO,10,6116,354,531,0,698,47.9389378076,40-49,697,7,33,58,91,91,33,58,6,2.3793103448,1222.2995701422,0.0472485013,0.0844932845,0.29189354,0,66,1.6352781706731423E-4,2.0371236E-4,2.0635827E-4,47,30,0,203,0,0
244196762,jinnysims,10,1081,1846,1470,86,3,53.291980663,50-59,727,5,241,213,454,454,241,213,6,2.2390358219,25505.3665627112,0.304703976,0.0740146454,0.21718702,0,66,0.0011881941,0.0014499527,0.0014627159,390,170,9,200,9,0.045
244299485,greenmarcel,10,2105,80,58,0,26,27.0760765394,20-29,600,6,20,12,32,32,20,12,7,2.8061600268,34.5729307681,0.0275690056,0.1683467742,0.33333334,0,66,1.0859714721576935E-4,1.2582233E-4,1.2745657E-4,47,1,2,200,2,0.01
244534330,Wayne_Comeau,10,493,44,340,1,51,38.4864896305,30-39,535,5,8,29,37,37,8,29,7,2.5708068296,84.7689798739,0.0210414197,0.1659159159,0.38916257,0,66,7.657954322487489E-5,5.392386E-5,5.4624245E-5,140,5,2,200,2,0.01
244600462,Oyekuise,10,58329,976,1999,34,29935,41.7578935674,40-49,744,9,6,6,12,12,6,6,7,3.1399397389,3810.4487783564,0.0033957127,0.0454545455,0.14285715,0,66,1.6262045249650187E-4,4.194078E-5,4.2485524E-5,47,2,0,200,0,0
244612695,Min_Reyes,10,136154,8544,5006,505,3299,66.3599307127,60-69,962,10,588,418,1006,1006,588,418,6,2.0582524272,167377.32183384,0.5245391528,0.0303136405,0.10314756,0,66,0.0020809605,0.003529017,0.0035566452,47,1229,1,207,1,0.0048309179
244622688,HomeRobert,10,764,21,74,0,1,18.249115778,10-19,235,4,2,7,9,9,2,7,7,3.0113826582,3.5547294834,0.002203524,0.1944444444,0.52380955,0,66,9.104040384044588E-5,1.797462E-5,1.8208082E-5,372,12,0,200,0,0
244650352,Chuckw12,10,1000,7,47,0,6,13.8612966293,10-19,217,5,0,4,4,4,0,4,7,3.0210843373,0,0,0.5,0.8333333,0,503,4.4780486537007367E-5,0,6.0693606E-6,140,1,0,200,0,0
244680936,thefamousmrX,10,2742,86,425,2,14,31.4696006383,30-39,596,6,3,7,10,10,3,7,7,2.8871777703,7.3568533817,0.0016708023,0.2444444444,0.43055555,0,66,4.9293576793887016E-5,2.396616E-5,2.4277442E-5,372,0,0,199,0,0
244816624,pau1234la,10,3883,245,503,3,402,42.8478660992,40-49,682,6,13,22,35,35,13,22,7,2.8761298962,86.7642455436,0.0107034375,0.1411764706,0.4402174,0,66,8.930597223655317E-5,8.388156E-5,8.497105E-5,390,24,0,200,0,0
245019687,marciesharp,10,842,52,235,0,38,33.0883697323,30-39,519,5,1,2,3,3,1,2,7,3.2477402076,0,5.511668883963276E-4,0.1666666667,0.5,0,66,4.9714077548719635E-5,1.198308E-5,1.2138721E-5,390,3,1,200,1,0.005
245030913,jenccrane,10,3106,625,1319,12,8,46.3203693208,40-49,665,6,110,187,297,297,110,187,6,2.286575159,7350.8624349882,0.1631389218,0.0821275821,0.25879398,0,66,6.38628355546741E-4,6.6506094E-4,6.73699E-4,140,29,9,200,8,0.045
245039169,Malcolm_AllenMP,10,571,1773,698,129,4,47.0506674901,40-49,677,4,216,87,303,303,216,87,7,2.5055239371,6215.6903292978,0.2599252056,0.106277184,0.2511952,0,66,0.0011776983,0.0013001641,0.0013109819,390,25,19,200,19,0.095
245095160,Erasmus111,10,3523,69,120,6,144,43.0131365875,40-49,609,6,8,6,14,14,8,6,7,2.9186474724,17.9788739021,0.011977196,0.1923076923,0.42727274,0,66,8.398818418914875E-5,5.392386E-5,5.4624245E-5,47,9,1,200,1,0.005
245212504,mikelondoncan,10,622,331,348,11,2611,49.8237850801,40-49,747,7,61,68,129,129,61,68,6,2.484432541,1796.9755161784,0.0937150514,0.1067102713,0.25846833,0,66,3.371277238047577E-4,3.7147547E-4,3.7630036E-4,390,68,0,200,0,0
245400098,HaydenRooney,10,2060,167,249,0,76,31.4120655207,30-39,668,6,0,0,0,0,0,0,0,0,0,0,0,0,29,102,4.4780486537007367E-5,0,0,23,0,0,200,0,0
245477839,trandell88,10,3620,205,180,2,1,40.4434562992,40-49,676,7,5,7,12,12,5,7,8,4.6591898226,9.5963235294,4.359105943609273E-4,0.1287878788,0.5535714,0,66,2.307106946330971E-4,3.594924E-5,3.6416164E-5,31,46,0,200,0,0
245660950,MeToddScott,10,4476,208,354,6,30,44.69646525,40-49,690,7,10,22,32,32,10,22,7,2.6930030131,47.647898192,0.0152820867,0.1078629032,0.32900432,0,66,7.153616518905426E-5,6.590694E-5,6.6762965E-5,47,13,0,200,0,0
245693197,Voiceof9jathugs,10,213728,2954,1316,44,310,47.8953916891,40-49,781,7,1,0,1,1,1,0,0,0,0,7.645535613750089E-5,0,0,0,455,6.734277591528606E-5,1.198308E-5,0,55,0,0,201,0,0
245839288,carolyn1775,10,471,37,162,0,0,21.3573355193,20-29,607,4,0,1,1,1,0,1,7,3.1208165997,0,0,0,0,0,671,4.4780486537007367E-5,0,6.0693606E-6,390,0,0,199,0,0
246393685,TYoungWrite,10,2428,271,661,4,12,35.3625471236,30-39,575,5,10,39,49,49,10,39,6,2.5460328088,64.3818636186,0.0230741594,0.1517857143,0.3839406,0,66,9.968728998802316E-5,6.590694E-5,6.6762965E-5,390,2,0,200,0,0
246426922,voxgroove,10,11793,879,692,21,1223,54.2667787761,50-59,728,7,5,7,12,12,5,7,7,3.0107130901,8.4035312795,0.0033367333,0.0833333333,0.3392857,0,66,6.595426033406831E-5,3.594924E-5,3.6416164E-5,372,12,0,200,0,0
246436394,reverb256,10,26,41,183,0,3,43.126285367,40-49,338,3,1,8,9,9,1,8,7,2.9189822564,1.0689538968,5.63615513737243E-4,0.125,0.23214285,0,66,4.842532685708261E-5,1.198308E-5,1.2138721E-5,47,0,0,17,0,0
246455540,mpmikea,10,2630,980,257,82,1,48.0875678995,40-49,682,5,61,15,76,76,61,15,7,2.7412119183,457.629836679,0.083634201,0.1687719298,0.2962704,0,66,4.413164044225331E-4,3.7147547E-4,3.70231E-4,372,22,5,200,5,0.025
246612992,leadnowca,10,1645,10107,1559,307,0,60.2629507277,60-69,826,5,615,152,767,767,615,152,6,2.2514228323,122939.49176569,0.4775243821,0.0377483737,0.07149865,0,66,0.002848747,0.0036907885,0.0036234083,47,899,1,200,1,0.005
246637413,fermangogo,10,499,27,106,0,6,25.630856559,20-29,479,4,1,11,12,12,1,11,7,2.8754603281,2.0514797163,1.695847130393636E-4,0.2045454545,0.27272728,0,66,4.6426260340864236E-5,1.198308E-5,1.2138721E-5,140,0,0,199,0,0
246667561,pqpolitics,10,36794,2276,2219,97,8,47.9518418841,40-49,796,9,198,170,368,368,198,170,6,2.2253096753,14058.7082930727,0.2528777076,0.0599380998,0.2124774,0,66,6.076776523015804E-4,0.0011923164,0.0012078028,47,354,0,218,0,0
246823640,1girlonthehill,10,819,144,279,3,4,29.2849033492,20-29,551,5,30,68,98,98,30,68,7,2.562437228,104.8271409727,0.0418305917,0.1958762887,0.50072074,0,66,1.5705699185047665E-4,1.8573774E-4,1.8815018E-4,390,8,3,200,3,0.015
246901576,dakTdek,10,74,49,46,0,1,35.4545034262,30-39,439,3,7,7,14,14,7,7,7,3.1697355206,3398.5661465348,0.0026019598,0.1263736264,0.5694444,0,66,1.403782651902971E-4,4.793232E-5,4.8554884E-5,55,16,1,93,1,0.0107526882
246948963,Womanwhovotes,10,12978,1687,2001,76,86,48.235887234,40-49,738,8,250,275,525,525,250,275,7,2.2196183462,23751.3864409207,0.3092364439,0.0592002908,0.18315537,0,66,9.109938778165634E-4,0.0015038765,0.0015234095,140,26,0,200,0,0
247125962,ChelseyRaeS,10,731,171,887,10,0,29.0880549171,20-29,480,5,1,1,2,2,1,1,8,3.6832942752,0,3.0280442900443825E-4,0,0,0,66,5.8129038212847856E-5,1.198308E-5,1.2138721E-5,47,0,0,199,0,0
247404995,michelineless,10,1389,76,251,7,4,25.6013855861,20-29,381,6,6,27,33,33,6,27,6,2.5289588216,15.1441273354,0.0086336152,0.2888257576,0.5640394,0,66,5.5415459360372776E-5,4.194078E-5,4.2485524E-5,390,0,2,200,2,0.01
247478131,heron09,10,4407,60,179,1,244,35.2310246004,30-39,524,7,28,53,81,81,28,53,7,2.4087713425,310.7106381433,0.0479923813,0.1611111111,0.37283653,0,66,1.1512679192545255E-4,1.7375466E-4,1.7601145E-4,47,9,4,222,4,0.018018018
247528533,H2OWise,10,4167,162,152,8,213,40.8742510096,40-49,651,7,16,16,32,32,16,16,7,2.8028121861,56.2421493209,0.0270382296,0.1743951613,0.32936507,0,66,9.541087140605014E-5,1.0185618E-4,1.0317913E-4,140,12,1,200,1,0.005
247571455,savagestate,10,4437,122,92,5,1748,44.7915752116,40-49,659,7,3,3,6,6,3,3,7,3.6193505189,0,4.979721591437422E-4,0.1,1,0,66,6.913275583692257E-5,2.396616E-5,2.4277442E-5,47,2,0,199,0,0
247776029,adrianasn11,10,11623,229,286,0,1012,45.3065869954,40-49,745,7,0,0,0,0,0,0,0,0,0,0,0,0,149,299,4.4780486537007367E-5,0,0,146,26,0,201,0,0
247862756,Hunterlo44,10,7128,77,348,0,110,35.0887999289,30-39,675,6,2,3,5,5,2,3,7,3.1479745564,1.4134440876,0.0028337209,0,0,0,66,5.33708879741348E-5,1.797462E-5,1.8208082E-5,47,8,0,198,0,0
247897149,ShaneMackenzie_,10,14054,1253,1944,28,50,58.9661195997,50-59,745,8,147,226,373,373,147,226,6,2.2403749582,13123.8987668768,0.1619679571,0.0744400242,0.22367807,0,66,5.749528106734122E-4,8.867479E-4,8.982654E-4,140,91,1,200,1,0.005
248412992,firstcircle12,10,1776,269,336,3,240,46.9893277989,40-49,661,5,59,62,121,121,59,62,6,2.379979913,1047.9661096961,0.0942172966,0.0646694215,0.32726076,0,66,2.0890515878720304E-4,3.594924E-4,3.6416165E-4,47,86,1,209,1,0.004784689
248827135,chamberlainusoh,10,4902,6721,175,41,8,60.8636863668,60-69,787,6,3,1,4,4,3,1,2,1.5,5,2.2637987366772705E-4,0,0,0,186,1.8362925590659695E-4,2.396616E-5,2.4277442E-5,55,8,0,200,0,0
249128266,je67an,10,7034,643,584,18,71,48.8575474301,40-49,736,7,148,141,289,289,148,141,6,2.2882490793,6310.3055363634,0.1932033126,0.045475298,0.29933792,0,66,4.101343219149339E-4,8.9273945E-4,9.043347E-4,47,91,1,199,1,0.0050251256
249181686,Holgadoo,10,1233,100,196,1,12,37.1893933906,30-39,586,5,1,1,2,2,1,1,3,2,0,7.49471721243357E-5,0,0,121,238,9.990168110805797E-5,1.198308E-5,1.2138721E-5,117,27,0,199,0,0
249221943,bbbrobin,10,1221,100,121,3,0,35.8404843832,30-39,577,5,14,17,31,31,14,17,7,2.6973552059,84.1445059905,0.0242709959,0.1096774194,0.50292397,0,66,9.076641060669988E-5,8.98731E-5,9.104041E-5,47,5,0,200,0,0
249264319,ErikJohnline,10,559,77,144,3,0,43.9252429774,40-49,577,5,15,13,28,28,15,13,7,3.1449614998,6134.7730936228,0.007221805,0.085978836,0.4117647,0,66,1.754058466871111E-4,9.586464E-5,9.710977E-5,55,38,1,200,1,0.005
249366006,josh_cota,10,6655,274,399,4,685,43.6795852335,40-49,703,7,1,1,2,2,1,1,1,1,0,7.49471721243357E-5,0,0,375,686,2.9852402567743944E-4,1.198308E-5,1.2138721E-5,385,4,0,199,0,0
249421095,stratosphear,10,35419,3378,3472,85,55,,,821,9,197,242,439,439,197,242,6,2.1884834282,37886.2689288062,0.2562200581,0.0396709,0.1929607,0,66,8.211366114690143E-4,0.0011863249,0.0012017334,140,104,1,205,1,0.0048780488
249809370,alicebmcgregor,10,17603,336,622,5,184,40.8978547526,40-49,716,8,73,91,164,164,73,91,7,2.3987278206,1170.3976926733,0.1069980186,0.1351189586,0.2717368,0,66,2.302311122267853E-4,4.4337395E-4,4.491327E-4,47,63,0,213,0,0
250089059,nwohashtag,10,137382,10227,6203,324,8,57.5456635897,50-59,891,9,18,7,25,25,18,7,7,2.9092735186,17471.0728586836,0.0122180157,0.0716666667,0.16428572,0,66,1.3752531315544355E-4,1.1383926E-4,1.1531785E-4,47,14,1,201,1,0.0049751244
250154970,As_In_Speech,10,1639,48,57,1,0,29.4639035671,20-29,568,6,2,6,8,8,2,6,7,2.8935386676,48.0492225782,0.0014304627,0.1964285714,0.56666666,0,66,7.549984949484228E-5,1.797462E-5,1.8208082E-5,390,4,2,200,2,0.01
250159277,Harringtonkent,10,24176,1750,2002,57,6659,43.5874111485,40-49,775,8,9,15,24,24,9,15,7,2.833277536,933.7532362825,0.0071554788,0.0380434783,0.18095239,0,66,8.455345966911259E-5,5.99154E-5,6.069361E-5,47,5,0,201,0,0
250164587,as_LSL,10,173,32,71,0,25,13.4410238165,10-19,84,3,1,5,6,6,1,5,7,2.9578172079,0.9704395823,0.00703058,0.2,0.5,0,66,9.152841714394098E-5,1.198308E-5,1.2138721E-5,55,0,0,177,0,0
250170548,Teresa_Kelly,10,1601,250,304,7,4,42.133772062,40-49,565,6,8,18,26,26,8,18,7,2.7335118848,113.306526837,0.0071491759,0.1061538462,0.3267974,0,66,7.538612772133026E-5,5.392386E-5,5.4624245E-5,390,1,1,200,1,0.005
250282374,susanicoleberry,10,1694,257,426,10,12,46.2459594549,40-49,653,5,44,75,119,119,44,75,7,2.4057582859,1076.9962040122,0.0725067857,0.0874519299,0.31886536,0,66,1.929645987630908E-4,2.696193E-4,2.7312123E-4,47,16,1,200,1,0.005
250306808,NearFutureComm,10,1271,139,620,2,21,26.8121236993,20-29,556,5,13,84,97,97,13,84,6,2.4198192166,194.12073696,0.0284460835,0.1783719931,0.3577031,0,66,1.4987651237770966E-4,8.388156E-5,8.497105E-5,372,3,7,200,6,0.035
250364353,tomcintosh,10,3328,205,75,5,14,47.446078123,40-49,720,6,21,7,28,28,21,7,7,3.1834616672,35.4911500876,0.0139114449,0.167989418,0.2753846,0,66,1.4730444471988587E-4,1.3181388E-4,1.3352593E-4,390,86,0,200,0,0
250448044,mclabradore,10,15794,526,347,11,11,47.9006657256,40-49,768,8,43,43,86,86,43,43,7,2.7797120857,810.7391752952,0.0540821834,0.1306429549,0.28601876,0,66,2.7329324841562864E-4,2.6362776E-4,2.6705186E-4,140,30,3,202,3,0.0148514851
250834460,verbum_sap,10,819,22,23,2,0,21.342334958,20-29,509,4,6,0,6,6,6,0,0,0,0,0.009249476,0.2333333333,0.36666667,0,47,5.800399479745888E-5,4.194078E-5,0,47,0,0,200,0,0
250906632,billhillier,10,36537,1193,38,35,2,47.8896011178,40-49,839,8,275,17,292,292,275,17,7,2.7392032139,1419.116757538,0.2815111591,0.105728946,0.18500331,0,66,7.142500628054611E-4,0.001653665,0.0016751435,47,469,0,212,0,0
250931446,SSexpress10,10,14749,258,258,0,869,42.9809239008,40-49,721,7,8,8,16,16,8,8,2,1.3846153846,10.7674603175,6.769291526699885E-4,0.0875,0.6785714,26,99,3.9744593976229973E-4,5.392386E-5,5.4624245E-5,49,60,0,199,0,0
250941432,knitram24,10,11047,283,835,1,283,31.887213259,30-39,576,8,33,127,160,160,33,127,6,2.2899229997,1501.648469113,0.0391129643,0.1006289308,0.21233043,0,66,1.278798253438695E-4,2.0371236E-4,2.0635827E-4,390,2,1,199,1,0.0050251256
251015682,ahayher,10,2476,300,514,1,6,41.5963258979,40-49,683,6,8,22,30,30,8,22,7,2.8399732173,33.9027263916,0.0100368884,0.1908045977,0.41,0,66,7.490571755949368E-5,5.392386E-5,5.4624245E-5,372,7,0,200,0,0
251116380,BradButtMP,10,3413,1654,725,91,3,53.6810325023,50-59,683,5,95,45,140,140,95,45,7,2.7623033144,1057.5496604381,0.1020374642,0.1347893114,0.25307345,0,66,7.0554854241658E-4,5.7518785E-4,5.705199E-4,372,34,7,200,7,0.035
251256864,CPCANADIANS,10,2063,624,580,17,1,49.7600821048,40-49,729,6,13,12,25,25,13,12,7,3.6618680951,62168.6792333369,0.002889381,0.0516666667,0.33974358,0,66,5.443087680884565E-4,8.388156E-5,8.497105E-5,31,356,0,206,0,0
251564109,JimvanderDeijl,10,1262,573,64,9,2,45.2600623828,40-49,679,5,1,1,2,2,1,1,2,1.5,0,7.645535613750089E-5,0,0,51,140,2.29874507414389E-4,1.198308E-5,1.2138721E-5,42,8,0,200,0,0
251584824,pbtrue1,10,33772,2008,2209,60,1006,44.922572488,40-49,744,9,16,18,34,34,16,18,7,3.0127217944,577.2824406055,0.0043746051,0.055258467,0.24285714,0,66,1.8468198204808967E-4,1.0185618E-4,1.0317913E-4,47,9,0,200,0,0
252109262,V4Daddy,10,19072,202,322,4,87,39.722011386,30-39,755,8,4,4,8,8,4,4,7,3.3247405424,2.476984583,0.0049372062,0.2142857143,0.42857143,0,66,5.980839731513856E-5,2.99577E-5,3.0346804E-5,372,6,0,201,0,0
252167009,marcel_campelo,10,34001,1349,1348,22,27,65.6239913645,60-69,799,9,0,0,0,0,0,0,0,0,0,0,0,0,93,200,4.4780486537007367E-5,0,0,88,17,0,200,0,0
252237345,IndependentNL,10,682,3294,1192,84,0,47.2972561985,40-49,663,4,28,22,50,50,28,22,7,2.8891864747,741.1236494294,0.0158599351,0.0771428571,0.24420677,0,66,1.5938743455141616E-4,1.7375466E-4,1.7601145E-4,390,20,0,200,0,0
252272072,vihhleiva,10,8318,224,187,0,0,26.8295260853,20-29,730,7,3,3,6,6,3,3,2,1.4,0.3333333333,2.3581194560091964E-4,0.2,0.9166667,317,575,2.6489724383633106E-4,2.396616E-5,2.4277442E-5,318,11,0,199,0,0
252274047,Roberto59xx,10,296,94,821,0,2,14.4175789717,10-19,299,4,1,10,11,11,1,10,7,2.9645128892,0.5215582596,4.382701083019964E-4,0.2363636364,0.4,0,66,4.7417036255471055E-5,1.198308E-5,1.2138721E-5,55,0,0,200,0,0
252401073,RoyalShipyard,10,22923,150,52,4,0,43.5584777351,40-49,596,6,3,0,3,3,3,0,0,0,0,0.0064544663,0.3333333333,0.5,0,51,5.0494860569512354E-5,2.396616E-5,0,47,3,0,201,0,0
252443979,d_zels,10,997,200,285,2,110,35.7155109737,30-39,592,5,6,11,17,17,6,11,7,3.0944091061,24.5462860057,8.535180887492487E-4,0.1507352941,0.6,0,66,9.507191944372717E-5,4.194078E-5,4.2485524E-5,372,3,0,198,0,0
252605568,Chris_Grimshaw,10,1265,92,243,4,4,38.2330221113,30-39,514,5,1,5,6,6,1,5,7,3.1225309675,0.9654028672,5.076649585671402E-4,0.2666666667,0.5,0,66,5.2658610429339275E-5,1.198308E-5,1.2138721E-5,140,0,0,200,0,0
252824869,JackFonsec,10,90,61,105,3,1,40.5727609415,40-49,461,2,7,13,20,20,7,13,6,2.8711081353,2566.8633149778,0.0048205253,0.1421052632,0.3904762,0,66,1.1478750017229275E-4,4.793232E-5,4.2485524E-5,372,27,1,103,1,0.0097087379
253086457,TOTigerLilly,10,18405,1220,1999,34,1052,46.0400669655,40-49,753,8,24,37,61,61,24,37,7,2.6444593237,330.3938513486,0.0211463306,0.0980874317,0.3805121,0,66,1.7856488744853594E-4,1.497885E-4,1.5173401E-4,47,13,0,201,0,0
253180312,Shhlie,10,1426,133,164,1,330,39.2117400588,30-39,620,5,4,4,8,8,4,4,2,1.2,0,3.2182929738269154E-4,0.1071428571,1,209,402,2.6065177531832076E-4,2.99577E-5,3.0346804E-5,341,22,0,200,0,0
253382876,OccupyCoscienza,10,11727,615,969,14,1365,47.8975036571,40-49,748,8,44,74,118,118,44,74,6,2.3116839638,6668.2754747597,0.0773811892,0.0878603506,0.35172158,0,66,1.9311943699221128E-4,2.696193E-4,2.7312123E-4,47,20,0,200,0,0
254228285,anatta60,10,1812,93,778,1,64,34.1697114074,30-39,467,5,12,48,60,60,12,48,6,2.4499497824,490.0515792733,0.0154281096,0.1446327684,0.33289006,0,66,7.907658046824139E-5,7.789002E-5,7.8901685E-5,47,0,0,201,0,0
254342818,KellmMurph,10,1055,218,353,11,5,44.5594729061,40-49,593,5,17,22,39,39,17,22,7,2.7281553398,70.5897964215,0.0149675847,0.141025641,0.3731527,0,66,9.376858713614534E-5,1.0784772E-4,1.0924849E-4,390,14,0,200,0,0
254388885,FireClef,10,884,318,736,2,87,22.7766664199,20-29,555,5,1,8,9,9,1,8,7,2.6863073318,1.2259305268,0.0016863791,0.1388888889,0.23214285,0,66,4.553966086114525E-5,1.198308E-5,1.2138721E-5,47,0,2,200,2,0.01
254714696,MediatedJustice,10,1635,196,433,17,3,42.3330194385,40-49,617,6,18,40,58,58,18,40,7,2.4730498828,708.6594444599,0.0390346576,0.165154265,0.36879432,0,66,1.3420290831651612E-4,1.1383926E-4,1.1531785E-4,140,6,0,200,0,0
254749458,ezpe98_,10,7885,58,160,0,1,30.4733237673,30-39,659,6,2,20,22,22,2,20,7,2.8804820891,7.982339954,0.0046542166,0.3896103896,0.6666667,0,66,4.939757183859327E-5,1.797462E-5,1.8208082E-5,140,3,4,201,4,0.0199004975
254777166,Nik_koy,10,7869,224,266,1,21,30.8043930722,30-39,690,6,0,0,0,0,0,0,0,0,0,0,0,0,87,190,4.4780486537007367E-5,0,0,81,1,0,200,0,0
254814925,Fnolet,10,4375,210,484,6,13,38.1437208856,30-39,652,6,33,84,117,117,33,84,6,2.5199196518,148.5094342665,0.0597151788,0.1984232243,0.58837533,0,66,2.0855425948286795E-4,2.0371236E-4,2.0635827E-4,390,23,0,200,0,0
254999238,trapdinawrpool,10,86241,2671,2458,97,93,56.3362666489,50-59,895,10,388,396,784,784,388,396,6,2.067626381,62189.7049217134,0.4272703639,0.0344224855,0.16819046,0,66,0.0011008879,0.002330709,0.002354912,47,990,1,225,1,0.0044444444
255067647,cmusician,10,51912,1141,1997,43,7856,44.1282451974,40-49,787,9,190,176,366,366,190,176,6,2.2922664881,17822.4696261864,0.2278318842,0.0702747212,0.16929084,0,66,7.815518265834287E-4,0.0011443842,0.001159248,390,188,0,221,0,0
255124676,YasmenHasan,10,7640,527,1088,9,203,48.5158065163,40-49,740,7,10,13,23,23,10,13,7,2.8239035822,41.3782293189,0.0105003965,0.0968379447,0.24264705,0,66,8.186313929906882E-5,6.590694E-5,6.6762965E-5,140,57,0,201,0,0
255332775,alip450,10,3277,182,739,1,281,45.4504507868,40-49,667,7,2,43,45,45,2,43,7,2.598928691,25.3032193635,0.0049008771,0.2833333333,0.49667773,0,66,5.182208695264831E-5,1.797462E-5,1.8208082E-5,140,10,0,201,0,0
255480780,KLAFFS103,10,273,55,110,0,1,16.6067878497,10-19,391,3,0,0,0,0,0,0,0,0,0,0,0,0,234,453,4.4780486537007367E-5,0,0,230,7,0,199,0,0
255487471,K7K2tog,10,8607,390,573,7,819,47.4561013834,40-49,737,7,13,15,28,28,13,15,7,2.900903917,124.6752193159,0.0074806961,0.0767195767,0.20238096,0,66,9.533298840167869E-5,8.388156E-5,8.497105E-5,140,6,1,201,1,0.0049751244
255696084,k_menard,10,472,113,946,3,1,19.3189892194,10-19,232,5,6,62,68,68,6,62,7,2.5215935721,215.9416415451,0.0160335886,0.2631694469,0.50898993,0,66,7.500450883071182E-5,4.194078E-5,4.2485524E-5,372,0,1,199,1,0.0050251256
255823181,lefthungry,10,1899,40,164,3,38,27.2282852928,20-29,572,5,0,3,3,3,0,3,7,3.0010040161,0,0,0.5,0.8333333,0,388,4.4780486537007367E-5,0,6.0693606E-6,140,1,0,200,0,0
255917337,annemariebenoit,10,5550,574,1248,10,79,47.6091501656,40-49,604,7,51,87,138,138,51,87,6,2.2875795112,6845.3375013239,0.0712783606,0.0601925315,0.244587,0,66,1.8690598891899006E-4,3.1156008E-4,3.1560674E-4,47,14,1,200,1,0.005
256005257,liordegani,10,1788,460,849,6,219,61.1867104665,60-69,607,6,0,0,0,0,0,0,0,0,0,0,0,0,148,298,4.4780486537007367E-5,0,0,145,1,0,200,0,0
256099934,PattyMC22,10,1970,433,418,8,1,60.1481362047,60-69,670,6,28,36,64,64,28,36,6,2.7418814864,487.7255847505,0.014308307,0.1173115079,0.36969697,0,66,2.2864153962975006E-4,1.7375466E-4,1.7601145E-4,372,30,0,200,0,0
256124395,Westcoastmaven,10,1161,31,72,2,6,25.1682105011,20-29,524,3,8,11,19,19,8,11,7,2.7941078005,0.1234319702,0.0168761434,0.2865497076,0.7380952,0,66,6.555850129704277E-5,5.392386E-5,5.4624245E-5,140,3,0,200,0,0
256215901,Colton_Ness,10,4299,421,1026,5,305,44.6177432265,40-49,688,6,27,73,100,100,27,73,6,2.5738198862,1098.0421115128,0.0291171439,0.1406060606,0.30473113,0,66,1.6773928019129034E-4,1.6776312E-4,1.699421E-4,372,6,4,200,4,0.02
256508013,CER_Chile,10,267,1501,49,45,1,48.5401135115,40-49,648,3,2,4,6,6,2,4,9,4.6052895882,5,2.1510703965817429E-4,0.1,0.33333334,0,66,1.8630248228475728E-4,1.797462E-5,1.8208082E-5,320,7,0,200,0,0
256664075,RexdaleCLC,10,757,110,82,5,0,30.2117547154,30-39,506,5,2,2,4,4,2,2,7,3.239370606,15.1270236098,0.0022688021,0,0,0,66,9.776042757753394E-5,1.797462E-5,1.8208082E-5,140,5,1,200,1,0.005
256773530,WFTitanBaseball,10,1189,211,29,1,5,42.6949907924,40-49,621,3,3,1,4,4,3,1,3,2,0,2.3256498589093082E-4,0.25,1,80,179,3.1919263514044495E-4,2.396616E-5,2.4277442E-5,74,59,0,199,0,0
256775505,SeanCaseyMP,10,1498,2038,1226,107,3,52.5447220836,50-59,721,5,152,64,216,216,152,64,7,2.5256109809,4696.7549780136,0.1878580112,0.0981696813,0.2229826,0,66,8.024004680180796E-4,9.167056E-4,9.225428E-4,140,154,4,199,4,0.0201005025
256807621,bel_ang,10,783,80,221,2,82,43.7899975153,40-49,604,5,1,6,7,7,1,6,1,1,0,7.800895368099194E-5,0.3571428571,0.6666667,250,479,5.604369333356824E-5,1.198308E-5,1.2138721E-5,248,8,0,201,0,0
256952235,jessiesitnick,10,723,163,336,6,3,41.744401182,40-49,574,5,4,19,23,23,4,19,7,2.7311683964,79.4383496144,0.005400661,0.1067193676,0.23976608,0,66,5.676157838426801E-5,2.99577E-5,3.0346804E-5,55,2,0,199,0,0
257144050,ZachFleish,10,1024,249,484,3,5,38.201197464,30-39,593,5,6,9,15,15,6,9,7,2.9203213927,53.9591369205,0.0026027063,0.1761904762,0.25274727,0,66,6.945595479766388E-5,4.194078E-5,4.2485524E-5,140,3,0,200,0,0
257144150,EVCoffeehouse,10,697,637,1028,31,20,42.7274484595,40-49,653,5,8,14,22,22,8,14,7,2.724137931,1352.0742390618,0.0046264042,0.0887445887,0.2,0,66,1.1984734683943261E-4,5.392386E-5,5.4624245E-5,55,7,0,199,0,0
257644524,wapimaskwa69,10,21988,1309,1505,43,10,50.3709057233,50-59,775,8,114,100,214,214,114,100,6,2.3441580181,14214.7273301449,0.1194435379,0.0333464964,0.15729032,0,66,4.1291032667926524E-4,6.890271E-4,6.979765E-4,47,74,0,202,0,0
257761286,danolsonbc,10,3043,212,401,16,20,28.7642825579,20-29,616,6,15,37,52,52,15,37,7,2.58319384,51.0113650486,0.0262202635,0.1644042232,0.4147436,0,66,9.592432817209768E-5,9.586464E-5,9.710977E-5,140,1,0,199,0,0
258135801,JulieSLalonde,10,10251,1792,1988,81,9,57.7639780692,50-59,772,7,98,111,209,209,98,111,6,2.3341144961,12484.304340795,0.1085914236,0.0720463747,0.20859706,0,66,4.4299716522804423E-4,5.9316243E-4,5.88728E-4,390,131,1,201,1,0.0049751244
258151703,BarbaraCee,10,582,54,171,1,7,40.4005250232,40-49,559,4,6,13,19,19,6,13,7,2.7666555072,42.4452562994,0.0063934981,0.0964912281,0.27564102,0,66,6.207569250191492E-5,4.194078E-5,4.2485524E-5,140,12,1,200,1,0.005
258170457,BLTimpson,10,2160,213,271,5,31,41.9695373875,40-49,625,6,9,14,23,23,9,14,7,2.8794777369,72.4406934654,0.0067630991,0.162055336,0.3627451,0,66,7.276136605304193E-5,5.99154E-5,6.069361E-5,372,3,1,198,1,0.0050505051
258463599,Hctraf,10,5676,183,153,0,304,44.6166079494,40-49,719,7,0,0,0,0,0,0,0,0,0,0,0,0,67,160,4.4780486537007367E-5,0,0,59,2,0,201,0,0
258497039,MND1980,10,5753,338,919,7,88,47.4517234414,40-49,700,7,6,12,18,18,6,12,7,2.8008034818,10.7606367894,0.0098553919,0.1307189542,0.49242425,0,66,7.179079800180834E-5,4.194078E-5,4.2485524E-5,390,2,0,201,0,0
258549215,sjaroszuk,10,2523,477,943,13,41,55.0438518436,50-59,673,6,48,89,137,137,48,89,6,2.4161365919,2129.580967311,0.0447164349,0.084048948,0.26252574,0,66,2.5708595323649554E-4,2.9358547E-4,2.9739868E-4,372,18,1,201,1,0.0049751244
258562269,SpYeDeR,10,2458,552,2000,7,374,36.5273015869,30-39,597,6,27,100,127,127,27,100,6,2.2524271845,2241.8877859009,0.0471675244,0.1562304712,0.38444445,0,66,1.0557346547185597E-4,1.6776312E-4,1.699421E-4,47,5,0,200,0,0
258673327,vradrian99,10,1975,209,824,3,2,38.7954923148,30-39,583,6,6,32,38,38,6,32,7,2.5878808169,64.1794943516,0.0062858244,0.1301564723,0.26612905,0,66,6.251477190312775E-5,4.194078E-5,4.2485524E-5,55,0,0,200,0,0
259128842,beesenitch,10,4140,162,261,1,43,46.7548833715,40-49,699,6,9,23,32,32,9,23,7,2.9879477737,41.970866984,0.0035157921,0.1673387097,0.34757835,0,66,7.448065994104585E-5,5.99154E-5,6.069361E-5,372,11,0,200,0,0
259226302,webgra,10,1148,173,124,1,0,34.6167078325,30-39,461,3,1,0,1,1,1,0,0,0,0,7.34391852452689E-5,0,0,50,138,8.284390166388585E-5,1.198308E-5,0,41,1,0,200,0,0
259330135,0lddutch,10,10557,359,198,11,37,40.139216054,40-49,741,7,139,82,221,221,139,82,6,2.3769668564,1751.665145151,0.1861648535,0.1067873303,0.2883592,0,66,3.853640355727562E-4,8.388156E-4,8.497105E-4,47,96,3,201,3,0.0149253731
259606419,StigNasty,10,7274,103,191,1,50,41.0891969493,40-49,684,6,25,11,36,36,25,11,7,2.7820555742,41.9092289653,0.0384018957,0.1603174603,0.4002463,0,66,1.0469996195878626E-4,1.5578004E-4,1.5780337E-4,47,8,1,200,1,0.005
260000449,isaacmacd,10,1032,160,454,0,5,38.7573170766,30-39,614,5,10,18,28,28,10,18,7,2.8061600268,72.7239626675,0.0076518288,0.1402116402,0.37105262,0,66,8.082225404850849E-5,6.590694E-5,6.6762965E-5,372,16,0,199,0,0
260048608,rpfahlman,10,2293,625,1373,17,709,44.2834107359,40-49,648,6,171,335,506,506,171,335,6,2.1108135253,34699.5144958331,0.2089032207,0.0538879975,0.16943955,0,66,5.25949121160441E-4,0.0010305449,0.0010439301,47,20,3,200,3,0.015
260423578,Lynne_Rodier,10,6731,1017,1775,25,169,37.5188410478,30-39,669,7,26,51,77,77,26,51,7,2.5199196518,867.297668458,0.0310454891,0.0637388927,0.2138009,0,66,1.374308372454699E-4,1.6177158E-4,1.6387274E-4,390,0,1,200,1,0.005
260448523,TheHarperGov,10,4267,937,0,46,0,41.1951968358,40-49,742,4,183,0,183,183,183,0,0,0,0,0.1866958787,0.1033447427,0.1620729,0,5,5.710969572729534E-4,0.0011024433,0,47,82,4,200,4,0.02
260559024,paulfaoro,10,523,641,422,24,1,46.5856834778,40-49,616,4,49,26,75,75,49,26,7,2.8567124205,305.0038491982,0.0521518447,0.1322522523,0.31390977,0,66,2.8315101479532505E-4,2.99577E-4,3.0346803E-4,390,9,0,199,0,0
260566096,Bibliocracy,10,2527,406,205,17,393,51.2389596437,50-59,704,6,22,13,35,35,22,13,7,2.9912956143,9206.2188450205,0.0108155462,0.0462184874,0.15036231,0,66,3.0699328922400426E-4,1.3780541E-4,1.395953E-4,372,125,0,200,0,0
260827091,harmanfreelance,10,2533,318,992,9,5,43.2269788362,40-49,613,6,10,59,69,69,10,59,6,2.3896886508,87.4945700766,0.0202809978,0.2335890878,0.42411423,0,66,9.063458085316095E-5,6.590694E-5,6.6762965E-5,140,2,10,200,10,0.05
260980623,skmckenzie,10,11612,469,348,2,1875,38.5799504095,30-39,735,7,2,2,4,4,2,2,1,1,2,1.4992441991589235E-4,0,0,288,537,4.3582306220354E-4,1.797462E-5,1.8208082E-5,332,31,0,200,0,0
261024394,tylermcghie,10,103,90,275,5,12,34.95933624,30-39,436,3,1,3,4,4,1,3,4,2.5555555556,8,7.49471721243357E-5,0.0833333333,0.16666667,0,546,1.0912479197109002E-4,1.198308E-5,1.2138721E-5,352,6,0,101,0,0
261309062,InfoAlerteBot,10,4888,3437,122,178,4,56.349031285,50-59,780,6,332,13,345,345,332,13,7,3.0013391363,606.9921907971,0.3464835333,0.0714357937,0.10077608,0,66,0.0018699875,0.0019951828,0.0020089585,140,158,45,200,45,0.225
261487188,poshbirdQ,10,63400,1018,911,40,4213,50.0268988383,50-59,787,9,10,9,19,19,10,9,7,3.0150652829,120.5239688498,0.0099612072,0.0497076023,0.18939394,0,66,8.823649500810968E-5,6.590694E-5,6.6762965E-5,47,0,0,200,0,0
261539076,gayhuckabee,10,6161,735,1532,15,1497,47.8927161567,40-49,704,7,4,15,19,19,4,15,7,2.7365249414,22.7595880606,0.0029675587,0.0935672515,0.20476191,0,66,5.2034253257751715E-5,2.99577E-5,3.0346804E-5,47,2,0,200,0,0
261751772,CarolHusband,10,8621,947,1122,14,401,49.9036999637,40-49,744,7,55,98,153,153,55,98,6,2.541680616,1989.4842862452,0.0289497989,0.0790763674,0.27353913,0,66,2.4569453848455677E-4,3.3552625E-4,3.398842E-4,372,38,0,200,0,0
261857919,JacksonUTE,10,9182,306,634,3,0,45.7122704789,40-49,697,7,49,122,171,171,49,122,6,2.2825577503,2910.2873471351,0.0834995373,0.123873409,0.35085964,0,66,2.1760864604561695E-4,2.99577E-4,3.0346803E-4,390,29,2,200,2,0.01
262153595,Charles_McD,10,64,12,310,0,10,16.8149155262,10-19,99,3,0,0,0,0,0,0,0,0,0,0,0,0,361,655,4.4780486537007367E-5,0,0,370,0,0,59,0,0
262244948,heritagektown,10,4251,1334,1994,19,2430,48.1884874332,40-49,642,6,17,40,57,57,17,40,6,2.6595246066,1006.2587656487,0.0141603054,0.1087092732,0.28012684,0,66,1.0396004694810879E-4,1.0784772E-4,1.0924849E-4,372,25,0,199,0,0
262280216,OntarioCStores,10,1925,498,831,6,8,44.4305588824,40-49,640,5,16,49,65,65,16,49,6,2.4911282223,900.1827348702,0.0163524101,0.1423076923,0.35921568,0,66,1.5274895815720255E-4,1.0185618E-4,1.0317913E-4,372,10,0,199,0,0
262323897,MeierMac,10,5956,308,390,5,243,41.7113688141,40-49,608,7,42,69,111,111,42,69,7,2.4315366589,1327.758667743,0.0478706053,0.0627354627,0.23229814,0,66,1.6747270943655136E-4,2.5763622E-4,2.6098252E-4,47,19,1,199,1,0.0050251256
262476027,spiderrico38,10,1740,46,49,0,25,32.0591002198,30-39,562,6,18,20,38,38,18,20,7,2.6752594576,160.2315993552,0.0122167541,0.1621621622,0.49867725,0,66,1.2259083482616043E-4,1.1383926E-4,1.1531785E-4,372,5,3,197,3,0.0152284264
262501181,solutionsonly,10,217,43,225,0,5,25.5027182162,20-29,349,3,3,34,37,37,3,34,7,2.6468028122,38.4901837814,0.0015149248,0.286036036,0.5508021,0,66,5.250371214241395E-5,2.396616E-5,2.4277442E-5,140,9,0,200,0,0
262520354,msmely,10,6175,56,97,1,77,36.5278288174,30-39,664,7,2,1,3,3,2,1,8,3.59390693,0.0984951993,0.0022410768,0.3333333333,0.33333334,0,66,4.807166088595508E-5,1.797462E-5,1.8208082E-5,47,1,0,200,0,0
262522708,NoEasyBrushOff,10,8844,323,387,12,20,46.8557555901,40-49,691,7,60,76,136,136,60,76,6,2.3793103448,2266.2029075935,0.0868193917,0.0668300654,0.31518987,0,66,1.9935182563831207E-4,3.6548392E-4,3.70231E-4,47,36,0,203,0,0
262540645,Usual5uspect,10,1927,454,492,6,63,45.9354010143,40-49,628,6,30,66,96,96,30,66,6,2.6464680281,419.6778089304,0.0186176056,0.1117324561,0.34164536,0,66,1.4505742237961512E-4,1.8573774E-4,1.8815018E-4,372,22,0,199,0,0
262689657,DriverHireDton,10,128,78,300,0,1,38.9790983396,30-39,449,3,1,1,2,2,1,1,1,1,0,7.49471721243357E-5,0,0,48,136,2.9852402567743944E-4,1.198308E-5,1.2138721E-5,39,12,0,200,0,0
262885487,Botty11,10,7792,123,372,5,10,40.6097167637,40-49,733,7,1,1,2,2,1,1,1,1,0,7.49471721243357E-5,0,0,255,485,2.9852402567743944E-4,1.198308E-5,1.2138721E-5,253,65,0,200,0,0
263122187,liamswiss,10,846,303,640,20,27,,,581,5,10,18,28,28,10,18,7,2.9812520924,6188.8116054015,0.0046223145,0.1283068783,0.27705628,0,66,1.238332918346352E-4,6.590694E-5,6.6762965E-5,390,9,0,200,0,0
263222957,buttsaima,10,3100,217,582,2,39,41.4447994497,40-49,606,6,6,34,40,40,6,34,7,2.5845329762,124.657738566,0.0031130327,0.1705128205,0.30793652,0,66,6.47362101182319E-5,4.194078E-5,4.2485524E-5,372,5,0,200,0,0
263580149,55FiftyFive55,10,674,580,91,24,0,42.9612783517,40-49,592,4,4,1,5,5,4,1,1,1,3102,3.060883101769681E-4,0,0,0,57,6.681792381853696E-4,2.99577E-5,2.4277442E-5,320,15,0,200,0,0
263691341,bluecanadaca,10,2269,518,524,15,7,50.0114586131,50-59,715,6,48,50,98,98,48,50,6,2.6936725812,1123.6021707919,0.0275558484,0.0857353251,0.33527234,0,66,3.8158060860824113E-4,2.9358547E-4,2.9739868E-4,372,99,14,200,14,0.07
263831999,amneetbali,10,2716,340,140,3,100,41.5292524667,40-49,699,6,12,27,39,39,12,27,7,2.7355205892,19.6046462956,0.0207444045,0.2307692308,0.60645163,0,66,1.35547761261836E-4,7.789002E-5,7.8901685E-5,390,16,1,200,1,0.005
263850473,madisonduan,10,944,127,115,0,411,34.3198236759,30-39,586,5,0,0,0,0,0,0,0,0,0,0,0,0,96,203,4.4780486537007367E-5,0,0,91,12,0,200,0,0
263863782,KamillaBerdin,10,2672,266,687,3,121,41.8277739118,40-49,559,5,0,2,2,2,0,2,7,3.1452476573,0,0,0.5,1,0,602,4.4780486537007367E-5,0,6.0693606E-6,140,1,0,200,0,0
263891856,Cleon255,10,45574,1560,1321,2,39,43.714075409,40-49,789,9,1,1,2,2,1,1,1,1,0,7.49471721243357E-5,0,0,141,282,2.9852402567743944E-4,1.198308E-5,1.2138721E-5,317,22,0,202,0,0
264003758,NadineMBailey,10,3753,490,362,20,14,40.3131845574,40-49,676,6,28,18,46,46,28,18,7,2.8791429528,263.0988479557,0.0282246525,0.1043478261,0.26638657,0,66,1.6498591508486057E-4,1.7375466E-4,1.7601145E-4,390,20,0,200,0,0
264138087,joshdneufeld,10,1849,969,537,31,231,54.1870984997,50-59,704,5,20,21,41,41,20,21,7,2.937730164,9013.6207307547,0.0082729673,0.0701219512,0.29333332,0,66,2.8527510095674306E-4,1.2582233E-4,1.2138722E-4,55,236,2,200,2,0.01
264267429,JerryPrag,10,5536,146,62,9,2,49.9250468739,40-49,676,7,35,13,48,48,35,13,7,2.8048208905,99.9746201902,0.0614898416,0.1737588652,0.3583043,0,66,1.7636013602376953E-4,2.1569544E-4,2.1849698E-4,47,93,0,200,0,0
264364455,davidfinnis4NDP,10,594,771,1626,38,3,43.1562554197,40-49,595,5,76,120,196,196,76,120,6,2.3401406093,5080.2172930305,0.1013004068,0.110570382,0.3098217,0,66,3.5287783799639355E-4,4.6134857E-4,4.6734078E-4,390,7,0,200,0,0
264451340,onahunttoday,10,52185,695,807,19,59506,54.5290110285,50-59,725,9,4,2,6,6,4,2,8,3.2668228992,1.8107809292,0.0040206224,0.2,0.36666667,0,66,5.649169254741309E-5,2.99577E-5,3.0346804E-5,47,4,0,201,0,0
264828297,SistaMax112,10,285,82,315,3,4,31.3401093122,30-39,425,4,18,45,63,63,18,45,7,2.5460328088,600.4436029106,0.0204346167,0.1438812084,0.3477891,0,66,1.1400483128794868E-4,1.1383926E-4,1.1531785E-4,390,11,0,200,0,0
265041082,TrickNig,10,2570,184,589,0,8,35.2004409242,30-39,616,6,12,43,55,55,12,43,7,2.6099765651,450.0037816664,0.013631817,0.1451178451,0.34191918,0,66,7.434207464814314E-5,7.789002E-5,7.8901685E-5,47,2,1,199,1,0.0050251256
265049085,Sliik07,10,1706,52,51,0,11,33.0431272841,30-39,506,4,0,0,0,0,0,0,0,0,0,0,0,0,294,545,4.4780486537007367E-5,0,0,291,1,0,202,0,0
265733538,akplourdee,10,944,176,412,0,334,32.9772350398,30-39,579,4,1,1,2,2,1,1,1,1,0,7.49471721243357E-5,0,0,39,123,2.9852402567743944E-4,1.198308E-5,1.2138721E-5,201,5,0,198,0,0
266048357,CampaignLife,10,1651,654,362,27,3,48.8233876454,40-49,707,5,22,48,70,70,22,48,7,2.6287244727,7497.814671925,0.0071314753,0.1341614907,0.28531075,0,66,2.216428009662466E-4,1.3780541E-4,1.395953E-4,372,72,2,200,2,0.01
266225680,fyrwulf13,10,674,30,94,0,25,14.675146986,10-19,497,4,4,10,14,14,4,10,7,2.9571476398,2.806698384,0.0054239341,0.2087912088,0.37121212,0,66,5.407591541934201E-5,2.99577E-5,3.0346804E-5,390,1,1,200,1,0.005
266237186,EcoDivaNomi,10,1504,276,564,5,7,30.8349555756,30-39,540,5,7,20,27,27,7,20,6,2.6170070305,89.1886743378,0.0072754121,0.1096866097,0.29210526,0,66,6.901007773762548E-5,4.793232E-5,4.8554884E-5,47,0,0,200,0,0
266435289,gentajiri,10,316,29,45,0,62,26.5948095752,20-29,379,4,0,0,0,0,0,0,0,0,0,0,0,0,330,596,4.4780486537007367E-5,0,0,335,0,0,201,0,0
266620548,camdearlove,10,6037,879,853,47,23,52.456033047,50-59,740,7,83,107,190,190,83,107,6,2.3565450285,7080.22938756,0.0961244601,0.0864940128,0.2717766,0,66,3.4747718616041673E-4,5.0328934E-4,5.098263E-4,390,47,0,200,0,0
266635199,RodgerCuzner,10,1014,2495,703,133,0,51.6063047903,50-59,727,5,217,85,302,302,217,85,7,2.4837629729,6842.1124365672,0.2841045064,0.0873908165,0.2042529,0,66,0.0013339881,0.0013061557,0.0013170512,140,79,8,200,8,0.04
266793860,Abeer_Raafat,10,4457,151,273,0,459,36.2247102145,30-39,677,6,0,0,0,0,0,0,0,0,0,0,0,0,232,451,4.4780486537007367E-5,0,0,228,0,0,200,0,0
266914729,Macktrocity,10,10,6,26,0,2,11.8833382982,10-19,26,1,2,3,5,5,2,3,7,3.3468362906,0,2.7454836662396117E-4,0.15,0.6666667,0,66,5.1682692711646634E-5,1.797462E-5,1.8208082E-5,390,0,1,12,1,0.0833333333
266965724,katiesmith1963,10,1130,59,331,0,25,28.4822890935,20-29,569,5,13,70,83,83,13,70,6,2.4646802812,185.6910258679,0.0233823032,0.1866000588,0.35739437,0,66,9.82309882288948E-5,8.388156E-5,8.497105E-5,390,2,0,200,0,0
266986977,Myles_Courchene,10,1628,102,250,0,16,39.2121863404,30-39,568,5,5,14,19,19,5,14,7,2.8346166722,39.8863924198,0.0060993876,0.1023391813,0.25274727,0,66,5.962207522202629E-5,3.594924E-5,3.6416164E-5,47,4,0,200,0,0
266987043,HeartAGlow,10,8926,957,1465,45,6438,63.7492387249,60-69,756,8,93,141,234,234,93,141,7,2.3009708738,12712.8775599168,0.1585651309,0.0841128352,0.2840845,0,66,3.548704345427957E-4,5.6320475E-4,5.705199E-4,47,19,0,200,0,0
267121768,ernieandbert1,10,5345,507,1745,3,28,43.8135368026,40-49,657,7,10,67,77,77,10,67,7,2.47941078,1281.2659368803,0.0100021787,0.1401230349,0.2625509,0,66,7.060950845684897E-5,6.590694E-5,6.6762965E-5,140,10,0,200,0,0
267184794,Orange_Tory,10,3184,196,324,6,40,43.0665312897,40-49,661,6,24,40,64,64,24,40,7,2.6076330767,288.3939364022,0.0315323549,0.1336805556,0.2946939,0,66,1.6347271646053511E-4,1.497885E-4,1.5173401E-4,390,13,3,200,3,0.015
267358228,northernsooner,10,10276,393,1720,4,206,48.181917244,40-49,708,7,16,60,76,76,16,60,7,2.4703716103,344.6224948158,0.0246937618,0.1342105263,0.31094658,0,66,9.381174170269676E-5,1.0185618E-4,1.0317913E-4,47,18,0,201,0,0
267462180,Aaron_Stamper9,10,7174,4700,442,1,770,52.0856174916,50-59,734,7,3,4,7,7,3,4,1,1,6,2.2953318094247384E-4,0.0714285714,0.41666666,80,179,3.462198478431495E-4,2.396616E-5,2.4277442E-5,74,15,0,196,0,0
267529750,APsalmanD,10,1706,282,358,4,29,47.447385356,40-49,632,6,78,115,193,193,78,115,6,2.359223301,1932.3035666339,0.0959389203,0.0673844991,0.30704647,0,66,2.1878291142582795E-4,4.7333166E-4,4.794795E-4,47,97,1,232,1,0.0043103448
267728489,annickdes,10,2207,491,666,6,5,45.5340187543,40-49,692,6,20,29,49,49,20,29,7,2.6943421493,295.475308625,0.022415623,0.0867346939,0.36021507,0,66,1.392247801937767E-4,1.2582233E-4,1.2745657E-4,390,5,0,200,0,0
267813818,alissagolob,10,1504,693,1126,15,13,48.2572197634,40-49,695,6,30,23,53,53,30,23,7,3.0385001674,1474.9056316209,0.0071563933,0.0634978229,0.1891892,0,66,2.3448889569187075E-4,1.8573774E-4,1.8815018E-4,372,118,1,200,1,0.005
267881942,JeanBPe,10,409,107,329,3,2,26.4217324907,20-29,509,4,7,17,24,24,7,17,7,2.7278205557,32.4953847172,0.0198367317,0.1974637681,0.47076023,0,66,1.5138267841251137E-4,4.793232E-5,4.8554884E-5,372,0,0,200,0,0
267902492,CorrieBanman,10,2397,64,205,2,22,34.7410965479,30-39,616,6,5,5,10,10,5,5,7,3.1245396719,4.0467760428,0.0065669658,0.1222222222,0.6666667,0,66,6.610218886699537E-5,3.594924E-5,3.6416164E-5,372,0,1,200,1,0.005
267924719,s_a_t_i_n_k_a,10,2062,106,156,0,3,22.6134329678,20-29,606,6,9,21,30,30,9,21,7,2.6364245062,21.2157291354,0.0183582625,0.1804597701,0.395,0,66,6.437825303121288E-5,5.99154E-5,6.069361E-5,47,3,0,200,0,0
267967167,StephAubry_CS,10,3495,286,222,12,58,48.8845046439,40-49,662,6,22,23,45,45,22,23,7,2.7227987948,533.10224082,0.0347155387,0.0984848485,0.2731855,0,66,1.51663743381993E-4,1.3780541E-4,1.395953E-4,390,44,2,200,1,0.01
268137967,marktmaclean,10,4606,307,656,11,156,46.1286340638,40-49,678,7,9,33,42,42,9,33,7,2.598928691,128.850047799,0.0067213937,0.1684088269,0.40374333,0,66,7.796953390123073E-5,5.99154E-5,6.069361E-5,140,4,0,199,0,0
268401139,life_lite,10,10983,990,953,24,41,44.1599475329,40-49,762,8,259,264,523,523,259,264,6,2.135587546,35360.5280183178,0.3020697956,0.0375376365,0.21293932,0,66,7.648947935784094E-4,0.0015578003,0.0015780338,47,223,1,202,1,0.004950495
268412615,LaurierInst,10,389,339,94,30,0,44.3273283442,40-49,548,2,27,13,40,40,27,13,7,2.8754603281,174.0749767883,0.0401675117,0.1371794872,0.25757575,0,66,2.7279000540490094E-4,1.6776312E-4,1.699421E-4,140,4,0,200,0,0
268538413,ActivistKent,10,698,770,630,17,71,49.8867243982,40-49,743,7,58,51,109,109,58,51,7,2.7298292601,5054.2980306222,0.042233745,0.0761977574,0.21345322,0,66,2.4478669875316946E-4,3.5350086E-4,3.5809228E-4,390,124,3,200,3,0.015
268539428,Miss782,10,733,182,739,2,45,36.58765911,30-39,513,5,13,43,56,56,13,43,7,2.4124539672,3072.0469898381,0.0180987012,0.1012987013,0.23467231,0,66,1.020079022918562E-4,8.388156E-5,8.497105E-5,55,4,0,200,0,0
268622701,InManibusDei,10,51039,1682,1647,65,132,56.607102171,50-59,853,10,2,3,5,5,2,3,7,3.5215935721,0.3879010035,4.7661807516977177E-4,0.1,0.6666667,0,66,6.387814258470701E-5,1.797462E-5,1.8208082E-5,372,40,0,200,0,0
268672435,clepsydre,10,11282,1396,1364,27,26,46.5115480318,40-49,757,8,32,34,66,66,32,34,6,2.5396719116,9579.739157652,0.0445423053,0.0564102564,0.34761906,0,66,1.6703762563288608E-4,1.9772082E-4,2.0028891E-4,47,9,0,202,0,0
268896921,A_Man_From_TO,10,1385,406,1192,7,22,44.786716739,40-49,624,5,41,96,137,137,41,96,6,2.4318714429,5210.964667191,0.0358329489,0.0801309575,0.18355796,0,66,1.6572437034721225E-4,2.5164467E-4,2.5491315E-4,390,23,0,200,0,0
268906600,Lizzsicle,10,361,20,131,0,6,19.5834285614,10-19,351,4,4,16,20,20,4,16,7,2.8667559424,635.0249885052,0.0026765402,0.1605263158,0.31617647,0,66,6.836388666133253E-5,2.99577E-5,3.0346804E-5,390,1,2,200,2,0.01
269437734,maxvillejim,10,584,49,116,1,2,24.1906341196,20-29,458,4,1,15,16,16,1,15,6,2.7649815869,10.8238002857,0.0010983649,0.2916666667,0.5285714,0,66,4.63462263885734E-5,1.198308E-5,1.2138721E-5,372,1,0,200,0,0
269485235,ReverendBlair,10,17521,419,580,15,135,46.9307334104,40-49,742,8,82,105,187,187,82,105,7,2.3967191162,2593.6535927066,0.1341067109,0.1135932379,0.30678403,0,66,3.016897353534389E-4,4.972978E-4,5.037569E-4,47,29,0,201,0,0
269511391,ERICatEXECUCOR,10,1373,285,302,1,0,46.8961050437,40-49,654,6,21,31,52,52,21,31,6,2.5286240375,52.9290089409,0.0396429996,0.1021870287,0.51310486,0,66,9.569023239395061E-5,1.3181388E-4,1.3352593E-4,47,42,3,200,3,0.015
269643383,nicpwall,10,990,134,521,1,9,34.4094453909,30-39,520,5,13,40,53,53,13,40,7,2.5764981587,152.372620352,0.0183465565,0.1850507983,0.40808415,0,66,8.118925530441491E-5,8.388156E-5,8.497105E-5,140,2,3,200,3,0.015
269666410,ChrisBataluk,10,3121,697,1360,15,4,40.8591677254,40-49,703,6,47,85,132,132,47,85,6,2.5855373284,1339.6113254438,0.0325354154,0.0943789035,0.30911645,0,66,2.5906266036628743E-4,2.8759392E-4,2.913293E-4,372,5,0,199,0,0
269899834,Ang_Amalfitano,10,224,27,37,1,0,25.3206287038,20-29,369,3,1,0,1,1,1,0,0,0,0,6.51798925476034E-4,0,0,0,62,4.6289777447431015E-5,1.198308E-5,0,47,3,0,199,0,0
270088915,charlesmire,10,2665,129,189,7,80,41.3953181683,40-49,587,6,5,6,11,11,5,6,7,3.1513223971,26.1502037415,0.004520744,0.0727272727,0.43333334,0,66,1.1118441275425131E-4,3.594924E-5,3.6416164E-5,55,7,0,200,0,0
270091796,cwstewart9,10,8582,344,935,12,84,32.5513794101,30-39,670,7,55,109,164,164,55,109,7,2.3394710412,882.9097610284,0.0953978769,0.1167514589,0.33841333,0,66,1.9264836668265325E-4,3.3552625E-4,3.398842E-4,47,3,1,199,1,0.0050251256
270534541,brtalbot,10,147,4,25,0,1,16.4815821791,10-19,64,3,1,2,3,3,1,2,6,2.8459993304,0.4511664321,0.0035221389,0,0,0,66,5.0959439341855286E-5,1.198308E-5,1.2138721E-5,390,0,0,150,0,0
270646972,stephEmerrill,10,2514,575,972,14,13,47.4391643527,40-49,682,6,36,64,100,100,36,64,6,2.3993973887,3217.9640452508,0.0495291999,0.0688888889,0.22797203,0,66,1.870344333719445E-4,2.2168698E-4,2.2456635E-4,47,29,1,200,1,0.005
270889290,1charlesjohnson,10,496,48,156,1,13,27.071033782,20-29,360,4,10,37,47,47,10,37,7,2.5282892534,239.9033272624,0.015503398,0.1410730805,0.31756756,0,66,6.791238339707136E-5,6.590694E-5,6.6762965E-5,47,1,2,200,2,0.01
270889394,RealMattHopkins,10,21029,887,783,20,661,46.1870109279,40-49,782,8,211,253,464,464,211,253,6,2.1804486106,34143.425852695,0.2437704523,0.0556667536,0.17848365,0,66,7.727924739263349E-4,0.0012702064,0.0012867044,140,1158,2,278,2,0.0071942446
270891869,PeterHfx,10,408,129,443,2,62,34.7867923098,30-39,554,4,34,105,139,139,34,105,7,2.3783059926,638.5985922458,0.0594601644,0.1398185799,0.33102587,0,66,1.424258959441589E-4,2.097039E-4,2.1242762E-4,47,5,0,200,0,0
270927838,laumicant,10,419,146,420,2,1,28.1534261228,20-29,486,4,8,36,44,44,8,36,6,2.5172413793,91.5989190332,0.0095619508,0.2315010571,0.49502134,0,66,7.2840462182993E-5,5.392386E-5,5.4624245E-5,140,1,0,200,0,0
270928670,NSchwen,10,544,112,195,2,2,30.2259592614,30-39,449,4,9,34,43,43,9,34,7,2.7572815534,89.5339208668,0.0148334338,0.1954595792,0.36984354,0,66,1.0243344456667103E-4,5.99154E-5,6.069361E-5,372,13,2,199,2,0.0100502513
271006415,ingriddecorator,10,5276,74,537,0,14,22.037057394,20-29,497,7,22,106,128,128,22,106,7,2.3739537998,320.9242624213,0.0316134184,0.1583415354,0.2978034,0,66,9.965834957443618E-5,1.3780541E-4,1.395953E-4,47,2,1,200,1,0.005
271073165,KirstyDuncanMP,10,2976,2411,216,132,1,54.4475346835,50-59,745,6,298,27,325,325,298,27,7,2.7435554068,16637.0747022191,0.3057889134,0.0958879392,0.14893036,0,66,0.0014214416,0.0017914705,0.0017722533,140,166,4,200,4,0.02
271074952,penottawa,10,8739,1482,1803,41,1043,53.6410344529,50-59,741,7,138,96,234,234,138,96,6,2.3324405758,4266.2517530277,0.2347955609,0.095264297,0.2688839,0,66,9.070830210975451E-4,8.3282404E-4,8.436411E-4,140,45,0,200,0,0
271117979,arun_smith,10,11332,603,983,13,19,56.6629788164,50-59,738,8,65,114,179,179,65,114,6,2.3555406763,5418.0095718356,0.0857419796,0.1011863662,0.2561441,0,66,3.0339040187032175E-4,3.9544163E-4,4.0057782E-4,390,129,0,201,0,0
271183691,unionjason,10,1030,158,254,1,2,43.3242953307,40-49,594,5,19,34,53,53,19,34,7,2.7318379645,495.1591011597,0.0210495152,0.1288098694,0.36486486,0,66,1.1133622797650969E-4,1.198308E-4,1.2138722E-4,390,31,0,200,0,0
271229421,shelleyshell4,10,3414,79,294,1,23,41.6677233727,40-49,565,5,8,17,25,25,8,17,7,2.7258118514,81.7331317041,0.0139532272,0.14,0.33918127,0,66,7.940825973788773E-5,5.392386E-5,5.4624245E-5,47,11,2,201,2,0.0099502488
271266410,kns223,10,710,192,194,0,233,36.5823195299,30-39,546,3,1,1,2,2,1,1,2,1.5,0,7.645535613750089E-5,0,0,316,574,2.29874507414389E-4,1.198308E-5,1.2138721E-5,328,1,0,200,0,0
271284946,KSeesequasis,10,1596,658,889,16,18,44.4503651374,40-49,647,6,79,103,182,182,79,103,7,2.379979913,6117.0205050785,0.0861977244,0.0693036246,0.2759009,0,66,3.312836988454005E-4,4.793232E-4,4.8554887E-4,140,24,1,199,1,0.0050251256
271475860,RJMcClelland,10,11211,684,485,26,0,58.5731022216,50-59,774,7,173,144,317,317,173,144,6,2.2912621359,7859.9257932973,0.2112085748,0.0817593739,0.21187288,0,66,5.556526231900087E-4,0.001042528,0.0010439301,47,219,1,202,1,0.004950495
271516426,Alcala1818,10,253,160,198,0,3,35.5183374615,30-39,567,4,1,1,2,2,1,1,1,1,0,7.49471721243357E-5,0,0,116,232,2.9852402567743944E-4,1.198308E-5,1.2138721E-5,113,48,0,200,0,0
271646800,simonkinglaw,10,15354,526,1014,8,1525,45.1710837155,40-49,743,8,40,53,93,93,40,53,6,2.4968195514,1413.1598672589,0.0592589443,0.1284478728,0.2884117,0,66,1.9154816489135352E-4,2.4565315E-4,2.4884377E-4,140,12,0,203,0,0
271649526,politicalicia,10,1178,292,498,6,1,32.144071653,30-39,552,5,40,67,107,107,40,67,7,2.463675929,1191.5192420802,0.0481575935,0.1027155704,0.29105264,0,66,1.8170754195166313E-4,2.4565315E-4,2.4884377E-4,390,1,2,200,2,0.01
271670918,vwriding,10,88,99,56,10,7,28.0121794975,20-29,545,3,8,8,16,16,8,8,7,3.0220957482,157.9413414761,0.0038330047,0.0958333333,0.34545454,0,66,7.590686262950654E-5,5.392386E-5,5.4624245E-5,372,1,2,88,2,0.0227272727
271681559,brianwhiteNDP,10,545,455,441,25,2,60.4043096485,60-69,600,4,51,53,104,104,51,53,7,2.5758285906,4415.7696523292,0.0721826935,0.127987304,0.39440992,0,66,3.076236972036608E-4,3.1156008E-4,3.1560674E-4,390,3,4,200,4,0.02
271762869,happytovote,10,4462,402,960,9,34,40.0403812244,40-49,650,7,22,76,98,98,22,76,6,2.5400066957,2649.5235340892,0.0139821786,0.112244898,0.26736844,0,66,1.2712918826035047E-4,1.3780541E-4,1.395953E-4,372,4,1,199,1,0.0050251256
271965841,WildRoseMike4MP,10,1288,167,318,17,5,29.076187504,20-29,573,6,13,28,41,41,13,28,6,2.603950452,332.769695543,0.0232668014,0.0890243902,0.2777778,0,66,1.308743021583068E-4,8.388156E-5,8.497105E-5,47,0,1,199,1,0.0050251256
271972887,ChloeMilan101,10,6031,113,133,1,1564,53.7910422903,50-59,657,6,0,0,0,0,0,0,0,0,0,0,0,0,300,555,4.4780486537007367E-5,0,0,299,2,0,200,0,0
272059064,marilynrbush,10,663,41,140,0,710,44.2866416591,40-49,581,6,2,2,4,4,2,2,8,4.0492132574,1,1.8579378519042617E-4,0,0,0,66,9.645704293253715E-5,1.797462E-5,1.8208082E-5,47,0,0,200,0,0
272124058,MyCatIsFat,10,42,6,55,0,0,16.5674566246,10-19,206,2,1,17,18,18,1,17,7,2.7653163709,0.0181683813,0.0010983649,0.3267973856,0.5882353,0,66,4.63462263885734E-5,1.198308E-5,1.2138721E-5,390,0,0,43,0,0
272141036,dbmeaford,10,2090,60,109,1,2,38.9195069725,30-39,655,5,20,19,39,39,20,19,7,2.7683294275,42.3601924956,0.0337376841,0.1997300945,0.33613446,0,66,1.0460889358171571E-4,1.2582233E-4,1.2745657E-4,140,15,1,200,1,0.005
272177720,peterjwray,10,168,21,66,1,0,22.2794009995,20-29,374,3,0,4,4,4,0,4,7,3.1552878179,0,0,0.3333333333,0.41666666,0,553,4.4780486537007367E-5,0,6.0693606E-6,140,3,0,173,0,0
272185225,fsorbara,10,4682,297,530,3,15,43.0717423642,40-49,665,7,68,83,151,151,68,83,7,2.4489454302,1291.7116483663,0.1029621469,0.12401766,0.35474005,0,66,2.84948011644293E-4,4.1341624E-4,4.1878587E-4,140,24,1,200,1,0.005
272214370,ClaysonBra,10,1101,452,696,0,68,30.1834551259,30-39,509,5,0,0,0,0,0,0,0,0,0,0,0,0,183,346,4.4780486537007367E-5,0,0,178,6,0,200,0,0
272237849,TippiStar,10,5906,265,235,3,177,46.1708568404,40-49,657,6,11,15,26,26,11,15,7,2.7686642116,41.0116024185,0.0117478568,0.1,0.4125,0,66,7.755711102242106E-5,7.189848E-5,7.283233E-5,47,45,0,201,0,0
272247146,niipomakii,10,14552,844,647,40,136,52.1807045621,50-59,779,8,51,48,99,99,51,48,7,2.6370940743,748.8545081892,0.0375083998,0.0888476603,0.3027972,0,66,2.479755056498993E-4,3.1156008E-4,3.1560674E-4,47,27,0,200,0,0
272290840,scott_robb,10,25964,241,321,5,4,40.545306923,40-49,763,9,10,7,17,17,10,7,7,2.9986608637,15.9772807064,0.0107597247,0.1764705882,0.25,0,66,7.24215476242334E-5,6.590694E-5,6.6762965E-5,47,4,0,203,0,0
272398543,davidhyde2,10,3643,477,455,13,2,49.2544215627,40-49,684,6,1,4,5,5,1,4,7,3.260462002,0.7885098024,7.882766165610551E-4,0.05,0.1,0,66,4.7042335631851746E-5,1.198308E-5,1.2138721E-5,390,4,0,200,0,0
272498805,williamefwilson,10,6493,1194,198,31,3,48.3668106557,40-49,713,7,98,13,111,111,98,13,7,2.838299297,172.8245471202,0.1036725253,0.1219492219,0.183301,0,66,3.254772693094396E-4,5.9316243E-4,5.9479737E-4,140,11,0,207,0,0
272517144,NikSpohr,10,1366,395,419,26,1,42.8924676799,40-49,649,5,49,50,99,99,49,50,7,2.5584198192,550.2305137829,0.056685173,0.1960420532,0.40462962,0,66,1.937905850315161E-4,2.99577E-4,3.0346803E-4,390,23,0,200,0,0
272523322,BillMcKinnon875,10,15373,1057,1993,66,28,38.7682347572,30-39,742,8,160,306,466,466,160,306,6,2.1188483428,19249.7489403663,0.2264146297,0.0719322534,0.192903,0,66,5.155792074262889E-4,9.646379E-4,9.77167E-4,140,21,0,201,0,0
272525580,wtfrwe,10,389,22,81,0,6,22.1691318508,20-29,152,3,5,21,26,26,5,21,7,2.7110813525,52.7515125209,0.0018957268,0.1476923077,0.33809525,0,66,6.492059567267232E-5,3.594924E-5,3.6416164E-5,47,6,0,199,0,0
272573393,BevJD24,10,2146,61,60,4,7,19.4858508114,10-19,518,6,7,9,16,16,7,9,7,2.8881821225,5.6225952067,0.0085816965,0.1958333333,0.46153846,0,66,6.399183557329512E-5,4.793232E-5,4.8554884E-5,140,1,1,200,1,0.005
272583709,EnzodellaRocca,10,2579,518,1403,13,57,42.4464565386,40-49,585,6,7,32,39,39,7,32,7,2.6608637429,381.7225442184,0.0115076276,0.2071524966,0.36666667,0,66,6.921439199953506E-5,4.793232E-5,4.8554884E-5,372,12,1,200,1,0.005
272632742,cmoon55,10,2061,375,878,11,24,41.677524275,40-49,565,6,41,74,115,115,41,74,7,2.4777368597,1320.4668318339,0.050682222,0.1194508009,0.33227944,0,66,1.929403032769429E-4,2.5164467E-4,2.5491315E-4,390,5,0,200,0,0
272809054,ALYS_tweet,10,365,228,306,5,7,22.7621942383,20-29,529,4,32,47,79,79,32,47,7,2.6156678942,291.8384067658,0.0332209799,0.1161960402,0.35454544,0,66,1.4446504306338102E-4,1.9772082E-4,2.0028891E-4,140,0,4,200,4,0.02
273012474,jasonthistle,10,2486,366,1026,6,8,47.2832340349,40-49,682,6,12,52,64,64,12,52,7,2.4743890191,344.0395274728,0.0098440443,0.1436011905,0.3036338,0,66,8.88222443245945E-5,7.789002E-5,7.8901685E-5,140,11,0,200,0,0
273038120,WinnipegFatArse,10,8802,555,948,16,154,,,735,7,72,120,192,192,72,120,6,2.3083361232,7125.6086559366,0.1117316542,0.1195462478,0.30103925,0,66,2.6836163927296367E-4,4.373824E-4,4.4306333E-4,140,13,0,200,0,0
273160093,darcymurray,10,3633,260,771,6,1,39.5906018223,30-39,576,7,10,32,42,42,10,32,7,2.6384332106,343.3825440327,0.0101338371,0.1881533101,0.3739496,0,66,8.212171267998962E-5,6.590694E-5,6.6762965E-5,390,14,0,199,0,0
273201959,Wetaskijen,10,20391,719,1046,22,334,40.310449396,40-49,749,8,81,138,219,219,81,138,6,2.5055239371,8717.8217180885,0.0590390984,0.0720330108,0.20446666,0,66,4.116967883636959E-4,4.913063E-4,4.9768755E-4,372,32,3,205,3,0.0146341463
273223103,MP_Host,10,180,65,451,0,13,34.9600922811,30-39,433,4,9,76,85,85,9,76,6,2.5480415132,183.0801836545,0.0081132006,0.2200280112,0.39935064,0,66,6.874678673118247E-5,5.99154E-5,6.069361E-5,372,10,3,200,3,0.015
273280868,RobinVan,10,4226,378,494,11,20,39.067235921,30-39,673,7,46,46,92,92,46,46,6,2.3863408102,1066.5422749814,0.0716982625,0.1029622551,0.3079254,0,66,2.098030520125596E-4,2.8160238E-4,2.8525994E-4,47,7,2,200,2,0.01
273283728,djvanbc,10,12,79,678,0,3,29.7246350936,20-29,462,5,2,0,2,2,2,0,0,0,0,0.0051610631,0.5,1,0,11,5.179837177470212E-5,1.797462E-5,0,390,0,0,1,0,0
273405104,Beari8it,10,86646,3188,3023,81,11747,55.5698875376,50-59,899,10,530,494,1024,1024,530,494,7,2.0589219953,133506.053118849,0.4696167878,0.0311096728,0.095326096,0,66,0.0016731262,0.0031815078,0.0032228306,47,1329,17,376,17,0.045212766
273479738,wcgirl2,10,28666,2505,1821,104,0,44.0581658879,40-49,803,9,14,15,29,29,14,15,7,2.953130231,1852.4178842322,0.0059713759,0.039408867,0.25714287,0,66,1.5250302234612838E-4,8.98731E-5,9.104041E-5,47,49,0,202,0,0
273537714,darshisel,10,488,230,202,2,0,32.6930612011,30-39,560,4,12,16,28,28,12,16,7,2.9457649816,160.3882490876,0.0103208761,0.1137566138,0.28809524,0,66,9.761706517671144E-5,7.789002E-5,7.283233E-5,390,5,2,198,2,0.0101010101
273625397,RedLabelRyan,10,274,12,32,0,14,18.6493146519,10-19,142,3,0,1,1,1,0,1,1,1,0,0,0,0,0,433,4.4780486537007367E-5,0,6.0693606E-6,390,1,0,199,0,0
273657076,fieldpro,10,2570,147,257,2,10,35.1067475235,30-39,643,6,16,28,44,44,16,28,6,2.7331771008,234.0449717167,0.0129475538,0.1041226216,0.42857143,0,66,1.1279567400486304E-4,1.0185618E-4,1.0317913E-4,372,4,0,200,0,0
273683993,Blubdha,10,49567,875,1913,30,873,45.9217954798,40-49,761,9,45,71,116,116,45,71,7,2.4643454972,4130.563392676,0.0541563983,0.0884557721,0.24537815,0,66,1.8283062902907837E-4,2.7561083E-4,2.791906E-4,47,35,0,202,0,0
273703828,MilesKrauter,10,2212,203,545,6,9,41.0621506741,40-49,651,6,27,43,70,70,27,43,6,2.5256109809,135.9145997109,0.0457935167,0.1734989648,0.37406015,0,66,1.2728329317177078E-4,1.6776312E-4,1.699421E-4,390,27,0,200,0,0
273704144,creepsx5,10,957,45,175,0,124,23.3182249361,20-29,567,5,9,30,39,39,9,30,7,2.6682289923,15.3545741382,0.0133528242,0.1761133603,0.36742425,0,66,6.29359716881019E-5,5.99154E-5,6.069361E-5,47,2,2,194,1,0.0103092784
273758664,LALegault,10,12394,512,583,18,72,40.8500274634,40-49,704,7,50,64,114,114,50,64,7,2.4492802143,7842.1055072804,0.0810970098,0.0999068468,0.33963963,0,66,2.804444082921497E-4,3.0556854E-4,3.095374E-4,140,12,0,200,0,0
273792908,martantomkat,10,2860,129,488,3,45,44.0219360843,40-49,654,6,15,53,68,68,15,53,6,2.4539671912,103.7099253081,0.0336732602,0.1942493415,0.4176065,0,66,1.282506178674232E-4,9.586464E-5,9.710977E-5,140,1,2,200,2,0.01
274012183,elizsamuels,10,3510,554,550,12,292,63.7768909121,60-69,689,6,81,69,150,150,81,69,6,2.5410110479,1579.3842841296,0.0993334303,0.1394183445,0.31609446,0,66,4.8387932777058E-4,4.913063E-4,4.9768755E-4,140,65,5,200,5,0.025
274058279,alexpensato,10,8195,450,2000,6,1984,41.0018912233,40-49,693,7,36,136,172,172,36,136,6,2.2691663877,4363.2035188996,0.0625440026,0.1033251734,0.24351852,0,66,2.2046646639445417E-4,2.2168698E-4,2.2456635E-4,140,2,0,200,0,0
274074495,teampalerider,10,3978,81,109,1,1,31.0699598428,30-39,611,6,10,16,26,26,10,16,7,2.6066287245,88.8969629768,0.0170869866,0.1738461538,0.4526316,0,66,7.427751272000233E-5,6.590694E-5,6.6762965E-5,390,3,7,200,7,0.035
274090688,Blackwell_Rez,10,1658,778,1432,7,23,38.1626190267,30-39,614,6,29,40,69,69,29,40,6,2.5339805825,797.4794698079,0.0340132075,0.0530690537,0.23867595,0,66,1.2866428560301486E-4,1.797462E-4,1.8208082E-4,47,0,0,200,0,0
274214651,rabbitupnorth,10,3219,134,314,9,666,42.9255820356,40-49,660,6,7,14,21,21,7,14,7,2.9203213927,1351.3969740145,0.0064788707,0.1142857143,0.31428573,0,66,7.81387450241186E-5,4.793232E-5,4.8554884E-5,390,3,0,200,0,0
274300708,NDPLakeshore,10,369,151,177,5,0,33.0455350851,30-39,460,4,36,37,73,73,36,37,6,2.6226983596,161.9703611969,0.0403984014,0.2562785388,0.5079323,0,66,1.491856568962466E-4,2.2168698E-4,2.2456635E-4,390,10,4,199,4,0.0201005025
274325886,RedLangara,10,876,245,348,15,1,42.5757019823,40-49,562,5,18,25,43,43,18,25,7,2.69768999,216.6057060008,0.0244023666,0.0736434109,0.2977208,0,66,1.1373908135549195E-4,1.1383926E-4,1.1531785E-4,390,12,1,200,1,0.005
274349407,zarpaoo,10,1591,165,380,1,10,30.0982566981,30-39,594,6,1,1,2,2,1,1,10,5.6032808838,0,7.840988673133993E-5,0,0,0,66,6.570656681225841E-5,1.198308E-5,1.2138721E-5,320,1,0,196,0,0
274433778,amandhacaldista,10,4408,370,570,0,83,36.581736223,30-39,706,6,0,0,0,0,0,0,0,0,0,0,0,0,408,732,4.4780486537007367E-5,0,0,419,12,0,200,0,0
274606474,CapitalSquirrel,10,16484,1511,1552,46,669,43.3920343626,40-49,771,8,153,157,310,310,153,157,6,2.2464010713,14381.0623895354,0.2218278505,0.0538991544,0.32911867,0,66,4.7502159272461283E-4,9.2269713E-4,9.3468156E-4,47,81,0,204,0,0
274743250,LauraMorie,10,841,240,574,1,15,41.09068688,40-49,493,5,20,53,73,73,20,53,6,2.4372279879,2111.7735914864,0.0282881645,0.1017884323,0.26450035,0,66,1.0370880928026383E-4,1.2582233E-4,1.2745657E-4,47,12,2,200,2,0.01
274818699,Mark_Hosak,10,1070,164,451,6,3,26.234555254,20-29,576,5,28,77,105,105,28,77,6,2.3943756277,243.1616090838,0.0507415661,0.1385531136,0.36763236,0,66,1.2796249178661584E-4,1.7375466E-4,1.7601145E-4,390,0,3,196,3,0.0153061224
274867725,VoluntaryExit,10,3384,135,462,1,108,29.2872654149,20-29,635,7,25,62,87,87,25,62,6,2.4455975896,654.1265606043,0.0412799958,0.1093290564,0.2331992,0,66,1.1258434422272616E-4,1.5578004E-4,1.5780337E-4,47,4,0,200,0,0
275038599,AppalledBC,10,7903,264,521,27,17,45.8079534761,40-49,691,7,44,51,95,95,44,51,7,2.4720455306,797.6393326746,0.0702932525,0.1643896976,0.3531321,0,66,1.5307362716086625E-4,2.696193E-4,2.7312123E-4,47,21,1,200,1,0.005
275078381,TOprogressive,10,1972,243,611,8,15,36.3652794285,30-39,624,6,16,57,73,73,16,57,7,2.5018413124,371.8362611401,0.0264274791,0.151826484,0.36237144,0,66,9.389801037388594E-5,1.0185618E-4,1.0317913E-4,140,2,1,199,1,0.0050251256
275164696,yvonne4tn,10,1390,188,344,1,40,28.178033063,20-29,561,5,80,104,184,184,80,104,7,2.3990626046,752.0141069068,0.1210893922,0.1303159895,0.3631288,0,66,2.389114180206604E-4,4.8531473E-4,4.9161824E-4,47,3,4,200,3,0.02
275185537,FBoivinNPD,10,3820,2717,996,145,3,54.8352549587,50-59,738,7,247,121,368,368,247,121,6,2.348844995,9664.4840051552,0.3303511341,0.0888668404,0.22551592,0,66,0.0014086921,0.0014859019,0.0014991321,390,164,5,200,5,0.025
275210802,67Capt_Canuck,10,15528,375,390,9,39,42.5906101948,40-49,731,8,61,77,138,138,61,77,6,2.3669233344,1534.7359887931,0.0979045861,0.1109171692,0.31948245,0,66,3.2966005997482514E-4,3.7147547E-4,3.7630036E-4,140,59,1,204,1,0.0049019608
275295586,wwwwwayne,10,135,6,22,0,2,11.8833382982,10-19,66,2,2,4,6,6,2,4,7,3.1141613659,0.8505587255,9.820129692410201E-4,0.2,0.4,0,66,5.1709464610847275E-5,1.797462E-5,1.8208082E-5,372,1,0,139,0,0
275313660,sylvainchicoine,10,485,856,708,92,1,46.0754685548,40-49,621,4,113,98,211,211,113,98,6,2.3739537998,3388.6739843682,0.1761139712,0.0793951704,0.37867594,0,66,6.448994456745014E-4,6.830355E-4,6.8583776E-4,390,42,4,200,4,0.02
275342624,Poet_Moglica,10,1233,987,1985,59,1413,46.8400754539,40-49,639,5,33,90,123,123,33,90,6,2.4050887178,2150.1670777595,0.0505936963,0.1211515394,0.31684983,0,66,1.986291321646906E-4,2.0371236E-4,2.0635827E-4,140,90,0,200,0,0
275529865,gordmcfee,10,13445,211,437,2,117,39.7518371087,30-39,686,8,10,30,40,40,10,30,6,2.5329762303,55.6919136425,0.028922309,0.1974358974,0.5204301,0,66,1.1226516777940747E-4,6.590694E-5,6.6762965E-5,140,14,0,201,0,0
275699060,TroyMorgan1977,10,4157,236,515,4,2,54.9298875006,50-59,726,7,78,150,228,228,78,150,7,2.3752929361,12598.0726460339,0.0839061523,0.0692480099,0.2213734,0,66,2.8734624297762924E-4,4.7333166E-4,4.794795E-4,140,618,0,226,0,0
275712545,JosebaAlfaro,10,5312,502,492,19,71,52.4092638104,50-59,659,6,0,0,0,0,0,0,0,0,0,0,0,0,339,612,4.4780486537007367E-5,0,0,347,0,0,200,0,0
275793678,Pentoth,10,843,90,252,0,38,22.3480075281,20-29,540,5,5,27,32,32,5,27,6,2.5249414128,32.8098316411,0.0138402329,0.1401209677,0.2948718,0,66,6.477136612809232E-5,3.594924E-5,3.6416164E-5,140,2,0,200,0,0
275815874,LiseFrigault,10,558,85,106,1,1,40.7741789977,40-49,579,4,11,18,29,29,11,18,7,2.901238701,471.1194446712,0.0099280002,0.1391625616,0.32034633,0,66,1.0260150986162493E-4,7.189848E-5,7.283233E-5,47,13,0,200,0,0
275907942,LauraBeeMarie,10,2752,291,550,14,442,39.0905610388,30-39,601,6,15,39,54,54,15,39,7,2.6267157683,471.041389262,0.0306628015,0.1271837876,0.28903654,0,66,1.4584915120610217E-4,9.586464E-5,9.710977E-5,55,5,0,200,0,0
276179070,andreapercycdn,10,33,1,13,0,2,10.6708586376,10-19,31,2,1,4,5,5,1,4,7,2.9394040844,1.0274217832,0.004938,0.2,0.6666667,0,66,5.084480164059419E-5,1.198308E-5,1.2138721E-5,55,0,0,35,0,0
276518876,gonzopolecon,10,3607,183,352,1,318,45.7441099525,40-49,676,6,51,82,133,133,51,82,6,2.3863408102,871.0034241513,0.0829859396,0.1108452951,0.308634,0,66,1.9124459647606548E-4,3.1156008E-4,3.1560674E-4,47,62,0,203,0,0
276586569,riseupforcanada,10,1268,43,63,1,75,27.3452111224,20-29,566,5,12,15,27,27,12,15,7,2.6632072313,79.8412344591,0.021110865,0.2407407407,0.44746378,0,66,7.858336133435597E-5,7.789002E-5,7.8901685E-5,47,2,1,200,1,0.005
276595482,JPNichollsNPD,10,2176,743,354,66,15,50.8182606753,50-59,675,6,128,73,201,201,128,73,6,2.5135587546,1042.9381391184,0.1812121272,0.1556965174,0.36571547,0,66,7.089553293844035E-4,7.729087E-4,7.829475E-4,390,77,5,200,5,0.025
276713213,s_guilbeault,10,6970,10103,246,253,2,59.9117238826,50-59,770,7,92,13,105,105,92,13,7,2.8058252427,815.0882040079,0.1026965269,0.1243589744,0.19158415,0,66,6.93524414231052E-4,5.572132E-4,5.583812E-4,390,32,0,200,0,0
276761716,artymccomish,10,2089,257,1055,3,7,52.4161517125,50-59,630,6,30,91,121,121,30,91,7,2.5031804486,541.5195270702,0.0455718187,0.1420798898,0.32401314,0,66,1.7009262035267637E-4,1.8573774E-4,1.8815018E-4,140,6,1,200,1,0.005
277060347,Francois_Soucy,10,2455,634,1969,22,0,42.8579435528,40-49,585,6,106,217,323,323,106,217,6,2.265483763,5332.7363605709,0.1471197526,0.0992346595,0.27974412,0,66,5.54081188033071E-4,6.4109475E-4,6.494216E-4,390,16,3,199,2,0.0150753769
277132286,rightsprung,10,8584,662,859,21,94,50.5659124743,50-59,730,7,85,141,226,226,85,141,6,2.2423836625,5051.8080565346,0.1227364495,0.0647394297,0.23795545,0,66,2.839115710849493E-4,5.1527243E-4,5.2196503E-4,47,49,0,207,0,0
277145358,johnrbolton1,10,2649,395,488,6,0,45.8926032095,40-49,672,6,29,39,68,68,29,39,6,2.7258118514,931.9768344495,0.0180875996,0.1132572432,0.40386474,0,66,1.8258546752896422E-4,1.797462E-4,1.8208082E-4,372,23,0,199,0,0
277263155,ElectionCDA,10,24483,6785,7375,81,0,40.5326925749,40-49,732,8,87,5,92,92,87,5,7,2.8731168396,520.1003394589,0.1136753986,0.1371237458,0.22599591,0,66,3.241746516124064E-4,5.272555E-4,5.341037E-4,47,43,1,201,1,0.0049751244
277316485,KHildebrand78,10,533,113,264,6,2,43.2946289585,40-49,624,5,8,14,22,22,8,14,7,2.8262470706,331.2213930782,0.0056048207,0.0584415584,0.21978022,0,66,7.669425236128342E-5,5.392386E-5,5.4624245E-5,390,15,0,200,0,0
277351885,Mr_Soch,10,814,119,39,2,32,41.9011146184,40-49,556,5,1,1,2,2,1,1,8,4.1446267158,0,1.3277175733584584E-4,0,0,0,66,5.624933352247571E-5,1.198308E-5,1.2138721E-5,55,38,0,200,0,0
277580021,pureozone,10,72,13,218,0,6,18.0024103914,10-19,33,3,0,10,10,10,0,10,7,2.9100334448,0,0,0.2777777778,0.43333334,0,204,4.4780486537007367E-5,0,6.0693606E-6,140,1,0,77,0,0
277730808,Ggulo,10,14291,395,496,10,735,,,753,8,110,126,236,236,110,126,7,2.3354536324,1390.2739478872,0.1710693751,0.1160836639,0.32784545,0,66,3.299505981774041E-4,6.6506094E-4,6.73699E-4,47,34,3,202,3,0.0148514851
277997330,alebarbosas,10,2619,285,120,2,375,39.1882830403,30-39,660,6,0,1,1,1,0,1,1,1,0,0,0,0,203,495,4.4780486537007367E-5,0,6.0693606E-6,212,13,0,200,0,0
278228855,varota201,10,2000,117,266,1,4,35.5155350723,30-39,617,6,3,16,19,19,3,16,7,2.7458988952,13.6884886238,0.0035074935,0.1111111111,0.23333333,0,66,5.8177989790408945E-5,2.396616E-5,2.4277442E-5,47,3,0,199,0,0
278325086,vicki_strelioff,10,3577,177,199,10,1,41.8421769934,40-49,616,6,19,22,41,41,19,22,7,2.6109809173,243.6703658901,0.033027572,0.1274390244,0.41379312,0,66,1.2307633798231858E-4,1.198308E-4,1.2138722E-4,47,8,13,201,13,0.0646766169
278768935,SkeenaSage,10,553,99,292,1,18,37.125404575,30-39,576,5,41,89,130,130,41,89,6,2.3726146635,2635.5740219295,0.0633331577,0.1505068575,0.3822923,0,66,1.5444598288879088E-4,2.5164467E-4,2.5491315E-4,47,12,0,199,0,0
278789553,JeffreyBenton,10,9374,337,188,1,4626,46.6853738585,40-49,744,7,8,8,16,16,8,8,2,1.3846153846,18.5579365079,6.689274338514532E-4,0.0625,0.48214287,26,99,4.5131538111607174E-4,5.392386E-5,5.4624245E-5,49,26,0,200,0,0
279142381,stoughtonfreak,10,1464,158,184,2,100,41.7051408975,40-49,631,5,18,19,37,37,18,19,7,2.921660529,259.1669156808,0.0112375304,0.0600600601,0.33157894,0,66,1.157493115296889E-4,1.1383926E-4,1.1531785E-4,390,9,3,200,3,0.015
279146802,Hemporium17th,10,624,55,65,2,1,26.2251057018,20-29,532,4,5,6,11,11,5,6,7,2.6655507198,11.0695040481,0.0107359811,0.1181818182,0.42857143,0,66,5.7850377223210584E-5,3.594924E-5,3.6416164E-5,47,1,0,196,0,0
279237257,wakeupjohnston,10,1549,44,83,0,14,38.0126228516,30-39,548,5,4,1,5,5,4,1,8,4.0857047205,0.041937731,0.0075166934,0.25,0.35,0,66,5.62794426030705E-5,2.99577E-5,3.0346804E-5,47,6,0,200,0,0
279550566,rociolf12,10,3400,174,240,0,1097,41.3260393324,40-49,713,6,3,2,5,5,3,2,2,1.7142857143,0.5,2.419241810757556E-4,0.15,0.8333333,52,142,2.6467175579011144E-4,2.396616E-5,2.4277442E-5,316,4,0,200,0,0
279623396,moeyd64,10,2924,154,467,1,42,39.9733369115,30-39,595,7,54,122,176,176,54,122,6,2.255440241,2502.7508427088,0.0830822341,0.1192532468,0.29630896,0,66,2.309525785568888E-4,3.295347E-4,3.3381482E-4,390,11,3,207,3,0.0144927536
279644970,MgS_2011,10,272,22,82,0,1,22.3683243166,20-29,455,3,9,26,35,35,9,26,6,2.5279544694,3491.8161222987,0.0189468157,0.1268907563,0.38615385,0,66,8.635806547356087E-5,5.99154E-5,6.069361E-5,140,9,1,200,1,0.005
279655508,TIBETANS,10,76535,5053,5519,199,182,55.6115641755,50-59,897,10,34,35,69,69,34,35,7,2.6729159692,1244.3890186505,0.0309219504,0.0453964194,0.24358974,0,66,1.683448540325781E-4,2.097039E-4,2.1242762E-4,47,277,0,201,0,0
279679549,JordanAGlass,10,22028,1415,1887,25,77,56.895719419,50-59,755,8,128,128,256,256,128,128,7,2.4767325075,5685.4467651815,0.1678413207,0.1042738971,0.25121725,0,66,5.895087955286645E-4,7.729087E-4,7.829475E-4,140,99,8,205,7,0.0390243902
279758619,gonzalo_barra94,10,69753,1113,1536,4,31,37.5675272228,30-39,704,8,1,3,4,4,1,3,9,4.6066287245,0,1.1057485856814353E-4,0.1666666667,0.5,0,66,6.79464955354548E-5,1.198308E-5,1.2138721E-5,320,0,0,201,0,0
280047851,ykvmc,10,1046,67,298,1,3,25.9219558315,20-29,552,5,7,49,56,56,7,49,7,2.5811851356,190.80442131,0.0205051192,0.224025974,0.45705783,0,66,7.917997050063998E-5,4.793232E-5,4.8554884E-5,140,2,1,200,1,0.005
280273788,john__bennett,10,2880,1192,397,57,64,54.4629340014,50-59,727,6,158,75,233,233,158,75,6,2.3521928356,13724.2083963303,0.1933917221,0.0785296729,0.17073525,0,66,9.656752900624062E-4,9.5265487E-4,9.58959E-4,47,144,0,199,0,0
280831905,danharrisndp,10,2206,1738,324,112,2,52.9391094531,50-59,735,6,277,93,370,370,277,93,7,2.4881151657,9871.0734325741,0.3329369469,0.0952025196,0.20705737,0,66,0.0016063913,0.0016656481,0.0016751435,390,180,10,200,10,0.05
281276278,canadian_stew,10,2486,102,226,0,65,38.9703801408,30-39,625,6,21,30,51,51,21,30,7,2.6334114496,436.3707056007,0.0297514508,0.0980392157,0.24615385,0,66,1.0998911891835983E-4,1.3181388E-4,1.3352593E-4,47,22,0,200,0,0
281329064,trentworkman,10,226,70,199,0,22,19.1433376322,10-19,517,4,0,1,1,1,0,1,7,3.4695448461,0,0,0,0,0,628,4.4780486537007367E-5,0,6.0693606E-6,140,0,0,199,0,0
281582497,C_paws,10,446,22,65,0,24,20.1282449678,20-29,433,4,5,17,22,22,5,17,7,2.734516237,3100.9010291911,0.0085827965,0.2337662338,0.45614034,0,66,5.379950976293402E-5,3.594924E-5,3.6416164E-5,140,4,1,199,1,0.0050251256
281639257,nmthomsen,10,608,432,831,8,32,58.3220966197,50-59,583,5,1,1,2,2,1,1,1,1,0,7.49471721243357E-5,0,0,193,372,2.9852402567743944E-4,1.198308E-5,1.2138721E-5,196,6,0,199,0,0
281661071,iyer_a,10,1386,190,682,2,4,46.538943956,40-49,580,5,9,66,75,75,9,66,6,2.4415801808,451.5151220601,0.0070008903,0.1574774775,0.2923077,0,66,7.495085911878801E-5,5.99154E-5,6.069361E-5,140,4,1,200,1,0.005
281891570,Dont_h8_Kate,10,90,53,351,1,1,23.3449308091,20-29,215,3,0,8,8,8,0,8,7,3.0809906292,0,0,0.2321428571,0.3392857,0,609,4.4780486537007367E-5,0,6.0693606E-6,390,0,0,99,0,0
282252740,Electoral_BS,10,59,4,77,0,0,18.0031050061,10-19,226,2,0,24,24,24,0,24,7,2.8316599732,0,0,0.3768115942,0.625,0,156,4.4780486537007367E-5,0,6.0693606E-6,140,6,1,72,1,0.0138888889
282277983,newbetweeter,10,5110,209,221,2,446,45.9131417739,40-49,714,7,41,33,74,74,41,33,7,2.5748242384,333.9399814714,0.0474763275,0.0938541281,0.30941176,0,66,2.12316817844191E-4,2.5164467E-4,2.5491315E-4,47,73,0,201,0,0
282282958,WilsonES13,10,1655,223,1169,2,205,46.5684126041,40-49,598,6,68,208,276,276,68,208,6,2.1834616672,3803.2235876644,0.0980489293,0.1002108037,0.24880415,0,66,2.2861616587265725E-4,4.1341624E-4,4.1878587E-4,47,25,0,209,0,0
282698826,OranKearney,10,1558,2160,183,3,46,46.6459578465,40-49,735,4,6,2,8,8,6,2,1,1,0,4.857434136294662E-4,0.3392857143,0.5952381,2,178,1.9760708903596182E-4,4.194078E-5,4.2485524E-5,322,25,0,197,0,0
282894960,Can_ada,10,75367,2073,2280,83,1494,46.4625968415,40-49,816,9,275,131,406,406,275,131,6,2.2775359893,18686.871532418,0.2756220114,0.0647509579,0.1687688,0,66,7.653325043753452E-4,0.001653665,0.0016690742,47,449,2,259,2,0.0077220077
282900362,kelly_t_mac,10,3611,233,420,7,639,42.440299539,40-49,653,6,45,78,123,123,45,78,6,2.6052895882,513.1743326655,0.0236705333,0.0974943356,0.34808794,0,66,1.9948126707994653E-4,2.7561083E-4,2.791906E-4,372,6,0,200,0,0
283199001,SharperPM,10,589,111,96,2,2,24.2875433599,20-29,586,4,17,24,41,41,17,24,7,2.5895547372,15.8923063903,0.0306348749,0.212195122,0.3952381,0,66,8.86342602769261E-5,1.0784772E-4,1.0924849E-4,47,2,0,200,0,0
283258239,LukewSavage,10,5733,549,1986,7,115,47.2361493565,40-49,685,6,42,118,160,160,42,118,6,2.3816538333,2552.7735897362,0.0671293987,0.1524764151,0.32963625,0,66,2.1358814792598536E-4,2.5763622E-4,2.6098252E-4,390,22,11,200,11,0.055
283292134,tuesdaymudds,10,1502,44,81,0,8,31.1832926036,30-39,454,6,2,4,6,6,2,4,7,3.0662872447,1.955923631,0.0024011189,0.2333333333,0.36666667,0,66,5.1441156510850135E-5,1.797462E-5,1.8208082E-5,140,0,0,201,0,0
283301194,Haggisman57,10,7034,1594,2001,22,13,48.5756439288,40-49,705,7,62,90,152,152,62,90,6,2.5557415467,9311.9366519475,0.0317081578,0.0691443012,0.25333333,0,66,3.6087660707537206E-4,3.7746702E-4,3.8236973E-4,372,29,1,200,1,0.005
283332808,PACE_ag,10,10001,407,547,10,122,33.9978009169,30-39,680,7,30,60,90,90,30,60,7,2.4750585872,820.4838497051,0.0555364206,0.1314606742,0.3380823,0,66,1.4653691665849508E-4,1.8573774E-4,1.8815018E-4,140,10,0,200,0,0
283368566,OwnYourVote,10,296,74,414,0,0,22.9428163389,20-29,335,5,5,45,50,50,5,45,6,2.5242718447,338.5247701811,0.009990775,0.152244898,0.2589372,0,66,6.643631074022573E-5,3.594924E-5,3.6416164E-5,390,2,0,199,0,0
283590835,tek_heretik,10,1796,110,111,0,0,24.5727773356,20-29,626,6,19,20,39,39,19,20,6,2.5212587881,184.0038775368,0.0366251348,0.0695006748,0.45789474,0,66,9.645616512044804E-5,1.198308E-4,1.2138722E-4,47,3,0,200,0,0
284242666,adriandpetry,10,4760,225,181,9,831,42.5010537637,40-49,681,6,6,8,14,14,6,8,7,2.9045865417,15.7234278173,0.0175297519,0.2582417582,0.6,0,66,8.510235236935262E-5,4.194078E-5,4.2485524E-5,372,5,0,200,0,0
284495320,musafonia,10,8126,330,282,3,7,46.2482734001,40-49,720,7,2,3,5,5,2,3,11,6.6002678273,0.6,2.0710324681093756E-4,0.15,0.25,0,66,1.3537636135373113E-4,1.797462E-5,1.8208082E-5,320,6,0,201,0,0
284619179,VeryEthnic,10,1268,979,965,28,140,45.6514653692,40-49,657,5,48,46,94,94,48,46,6,2.4502845665,1031.9970238023,0.0809125791,0.0590253946,0.32354996,0,66,1.949023495466761E-4,2.9358547E-4,2.9739868E-4,47,9,0,200,0,0
284630825,ashboxlive,10,9415,543,851,12,830,55.3421447573,50-59,713,7,50,79,129,129,50,79,6,2.3401406093,7121.4240053984,0.0677782107,0.0571705426,0.22654982,0,66,3.2564816790496066E-4,3.0556854E-4,3.095374E-4,372,32,4,203,4,0.0197044335
284725852,MPEveAdams,10,830,1501,178,76,1,49.9304784277,40-49,695,4,157,24,181,181,157,24,7,2.7515902243,3272.0812600603,0.1566015081,0.1093308778,0.17409846,0,66,0.0012660059,9.466633E-4,9.4682025E-4,372,99,4,200,4,0.02
284757897,ckane616,10,2744,1454,1955,25,147,52.5942086456,50-59,649,7,16,0,16,16,16,0,0,0,0,0.0133288433,0.1833333333,0.34583333,0,24,1.328166268143072E-4,1.0185618E-4,0,47,3,0,202,0,0
284838499,tonkin12,10,2362,293,955,4,45,42.2159443378,40-49,562,6,84,244,328,328,84,244,7,2.2206226984,10709.4689021054,0.1093599272,0.0827739241,0.21377446,0,66,2.523247974126165E-4,5.092809E-4,5.1589566E-4,47,8,2,201,2,0.0099502488
284853577,TrashManPalmer,10,2323,120,250,0,3,31.6939985633,30-39,619,6,7,6,13,13,7,6,7,2.8044861065,61.5746281411,0.0127535502,0.0833333333,0.31944445,0,66,7.299331319693118E-5,4.793232E-5,4.8554884E-5,390,12,0,199,0,0
285097792,Stephen_Farr,10,168,31,119,0,5,30.9540614643,30-39,479,3,0,0,0,0,0,0,0,0,0,0,0,0,262,493,4.4780486537007367E-5,0,0,259,3,0,191,0,0
285249984,BinkyBaxter1,10,2018,669,1426,4,2,47.6995040902,40-49,694,5,206,338,544,544,206,338,6,2.0863742886,29205.2394337994,0.2235072883,0.0463621222,0.17032033,0,66,5.276577875124086E-4,0.0012402488,0.0012563576,47,81,1,200,1,0.005
285343383,asham520,10,869,19,173,0,2,27.2023276647,20-29,488,5,0,0,0,0,0,0,0,0,0,0,0,0,291,541,4.4780486537007367E-5,0,0,287,0,0,200,0,0
285709236,DannyHozack,10,2884,1921,2039,19,33,49.7732675102,40-49,694,7,85,102,187,187,85,102,6,2.4690324741,16605.7118790169,0.0577066599,0.0506008855,0.2504043,0,66,4.948896367489712E-4,5.1527243E-4,5.2196503E-4,372,50,0,212,0,0
285717387,LucasChnd,10,17105,198,105,0,263,34.784271113,30-39,746,7,0,0,0,0,0,0,0,0,0,0,0,0,106,218,4.4780486537007367E-5,0,0,101,4,0,201,0,0
285734431,ajssinc,10,3594,236,195,11,21,46.2823503514,40-49,639,6,22,23,45,45,22,23,7,2.6083026448,119.110937514,0.03179882,0.1641414141,0.33633634,0,66,1.0970616126354192E-4,1.3780541E-4,1.395953E-4,47,13,1,201,1,0.0049751244
285744807,mathias_berlin,10,10,10,18,0,5,12.3207895825,10-19,30,1,0,0,0,0,0,0,0,0,0,0,0,0,136,268,4.4780486537007367E-5,0,0,133,0,0,11,0,0
285771480,nstdenis,10,10333,527,772,14,377,47.9651495184,40-49,721,7,105,179,284,284,105,179,6,2.192835621,6229.9350116846,0.1535960909,0.0781117802,0.24594237,0,66,3.672071968803387E-4,6.351032E-4,6.433522E-4,47,93,1,207,1,0.0048309179
285796366,jdumes98,10,368,108,181,1,1,36.145735691,30-39,542,4,12,17,29,29,12,17,7,2.9594911282,30.6111392014,0.0083907028,0.131773399,0.37142858,0,66,7.834823795183456E-5,7.789002E-5,7.8901685E-5,140,18,1,200,1,0.005
286014324,politicalham,10,567,158,456,1,0,63.7383090775,60-69,520,4,6,31,37,37,6,31,6,2.7274857717,13.2830383561,0.0050777336,0.2394894895,0.4564394,0,66,7.631966267303751E-5,4.194078E-5,4.2485524E-5,372,2,0,200,0,0
286229457,MarjBoutinSweet,10,875,998,941,85,7,48.989634144,40-49,672,5,123,124,247,247,123,124,6,2.374958152,6399.3620732233,0.1664826115,0.1022678648,0.3647229,0,66,7.17851097734848E-4,7.4295094E-4,7.40462E-4,390,146,4,200,4,0.02
286278904,bailey_jade,10,1260,103,219,0,1022,38.5933381576,30-39,569,5,3,3,6,6,3,3,7,3.0826916639,5.372395421,0.0024872527,0,0,0,66,5.453962795646596E-5,2.396616E-5,2.4277442E-5,47,6,0,200,0,0
286320498,1_Non_Blonde,10,974,28,29,0,3,19.8157066905,10-19,573,5,0,1,1,1,0,1,8,3.6462516734,0,0,0,0,0,678,4.4780486537007367E-5,0,6.0693606E-6,390,0,2,200,1,0.01
286424432,RichardFantin,10,14533,947,1754,35,63,45.1796803701,40-49,760,7,139,224,363,363,139,224,6,2.1486441245,21490.1219484942,0.1830425602,0.0523111578,0.17621131,0,66,4.5807252000130234E-4,8.388156E-4,8.497105E-4,47,57,0,202,0,0
286504250,AnonimaPapaya,10,25896,1200,979,5,5786,46.7188630319,40-49,788,8,1,0,1,1,1,0,0,0,0,7.34391852452689E-5,0,0,130,250,8.284390166388585E-5,1.198308E-5,0,127,38,0,202,0,0
286723230,kevinrns,10,30144,819,931,26,17851,43.7416517055,40-49,771,9,120,120,240,240,120,120,7,2.3157013726,5535.2030954508,0.1656123988,0.064609484,0.24084108,0,66,4.1716934469036024E-4,7.2497636E-4,7.343926E-4,390,140,4,216,3,0.0185185185
286985249,VE3ZKS,10,11941,335,956,8,218,36.2594207255,30-39,711,8,61,138,199,199,61,138,7,2.4107800469,1940.3052066863,0.0836138115,0.153469367,0.2787337,0,66,2.276227483321189E-4,3.7147547E-4,3.7630036E-4,390,25,9,203,8,0.0443349754
287040067,davejrider,10,170,58,347,0,19,32.4052502923,30-39,442,3,6,57,63,63,6,57,6,2.4877803817,80.6287882905,0.0052064981,0.1774193548,0.31986216,0,66,5.9057766879494586E-5,4.194078E-5,4.2485524E-5,140,5,0,173,0,0
287241249,FonsecaSFC,10,411,130,155,0,1,38.647134506,30-39,609,4,4,4,8,8,4,4,2,1.2,0.25,3.2341590948101786E-4,0.1071428571,0.9166667,167,321,2.7074367365054316E-4,2.99577E-5,3.0346804E-5,289,44,0,197,0,0
287260619,AlbertaGrl,10,15283,1800,947,46,530,53.1277142341,50-59,781,8,113,164,277,277,113,164,6,2.3655841982,12922.8996008123,0.062699368,0.0633730968,0.16727036,0,66,4.512521251575749E-4,6.830355E-4,6.9190713E-4,372,238,6,207,6,0.0289855072
287655600,Juscored,10,1430,124,752,1,44,23.0257298973,20-29,405,6,6,43,49,49,6,43,6,2.5179109474,161.5254412502,0.0097127709,0.1964285714,0.37264672,0,66,6.863740573376276E-5,4.194078E-5,4.2485524E-5,140,1,3,200,3,0.015
287695900,funnyhaircut,10,2896,235,775,6,36,25.8194369304,20-29,595,6,16,43,59,59,16,43,6,2.5487110814,416.4904257409,0.0194262263,0.1040327294,0.30021143,0,66,1.0821003305123294E-4,1.0185618E-4,1.0317913E-4,372,2,0,193,0,0
287752788,Rabnew,10,5149,246,466,4,16,50.7551004128,50-59,704,7,90,137,227,227,90,137,7,2.3167057248,3540.9016104982,0.1111369379,0.1006393513,0.26342988,0,66,2.538931395525717E-4,5.452301E-4,5.5231183E-4,47,193,1,260,1,0.0038461538
287866585,SignGuyOttawa,10,1370,192,381,5,12,43.2182718378,40-49,610,5,2,2,4,4,2,2,2,1.6,0,1.5926843064470052E-4,0.25,0.8333333,0,49,1.8649263792208323E-4,1.797462E-5,1.8208082E-5,27,7,0,200,0,0
287905776,BlaineBadiuk,10,1019,79,162,0,16,29.7301391003,20-29,488,5,6,10,16,16,6,10,7,2.9330431871,7.8009044465,0.0084512639,0.1125,0.25,0,66,6.650810170827457E-5,4.194078E-5,4.2485524E-5,390,1,2,200,2,0.01
287974083,BlondeRachellll,10,1646,287,234,0,222,41.394315171,40-49,635,5,4,2,6,6,4,2,2,1.6,0,3.2182929738269154E-4,0.2,1,209,402,2.6065177531832076E-4,2.99577E-5,3.0346804E-5,341,22,0,198,0,0
288067030,KweschnMedia,10,10610,720,527,9,708,42.7107149421,40-49,729,7,1,1,2,2,1,1,7,3.7127552728,0,2.0701029392233532E-4,0,0,0,66,5.2731590636623866E-5,1.198308E-5,1.2138721E-5,47,26,0,200,0,0
288198163,DeviIinDisguise,10,3511,706,145,0,108,39.7457090635,30-39,601,6,0,0,0,0,0,0,0,0,0,0,0,0,391,708,4.4780486537007367E-5,0,0,401,0,0,201,0,0
288372843,goinkforward,10,1373,72,173,0,34,37.8461134199,30-39,551,5,12,14,26,26,12,14,7,2.8028121861,77.4083483117,0.0128662336,0.1476923077,0.28138527,0,66,8.355592673982894E-5,7.789002E-5,7.8901685E-5,372,3,1,199,1,0.0050251256
288521315,CooperMatheson,10,809,184,219,1,250,44.7787566015,40-49,580,5,12,18,30,30,12,18,7,2.9548041513,204.6400182154,0.0072887006,0.1505747126,0.44155845,0,66,1.3392017012261553E-4,7.789002E-5,7.8901685E-5,372,12,3,200,3,0.015
289629680,soychilecl,10,60610,28441,6150,204,0,63.8817473648,60-69,882,6,7,4,11,11,7,4,10,5.598928691,16313.8333333338,6.576663842133841E-4,0.0454545455,0.23809524,0,66,2.284012929351859E-4,4.793232E-5,4.8554884E-5,320,7,0,201,0,0
289720713,StephenVail,10,1952,478,586,0,13,33.7535434701,30-39,563,4,1,2,3,3,1,2,1,1,1,7.49471721243357E-5,0,0,0,528,1.2969692065828504E-4,1.198308E-5,1.2138721E-5,320,0,0,200,0,0
290294378,DamnLapin,10,2,21,109,0,0,12.9916482201,10-19,21,1,2,2,4,4,2,2,7,2.9983260797,0.6246671592,0.002877709,0,0,0,66,4.947954594634506E-5,1.797462E-5,1.8208082E-5,47,0,0,2,0,0
290312086,DavidFox_Canada,10,637,112,616,1,105,31.3318790628,30-39,541,5,22,97,119,119,22,97,6,2.2986273853,788.3516757806,0.0382044541,0.1660732089,0.32527664,0,66,1.0922881618699027E-4,1.3780541E-4,1.395953E-4,390,2,1,198,1,0.0050505051
290704632,IkeNDP,10,873,355,391,5,0,42.7223683191,40-49,631,5,104,84,188,188,104,84,6,2.5614328758,803.2117737752,0.1361453537,0.1300773694,0.40871063,0,66,5.103481105504583E-4,6.291117E-4,6.3728285E-4,390,24,4,200,4,0.02
290895809,CPoliticalScene,10,401,61,18,2,0,25.2735839662,20-29,527,2,16,4,20,20,16,4,7,3.1690659525,449.9380869015,0.0175606411,0.1,0.16993465,0,66,8.813968622206045E-5,1.0185618E-4,1.0317913E-4,47,38,0,200,0,0
291126048,YQRosie,10,3652,287,431,11,411,39.0966235561,30-39,610,6,25,27,52,52,25,27,7,2.6344158018,396.9266295161,0.0253443154,0.0950226244,0.26458037,0,66,1.3054636590450498E-4,1.5578004E-4,1.5780337E-4,390,0,6,198,5,0.0303030303
291142267,CDM4Sarnia,10,2415,48,35,3,618,24.0609325951,20-29,401,6,3,1,4,4,3,1,7,3.3404753934,0.4204257443,0.0052398887,0.1666666667,0.6666667,0,66,6.0199615493815546E-5,2.396616E-5,2.4277442E-5,372,0,0,196,0,0
291497597,Marchand_Phil,10,870,153,336,4,24,40.3414901881,40-49,556,5,20,40,60,60,20,40,7,2.7007030465,28.6044561653,0.0263649352,0.2192090395,0.6287879,0,66,1.1929223721677289E-4,1.2582233E-4,1.2745657E-4,390,24,5,200,5,0.025
291626846,AnnieClaireBO,10,2712,461,861,24,15,45.8133060801,40-49,659,6,14,27,41,41,14,27,7,2.8232340141,41.4167566183,0.0379052182,0.2262195122,0.56534094,0,66,2.1165141851150424E-4,8.98731E-5,9.104041E-5,140,15,3,200,3,0.015
292074881,Sharpestick,10,8750,312,99,8,194,52.5218758148,50-59,706,7,25,13,38,38,25,13,7,2.9072648142,16.4034061011,0.0175852249,0.1899004267,0.58465606,0,66,1.5331069849092112E-4,1.5578004E-4,1.5780337E-4,372,20,0,199,0,0
292123879,BennViel,10,1664,90,264,1,153,37.2976588313,30-39,600,5,3,4,7,7,3,4,7,3.0820220957,0.937372065,0.0037224357,0.1428571429,0.33333334,0,66,5.2236307912470375E-5,2.396616E-5,2.4277442E-5,47,0,0,200,0,0
292357569,Adam_Dee_Em,10,3805,666,1651,35,149,45.0609757178,40-49,657,7,39,91,130,130,39,91,6,2.29159692,3542.9229936788,0.0547703811,0.0760286225,0.22443861,0,66,1.6482464556843605E-4,2.396616E-4,2.4277443E-4,140,2,4,199,4,0.0201005025
292413983,danminkin,10,2692,271,698,5,80,44.9556857014,40-49,670,6,30,56,86,86,30,56,7,2.5410110479,421.764766006,0.04220553,0.1567715458,0.3638625,0,66,1.4234716548796025E-4,1.8573774E-4,1.8815018E-4,390,10,1,200,1,0.005
292460155,AkileChoh,10,322,540,362,15,17,42.4585182682,40-49,626,3,26,26,52,52,26,26,7,2.7626380984,3411.1949922532,0.021008012,0.137254902,0.23623188,0,66,2.131733990154622E-4,1.6177158E-4,1.5780337E-4,47,3,0,200,0,0
292624934,AB_CutRock,10,12949,922,1990,12,80,32.6989626776,30-39,681,7,29,52,81,81,29,52,6,2.5644459324,1101.5031039101,0.0169683434,0.1175925926,0.4566365,0,66,1.4532707884000804E-4,1.797462E-4,1.8208082E-4,372,4,0,199,0,0
292659175,Diatribenscreed,10,1992,75,137,0,24,40.9905933301,40-49,589,6,13,16,29,29,13,16,7,2.8188818212,154.2839293763,0.0102474541,0.1145320197,0.40263158,0,66,8.84431111411187E-5,8.388156E-5,8.497105E-5,372,5,0,201,0,0
292686476,ArmandLaBarge,10,1023,224,353,1,5,43.7098691562,40-49,613,5,9,21,30,30,9,21,7,2.9173083361,24.8415464608,0.0105889554,0.2183908046,0.4088319,0,66,1.1168392193209433E-4,5.99154E-5,6.069361E-5,372,8,1,200,1,0.005
293056684,JsrSmith,10,421,217,386,1,3,44.3946516327,40-49,573,4,68,104,172,172,68,104,7,2.4248409776,1106.8367643206,0.0896028877,0.1582347341,0.39401057,0,66,3.3887680556211414E-4,4.1341624E-4,4.1271653E-4,390,56,7,200,7,0.035
293082921,bowman_law,10,1086,972,1944,32,126,43.5557385037,40-49,616,5,30,44,74,74,30,44,7,2.5868764647,2654.1445143549,0.0349045346,0.0796001481,0.18953635,0,66,2.0187290007023446E-4,1.8573774E-4,1.8815018E-4,55,10,0,200,0,0
293196522,JakeC_SBG,10,8140,575,567,1,500,35.7873137957,30-39,736,7,1,1,2,2,1,1,2,1.75,0,7.800935181318625E-5,0,0,80,179,1.1835168135136378E-4,1.198308E-5,1.2138721E-5,74,11,0,199,0,0
293223633,1967canadian,10,14119,507,607,13,301,41.0820211313,40-49,754,8,51,62,113,113,51,62,6,2.52058922,1931.8090090231,0.0280414223,0.0747471555,0.4093702,0,66,2.2059128727555698E-4,3.1156008E-4,3.1560674E-4,372,67,0,201,0,0
293313896,RobertRoss4,10,13312,564,2001,6,0,48.7254027004,40-49,741,6,26,46,72,72,26,46,6,2.4981586876,735.6293475124,0.014837087,0.1294992175,0.37554428,0,66,1.298840387108727E-4,1.6177158E-4,1.6387274E-4,372,193,8,202,8,0.0396039604
293488070,jannovision,10,2448,164,519,3,493,41.3721179483,40-49,594,5,15,41,56,56,15,41,6,2.4576498159,68.4340872782,0.028782047,0.1532467532,0.39953542,0,66,8.619640283732377E-5,9.586464E-5,9.710977E-5,390,19,0,200,0,0
293866044,MalcolmFrench,10,5702,430,287,17,4,49.05923779,40-49,712,7,63,47,110,110,63,47,7,2.5564111148,677.8670821721,0.0835459677,0.1251876564,0.33919752,0,66,2.7040621320708886E-4,3.8345857E-4,3.8843908E-4,390,48,2,200,2,0.01
294078512,thompsonty,10,504,50,56,0,99,26.6686685597,20-29,536,4,2,2,4,4,2,2,2,1.6666666667,0,1.623921402690799E-4,0.0833333333,1,264,497,1.1748037124471323E-4,1.797462E-5,1.8208082E-5,261,4,0,200,0,0
294174645,katheaney,10,806,423,941,11,2,41.9224914021,40-49,634,5,47,111,158,158,47,111,6,2.3669233344,3007.9663717982,0.0557064975,0.130210433,0.34970015,0,66,2.2699378416690108E-4,2.8759392E-4,2.913293E-4,390,13,4,199,4,0.0201005025
294509806,yusriyusoff,10,7543,156,208,3,5,44.0366017634,40-49,721,7,0,0,0,0,0,0,0,0,0,0,0,0,356,649,4.4780486537007367E-5,0,0,365,0,0,200,0,0
295364492,FunsizeKim31,10,3479,65,144,0,304,25.7529180384,20-29,635,6,0,0,0,0,0,0,0,0,0,0,0,0,238,460,4.4780486537007367E-5,0,0,234,2,0,200,0,0
295402999,SimonTresim37,10,2802,2436,2370,15,11,51.2480158475,50-59,686,6,21,20,41,41,21,20,7,2.7261466354,532.671452641,0.019851446,0.0487804878,0.3181818,0,66,1.3359726772024948E-4,1.3181388E-4,1.3352593E-4,390,5,0,200,0,0
295707178,BCaramento,10,8957,371,350,8,98,46.0599482084,40-49,736,7,29,42,71,71,29,42,6,2.4780716438,395.0843620706,0.0357502901,0.0832997988,0.32346722,0,66,1.1869667306173746E-4,1.797462E-4,1.8208082E-4,47,26,0,201,0,0
296350580,KevinROKeefe,10,599,93,89,3,0,42.1771487323,40-49,407,3,22,14,36,36,22,14,7,2.7147639772,46.8514393453,0.0385473148,0.1333333333,0.38746437,0,66,1.2204077271763633E-4,1.3780541E-4,1.395953E-4,47,21,5,200,5,0.025
296482531,Tigergal62,10,11234,712,977,25,574,38.1637470261,30-39,686,8,2,3,5,5,2,3,8,3.4599933043,25.961991933,5.432972609206304E-4,0.05,0.16666667,0,66,6.379014922957469E-5,1.797462E-5,1.8208082E-5,47,5,0,198,0,0
296504381,mADtivity,10,59544,1385,1640,83,5,46.1822746157,40-49,685,9,3,1,4,4,3,1,8,4.4204887847,5631.7607054604,0.0012629596,0,0,0,66,1.3476949278548228E-4,2.396616E-5,2.4277442E-5,320,4,0,202,0,0
296543799,kamil_kamarudin,10,4585,141,186,1,468,42.0887454183,40-49,676,6,0,0,0,0,0,0,0,0,0,0,0,0,346,633,4.4780486537007367E-5,0,0,355,6,0,200,0,0
296553576,Erin_M_OToole,10,1083,909,202,19,4,59.7808503915,50-59,703,5,93,20,113,113,93,20,7,2.7710077,1550.5354457445,0.0941269787,0.114017067,0.20292448,0,66,6.659175479836964E-4,5.6320475E-4,5.705199E-4,372,124,3,200,3,0.015
296560575,ChristeezyNRG,10,5386,73,150,0,2188,22.0236993694,20-29,525,2,0,0,0,0,0,0,0,0,0,0,0,0,378,689,4.4780486537007367E-5,0,0,388,0,0,200,0,0
297162974,Ruskin701,10,571,50,322,0,181,31.2683785644,30-39,402,5,2,18,20,20,2,18,7,2.7144291932,15.0617775045,0.0040414364,0.3342105263,0.6461988,0,66,5.274729508834334E-5,1.797462E-5,1.8208082E-5,140,0,0,200,0,0
297239016,a_w_young,10,9832,686,1844,17,437,58.1037090682,50-59,744,7,71,91,162,162,71,91,7,2.3672581185,2193.9676524847,0.1087809578,0.1033663063,0.28735223,0,66,2.4748837004844623E-4,4.313909E-4,4.3699396E-4,47,21,0,200,0,0
297483708,albertasoapbox,10,2484,341,384,12,4,45.4673863345,40-49,669,6,43,49,92,92,43,49,6,2.5942417141,1065.3654552279,0.0270731126,0.0821786909,0.47960785,0,66,2.1984935916552695E-4,2.6362776E-4,2.6705186E-4,372,139,2,199,2,0.0100502513
297568021,bush_wendy,10,2070,357,235,10,49,44.9928845077,40-49,653,6,17,18,35,35,17,18,7,2.6079678607,171.7927558624,0.0244666009,0.0546218487,0.23809524,0,66,9.27397761110771E-5,1.0784772E-4,1.0924849E-4,47,18,0,201,0,0
297771685,frogsarelovely,10,75584,3280,2250,104,1731,56.1722097065,50-59,877,9,145,121,266,266,145,121,6,2.3515232675,20665.1216278647,0.1634712607,0.048233792,0.22346072,0,66,5.675867113746479E-4,8.747648E-4,8.800573E-4,47,123,0,200,0,0
297787306,evilscientistca,10,2513,219,381,4,130,46.1910890958,40-49,689,6,35,47,82,82,35,47,7,2.5393371276,11775.3768140877,0.0553022013,0.0808491418,0.37244898,0,66,1.9842707628224524E-4,2.1569544E-4,2.1849698E-4,47,21,1,204,1,0.0049019608
297944158,cpcholding,10,1338,996,1994,0,2,26.6014114939,20-29,545,4,0,0,0,0,0,0,0,0,0,0,0,0,47,135,4.4780486537007367E-5,0,0,38,4,0,200,0,0
298034083,gariovich,10,4150,171,190,7,44,46.8813178583,40-49,711,7,28,50,78,78,28,50,7,2.5252761969,318.079123623,0.0395520932,0.1188811189,0.3951782,0,66,1.2070047236764029E-4,1.7375466E-4,1.7601145E-4,47,38,0,200,0,0
298540272,AngryAccountant,10,1327,156,327,0,52,27.6321892287,20-29,594,5,0,1,1,1,0,1,7,3.6927710843,0,0,0,0,0,552,4.4780486537007367E-5,0,6.0693606E-6,390,3,0,200,0,0
298619156,SeerLen,10,15808,1235,1999,24,3437,41.7005984525,40-49,743,7,13,23,36,36,13,23,7,2.8091730834,624.7432849887,0.0109315252,0.0785714286,0.34980237,0,66,1.11884881460391E-4,8.388156E-5,8.497105E-5,47,16,0,201,0,0
299228664,jermo_8,10,1404,182,145,0,85,37.428132149,30-39,636,6,1,1,2,2,1,1,9,5.6585202544,0,8.478436128764517E-5,0,0,0,66,9.202613453265988E-5,1.198308E-5,1.2138721E-5,31,16,0,198,0,0
299241117,michelle373737,10,1558,282,1064,5,67,42.3427068853,40-49,594,6,6,15,21,21,6,15,7,2.921995313,148.0744701343,0.0020134669,0.1142857143,0.3809524,0,66,8.050173538560402E-5,4.194078E-5,4.2485524E-5,55,22,0,200,0,0
299360167,janicetwlee,10,2621,32,34,2,6,40.1289957527,40-49,624,5,1,2,3,3,1,2,8,3.6340810177,0,1.438493765964687E-4,0.1666666667,1,0,66,5.632733933819057E-5,1.198308E-5,1.2138721E-5,55,1,0,200,0,0
299444560,calg_kiaguy,10,3054,76,68,0,9,45.6522195804,40-49,682,6,14,1,15,15,14,1,7,3.1797790425,2.6240260438,0.0176421527,0.1428571429,0.26923078,0,66,8.105004836700614E-5,8.98731E-5,9.104041E-5,47,94,0,206,0,0
299506138,ThatJBrown,10,6115,351,1148,4,139,46.5229693602,40-49,713,7,19,85,104,104,19,85,6,2.3244057583,462.8405922012,0.0411978954,0.1776512323,0.33760685,0,66,1.5468059216155225E-4,1.198308E-4,1.2138722E-4,372,3,2,200,1,0.01
299738128,ArnaldoBeni,10,37,6,40,0,0,13.8378558686,10-19,115,2,0,1,1,1,0,1,8,3.6462516734,0,0,0,0,0,437,4.4780486537007367E-5,0,6.0693606E-6,390,1,0,45,0,0
300070934,ALiberalCase,10,6420,602,723,17,26,54.7210883442,50-59,742,7,65,81,146,146,65,81,6,2.4392366923,3056.9634248554,0.0782906777,0.1139820501,0.29291075,0,66,2.8152845182951436E-4,3.9544163E-4,4.0057782E-4,140,31,0,199,0,0
300290452,carbonexplorer,10,1332,252,522,13,29,47.0270462286,40-49,602,5,3,9,12,12,3,9,7,2.8115165718,21.0924769878,0.0073455114,0.1742424242,0.5138889,0,66,6.064823386545359E-5,2.396616E-5,2.4277442E-5,55,2,0,200,0,0
300400577,TartsnTattoos,10,3467,300,387,6,45,40.9976642984,40-49,636,6,1,3,4,4,1,3,7,2.9976565116,0.1756229686,0.0010759105,0.1666666667,0.6666667,0,66,4.94405029247494E-5,1.198308E-5,1.2138721E-5,390,2,0,199,0,0
300474179,pegcitymadman,10,730,22,91,1,15,17.630140184,10-19,448,5,0,2,2,2,0,2,8,3.6700133869,0,0,0,0,0,576,4.4780486537007367E-5,0,6.0693606E-6,372,1,0,200,0,0
300669060,chewislewis,10,1296,165,158,1,161,40.1167771413,40-49,623,6,0,0,0,0,0,0,0,0,0,0,0,0,192,371,4.4780486537007367E-5,0,0,188,7,0,200,0,0
302232667,amtanx,10,10211,244,169,1,1961,37.8640746939,30-39,716,6,1,1,2,2,1,1,9,5.6588550385,0,8.634057248977776E-5,0,0,0,66,1.0362282914105973E-4,1.198308E-5,1.2138721E-5,31,11,0,200,0,0
302418309,VAC_CF_News,10,11436,19,5,0,0,15.2297162328,10-19,211,4,1,1,2,2,1,1,8,3.5413458319,0.1821731533,4.2310605758341294E-4,0,0,0,66,4.610632938191189E-5,1.198308E-5,1.2138721E-5,140,0,0,267,0,0
302659496,nucks99,10,1635,97,221,3,9,40.4416572366,40-49,616,6,11,21,32,32,11,21,6,2.7626380984,85.1524143962,0.010147391,0.125,0.4904762,0,66,8.414677931157608E-5,7.189848E-5,7.283233E-5,372,1,0,192,0,0
302873036,Jose_Quilon,10,731,145,286,1,7,41.6623326352,40-49,465,5,0,2,2,2,0,2,9,4.5910307898,0,0,0,0,0,149,4.4780486537007367E-5,0,6.0693606E-6,320,0,0,200,0,0
302951386,JoelBReed,10,4019,408,473,7,1,42.8877202295,40-49,715,7,13,27,40,40,13,27,7,2.9337127553,199.2964784497,0.015268643,0.1724358974,0.3693182,0,66,1.670051403931948E-4,8.388156E-5,8.497105E-5,140,6,1,201,1,0.0049751244
303321116,A_ShotOfTequila,10,12098,280,275,1,17,33.6438576803,30-39,703,6,0,0,0,0,0,0,0,0,0,0,0,0,207,396,4.4780486537007367E-5,0,0,203,7,0,199,0,0
303665229,Rod_McCallum,10,26563,830,1994,22,11,55.7281179412,50-59,773,8,67,146,213,213,67,146,6,2.3033143622,3292.7210147308,0.0894306086,0.1086677296,0.25535363,0,66,2.218034084454047E-4,4.0742473E-4,4.1271653E-4,47,256,0,216,0,0
303853801,JensenMusicJMI,10,4235,521,566,13,2,44.1082279926,40-49,631,7,3,1,4,4,3,1,8,4.1298962169,0.0635854342,0.0040365475,0.1666666667,0.16666667,0,66,5.286013865389503E-5,2.396616E-5,2.4277442E-5,390,6,0,201,0,0
305330589,gelagaffe,10,1082,166,223,2,213,44.3606971045,40-49,615,6,60,67,127,127,60,67,6,2.4101104787,936.0571709258,0.0819650229,0.0594925634,0.37949955,0,66,1.8599060932126388E-4,3.6548392E-4,3.70231E-4,47,209,4,200,4,0.02
305360589,EvanPivnick,10,1284,123,348,3,7,35.9035963827,30-39,561,5,8,43,51,51,8,43,7,2.593572146,53.0036947655,0.0126705879,0.2043137255,0.389372,0,66,6.978868145867561E-5,5.392386E-5,5.4624245E-5,140,5,1,200,1,0.005
305850379,DonnaChevrier,10,750,73,219,0,29,21.9491528975,20-29,462,5,5,13,18,18,5,13,7,2.6006026113,13.3880259534,0.0091756668,0.1241830065,0.35897437,0,66,5.745755126109798E-5,3.594924E-5,3.6416164E-5,47,0,0,200,0,0
305894011,Deb_Libby,10,17384,707,817,25,742,44.5579910447,40-49,774,8,6,9,15,15,6,9,7,3.0274522933,118.9307598797,0.0013687469,0.0142857143,0.06944445,0,66,6.983501926826667E-5,4.194078E-5,4.2485524E-5,47,6,0,200,0,0
306018798,seriousHabit,10,4475,889,1989,20,71,48.9040624617,40-49,740,7,12,38,50,50,12,38,6,2.5162370271,3448.4765992359,0.0167989988,0.1089795918,0.26813656,0,66,8.643606358646652E-5,7.789002E-5,7.8901685E-5,47,10,0,200,0,0
306118444,MapleLeaks,10,35016,922,1204,16,5,39.1791022787,30-39,724,6,182,274,456,456,182,274,6,2.1288918647,15289.3296127194,0.220778236,0.0708502024,0.23403803,0,66,5.078837052287469E-4,0.0010964518,0.001110693,47,66,0,201,0,0
306279729,buck_tracks,10,4856,307,549,12,453,48.1345581961,40-49,682,7,12,14,26,26,12,14,7,2.817877469,2123.0027476323,0.0109102967,0.0584615385,0.24761905,0,66,8.623549215705731E-5,7.789002E-5,7.8901685E-5,390,22,0,201,0,0
306494846,popoffculture,10,4813,189,350,4,3,47.4233175926,40-49,692,7,45,60,105,105,45,60,6,2.41680616,417.3689240583,0.0851676097,0.1531135531,0.33557424,0,66,2.370908828012885E-4,2.7561083E-4,2.791906E-4,140,30,16,200,16,0.08
306832808,jonathan_sas,10,3791,411,809,14,173,49.6604722838,40-49,698,7,34,65,99,99,34,65,6,2.4522932708,1664.3918273869,0.0649603076,0.1284271284,0.2975358,0,66,2.7161928701168153E-4,2.097039E-4,2.1242762E-4,140,65,0,202,0,0
306944225,vukmanx,10,1704,72,213,3,2,36.77362331,30-39,581,6,8,18,26,26,8,18,7,2.6749246736,606.306033625,0.016195129,0.1230769231,0.4117647,0,66,6.960569156142067E-5,5.392386E-5,5.4624245E-5,390,31,0,200,0,0
307884494,kitconlib,10,502,175,252,5,0,45.1259426908,40-49,592,5,33,45,78,78,33,45,7,2.5815199197,3255.4175060646,0.0475499747,0.1396936397,0.46606335,0,66,1.534082666060261E-4,2.0371236E-4,2.0635827E-4,140,74,0,200,0,0
307963985,RayMartin2,10,1,4,0,0,0,,,4,0,0,0,0,0,0,0,0,0,0,0,0,0,9,78,4.4780486537007367E-5,0,0,6,0,0,2,0,0
308062165,LukaszukMLA,10,6137,4665,1193,111,203,61.2508345916,60-69,787,7,106,32,138,138,106,32,6,2.5811851356,6704.7671052027,0.0864517881,0.0806093304,0.16071963,0,66,6.618085802544867E-4,6.4109475E-4,6.433522E-4,372,278,1,201,1,0.0049751244
308347303,LaurentMichaut,10,609,284,350,8,0,41.3415090376,40-49,601,4,1,3,4,4,1,3,10,5.8514553362,0,7.49471721243357E-5,0.25,0.6666667,0,263,5.200742033902463E-5,1.198308E-5,1.2138721E-5,320,10,0,200,0,0
308606319,zambo57,10,84,245,60,6,7,40.7783239598,40-49,557,2,3,2,5,5,3,2,8,3.7417196387,2,2.2185542019710082E-4,0.15,0.25,0,106,1.057516340852866E-4,2.396616E-5,1.2138721E-5,140,24,0,100,0,0
308632273,BounTyBornToDie,10,6037,74,133,2,34,41.2114993845,40-49,692,7,0,0,0,0,0,0,0,0,0,0,0,0,89,194,4.4780486537007367E-5,0,0,84,10,0,201,0,0
308865688,mcbriena,10,1932,541,785,8,1,43.880715207,40-49,675,6,48,73,121,121,48,73,6,2.3357884165,2893.0665870787,0.0652726973,0.0693526171,0.2777778,0,66,2.859649422903394E-4,2.9358547E-4,2.9739868E-4,372,19,0,199,0,0
309251929,DannyCaladay,10,36736,2429,1848,119,0,47.372163912,40-49,724,5,7,8,15,15,7,8,8,3.869768999,26029.2925042158,5.485177255235375E-4,0.0047619048,0.027777778,0,66,3.24648096592183E-4,4.793232E-5,4.8554884E-5,320,0,0,201,0,0
309326261,LindaMae4,10,986,109,196,2,5,35.2654119846,30-39,582,5,17,23,40,40,17,23,7,2.6732507533,499.9387147044,0.0167848075,0.1243589744,0.45384616,0,66,1.0919739138915248E-4,1.0784772E-4,1.0317913E-4,390,5,0,200,0,0
309558781,KellyRek,10,64514,2535,2766,131,26276,47.0013892037,40-49,813,9,8,16,24,24,8,16,7,2.8041513224,1113.9842333342,0.0026817225,0.0199275362,0.0625,0,66,9.568721235094596E-5,5.392386E-5,5.4624245E-5,47,24,0,201,0,0
310286381,DealSharks,10,16,136,813,0,0,17.5078479933,10-19,261,3,0,0,0,0,0,0,0,0,0,0,0,0,326,590,4.4780486537007367E-5,0,0,329,1,0,16,0,0
310400113,Moe_Fugger_72,10,9653,602,679,15,512,55.6029035515,50-59,739,8,16,21,37,37,16,21,7,2.692668229,2341.7978866905,0.014477778,0.0668168168,0.3690476,0,66,8.619220792366692E-5,1.0185618E-4,1.0317913E-4,47,44,0,201,0,0
310425304,bernie8859,10,799,9,40,0,3,23.5544698802,20-29,333,4,2,2,4,4,2,2,7,3.1084700368,0,0.0047367567,0.25,0.8333333,0,66,5.251614908581462E-5,1.797462E-5,1.8208082E-5,390,3,0,200,0,0
310855387,antiharper101,10,16117,606,262,19,281,42.1192901846,40-49,741,8,190,76,266,266,190,76,7,2.3983930365,7197.234619622,0.2039677632,0.0955738403,0.2531392,0,66,4.965087496224836E-4,0.0011443842,0.001159248,47,101,1,215,1,0.0046511628
310942227,SteveRickettsSP,10,2789,105,184,4,2,51.0979300475,50-59,687,6,11,22,33,33,11,22,6,2.7981252092,65.4839077047,0.0069896359,0.1846590909,0.51,0,66,8.716487823726853E-5,7.189848E-5,7.283233E-5,372,63,0,204,0,0
310970714,cgvandenb,10,1093,39,62,0,49,31.0405612181,30-39,555,4,0,0,0,0,0,0,0,0,0,0,0,0,112,226,4.4780486537007367E-5,0,0,108,1,0,200,0,0
311098314,jhonatha_S,10,1191,134,143,0,2,35.446966226,30-39,599,5,0,0,0,0,0,0,0,0,0,0,0,0,385,699,4.4780486537007367E-5,0,0,395,1,0,200,0,0
311231357,350orbust1,10,4015,490,755,18,164,47.6877702734,40-49,688,6,66,117,183,183,66,117,6,2.3113491798,3760.7011436876,0.0982440253,0.0838287396,0.28353995,0,66,2.2479260240525068E-4,4.0143318E-4,4.0664716E-4,47,19,0,200,0,0
311285130,john_henise,10,563,134,233,3,37,36.246296076,30-39,591,4,0,0,0,0,0,0,0,0,0,0,0,0,403,724,4.4780486537007367E-5,0,0,411,11,0,200,0,0
311286748,jaystor,10,2489,172,448,3,3,47.6949774463,40-49,668,6,57,93,150,150,57,93,6,2.4291931704,1171.9842612644,0.1105945681,0.1211185682,0.2866145,0,66,3.847651737878754E-4,3.475093E-4,3.520229E-4,390,29,22,200,22,0.11
311469815,unsilenced_majo,10,214,7,127,0,0,27.7482487343,20-29,400,4,5,53,58,58,5,53,6,2.4245061935,14.8850071184,0.0096724793,0.3000604961,0.5471698,0,66,5.464100699589477E-5,3.594924E-5,3.6416164E-5,140,11,3,200,3,0.015
311567625,TheYazata,10,1918,210,298,4,232,44.0083221748,40-49,645,6,1,7,8,8,1,7,7,2.9253431537,0.6611214192,0.0016171619,0.2142857143,0.47619048,0,66,4.770024243342563E-5,1.198308E-5,1.2138721E-5,47,1,0,200,0,0
311568175,sas_robin,10,9448,611,1692,8,10987,49.9537886039,40-49,731,7,53,130,183,183,53,130,6,2.3069969869,3903.9854570064,0.0710008778,0.0818771393,0.20722413,0,66,2.3236250905314394E-4,3.2354315E-4,3.2774548E-4,390,47,0,201,0,0
311969504,Slyb24,10,418,146,421,1,6,34.2180783083,30-39,407,4,9,12,21,21,9,12,7,2.8299296953,338.6456186471,0.0066614122,0.0761904762,0.32051283,0,66,9.389283841519495E-5,5.99154E-5,6.069361E-5,47,2,0,198,0,0
312379410,MattMcLean1919,10,435,107,278,1,0,23.7752248204,20-29,557,4,11,20,31,31,11,20,7,2.656176766,3451.5144097624,0.012967613,0.2010752688,0.4981884,0,66,1.3339886756987514E-4,7.189848E-5,7.283233E-5,390,1,0,200,0,0
312422268,MatBoisvert,10,7638,380,691,9,1,33.7661438422,30-39,663,7,95,166,261,261,95,166,6,2.2825577503,4031.7191787749,0.1205332362,0.1029619805,0.2870677,0,66,4.119972733295338E-4,5.7518785E-4,5.826586E-4,390,17,2,200,2,0.01
312568240,Fundacion_ERLAC,10,715,440,536,6,94,40.6762392357,40-49,612,4,5,4,9,9,5,4,3,1.5714285714,4.5,3.951398835854586E-4,0.0833333333,0.55,52,142,4.4514408342411486E-4,3.594924E-5,3.6416164E-5,316,60,0,200,0,0
312660421,OSConservatives,10,584,357,1127,8,1,45.55281812,40-49,623,4,63,159,222,222,63,159,6,2.3223970539,15884.1407214003,0.0388151974,0.0856671151,0.19831294,0,66,3.2116198269494987E-4,3.8345857E-4,3.8843908E-4,372,88,0,200,0,0
312874303,RPrance,10,280,75,237,0,21,31.8932576762,30-39,503,4,4,6,10,10,4,6,7,2.9099430867,0.2540004565,0.0066576268,0.0888888889,0.46666667,0,66,5.321850887225625E-5,2.99577E-5,3.0346804E-5,47,11,0,200,0,0
313310001,MattLyte,10,557,86,189,1,46,26.7520904528,20-29,477,5,5,10,15,15,5,10,7,2.7827251423,7.161262144,0.0095917464,0.1952380952,0.5181818,0,66,5.809014538927524E-5,3.594924E-5,3.6416164E-5,47,1,0,200,0,0
313332496,DemocracyWatchr,10,1484,891,193,30,5,52.2330493996,50-59,698,5,161,44,205,205,161,44,7,2.5714763977,3087.2378911785,0.1746471356,0.0978718317,0.15960261,0,66,7.52766669793928E-4,9.7062945E-4,9.77167E-4,47,187,0,200,0,0
313465906,LaPryce,10,66,18,49,0,40,18.1766056551,10-19,438,3,0,0,0,0,0,0,0,0,0,0,0,0,61,153,4.4780486537007367E-5,0,0,52,8,0,68,0,0
313503716,JamesLoganpdx,10,13164,631,787,26,6,36.5520203091,30-39,718,8,4,4,8,8,4,4,7,3.0820220957,155.5588195688,0.0027600145,0.0535714286,0.25,0,66,6.827077054352614E-5,2.99577E-5,3.0346804E-5,47,1,0,198,0,0
313584539,SNWTodd,10,1081,133,310,2,52,32.472890579,30-39,594,5,4,5,9,9,4,5,7,3.0903916974,4.1700385479,0.0029909141,0.1388888889,0.5,0,66,5.648579152568922E-5,2.99577E-5,3.0346804E-5,372,0,0,200,0,0
315042301,rparmar958,10,1597,117,493,1,29,28.3496541761,20-29,470,6,5,22,27,27,5,22,7,2.6685637764,30.2223172297,0.0114318148,0.2307692308,0.5,0,66,7.465414031345078E-5,3.594924E-5,3.6416164E-5,55,1,3,200,3,0.015
315296719,lechefwayne,10,6986,104,108,3,99,44.2026709683,40-49,690,7,15,7,22,22,15,7,7,2.8192166053,34.8194886039,0.0222979842,0.1277056277,0.29411766,0,66,8.800885882584094E-5,9.586464E-5,9.710977E-5,47,36,0,225,0,0
315422740,emiliehigginson,10,204,18,83,0,4,12.8994027935,10-19,139,4,2,13,15,15,2,13,7,2.7472380315,6.609750718,0.002302206,0.219047619,0.47435898,0,66,5.168302232725848E-5,1.797462E-5,1.8208082E-5,140,0,3,199,3,0.0150753769
315943388,arsenic101,10,7309,738,915,9,216,40.4352860756,40-49,674,6,62,75,137,137,62,75,6,2.3876799464,882.3145997258,0.0975191265,0.0718656076,0.39801803,0,66,2.047524611552031E-4,3.7746702E-4,3.8236973E-4,47,6,3,200,3,0.015
316696841,CPYAMC,10,31,48,18,4,0,26.4616324078,20-29,179,0,1,1,2,2,1,1,1,1,0,7.49471721243357E-5,0,0,3,68,2.9852402567743944E-4,1.198308E-5,1.2138721E-5,83,4,0,33,0,0
316842662,Sallie_Lama,10,4,133,381,1,88,41.1046042032,40-49,605,5,12,38,50,50,12,38,7,2.567458989,26.3262443066,0.02271095,0.1885714286,0.4679487,0,66,8.177800637242601E-5,7.789002E-5,7.8901685E-5,140,4,0,33,0,0
316910129,hashonomy_gus,10,213287,2483,0,139,0,48.0280261767,40-49,793,10,9,0,9,9,9,0,0,0,0,0.014607515,0.2222222222,0.3888889,0,15,7.15361602070769E-5,5.99154E-5,0,47,8,0,201,0,0
317061843,Thinkey1013,10,10254,277,258,8,146,52.1886941927,50-59,706,8,7,8,15,15,7,8,7,2.7974556411,16.7498975916,0.008515207,0.1380952381,0.47777778,0,66,5.957452896471531E-5,4.793232E-5,4.8554884E-5,390,12,0,200,0,0
317228299,podBROski,10,7802,180,399,4,159,32.7073999628,30-39,686,7,4,9,13,13,4,9,7,2.8624037496,2.6726524897,0.0061142298,0.1538461538,0.5833333,0,66,6.460405843050285E-5,2.99577E-5,3.0346804E-5,372,8,0,200,0,0
317755864,LarryDiIanni,10,9230,1343,918,40,11,54.967750627,50-59,765,7,22,38,60,60,22,38,7,2.4666889856,582.601596562,0.0248703523,0.152259887,0.33205783,0,66,1.0747407742706133E-4,1.3780541E-4,1.395953E-4,140,50,0,200,0,0
318550526,Bajabreeze22,10,417,147,935,1,1,23.8047533775,20-29,361,5,19,79,98,98,19,79,6,2.2972882491,2313.4858661622,0.0243293871,0.1323374711,0.29600778,0,66,1.0483303324096954E-4,1.198308E-4,1.2138722E-4,55,0,2,197,1,0.0101522843
318568724,FredOliver245,10,4907,73,61,0,74,16.897913174,10-19,561,7,11,8,19,19,11,8,7,2.8429862739,35.1442641062,0.0189630991,0.134502924,0.36666667,0,66,7.258026823402371E-5,7.189848E-5,7.283233E-5,47,0,0,200,0,0
318577966,RichardPatey,10,1096,863,1999,18,5,55.1147217567,50-59,649,6,0,0,0,0,0,0,0,0,0,0,0,0,176,334,4.4780486537007367E-5,0,0,170,6,0,200,0,0
319538480,WorkingChepe,10,1621,117,138,0,2,38.4106803891,30-39,682,6,0,0,0,0,0,0,0,0,0,0,0,0,28,101,4.4780486537007367E-5,0,0,22,1,0,200,0,0
319742258,RanaldH,10,121,1,6,0,0,11.0632857838,10-19,21,3,0,1,1,1,0,1,7,3.250669344,0,0,0,0,0,274,4.4780486537007367E-5,0,6.0693606E-6,47,0,0,122,0,0
319746362,jenlovegreen,10,269,27,177,0,2,23.7358943565,20-29,340,4,1,1,2,2,1,1,8,3.5406762638,5.1373881041,1.2241878216061612E-4,0,0,0,66,5.26860724908835E-5,1.198308E-5,1.2138721E-5,390,0,0,200,0,0
319749893,dvmlifestyle,10,2633,72,524,0,163,29.0711439353,20-29,593,6,7,18,25,25,7,18,6,2.8051556746,28.989033727,0.0078384114,0.1616666667,0.51960784,0,66,7.410198682866628E-5,4.793232E-5,4.8554884E-5,372,6,0,200,0,0
320527513,Mu_rii_uhh33,10,7349,323,505,0,917,44.3786394754,40-49,739,7,1,1,2,2,1,1,1,1,0,7.49471721243357E-5,0,0,390,707,2.9852402567743944E-4,1.198308E-5,1.2138721E-5,402,31,0,200,0,0
320990339,justlynnp,10,586,32,13,2,1,30.9229650813,30-39,451,5,10,2,12,12,10,2,7,2.9132909274,16.8137927265,0.0115820237,0.2121212121,0.4181818,0,66,9.177894549910046E-5,6.590694E-5,6.6762965E-5,390,7,0,200,0,0
321045843,atremblay1,10,1246,55,14,1,3,33.884205399,30-39,671,5,19,2,21,21,19,2,7,3.0592567794,3.1405838741,0.032689134,0.3119047619,0.51666665,0,66,8.408064321911994E-5,1.198308E-4,1.2138722E-4,47,1,1,200,1,0.005
321545042,august_mk,10,6640,362,1048,9,136,50.1577759455,50-59,732,7,49,92,141,141,49,92,6,2.3622363575,1634.6069620569,0.0805300489,0.1144883485,0.32049504,0,66,2.2223302637804204E-4,2.99577E-4,3.0346803E-4,390,55,1,201,1,0.0049751244
321663386,GenestJourdain,10,273,299,49,28,0,40.8126502781,40-49,560,4,49,8,57,57,49,8,7,2.8948778038,78.3235481814,0.0767287734,0.2785087719,0.5279035,0,66,3.497563548510024E-4,2.99577E-4,3.0346803E-4,390,36,6,200,5,0.03
321852329,totallyluke,10,562,64,171,1,24,29.1497800421,20-29,587,5,4,19,23,23,4,19,7,2.64579846,27.2511281333,0.0094164851,0.2391304348,0.5131579,0,66,6.47304162589144E-5,2.99577E-5,3.0346804E-5,390,11,1,200,1,0.005
321871451,northernck,10,9021,455,728,10,49,41.0417266452,40-49,729,7,111,186,297,297,111,186,6,2.1948443254,5186.2731637435,0.1645428947,0.0838452088,0.30537897,0,66,3.03696193268938E-4,6.710525E-4,6.797684E-4,47,66,2,242,2,0.0082644628
321968555,MahassenF,10,2879,87,350,0,20,20.9988320141,20-29,569,6,18,59,77,77,18,59,7,2.453297623,151.3815085503,0.0287449666,0.1525974026,0.3514014,0,66,9.094166423249143E-5,1.1383926E-4,1.1531785E-4,47,4,0,200,0,0
322058839,Hnefi,10,207,43,115,0,8,21.0269549516,20-29,402,4,1,3,4,4,1,3,7,3.7596250418,0,1.1328759728597815E-4,0.1666666667,0.6666667,0,66,5.516749454382095E-5,1.198308E-5,1.2138721E-5,372,3,0,198,0,0
322089533,FAQMP,10,4775,1931,2006,41,2,52.736842892,50-59,732,7,331,317,648,648,331,317,6,2.0826916639,95704.2914396773,0.342025822,0.0198375217,0.112965286,0,66,0.0011805412,0.0019891912,0.0020150277,372,289,1,246,1,0.0040650407
322164578,gabaribeau,10,3426,307,751,6,3,45.3394716435,40-49,635,6,13,33,46,46,13,33,6,2.5975895547,690.8222657238,0.0141326447,0.1140096618,0.28403363,0,66,8.77446131360569E-5,8.388156E-5,8.497105E-5,140,5,1,200,1,0.005
322356264,GeraGuerraa,10,12638,211,194,2,2,30.5238997304,30-39,725,6,1,1,2,2,1,1,1,1,0,7.49471721243357E-5,0,0,33,111,2.9852402567743944E-4,1.198308E-5,1.2138721E-5,44,1,0,199,0,0
322367885,hedgeit_tcronin,10,8986,2509,515,76,128,54.7710821348,50-59,748,7,0,0,0,0,0,0,0,0,0,0,0,0,177,336,4.4780486537007367E-5,0,0,172,0,0,43,0,0
322615343,arsenaultashton,10,396,211,201,2,5,42.7397360469,40-49,671,6,13,14,27,27,13,14,6,2.7974556411,118.4658356886,0.0111678324,0.0854700855,0.37916666,0,66,8.466604178277168E-5,8.388156E-5,8.497105E-5,372,21,0,189,0,0
322802999,AddShoppers,10,1348,883,1335,23,1,43.8825427589,40-49,635,6,1,1,2,2,1,1,3,2.2222222222,7.8,7.34391852452689E-5,0,0,0,324,6.38121941004466E-5,1.198308E-5,6.0693606E-6,320,8,0,200,0,0
323291764,WalterPamic,10,479,425,1834,1,12,38.7905895875,30-39,564,5,14,62,76,76,14,62,6,2.4851021091,580.9222123878,0.0101474697,0.1328070175,0.27444956,0,66,9.364666946073287E-5,8.98731E-5,9.104041E-5,372,5,0,199,0,0
323400565,BCLA_InfoPolicy,10,172,82,41,1,1,41.3164563999,40-49,507,3,9,2,11,11,9,2,8,3.6334114496,127.5440055153,0.0049713903,0.1181818182,0.21111111,0,66,1.3440295488740986E-4,5.99154E-5,6.069361E-5,372,16,0,200,0,0
323447431,OliviaCailyn,10,3327,472,394,1,184,41.9663447913,40-49,697,6,0,0,0,0,0,0,0,0,0,0,0,0,402,723,4.4780486537007367E-5,0,0,410,10,0,200,0,0
323676011,CleptoEasy,10,50,85,195,0,5,22.7470090286,20-29,358,3,0,0,0,0,0,0,0,0,0,0,0,0,283,531,4.4780486537007367E-5,0,0,280,4,0,65,0,0
324086895,PriscillaJudd,10,20916,2285,2419,76,6644,48.5092784704,40-49,777,9,213,290,503,503,213,290,6,2.1255440241,56923.6292553606,0.2522831714,0.0430405614,0.18363515,0,66,6.580622574702384E-4,0.0012821895,0.0012988432,47,195,0,214,0,0
324400171,46erGlenn,10,513,25,87,0,0,20.3052778945,20-29,454,4,1,3,4,4,1,3,7,2.9253431537,1.4213721162,0.0040154336,0,0,0,66,4.9228986117376785E-5,1.198308E-5,1.2138721E-5,390,1,0,200,0,0
324489515,DanCas2,10,95282,1199,1992,26,420,45.9351011315,40-49,761,10,7,3,10,10,7,3,8,3.6287244727,50.2144582225,0.0011003209,0.1111111111,0.22222222,0,66,1.4364123766382863E-4,4.793232E-5,4.8554884E-5,47,0,0,201,0,0
324666915,YourDream_Charm,10,1305,124,102,0,2,39.1620078003,30-39,595,5,1,1,2,2,1,1,1,1,0,7.49471721243357E-5,0,0,200,381,2.9852402567743944E-4,1.198308E-5,1.2138721E-5,194,20,0,201,0,0
324871858,arc185,10,2217,432,2001,5,24,40.3996923869,40-49,621,6,29,103,132,132,29,103,7,2.4951456311,743.5136952342,0.0314467906,0.1722761971,0.3834372,0,66,1.4373041912056538E-4,1.797462E-4,1.8208082E-4,390,2,2,200,2,0.01
325022623,PrairieStorm2,10,16237,1143,1442,25,254,42.4993358977,40-49,765,8,82,95,177,177,82,95,6,2.4198192166,6935.2946266817,0.0511835046,0.0517141757,0.2765249,0,66,4.0460156721052636E-4,4.972978E-4,5.037569E-4,372,117,0,203,0,0
325147095,op_enough,10,1275,147,0,5,0,22.9220728209,20-29,642,5,0,0,0,0,0,0,0,0,0,0,0,0,248,476,4.4780486537007367E-5,0,0,244,0,0,200,0,0
325184070,Lady_KK_,10,465,251,235,14,98,35.9918392536,30-39,501,4,0,0,0,0,0,0,0,0,0,0,0,0,363,661,4.4780486537007367E-5,0,0,373,7,0,199,0,0
325315594,Beaches_E_York,10,813,848,2001,26,514,31.8320682343,30-39,530,5,14,47,61,61,14,47,6,2.5038500167,448.8335164006,0.0204667154,0.1669398907,0.37670067,0,66,9.685038142688804E-5,8.98731E-5,9.104041E-5,140,1,0,200,0,0
325333226,Jennyfromdabl,10,3646,247,232,0,369,33.7818557424,30-39,683,6,0,0,0,0,0,0,0,0,0,0,0,0,206,394,4.4780486537007367E-5,0,0,202,0,0,200,0,0
325555085,IsabelleMorinMP,10,1168,1063,1294,73,3,45.5654691307,40-49,633,5,147,149,296,296,147,149,7,2.3709407432,6417.7576622263,0.2081670362,0.1024851122,0.34214115,0,66,7.640336259307901E-4,8.867479E-4,8.92196E-4,390,28,1,200,1,0.005
325994896,Freedomzone_,10,4723,1737,1698,39,8,48.8689194384,40-49,728,7,42,71,113,113,42,71,6,2.5597589555,1843.862269877,0.0305942284,0.0721396966,0.23659673,0,66,1.9403593160955969E-4,2.5763622E-4,2.6098252E-4,372,53,0,200,0,0
326235711,quito_maggi,10,1751,594,589,17,40,62.7837172238,60-69,682,6,96,115,211,211,96,115,6,2.4034147975,3248.2861742967,0.1069878278,0.0890543895,0.28449848,0,66,4.2976897856328316E-4,5.811794E-4,5.88728E-4,140,149,0,201,0,0
326941453,HollyCassano,10,2587,708,1959,8,174,49.3157692685,40-49,624,6,3,3,6,6,3,3,2,1.25,0.5,2.3413472340332503E-4,0.1,0.8333333,169,323,3.413644345773779E-4,2.396616E-5,2.4277442E-5,342,39,0,200,0,0
327394273,skirri,10,761,27,87,0,6,23.886565494,20-29,490,5,3,14,17,17,3,14,7,2.6946769334,3.8231028645,0.0066994977,0.2573529412,0.5095238,0,66,5.3977718244164354E-5,2.396616E-5,2.4277442E-5,390,2,2,200,2,0.01
327533387,MrJoshArless,10,6454,259,717,3,326,47.9702039603,40-49,651,6,32,75,107,107,32,75,7,2.5597589555,963.8748460775,0.041810764,0.1137365544,0.3026973,0,66,1.594011096916107E-4,1.9772082E-4,2.0028891E-4,140,29,20,204,17,0.0980392157
327740140,la_cornish,10,3192,430,526,12,35,40.6823333022,40-49,661,6,36,32,68,68,36,32,6,2.5289588216,721.1444616766,0.051918574,0.1163301141,0.28921568,0,66,2.0524154466063769E-4,2.2168698E-4,2.2456635E-4,55,7,0,200,0,0
327747513,John_Acton,10,996,59,133,0,0,27.1905627017,20-29,366,5,10,25,35,35,10,25,7,2.5671242049,238.0646668504,0.0096427082,0.0966386555,0.25833333,0,66,7.048133352535397E-5,6.590694E-5,6.6762965E-5,390,1,1,199,1,0.0050251256
327807599,Carlos_Caimann,10,9302,675,1457,7,26,36.1620595467,30-39,744,7,0,5,5,5,0,5,9,4.6042154567,0,0,0.15,0.2,0,358,4.4780486537007367E-5,0,6.0693606E-6,320,3,0,200,0,0
328029510,alisonnn_taylor,10,4703,247,235,1,227,42.5238409194,40-49,695,6,5,5,10,10,5,5,1,1,1.75,3.999777216712776E-4,0.1,0.8,209,402,3.648004638058968E-4,3.594924E-5,3.6416164E-5,341,37,0,201,0,0
328112301,robert_kiley,10,2808,693,1157,26,65,48.514550343,40-49,681,6,29,71,100,100,29,71,6,2.3870103783,1765.6638041982,0.0422357423,0.1174747475,0.25790423,0,66,2.0650961261931786E-4,1.797462E-4,1.8208082E-4,140,23,0,200,0,0
330539177,PRBdata,10,1770,1085,345,61,3,54.4239191626,50-59,692,5,1,0,1,1,1,0,0,0,0,8.665799904493752E-5,0,0,0,25,6.16366293081432E-5,1.198308E-5,0,47,1,0,200,0,0
331241281,IBEW_M_Wayland,10,1434,300,579,8,8,43.5955639521,40-49,615,6,24,83,107,107,24,83,6,2.4214931369,1504.5858255182,0.0282490645,0.1286369247,0.28276333,0,66,1.350591365069321E-4,1.497885E-4,1.5173401E-4,390,18,3,198,3,0.0151515152
331272785,WhseMark,10,2447,224,366,7,7,46.6808075544,40-49,616,6,12,20,32,32,12,20,7,2.6990291262,211.6235101681,0.0170989745,0.0766129032,0.23376623,0,66,9.312543642353352E-5,7.789002E-5,7.8901685E-5,47,24,1,202,1,0.004950495
331376866,manny_ottawa,10,8808,538,298,9,45,54.517388754,50-59,757,7,63,42,105,105,63,42,6,2.578172079,1314.8155723958,0.0569843434,0.1148351648,0.2707016,0,66,4.2026092850054966E-4,3.8345857E-4,3.8236973E-4,372,179,2,202,2,0.0099009901
331655040,BrianONDP,10,403,342,466,20,0,41.1424182777,40-49,572,4,51,59,110,110,51,59,7,2.5878808169,655.8297031155,0.0555473585,0.151793161,0.32458204,0,66,1.7035943417312687E-4,3.1156008E-4,3.1560674E-4,390,4,1,200,1,0.005
331666614,AndreaMicieli,10,2079,433,686,8,63,48.036823562,40-49,669,6,87,131,218,218,87,131,6,2.4007365249,2057.334971331,0.0905182877,0.1068363421,0.32496643,0,66,3.6749326836829405E-4,5.272555E-4,5.341037E-4,140,136,1,200,1,0.005
331776617,SamSolar1,10,3059,3005,2964,4,0,43.97357971,40-49,654,5,5,5,10,10,5,5,7,2.703046535,5.019993985,0.0145485669,0.0555555556,0.45,0,66,5.887812281799419E-5,3.594924E-5,3.6416164E-5,47,18,0,200,0,0
331840766,adoresubtract,10,173,53,120,1,79,18.128616344,10-19,409,3,1,1,2,2,1,1,7,3.1797790425,0,0.0022879315,0,0,0,66,4.876272194723636E-5,1.198308E-5,1.2138721E-5,47,0,0,181,0,0
331998971,LukeAFBradley,10,3988,447,380,8,497,47.0823710052,40-49,719,6,51,62,113,113,51,62,6,2.5219283562,2757.4067525304,0.0515760649,0.0997945638,0.28117087,0,66,2.2030253196747665E-4,3.1156008E-4,3.095374E-4,140,50,0,200,0,0
332284449,NoWarNow2011,10,45478,3099,3278,68,993,47.2834192081,40-49,788,9,24,31,55,55,24,31,7,2.7485771677,1976.3407140177,0.0150279415,0.0252525253,0.11942959,0,66,1.379542494127921E-4,1.497885E-4,1.5173401E-4,47,23,0,201,0,0
332455169,DJOzroc,10,2568,138,111,3,69,42.2947888167,40-49,645,6,4,4,8,8,4,4,2,1.5,0,3.395898455675363E-4,0.1071428571,1,214,407,2.2320849686773938E-4,2.99577E-5,3.0346804E-5,266,32,0,200,0,0
332884767,Quig40,10,8792,510,921,16,66,35.8318456672,30-39,713,7,36,63,99,99,36,63,6,2.510210914,4710.29334894,0.0306543801,0.086477015,0.2890095,0,66,1.7603147993049747E-4,2.2168698E-4,2.2456635E-4,372,16,0,200,0,0
333016219,nsynd,10,271,240,163,8,2,37.504995475,30-39,548,4,29,28,57,57,29,28,7,2.6618680951,227.4220713601,0.0384401393,0.1779448622,0.38405797,0,66,1.4821509336897798E-4,1.797462E-4,1.8208082E-4,390,14,0,200,0,0
334475094,3bas1,10,2117,264,644,4,26,34.9901428683,30-39,627,6,28,60,88,88,28,60,7,2.5142283227,174.5447766211,0.0455815023,0.1298328109,0.34848484,0,66,1.0631357730985617E-4,1.7375466E-4,1.7601145E-4,47,4,0,196,0,0
334800870,thefirstrobg,10,46,13,140,0,0,18.3140902219,10-19,63,2,1,7,8,8,1,7,7,2.8791429528,0.8168271937,5.63615513737243E-4,0.2678571429,0.61904764,0,66,4.842532685708261E-5,1.198308E-5,1.2138721E-5,140,0,0,48,0,0
334911180,stevenclark9,10,2155,170,177,0,31,34.8093188928,30-39,654,5,4,6,10,10,4,6,2,1.1428571429,4.35,3.155323559578027E-4,0.1111111111,0.56666666,0,53,1.73808727221371E-4,2.99577E-5,3.0346804E-5,352,13,0,198,0,0
334976289,Dolfan_13,10,1203,90,218,0,15,36.4011068601,30-39,518,5,4,5,9,9,4,5,7,3.2885838634,60.5531735402,0.003868726,0.0555555556,0.23333333,0,66,7.245691144015738E-5,2.99577E-5,3.0346804E-5,372,5,0,200,0,0
334996907,atwLIVE,10,914,71,147,0,6,26.3404460603,20-29,545,4,0,0,0,0,0,0,0,0,0,0,0,0,104,214,4.4780486537007367E-5,0,0,99,3,0,200,0,0
335426737,Juicexlx,10,40017,1316,1308,49,3854,45.9355066777,40-49,785,9,171,157,328,328,171,157,6,2.2979578172,23200.0655515974,0.2100134161,0.0460766764,0.26667938,0,66,5.575190848622673E-4,0.0010305449,0.0010378606,47,237,1,231,1,0.0043290043
335439371,KeepItReaL57,10,632,44,174,0,11,13.684257086,10-19,532,5,3,15,18,18,3,15,7,2.6113157014,10.3219971963,0.003715341,0.2189542484,0.3345588,0,66,4.8380909205958136E-5,2.396616E-5,2.4277442E-5,47,0,0,200,0,0
336185834,JeffBuchananNDP,10,298,246,179,22,5,45.6104831247,40-49,581,4,31,25,56,56,31,25,7,2.8526950117,1467.1053544969,0.0227538761,0.1386363636,0.3263647,0,66,1.5589571559009992E-4,1.9172928E-4,1.9421954E-4,390,12,0,200,0,0
336221845,VanEastMan,10,93,11,43,0,0,14.6018026945,10-19,111,3,1,2,3,3,1,2,7,3.286575159,0,1.1587037933092188E-4,0.1666666667,1,0,66,5.0037485202879985E-5,1.198308E-5,1.2138721E-5,47,0,0,105,0,0
336398479,Robot_Anonymous,10,29956,567,0,18,6,35.3962059071,30-39,640,9,5,0,5,5,5,0,0,0,0,0.0025381896,0.2,0.35,0,46,9.308105197072567E-5,3.594924E-5,0,47,0,0,205,0,0
336541205,CAN_politNews,10,818,2080,2288,26,0,43.9931564522,40-49,598,5,107,113,220,220,107,113,7,2.4298627385,25682.1661757309,0.0712589683,0.0106060606,0.06506042,0,66,3.378145537199454E-4,6.470863E-4,6.5549096E-4,47,4,0,200,0,0
336821732,CharleneDesroch,10,12657,270,107,8,17,48.9614413934,40-49,749,8,42,21,63,63,42,21,7,2.8861734181,299.2182248902,0.0341558999,0.1216077829,0.2909804,0,66,2.1408919577667681E-4,2.5763622E-4,2.6098252E-4,47,129,0,201,0,0
337174475,CAS_OFL,10,2582,347,910,6,11,49.869811634,40-49,608,6,43,99,142,142,43,99,6,2.312688316,5260.6279335565,0.0487246494,0.09919089,0.27431566,0,66,1.9938102947096052E-4,2.6362776E-4,2.6705186E-4,390,53,1,202,1,0.004950495
338465827,USRadioNews,10,275103,476,54,6,1,45.1529103005,40-49,782,10,0,0,0,0,0,0,0,0,0,0,0,0,65,158,4.4780486537007367E-5,0,0,57,1,0,205,0,0
339060501,BenjaminoKinsey,10,19614,837,1998,15,1296,36.3441441084,30-39,755,8,98,180,278,278,98,180,6,2.2112487446,3733.215342864,0.1688208729,0.1094200452,0.30355647,0,66,3.945225855364145E-4,5.9316243E-4,6.008667E-4,140,24,0,200,0,0
339722887,SnowHydro,10,6089,784,995,46,414,57.6278483931,50-59,727,7,26,26,52,52,26,26,7,2.9598259123,1036.7915759849,0.0113745514,0.0592006033,0.1876877,0,66,2.3946143136829807E-4,1.6177158E-4,1.6387274E-4,55,170,0,208,0,0
340188238,onanongruengjan,10,69,12,54,0,2,12.4824719478,10-19,262,2,0,0,0,0,0,0,0,0,0,0,0,0,164,318,4.4780486537007367E-5,0,0,161,3,0,72,0,0
340965023,liberalanon,10,2519,347,644,15,2,41.9799563868,40-49,698,6,31,68,99,99,31,68,7,2.4941412789,3369.0113306877,0.05850015,0.1332714904,0.358756,0,66,1.9831158974054728E-4,1.9172928E-4,1.9421954E-4,140,1,1,198,1,0.0050505051
341105081,JDanAiken,10,2983,297,703,8,2,44.4636232987,40-49,639,6,11,29,40,40,11,29,6,2.7284901239,98.5338427465,0.0120853355,0.1788461538,0.40625,0,66,1.0036138550936903E-4,7.189848E-5,7.283233E-5,372,21,3,200,3,0.015
341310432,_RollingSt0ne,10,1742,165,250,0,56,22.2485589148,20-29,570,5,0,0,0,0,0,0,0,0,0,0,0,0,92,199,4.4780486537007367E-5,0,0,87,0,0,200,0,0
341813644,clintupham,10,12323,606,379,18,1052,41.4049834748,40-49,767,8,53,60,113,113,53,60,6,2.7023769669,714.3590892855,0.0290179457,0.0884955752,0.39296067,0,66,2.182787498619767E-4,3.2354315E-4,3.2774548E-4,372,177,1,202,1,0.004950495
342136282,SLEnergy,10,1899,335,1334,7,6,42.116328405,40-49,500,5,0,3,3,3,0,3,8,3.9190093708,0,0,0.1666666667,0.16666667,0,306,4.4780486537007367E-5,0,6.0693606E-6,372,0,0,200,0,0
342281222,cjlanarchist,10,1951,181,626,2,105,34.0993134283,30-39,560,6,20,57,77,77,20,57,7,2.4107800469,526.2202229007,0.0268499946,0.1387559809,0.3193989,0,66,1.0936132547503193E-4,1.2582233E-4,1.2745657E-4,390,2,0,200,0,0
342772599,BrilliantDeeCee,10,5406,553,825,1,143,46.0854419558,40-49,656,6,0,0,0,0,0,0,0,0,0,0,0,0,111,225,4.4780486537007367E-5,0,0,107,9,0,202,0,0
342867480,t_stewart9,10,627,207,112,1,105,41.1580134668,40-49,531,4,7,7,14,14,7,7,8,4.6588550385,6086.9166666667,6.118679944748264E-4,0.1043956044,0.625,0,66,3.89078650851176E-4,4.793232E-5,4.8554884E-5,31,37,0,200,0,0
344009584,a_mcgrath1,10,203,327,1212,10,0,34.0015857949,30-39,518,4,36,133,169,169,36,133,6,2.3990626046,1546.5953774052,0.0643649895,0.1463440406,0.32610562,0,66,3.090508425438052E-4,2.2168698E-4,2.2456635E-4,372,3,6,200,5,0.03
344029955,TL_Raww,10,4470,140,120,0,1913,41.3315275389,40-49,696,6,0,0,0,0,0,0,0,0,0,0,0,0,374,683,4.4780486537007367E-5,0,0,384,13,0,200,0,0
344564284,YayanneGzuup,10,2069,120,134,1,210,42.805493172,40-49,634,5,0,0,0,0,0,0,0,0,0,0,0,0,393,712,4.4780486537007367E-5,0,0,404,5,0,198,0,0
344690602,ingrx,10,29043,354,2000,7,531,46.0125095376,40-49,699,9,5,4,9,9,5,4,7,3.3555406763,3121.6575603954,0.0013210483,0.0138888889,0.06666667,0,66,7.932301478690788E-5,3.594924E-5,3.6416164E-5,47,10,0,201,0,0
344827349,WrightIdea_,10,4438,1023,1214,18,85,,,739,7,55,74,129,129,55,74,6,2.6608637429,1067.3940482813,0.034586055,0.0838783915,0.35361895,0,66,3.0939806210159633E-4,3.3552625E-4,3.398842E-4,372,35,0,197,0,0
345765280,Jerskuh,10,1586,115,249,2,92,35.724673372,30-39,602,5,0,0,0,0,0,0,0,0,0,0,0,0,376,687,4.4780486537007367E-5,0,0,386,2,0,200,0,0
345794855,LeslieJolliffe,10,159,19,44,0,0,27.6253433078,20-29,346,4,0,1,1,1,0,1,8,3.7874832664,0,0,0,0,0,658,4.4780486537007367E-5,0,6.0693606E-6,390,0,0,188,0,0
346705023,natif8,10,58922,625,976,49,2464,41.4076170414,40-49,736,9,37,33,70,70,37,33,7,2.6853029796,478.3037759323,0.0552234007,0.1035196687,0.28013468,0,66,1.389398960505468E-4,2.2767852E-4,2.306357E-4,47,29,0,202,0,0
346949719,Craig_McDowell,10,591,243,449,7,0,38.0671280174,30-39,561,4,68,94,162,162,68,94,6,2.4626715768,632.0603947522,0.1079903346,0.1685070163,0.45776954,0,66,3.773212167539059E-4,4.1341624E-4,4.1878587E-4,390,6,2,200,2,0.01
347203262,PauLambispinhas,10,2576,276,245,3,330,43.6581015927,40-49,656,5,3,4,7,7,3,4,2,1.4285714286,2.5,2.4037007762278773E-4,0.0952380952,0.5833333,52,142,2.779014133126098E-4,2.396616E-5,2.4277442E-5,316,20,0,200,0,0
347213984,flu9,10,1203,560,706,4,301,43.838933323,40-49,566,5,11,15,26,26,11,15,6,2.7201205223,1155.2597258498,0.0105470511,0.0446153846,0.21428572,0,66,9.352768750149017E-5,7.189848E-5,7.283233E-5,372,16,10,230,10,0.0434782609
347227889,D_Shepherd54,10,1477,244,242,0,21,37.3519227893,30-39,620,5,3,4,7,7,3,4,3,2,0.1666666667,2.555523055261908E-4,0.1428571429,0.9166667,26,99,1.7491981564444727E-4,2.396616E-5,2.4277442E-5,49,8,0,200,0,0
347321914,oscarcamilo3,10,98,22,114,0,0,18.2720158964,10-19,395,3,1,1,2,2,1,1,1,1,0,7.49471721243357E-5,0,0,33,111,2.9852402567743944E-4,1.198308E-5,1.2138721E-5,44,0,0,111,0,0
347414353,nmoore_33,10,796,102,507,0,14,19.3619818462,10-19,571,5,6,0,6,6,6,0,0,0,0,0.0076307775,0.3666666667,0.46666667,0,39,7.060886463409848E-5,4.194078E-5,0,372,0,2,201,2,0.0099502488
347878358,j_kneen,10,1730,227,60,12,11,42.0365237021,40-49,662,6,33,11,44,44,33,11,7,2.8634081018,310.2624064473,0.0557479678,0.1453488372,0.31904763,0,66,2.0445267297312234E-4,2.0371236E-4,2.0635827E-4,47,10,1,200,1,0.005
348090355,EthanCoxMtl,10,15719,2986,1898,101,47,63.1529799171,60-69,791,8,328,262,590,590,328,262,6,2.1868095079,43004.2570848293,0.3313597289,0.0550948174,0.14108513,0,66,0.001259023,0.0019712166,0.0019907502,390,199,0,204,0,0
348195475,stormchaserjs,10,31420,142,57,5,53,36.7841298647,30-39,643,7,0,1,1,1,0,1,1,1,0,0,0,0,37,120,4.4780486537007367E-5,0,6.0693606E-6,34,2,0,201,0,0
348226471,Nick_Sully24,10,3296,351,247,1,1461,44.5416283327,40-49,694,6,2,2,4,4,2,2,3,1.9230769231,0,1.7228063368901142E-4,0.0833333333,1,26,99,1.1973323811828786E-4,1.797462E-5,1.8208082E-5,49,7,0,200,0,0
348863339,H_Jutz,10,1549,255,185,0,111,37.5085043437,30-39,658,5,6,6,12,12,6,6,3,1.6923076923,3.953968254,5.079142821879304E-4,0.1060606061,0.64285713,26,99,3.156049060756155E-4,4.194078E-5,4.2485524E-5,49,16,0,197,0,0
349946938,angryaesthete,10,6895,384,1573,8,1256,43.8149933161,40-49,698,7,39,123,162,162,39,123,6,2.3779712086,2045.5629306333,0.0481121483,0.1036730312,0.24206446,0,66,1.793790891949676E-4,2.396616E-4,2.4277443E-4,390,3,0,200,0,0
350305569,AScar27,10,496,210,96,0,204,31.0552469777,30-39,586,5,8,6,14,14,8,6,3,1.6153846154,3.3333333333,6.769291526699885E-4,0.1153846154,0.71428573,26,99,3.8511649765785315E-4,5.392386E-5,5.4624245E-5,49,17,0,180,0,0
350499770,zpaikin,10,4808,1663,279,44,116,53.6648964693,50-59,737,6,193,42,235,235,193,42,7,2.6802812186,2654.054792792,0.2116460123,0.1091289325,0.19689794,0,66,8.760969852189505E-4,0.0011623588,0.001177456,140,86,0,200,0,0
350961252,hannycarson,10,8640,420,304,0,2011,45.6266316211,40-49,732,6,8,9,17,17,8,9,2,1.3076923077,16.9841269841,6.75308901246024E-4,0.0882352941,0.5972222,26,99,4.574228057190301E-4,5.392386E-5,5.4624245E-5,49,40,0,200,0,0
351012642,kls_73,10,10226,263,309,23,6,54.261132758,50-59,707,8,1,6,7,7,1,6,7,3.0308001339,4.1472555957,5.467247043343917E-4,0.0476190476,0.06666667,0,66,4.6606580470265185E-5,1.198308E-5,1.2138721E-5,47,6,0,202,0,0
351211110,PamFAQMP,10,1590,712,829,13,9,38.760891326,30-39,688,6,113,133,246,246,113,133,6,2.2336792769,5849.0876650213,0.1621625586,0.043454455,0.25653687,0,66,3.880789752553391E-4,6.830355E-4,6.9190713E-4,47,25,1,199,1,0.0050251256
351220065,PatrickFAQMP,10,540,433,725,8,0,36.2506299671,30-39,609,4,80,133,213,213,80,133,6,2.2510880482,5091.1674855827,0.117833719,0.0596819913,0.22685444,0,66,3.4350980580171635E-4,4.8531473E-4,4.9161824E-4,372,15,1,200,1,0.005
351237761,JoshPringleSSM,10,503,152,449,5,3,31.3191926424,30-39,489,4,7,38,45,45,7,38,6,2.6685637764,15.9334526405,0.0097974629,0.245959596,0.42682928,0,66,7.380895520300858E-5,4.793232E-5,4.8554884E-5,372,0,0,200,0,0
351847129,Julien_Leger,10,19,16,89,1,0,20.6493771953,20-29,65,1,0,11,11,11,0,11,7,2.796519411,0,0,0.4,0.6090909,0,465,4.4780486537007367E-5,0,6.0693606E-6,140,1,1,22,1,0.0454545455
352090345,iwolftail,10,34728,366,686,8,451,44.2829710261,40-49,726,8,7,14,21,21,7,14,7,2.6963508537,107.8151642824,0.0073580561,0.119047619,0.3901099,0,66,6.968992715631303E-5,4.793232E-5,4.8554884E-5,140,25,0,201,0,0
352091107,AtheistOutlet,10,86,25,104,0,3,17.6719571673,10-19,428,4,1,7,8,8,1,7,7,2.8657515902,0.213251954,0.0029131139,0.2321428571,0.52380955,0,66,4.839308717829337E-5,1.198308E-5,1.2138721E-5,47,0,0,92,0,0
352556797,ghost_station,10,3903,327,566,2,945,33.3005923404,30-39,588,6,6,11,17,17,6,11,7,2.7659859391,70.2643696509,0.0104561451,0.0992647059,0.3181818,0,66,6.492986587826148E-5,4.194078E-5,4.2485524E-5,47,0,0,200,0,0
353460946,Toronto_John63,10,9452,552,1278,14,31,52.3060957982,50-59,703,8,2,7,9,9,2,7,7,3.0274522933,2.4325793244,0.0013543377,0.0694444444,0.1904762,0,66,4.860271978742561E-5,1.797462E-5,1.8208082E-5,372,24,1,201,1,0.0049751244
353631941,Rob_de_Verteuil,10,261,93,217,6,0,40.0923042932,40-49,468,3,3,3,6,6,3,3,7,3.1724137931,16.0205103888,6.245691035528561E-4,0.1666666667,0.23333333,0,66,5.208482840238935E-5,2.396616E-5,2.4277442E-5,372,6,1,200,1,0.005
353995991,skapindo,10,8395,119,235,0,1,41.0454010833,40-49,625,7,1,1,2,2,1,1,7,3.1680616003,0,0.0019850712,0,0,0,66,4.7706985717987906E-5,1.198308E-5,1.2138721E-5,47,0,0,201,0,0
354330741,discombed,10,17938,1529,1878,41,5,42.521440997,40-49,682,8,12,10,22,22,12,10,7,3.2119183127,121.6409629801,0.0028153764,0.0822510823,0.3791209,0,66,1.4166743114579205E-4,7.789002E-5,7.8901685E-5,47,1,0,201,0,0
354570485,R_Cardinal,10,3475,445,898,6,38,43.0494584554,40-49,695,6,41,81,122,122,41,81,6,2.3927017074,2820.6664262794,0.0392398708,0.0801381927,0.21603677,0,66,1.9659414900694274E-4,2.5164467E-4,2.5491315E-4,47,13,1,200,1,0.005
354691591,DouglasMusk,10,120,10,116,0,0,20.3725785081,20-29,308,3,0,8,8,8,0,8,7,2.9434404284,0,0,0.3392857143,0.58928573,0,435,4.4780486537007367E-5,0,6.0693606E-6,372,4,0,136,0,0
354709978,KevinPatrickNL,10,44,4,25,0,0,12.8753588292,10-19,125,2,0,0,0,0,0,0,0,0,0,0,0,0,217,410,4.4780486537007367E-5,0,0,211,2,1,48,1,0.0208333333
354740222,jeffcliff1,10,7979,242,489,9,1585,43.3242763107,40-49,671,7,10,13,23,23,10,13,7,2.7224640107,51.6683537489,0.0202330249,0.0948616601,0.3857143,0,66,8.368385776122729E-5,6.590694E-5,6.6762965E-5,390,6,1,200,1,0.005
354743403,M_Almaleki,10,2883,85,155,1,1229,39.2892602452,30-39,655,5,1,7,8,8,1,7,7,2.9748911952,2.6688845224,6.442423900301305E-4,0.2142857143,0.4047619,0,66,4.640878291292658E-5,1.198308E-5,1.2138721E-5,140,4,1,199,1,0.0050251256
354963231,Batlacious,10,162,17,125,0,4,34.149910783,30-39,545,3,0,0,0,0,0,0,0,0,0,0,0,0,276,522,4.4780486537007367E-5,0,0,273,8,0,174,0,0
354973054,alinsenharbc,10,2021,120,161,3,8,28.6411832622,20-29,545,6,9,14,23,23,9,14,7,2.8091730834,56.7019685694,0.0143893384,0.0671936759,0.2375,0,66,7.109895296226161E-5,5.99154E-5,6.069361E-5,55,0,2,199,2,0.0100502513
355105989,MommaYomma,10,33267,1647,1496,47,1373,56.0874511306,50-59,802,9,54,60,114,114,54,60,6,2.4466019417,3789.5721367906,0.045712385,0.0438596491,0.23487103,0,66,2.259949113778029E-4,3.295347E-4,3.3381482E-4,372,158,0,201,0,0
355577666,CanadianCrone,10,8855,887,1999,17,93,,,724,8,236,294,530,530,236,294,6,2.1379310345,18927.1983672118,0.2887481448,0.0686164711,0.2034823,0,66,6.352951370789446E-4,0.001419995,0.0014384384,47,36,2,199,2,0.0100502513
356262824,GregT_theMetis,10,1879,255,386,8,14,47.7086980623,40-49,647,6,35,27,62,62,35,27,7,2.6695681286,1682.3426302343,0.0347457128,0.0589635114,0.18498942,0,66,1.946591777403198E-4,2.1569544E-4,2.1849698E-4,47,63,2,200,2,0.01
356303383,Maryann_Chichak,10,1245,402,527,12,12,41.2902353504,40-49,604,5,32,49,81,81,32,49,6,2.5182457315,573.9659134405,0.0296031841,0.112654321,0.4767347,0,66,2.2520926606959767E-4,1.9772082E-4,2.0028891E-4,372,8,1,200,1,0.005
356378265,tbenskin,10,1161,916,260,64,0,45.5691824861,40-49,647,5,145,72,217,217,145,72,6,2.5165718112,1346.9607948397,0.2231311483,0.1477854583,0.36563194,0,66,8.619879573589388E-4,8.747648E-4,8.800573E-4,390,40,5,200,5,0.025
356647010,Desilien13,10,2175,151,95,2,63,43.1294762696,40-49,664,5,5,5,10,10,5,5,2,1.2857142857,6212.9,3.9526483130257483E-4,0.0777777778,0.6,0,53,2.1372900131690463E-4,3.594924E-5,3.6416164E-5,352,24,0,198,0,0
356883125,MaryanDiazC,10,18155,383,239,0,365,35.7878437442,30-39,736,7,0,0,0,0,0,0,0,0,0,0,0,0,126,243,4.4780486537007367E-5,0,0,123,11,0,200,0,0
357877628,iankokomo_01,10,2960,246,1703,2,66,41.7610924068,40-49,629,6,9,41,50,50,9,41,6,2.578172079,304.0242438874,0.0117524131,0.1775510204,0.35191637,0,66,1.1249344809427318E-4,5.99154E-5,6.069361E-5,372,1,0,200,0,0
358193491,ZazenMedia,10,896,215,211,4,0,30.3509753048,30-39,542,5,0,0,0,0,0,0,0,0,0,0,0,0,359,652,4.4780486537007367E-5,0,0,368,1,1,200,1,0.005
358291440,kingcambie,10,6899,64,103,1,2,48.6244836633,40-49,708,7,9,9,18,18,9,9,7,2.9912956143,4.3389216954,0.0211408962,0.2712418301,0.4875,0,66,9.23685998348348E-5,5.99154E-5,6.069361E-5,372,13,0,202,0,0
358506497,jot_au,10,118719,1851,2018,53,28911,55.0179665781,50-59,900,10,0,1,1,1,0,1,8,3.9581659973,0,0,0,0,0,523,4.4780486537007367E-5,0,6.0693606E-6,47,1,0,201,0,0
359011405,SimonDee_,10,942,298,435,1,6,40.9330210783,40-49,609,5,34,58,92,92,34,58,6,2.3783059926,1120.3220025188,0.0426587486,0.081581462,0.24270353,0,66,1.390205080850868E-4,2.097039E-4,2.1242762E-4,390,10,1,200,1,0.005
359788259,mangoparent,10,6741,891,1759,21,6,37.1456580178,30-39,709,7,53,159,212,212,53,159,6,2.2326749247,9589.592837033,0.0673443974,0.0879907002,0.22476415,0,66,2.047258268168257E-4,3.2354315E-4,3.2774548E-4,140,12,1,199,1,0.0050251256
359980797,CaregiversTakeA,10,626,130,158,2,1,37.2456996416,30-39,559,5,11,23,34,34,11,23,7,2.6946769334,12.3860904767,0.0196866859,0.2139037433,0.4722222,0,66,8.565174439088686E-5,7.189848E-5,7.283233E-5,140,12,1,199,1,0.0050251256
360129829,rkn429,10,21822,559,548,26,2242,47.2733396845,40-49,740,8,74,80,154,154,74,80,6,2.4101104787,12861.0626527014,0.0830451871,0.0569561158,0.2961775,0,66,2.5639377211121345E-4,4.493655E-4,4.5520204E-4,47,125,0,212,0,0
360341311,miguelgaraym,10,19137,1275,1995,5,8,56.2154174978,50-59,779,7,4,6,10,10,4,6,10,5.5999330432,2990.6666666667,3.099158266536495E-4,0.0666666667,0.23809524,0,66,1.378708966480061E-4,2.99577E-5,3.0346804E-5,320,43,0,208,0,0
360384010,LJBriar,10,273,9,83,0,3,20.4161753084,20-29,452,4,1,2,3,3,1,2,8,3.5821894878,1.3223361125,1.247437943842506E-4,0,0,0,66,5.9437713684008654E-5,1.198308E-5,1.2138721E-5,55,1,0,200,0,0
360605593,PrettyPatty89,10,4475,87,241,0,13,19.2105234616,10-19,627,6,0,0,0,0,0,0,0,0,0,0,0,0,340,613,4.4780486537007367E-5,0,0,348,8,0,199,0,0
360639045,2sej_hre,10,1303,18,167,0,321,14.708184835,10-19,499,6,1,10,11,11,1,10,7,2.8818212253,0.0738252758,0.0021587021,0.3909090909,0.5,0,66,4.6442216882367446E-5,1.198308E-5,1.2138721E-5,140,0,0,199,0,0
360975668,Metchitoweweyin,10,3311,489,684,12,152,52.1012366931,50-59,716,6,65,76,141,141,65,76,7,2.5309675259,4967.1019604158,0.0494879382,0.0731509625,0.26092798,0,66,2.3573844629391565E-4,3.9544163E-4,4.0057782E-4,47,47,2,200,2,0.01
360988971,hailthegreatpan,10,694,43,84,1,0,40.3845984512,40-49,739,7,1,2,3,3,1,2,8,3.6645463676,0.0591032609,8.015109175607049E-4,0.3333333333,0.5,0,66,4.5659487327114946E-5,1.198308E-5,1.2138721E-5,47,0,0,200,0,0
361058702,j_domin,10,2427,7255,7678,70,2,46.2009722502,40-49,734,6,374,405,779,779,374,405,6,2.0495480415,80596.2455624178,0.3849775121,0.0240321947,0.13334991,0,66,0.0010876177,0.0022468276,0.0022760103,47,18,1,200,1,0.005
361313270,TransCanada,10,2688,2901,436,83,1,59.9660526271,50-59,783,6,32,15,47,47,32,15,7,2.9243388015,3041.53339372,0.0211990629,0.1086956522,0.20383275,0,66,2.4441649964968703E-4,1.9772082E-4,1.9421954E-4,372,51,0,201,0,0
361405809,davidinkansas,10,58,38,20,0,1,24.5481429862,20-29,343,2,2,2,4,4,2,2,1,1,0,1.529712617250445E-4,0.0833333333,1,218,414,2.985240256774393E-4,1.797462E-5,1.8208082E-5,213,11,0,64,0,0
361428694,leticiaacutrim,10,1190,159,164,0,92,43.4398232228,40-49,626,5,1,1,2,2,1,1,1,1,0,7.49471721243357E-5,0,0,166,320,2.9852402567743944E-4,1.198308E-5,1.2138721E-5,175,27,0,201,0,0
361448967,tulipgrrrl,10,1525,100,167,0,1033,32.2687640275,30-39,598,5,0,2,2,2,0,2,7,3.7245649264,0,0,0,0,0,391,4.4780486537007367E-5,0,6.0693606E-6,372,4,0,199,0,0
361496918,DPFINGST_17,10,10622,503,652,1,655,41.4137914813,40-49,736,7,2,3,5,5,2,3,2,1.25,0,1.560488797880424E-4,0.15,0.8333333,80,179,2.487219413690962E-4,1.797462E-5,1.8208082E-5,74,7,0,201,0,0
362100154,Nutzo56,10,12360,1109,597,28,1784,58.7173441181,50-59,772,8,54,39,93,93,54,39,6,2.6089722129,6592.9914471221,0.0564890762,0.0522440393,0.28092244,0,66,2.2626529541291138E-4,3.295347E-4,3.3381482E-4,47,64,0,201,0,0
362102805,E_YELLOWFLY,10,885,725,1544,10,0,35.7371297941,30-39,548,5,5,12,17,17,5,12,7,3.0200870439,102.5204818773,0.0040275229,0.0845588235,0.2651515,0,66,6.958463330211504E-5,3.594924E-5,3.6416164E-5,47,0,0,200,0,0
362170813,CrossPointsKC,10,210,39,28,0,0,23.567566506,20-29,400,2,2,2,4,4,2,2,1,1,0,1.529712617250445E-4,0.0833333333,1,218,414,2.985240256774393E-4,1.797462E-5,1.8208082E-5,213,7,0,200,0,0
362310283,Gmoore18,10,95,187,154,0,1,40.0412082485,40-49,589,4,7,6,13,13,7,6,8,4.6591898226,2,6.167148285747101E-4,0.1153846154,0.78571427,0,66,3.380638602310351E-4,4.793232E-5,4.8554884E-5,31,24,0,70,0,0
362725025,pembina_media,10,248,369,601,16,2,44.6829683527,40-49,574,4,37,66,103,103,37,66,6,2.4620020087,1329.9650532658,0.0568609821,0.1409670664,0.31780782,0,66,2.468742912910727E-4,2.2767852E-4,2.306357E-4,372,8,1,200,1,0.005
363064080,ShayneSangster,10,2543,136,385,4,5,41.7950352123,40-49,560,6,35,76,111,111,35,76,7,2.380314697,1538.2760814345,0.0526817025,0.1375102375,0.37800634,0,66,1.7276089254085857E-4,2.1569544E-4,2.1849698E-4,390,8,2,207,2,0.0096618357
363464356,SFNDP,10,425,101,75,6,1,27.3985795911,20-29,491,2,18,18,36,36,18,18,7,2.9484432541,15.1121250614,0.0218863747,0.2333333333,0.5307882,0,66,1.2965066037572647E-4,1.1383926E-4,1.1531785E-4,390,0,1,200,1,0.005
363490877,dugdangerfly,10,124,3,27,0,47,16.3417172752,10-19,23,2,0,1,1,1,0,1,1,1,0,0,0,0,37,126,4.4780486537007367E-5,0,6.0693606E-6,34,0,0,144,0,0
363497817,AntNom,10,80576,48608,46681,151,3177,56.7256029486,50-59,886,10,12,10,22,22,12,10,7,3.0562437228,22540.1634059963,0.0045065244,0.0043290043,0.030303031,0,66,3.6082167050950577E-4,7.789002E-5,7.283233E-5,320,9,0,202,0,0
363637819,JTDerbs,10,2636,198,342,0,310,42.6575339535,40-49,695,6,0,0,0,0,0,0,0,0,0,0,0,0,277,524,4.4780486537007367E-5,0,0,274,12,0,200,0,0
363666493,Darrahteitel,10,232,66,72,2,2,33.9002226406,30-39,476,3,9,22,31,31,9,22,7,2.6374288584,14.0282697446,0.0185692122,0.2204301075,0.5183333,0,66,8.611684957977403E-5,5.99154E-5,6.069361E-5,390,4,1,200,1,0.005
364330022,BrettParnell,10,1889,218,278,3,114,41.495097696,40-49,626,6,25,25,50,50,25,25,7,2.9989956478,521.2219398372,0.0085644284,0.0702040816,0.29032257,0,66,1.4211401388653387E-4,1.5578004E-4,1.5780337E-4,372,6,0,200,0,0
364402840,CdnEnginerd,10,2118,171,519,1,204,51.3855310201,50-59,592,6,5,17,22,22,5,17,7,2.8018078339,7.7480050176,0.0060315742,0.2164502165,0.40789473,0,66,6.582870336302546E-5,3.594924E-5,3.6416164E-5,140,0,0,200,0,0
365088087,steph_haldane,10,1072,158,363,0,205,35.7702966387,30-39,557,5,0,0,0,0,0,0,0,0,0,0,0,0,174,331,4.4780486537007367E-5,0,0,168,1,0,200,0,0
365103761,WesternUTories,10,228,163,181,5,1,40.8820307576,40-49,553,4,24,21,45,45,24,21,6,2.7961165049,489.0384843848,0.0187736106,0.1328282828,0.39112905,0,66,1.4390544435026595E-4,1.497885E-4,1.5173401E-4,372,33,2,200,2,0.01
365561959,ajeshilling,10,2114,227,541,5,361,43.0980920045,40-49,636,6,12,27,39,39,12,27,7,2.6806160027,174.6552417844,0.0111238862,0.0971659919,0.25738916,0,66,1.2107774922460421E-4,7.789002E-5,7.8901685E-5,47,2,0,200,0,0
365574202,kevinjs1977,10,613,83,177,0,31,32.2873924794,30-39,487,5,0,2,2,2,0,2,7,3.6854082999,0,0,0.5,0.5,0,367,4.4780486537007367E-5,0,6.0693606E-6,372,2,0,200,0,0
365592531,Matante_Loulou,10,320,35,181,0,5,27.0515352589,20-29,471,4,2,17,19,19,2,17,7,2.8008034818,1442.2875548465,1.9727328890826993E-4,0.1666666667,0.3345588,0,66,8.602545336804117E-5,1.797462E-5,1.8208082E-5,372,4,1,197,1,0.0050761421
365798739,eroland6,10,1834,262,225,0,217,40.2458323467,40-49,677,6,1,1,2,2,1,1,1,1,0,7.49471721243357E-5,0,0,281,529,2.9852402567743944E-4,1.198308E-5,1.2138721E-5,278,6,0,199,0,0
366095123,JulieCWC,10,611,208,373,6,0,40.7133962326,40-49,512,4,31,64,95,95,31,64,6,2.5383327754,1112.4866635578,0.0586050476,0.1546472564,0.43498966,0,66,3.690852715153866E-4,1.9172928E-4,1.9421954E-4,372,14,3,200,3,0.015
366307876,Peaceameat,10,3598,119,487,4,4,28.5475723617,20-29,500,7,24,74,98,98,24,74,7,2.4666889856,779.1766892066,0.0325285721,0.1508520934,0.37666667,0,66,1.2168138266383319E-4,1.497885E-4,1.5173401E-4,140,1,1,198,1,0.0050505051
366565098,ravenkitteh33,10,4680,1124,2000,30,44,34.2665081431,30-39,702,7,57,95,152,152,57,95,6,2.4238366254,25758.1409323473,0.0640458965,0.0784245382,0.30808082,0,66,2.586754422138848E-4,3.475093E-4,3.520229E-4,47,4,0,198,0,0
366654973,Conser_Hippy,10,707,98,123,1,1,40.2362011056,40-49,600,5,7,6,13,13,7,6,7,3.1647137596,7.037370977,0.0026553034,0.141025641,0.45833334,0,66,7.447146965543509E-5,4.793232E-5,4.8554884E-5,372,2,0,200,0,0
366864224,AndrewJReeve,10,2800,258,180,7,241,47.1853939915,40-49,650,6,37,30,67,67,37,30,7,2.7167726816,202.8196440605,0.0458869061,0.1408864767,0.35607845,0,66,1.5697297747040804E-4,2.2767852E-4,2.306357E-4,140,22,1,200,1,0.005
367333161,Dkrupski,10,12238,1786,1988,51,484,41.5515479354,40-49,753,8,48,51,99,99,48,51,6,2.4874455976,1918.4005711415,0.0328877439,0.088023088,0.38251367,0,66,2.0741728377473784E-4,2.9358547E-4,2.9739868E-4,372,65,0,200,0,0
367562844,ehamilt,10,1416,357,340,4,17,43.5227792129,40-49,613,6,29,30,59,59,29,30,6,2.5446936726,687.0905020819,0.0391651422,0.0523085915,0.2623106,0,66,1.5173938806795425E-4,1.797462E-4,1.8208082E-4,47,9,1,200,1,0.005
367958676,X_Tiiponpon,10,701,174,155,0,13,46.7976888903,40-49,688,5,2,2,4,4,2,2,7,3.5151515152,143.1,1.5463565477555065E-4,0,0,30,104,1.778402311966145E-4,1.797462E-5,1.8208082E-5,315,42,0,201,0,0
367960701,kellysummers96,10,569,363,197,1,96,43.3173289299,40-49,656,4,9,7,16,16,9,7,8,4.6588550385,5.7833333333,7.767425262917716E-4,0.1125,0.6666667,0,66,4.131342710978313E-4,5.99154E-5,6.069361E-5,31,29,0,199,0,0
368090766,radicalyfeliz,10,43363,951,398,7,55,39.6074699763,30-39,755,9,3,1,4,4,3,1,12,7.5922330097,0.5,2.3609632676139562E-4,0.1666666667,0.6666667,0,66,1.1854297784842988E-4,2.396616E-5,2.4277442E-5,320,7,0,200,0,0
368522365,cdmercer7,10,1096,405,1333,3,216,41.8128778143,40-49,615,5,7,33,40,40,7,33,7,2.6605289588,184.2958839422,0.0062291257,0.116025641,0.24810606,0,66,6.778648671354497E-5,4.793232E-5,4.8554884E-5,390,2,0,200,0,0
368839993,Driver_Skills,10,848,307,434,5,5,24.7263730731,20-29,581,5,0,0,0,0,0,0,0,0,0,0,0,0,56,146,4.4780486537007367E-5,0,0,46,0,0,198,0,0
369027713,OHIP4IVF,10,2388,1306,2001,16,69,49.5255044911,40-49,688,6,5,23,28,28,5,23,7,2.8617341815,403.4271075984,0.0030921858,0.1481481481,0.28442028,0,66,7.649635487463607E-5,3.594924E-5,3.6416164E-5,140,40,0,200,0,0
369088384,ALatendresseNPD,10,1306,976,771,61,2,50.457042427,50-59,655,5,148,120,268,268,148,120,6,2.4449280214,3099.5209616018,0.2025731617,0.1170691486,0.31848994,0,66,9.095523220300169E-4,8.9273945E-4,8.982654E-4,390,74,16,200,16,0.08
369212454,Ottawa_Steve,10,6242,269,446,1,67,42.7822841859,40-49,653,6,11,24,35,35,11,24,6,2.6993639103,673.3686031889,0.0129333891,0.1579831933,0.37962964,0,66,8.069781710070291E-5,7.189848E-5,7.283233E-5,372,7,3,199,3,0.0150753769
369757190,ErbiFullyLoaded,10,2639,316,439,1,1070,42.220006805,40-49,663,6,8,8,16,16,8,8,8,4.6585202544,8.4166666667,6.967832375625903E-4,0.0875,0.6785714,0,66,3.9347848772024863E-4,5.392386E-5,5.4624245E-5,31,24,0,200,0,0
370168544,DominicTerry,10,5142,291,359,5,9,46.4759519143,40-49,689,6,12,37,49,49,12,37,6,2.6260462002,83.1540314328,0.0138304615,0.2164115646,0.410148,0,66,1.0636377783476155E-4,7.789002E-5,7.8901685E-5,372,7,0,200,0,0
370384969,DonMartinYEG,10,265,2212,1651,39,202,53.5255824205,50-59,757,8,141,141,282,282,141,141,6,2.3003013057,21526.5943225829,0.0894131314,0.0261856086,0.15064877,0,66,5.537956395686698E-4,8.507987E-4,8.618492E-4,372,60,0,103,0,0
370453743,randTRUMP09,10,1030,60,179,0,148,35.5112782619,30-39,540,5,1,1,2,2,1,1,2,1.5,0,7.645535613750089E-5,0,0,197,378,2.29874507414389E-4,1.198308E-5,1.2138721E-5,197,21,0,198,0,0
370736598,MR_MiiLKYWAY,10,26953,377,303,1,92,35.123957795,30-39,779,8,2,2,4,4,2,2,1,1,0,1.529712617250445E-4,0.0833333333,1,63,155,2.985240256774393E-4,1.797462E-5,1.8208082E-5,72,16,0,198,0,0
370815539,EcoRational,10,793,145,132,8,119,42.041302091,40-49,594,5,18,14,32,32,18,14,7,2.796786073,161.4871991308,0.0244231405,0.1653225806,0.34330484,0,66,1.0358212166778846E-4,1.1383926E-4,1.1531785E-4,55,12,0,200,0,0
370852503,ARIApensions,10,1365,662,1997,14,3,46.5128037093,40-49,656,5,16,67,83,83,16,67,7,2.5343153666,2406.3704448293,0.0181487595,0.0981486923,0.19424883,0,66,1.246167083737699E-4,1.0185618E-4,1.0317913E-4,390,4,0,199,0,0
370964111,smokeycrow,10,1318,248,214,14,38,48.9631462467,40-49,661,5,2,2,4,4,2,2,7,2.9611650485,0,0.0043797862,0.0833333333,1,0,66,5.298732657835016E-5,1.797462E-5,1.8208082E-5,390,5,0,201,0,0
371062289,ShawnNason1,10,6741,202,236,5,218,43.3947617949,40-49,696,7,8,17,25,25,8,17,7,2.8295949113,243.5200342742,0.0095822781,0.1533333333,0.47058824,0,66,1.0970229757062062E-4,5.392386E-5,5.4624245E-5,372,11,0,200,0,0
371070418,CorrynSojourner,10,1025,108,182,0,249,34.4149919218,30-39,596,5,4,5,9,9,4,5,1,1,0.25,3.2182929738269154E-4,0.125,0.85,209,402,2.701198379081004E-4,2.99577E-5,3.0346804E-5,341,33,0,200,0,0
371094771,I_LuvTO2,10,17650,824,1220,17,23,42.1526756903,40-49,769,8,130,180,310,310,130,180,6,2.2534315367,12765.9441686495,0.1618495858,0.0624491074,0.21840706,0,66,4.362853071801162E-4,7.848917E-4,7.9508626E-4,140,112,1,211,1,0.0047393365
372189219,garthworld,10,4677,406,1139,0,3791,40.8374591442,40-49,607,7,17,50,67,67,17,50,6,2.4355540676,95.6503826943,0.0228540178,0.1621438263,0.4227451,0,66,7.933287748687403E-5,1.0784772E-4,1.0924849E-4,47,1,0,201,0,0
372212694,Cmeant,10,789,60,54,0,22,35.7386220891,30-39,574,5,2,3,5,5,2,3,8,3.666889856,3051.5860310072,0.0011183341,0,0,0,66,1.1515517574033093E-4,1.797462E-5,1.8208082E-5,390,11,0,200,0,0
372303687,MikmawRose,10,5320,530,778,5,461,45.2008174637,40-49,695,7,25,27,52,52,25,27,7,2.6842986274,501.5410247858,0.0251187601,0.0961538462,0.2617354,0,66,1.4525615063382615E-4,1.5578004E-4,1.5173401E-4,47,13,1,201,1,0.0049751244
372343086,Bee_Fowlow,10,999,72,395,0,4,35.0278270299,30-39,582,5,3,21,24,24,3,21,6,2.6796116505,132.6172713725,0.0051431951,0.1630434783,0.3008658,0,66,5.526400143137827E-5,2.396616E-5,2.4277442E-5,372,0,0,200,0,0
373244712,chris_gallaway,10,396,235,303,3,120,42.1350040108,40-49,568,4,28,42,70,70,28,42,7,2.7100770003,532.3137472573,0.0254963049,0.101863354,0.34927535,0,66,1.6044063453459783E-4,1.7375466E-4,1.7601145E-4,390,22,3,200,3,0.015
373581418,reason911,10,8354,223,306,3,21,32.2497048834,30-39,742,8,22,32,54,54,22,32,7,2.6575159022,783.6482452585,0.0226780385,0.0772187282,0.18583043,0,66,1.0215054743950286E-4,1.3780541E-4,1.395953E-4,372,70,0,200,0,0
373631302,MattyG0202,10,3020,373,256,0,206,41.029896317,40-49,703,6,1,1,2,2,1,1,1,1,0,7.49471721243357E-5,0,0,281,529,2.9852402567743944E-4,1.198308E-5,1.2138721E-5,278,17,0,196,0,0
373670338,SunDancePiper,10,9633,555,350,22,490,51.0884265746,50-59,736,7,8,9,17,17,8,9,7,3.0043521928,6114.4614723233,0.0046644393,0.0441176471,0.30555555,0,66,1.2063735729186531E-4,5.392386E-5,5.4624245E-5,47,7,0,201,0,0
373942398,TjayElbee,10,6449,249,259,0,29,49.9333060741,40-49,717,7,1,1,2,2,1,1,2,1.5,0,7.645535613750089E-5,0,0,397,716,2.29874507414389E-4,1.198308E-5,1.2138721E-5,408,91,0,200,0,0
374096811,ibroayo,10,10620,294,222,0,165,50.4055867615,50-59,744,7,0,0,0,0,0,0,0,0,0,0,0,0,103,213,4.4780486537007367E-5,0,0,98,8,0,201,0,0
374170691,EricMarkDo,10,3225,447,360,19,191,53.8913844548,50-59,696,6,19,24,43,43,19,24,7,2.6936725812,54.5687035819,0.0452917463,0.1915836102,0.47632575,0,66,1.6998144074889445E-4,1.198308E-4,1.2138722E-4,140,6,0,200,0,0
374184788,NicholasBrake,10,213,59,122,0,3,20.1950660534,20-29,355,4,1,1,2,2,1,1,7,3.3404753934,0,9.419342586916661E-4,0,0,0,66,4.9481557891212485E-5,1.198308E-5,1.2138721E-5,372,1,0,194,0,0
374545627,brenda_slomka,10,4639,345,333,11,22,46.7994772621,40-49,684,6,18,21,39,39,18,21,7,2.8630733177,327.6483196152,0.0273430734,0.0944669366,0.2735043,0,66,1.669902975017662E-4,1.1383926E-4,1.1531785E-4,140,29,2,200,2,0.01
374637511,traceyselkirk,10,3775,207,252,6,7,41.6489096747,40-49,657,7,15,15,30,30,15,15,7,2.8255775025,2434.1909580138,0.011979434,0.1333333333,0.23692308,0,66,1.2193942197604842E-4,9.586464E-5,9.710977E-5,390,8,0,198,0,0
374643582,kyallskNDP,10,1284,261,225,11,9,45.8088404864,40-49,628,5,29,24,53,53,29,24,7,2.8968865082,291.4393625059,0.020118423,0.0947024673,0.24831308,0,66,1.4693024194008153E-4,1.797462E-4,1.7601145E-4,390,40,5,199,5,0.0251256281
374658826,voter1vote,10,16228,1253,1445,48,2607,59.3241421367,50-59,744,8,12,15,27,27,12,15,7,3.1265483763,504.1945262124,0.0034686812,0.037037037,0.20952381,0,66,1.4064382108248851E-4,7.789002E-5,7.8901685E-5,47,11,0,201,0,0
374713557,political_k,10,844,142,814,1,1,37.0926898019,30-39,500,5,16,117,133,133,16,117,6,2.4181452963,504.0549670276,0.0134495796,0.1687172477,0.31609446,0,66,8.259521010509739E-5,1.0185618E-4,1.0317913E-4,140,6,0,199,0,0
374735534,honkey_blueye,10,255,8,36,0,5,32.6099289204,30-39,474,4,3,12,15,15,3,12,7,2.640441915,174.3971696248,0.0016700194,0.1333333333,0.25757575,0,66,6.244273051361753E-5,2.396616E-5,2.4277442E-5,372,18,7,200,7,0.035
374864512,MichelVigneault,10,204,21,32,0,0,16.6374517062,10-19,359,3,0,1,1,1,0,1,8,3.4253681392,0,0,0,0,0,468,4.4780486537007367E-5,0,6.0693606E-6,390,0,0,199,0,0
374871615,AMAPCEO_member,10,350,49,18,0,4,24.1544367801,20-29,580,4,2,1,3,3,2,1,8,3.8182122531,0.2865734953,2.895034083195907E-4,0.1666666667,0.16666667,0,66,5.032273845198781E-5,1.797462E-5,1.8208082E-5,390,8,0,200,0,0
375290882,mattlensen,10,324,225,322,0,35,38.6302482791,30-39,638,6,23,29,52,52,23,29,7,2.9169735521,359.985907036,0.0107034364,0.1195324284,0.3415916,0,66,1.1850131861871016E-4,1.4379696E-4,1.4566466E-4,390,25,1,193,1,0.0051813472
375634441,CamF57,10,1135,140,203,4,17,40.2180120302,40-49,652,5,73,67,140,140,73,67,6,2.3525276197,574.1299965856,0.1048236675,0.1464028777,0.37132224,0,66,1.970061974384901E-4,4.4337395E-4,4.491327E-4,47,7,4,200,4,0.02
376499821,langleyteacher,10,1437,308,183,20,10,47.3144877012,40-49,675,6,9,8,17,17,9,8,7,2.9641781051,68.6236907124,0.0090341539,0.0955882353,0.25641027,0,66,7.22271572862253E-5,5.99154E-5,6.069361E-5,55,9,0,200,0,0
376889920,fuckbrogan,10,8891,495,217,0,2046,46.8422660147,40-49,761,7,3,4,7,7,3,4,3,1.8461538462,2.0333333333,2.4881340236531947E-4,0.0952380952,0.5833333,26,99,1.7205787389522467E-4,2.396616E-5,2.4277442E-5,49,17,0,201,0,0
376996977,kate_england,10,205,78,211,1,11,38.340733544,30-39,480,4,0,2,2,2,0,2,7,2.9702141901,0,0,0.5,0.5,0,521,4.4780486537007367E-5,0,6.0693606E-6,140,10,0,200,0,0
377139026,angelocsn,10,7178,252,290,4,19,50.1358567534,50-59,700,7,7,10,17,17,7,10,7,2.8068295949,38.711841168,0.0111590133,0.1066176471,0.53333336,0,66,7.201869808440697E-5,4.793232E-5,4.8554884E-5,390,3,0,201,0,0
377540405,Jamiastar,10,51197,1456,955,59,8513,48.3814001937,40-49,773,9,21,20,41,41,21,20,7,2.8557080683,1789.3818308251,0.0167935015,0.0396341463,0.16096866,0,66,1.4350344288438898E-4,1.3181388E-4,1.3352593E-4,47,24,0,201,0,0
377574684,NYCGreenHouse,10,677,281,146,9,0,39.1305753969,30-39,556,4,1,1,2,2,1,1,1,1,0,7.49471721243357E-5,0,0,147,297,2.9852402567743944E-4,1.198308E-5,1.2138721E-5,144,15,0,200,0,0
377851562,hgCoASt,10,2121,914,1161,18,1,48.8336266849,40-49,693,6,98,114,212,212,98,114,6,2.3371275527,12455.0255489953,0.1022989563,0.0416256818,0.19684874,0,66,3.645166477543846E-4,5.9316243E-4,6.008667E-4,47,55,0,200,0,0
378066853,BhoRangzen,10,36473,1517,2004,58,70,44.9733864416,40-49,780,9,14,19,33,33,14,19,7,2.8121861399,754.4004084805,0.0118949407,0.0568181818,0.29473683,0,66,9.446057265226373E-5,8.98731E-5,9.104041E-5,47,105,0,201,0,0
378298356,MuskokaMoneybag,10,19439,981,1068,19,2730,46.4540758474,40-49,784,8,314,351,665,665,314,351,6,2.0632741881,50914.6528238769,0.3685030129,0.0516645529,0.18188354,0,66,8.553325129850599E-4,0.0018873351,0.0019118486,47,555,3,267,3,0.0112359551
378403945,Barsanti17,10,812,20,33,1,1,21.3501173106,20-29,446,4,2,7,9,9,2,7,7,2.8255775025,1.517854912,0.0020517756,0.1666666667,0.42857143,0,66,4.952851130524774E-5,1.797462E-5,1.8208082E-5,47,4,1,199,1,0.0050251256
378615823,HenrikSandbergJ,10,4802,10220,10999,121,64,59.6013916228,50-59,774,6,9,10,19,19,9,10,7,3.1141613659,75399.5881717605,0.0026685306,0.0029239766,0.022222223,0,66,3.9065621306185757E-4,5.99154E-5,6.069361E-5,320,1387,0,202,0,0
378826663,CaptainWalbran,10,4035,520,1301,12,293,44.7767744598,40-49,665,7,43,110,153,153,43,110,6,2.3548711081,1733.586565765,0.0573457654,0.0943412453,0.24920987,0,66,1.8856345013666234E-4,2.6362776E-4,2.6705186E-4,390,17,0,198,0,0
379008073,zb_armstrong,10,9333,756,1052,30,82,61.6170741252,60-69,752,7,86,127,213,213,86,127,6,2.379979913,8108.1352591174,0.1070506035,0.0956683497,0.28396764,0,66,4.3678079920050905E-4,5.21264E-4,5.280344E-4,140,99,2,203,2,0.0098522167
379207097,kylefarq,10,11971,699,1339,37,33,46.6016112725,40-49,762,8,109,103,212,212,109,103,6,2.333110144,4635.6343149334,0.1239693507,0.0831395869,0.19212177,0,66,3.8973848419995974E-4,6.590694E-4,6.6762965E-4,47,136,1,205,1,0.0048780488
379443332,Madison_Dazey,10,9250,641,572,0,1403,35.9828461758,30-39,721,7,1,1,2,2,1,1,1,1,0,7.49471721243357E-5,0,0,272,515,2.9852402567743944E-4,1.198308E-5,1.2138721E-5,270,16,0,201,0,0
379511927,ILoveCanada1987,10,14220,421,1052,7,1023,32.4858206351,30-39,728,8,51,95,146,146,51,95,6,2.3521928356,2517.1781280519,0.0610086426,0.0865847898,0.24505228,0,66,1.6287037469559347E-4,3.1156008E-4,3.1560674E-4,140,0,0,200,0,0
379529949,Dorion12,10,4720,409,677,2,1341,44.9537016748,40-49,673,7,38,58,96,96,38,58,7,2.6625376632,752.4225010843,0.0240872208,0.0628289474,0.27041742,0,66,1.6090350864121468E-4,2.3367006E-4,2.3670506E-4,47,7,0,201,0,0
379576582,lachildress,10,741,110,399,2,28,40.7579167622,40-49,497,5,23,43,66,66,23,43,7,2.6253766321,1033.821281442,0.0220357391,0.1158508159,0.35753933,0,66,1.2523372496197414E-4,1.4379696E-4,1.4566466E-4,47,4,0,197,0,0
379869808,leelsask,10,921,103,289,1,0,33.0300641677,30-39,554,5,9,11,20,20,9,11,7,2.979243388,61.2480752286,0.0049665487,0.0763157895,0.27564102,0,66,7.739094521663562E-5,5.99154E-5,5.4624245E-5,390,1,0,199,0,0
379906635,ashman213,10,249,31,75,0,0,32.8715828408,30-39,378,4,3,10,13,13,3,10,7,3.0147304988,2.7451582644,0.0022972702,0.2564102564,0.41666666,0,66,5.1793337863069414E-5,2.396616E-5,2.4277442E-5,390,1,2,200,1,0.01
379951860,advogadohenry,10,8277,563,2001,3,3,34.0583505456,30-39,639,7,0,1,1,1,0,1,3,2,0,0,0,0,203,499,4.4780486537007367E-5,0,6.0693606E-6,212,1,0,200,0,0
380016963,oectasudelem,10,687,80,58,2,1,33.5762212052,30-39,524,4,4,1,5,5,4,1,8,3.4137931034,0,0.001404334,0.15,0.25,0,66,5.4307177586428385E-5,2.99577E-5,3.0346804E-5,390,4,0,200,0,0
380376309,sjGoring,10,1921,323,291,18,46,,,670,6,3,1,4,4,3,1,8,4.1694007365,0.5,3.446864973461742E-4,0.0833333333,0.16666667,0,66,7.87070238763635E-5,2.396616E-5,2.4277442E-5,55,2,0,200,0,0
380382923,Exigenomicon,10,2031,157,274,4,14,39.3575490108,30-39,619,5,28,56,84,84,28,56,7,2.4964847673,422.7932481187,0.0542802516,0.1642283419,0.36896402,0,66,1.386646916309634E-4,1.7375466E-4,1.7601145E-4,390,7,10,200,10,0.05
380938969,larayav,10,5438,133,406,1,17,39.2112527143,30-39,623,7,1,3,4,4,1,3,9,4.6069635085,0,1.1057485856814353E-4,0.1666666667,0.33333334,0,66,6.79464955354548E-5,1.198308E-5,1.2138721E-5,320,1,0,199,0,0
381013583,YukonTeddy,10,230,114,327,3,3,29.4073605097,20-29,438,4,9,50,59,59,9,50,6,2.5550719786,362.4904969632,0.0090399142,0.1992986558,0.41254902,0,66,1.2039218034560926E-4,5.99154E-5,6.069361E-5,372,0,0,199,0,0
381058048,apoliq,10,2793,295,767,3,107,40.6076171495,40-49,642,6,37,102,139,139,37,102,6,2.3736190157,2424.7354894337,0.0590223516,0.0942550308,0.23530997,0,66,1.7264193857349265E-4,2.2767852E-4,2.306357E-4,47,9,2,200,2,0.01
381069997,_STiiNooO,10,3730,100,55,0,6,43.3899192538,40-49,669,6,2,2,4,4,2,2,1,1,0,1.529712617250445E-4,0.0833333333,1,63,155,2.985240256774393E-4,1.797462E-5,1.8208082E-5,72,6,0,201,0,0
381114629,King_Rob674,10,592,89,358,0,7,38.163391802,30-39,500,5,13,34,47,47,13,34,6,2.7472380315,196.1079211681,0.0099480843,0.1304347826,0.37731093,0,66,1.0507987120313746E-4,8.388156E-5,8.497105E-5,372,11,0,199,0,0
381136617,GatewayCaveMan,10,630,172,1752,0,0,23.7823634456,20-29,580,5,18,207,225,225,18,207,6,2.2266488115,1447.6344083378,0.0223556602,0.1507539683,0.261151,0,66,1.033325669633648E-4,1.1383926E-4,1.1531785E-4,390,29,0,200,0,0
381198439,benfreeland,10,656,199,289,4,17,53.1594104681,50-59,573,5,4,9,13,13,4,9,6,2.827920991,43.5965443779,0.0058051665,0.1538461538,0.44444445,0,66,6.754060995913574E-5,2.99577E-5,3.0346804E-5,372,5,0,200,0,0
381276559,Barack_McBush,10,20655,757,1376,12,60,43.7339744957,40-49,765,9,1,4,5,5,1,4,7,3.1610311349,1.0885426245,0.0014721909,0.4,0.5,0,66,4.6114985185253634E-5,1.198308E-5,1.2138721E-5,47,0,0,201,0,0
381289009,Ayo_Fermin,10,5211,130,121,0,17,38.6696058212,30-39,698,6,1,1,2,2,1,1,1,1,0,7.49471721243357E-5,0,0,227,443,2.9852402567743944E-4,1.198308E-5,1.2138721E-5,222,14,0,200,0,0
381630487,GordWaldie,10,2462,179,314,11,5,41.9880972806,40-49,633,5,4,4,8,8,4,4,7,3.2129226649,24.4360153862,0.0013314658,0.0535714286,0.2,0,66,7.41140185367892E-5,2.99577E-5,3.0346804E-5,47,7,0,200,0,0
381666934,JacquelineHine1,10,16845,798,593,17,1486,41.1034902529,40-49,744,8,8,7,15,15,8,7,7,3.4974891195,188.7639908747,0.0012998999,0.0714285714,0.41666666,0,66,1.4564200266515155E-4,5.392386E-5,5.4624245E-5,47,3,0,202,0,0
382330069,KellyDowdell,10,1112,180,256,3,30,40.0380781455,40-49,580,5,4,12,16,16,4,12,7,2.94810847,15.4168953117,0.0028340511,0.1916666667,0.34615386,0,66,6.597398321283336E-5,2.99577E-5,3.0346804E-5,372,1,1,199,1,0.0050251256
382516525,Buswell_FedNDP,10,4625,199,228,2,42,45.4417105982,40-49,702,6,57,61,118,118,57,61,6,2.5289588216,6861.0929345478,0.0818470622,0.1211791975,0.33255813,0,66,2.723725092287671E-4,3.475093E-4,3.520229E-4,390,66,26,200,21,0.13
382803993,sensethewonder,10,2319,565,1954,5,24,40.5383976134,40-49,612,6,154,324,478,478,154,324,6,2.1493136927,18051.2353364432,0.1843249392,0.0597440418,0.17855366,0,66,4.6051379201239167E-4,9.286887E-4,9.407509E-4,47,5,2,199,2,0.0100502513
383826803,AGO_RM,10,190,82,860,0,6,20.5678818226,20-29,473,5,0,3,3,3,0,3,2,1.4,0,0,0.3333333333,0.5,203,413,4.4780486537007367E-5,0,6.0693606E-6,212,0,0,192,0,0
383973753,ColinScott_NL,10,832,106,315,0,171,40.1219570139,40-49,572,5,6,15,21,21,6,15,7,2.8068295949,101.4417541723,0.0037136299,0.2119047619,0.3888889,0,66,6.106847836423386E-5,4.194078E-5,4.2485524E-5,390,14,0,200,0,0
384357977,NWVoyageur,10,2856,111,153,2,24,31.16472171,30-39,586,6,20,26,46,46,20,26,6,2.8215600937,27.4644522043,0.0145364736,0.1473429952,0.6453202,0,66,1.1694584129403932E-4,1.2582233E-4,1.2745657E-4,372,10,0,199,0,0
384610504,Its_LOLA_LoVe,10,1767,170,170,1,10,28.5715492276,20-29,622,5,2,2,4,4,2,2,1,1,0,1.529712617250445E-4,0.0833333333,1,181,343,2.985240256774393E-4,1.797462E-5,1.8208082E-5,296,9,0,199,0,0
384614410,StewartKiff,10,229,235,423,2,7,29.3580785899,20-29,486,4,16,47,63,63,16,47,7,2.6782725142,297.1427507389,0.0141586312,0.1377368152,0.33715987,0,66,1.33059169087286E-4,1.0185618E-4,1.0317913E-4,372,4,1,199,1,0.0050251256
384833727,fabio_capucho,10,1032,123,200,0,1,25.5697137574,20-29,625,5,0,3,3,3,0,3,2,1.4,0,0,0.3333333333,0.5,203,444,4.4780486537007367E-5,0,6.0693606E-6,212,2,0,200,0,0
385195352,CryingWolfe,10,2010,201,451,4,195,41.6825919356,40-49,648,6,19,39,58,58,19,39,7,2.6260462002,237.329632953,0.0278365643,0.1297640653,0.29747474,0,66,9.698810716469028E-5,1.198308E-4,1.2138722E-4,47,4,0,199,0,0
385486802,DDUOrden,10,555,75,444,1,8,40.4250955383,40-49,672,5,3,3,6,6,3,3,2,1.5714285714,0.5,2.419396189930435E-4,0.1,0.8333333,52,142,2.8690815099642256E-4,2.396616E-5,2.4277442E-5,316,193,0,200,0,0
385748033,BriggsAlexa,10,344,129,339,1,10,40.6592039027,40-49,513,4,14,36,50,50,14,36,7,2.6116504854,314.1719752448,0.012014531,0.1253061224,0.3430931,0,66,9.512893154575233E-5,8.98731E-5,9.104041E-5,372,7,0,200,0,0
385760695,RyanMerrill07,10,3148,364,283,0,758,46.8130414052,40-49,686,6,3,3,6,6,3,3,3,1.8461538462,1.0888888889,2.5687307458908124E-4,0.0666666667,0.5,26,99,1.7426130928695005E-4,2.396616E-5,2.4277442E-5,49,13,0,199,0,0
385789390,Fergyisms,10,438,162,152,2,1,33.1049467778,30-39,570,4,1,6,7,7,1,6,7,3.057248075,0.1556345828,2.5514026275077356E-4,0.2380952381,0.43333334,0,66,4.629480618748087E-5,1.198308E-5,1.2138721E-5,372,7,0,200,0,0
385830985,BigBossEmm,10,9033,295,289,1,952,35.4304374728,30-39,725,7,1,1,2,2,1,1,1,1,0,7.49471721243357E-5,0,0,227,443,2.9852402567743944E-4,1.198308E-5,1.2138721E-5,222,10,0,200,0,0
386347049,aVr16,10,424,30,127,0,344,17.5328980088,10-19,288,4,2,6,8,8,2,6,7,3.1272179444,28.7551710671,0.0020956683,0.1428571429,0.23809524,0,66,5.177301233429324E-5,1.797462E-5,1.8208082E-5,55,0,0,200,0,0
387348325,TommyManzano,10,4955,259,229,0,391,40.9859331231,40-49,693,7,1,1,2,2,1,1,1,1,0,7.645525756863154E-5,0,0,121,237,4.673511306965937E-4,1.198308E-5,1.2138721E-5,117,4,0,200,0,0
387381118,GuyLafond,10,99,12,48,0,0,14.9088438518,10-19,92,2,0,3,3,3,0,3,7,3.2285809906,0,0,0.1666666667,0.16666667,0,356,4.4780486537007367E-5,0,6.0693606E-6,390,1,0,111,0,0
387431860,TomK0tt,10,6634,383,204,8,445,60.6467978953,60-69,737,7,26,28,54,54,26,28,6,2.7231335788,301.5085564899,0.0187807465,0.0950384347,0.27524894,0,66,1.3838705652114642E-4,1.6177158E-4,1.6387274E-4,372,76,0,200,0,0
387707281,dlewis189,10,4114,98,123,3,168,44.3041847859,40-49,574,7,2,2,4,4,2,2,8,3.7927686642,0,2.576201070741237E-4,0.0833333333,1,0,66,7.022491510904732E-5,1.797462E-5,1.8208082E-5,47,2,0,201,0,0
387970645,rmfaris,10,10250,799,1699,37,108,40.5616398083,40-49,755,8,53,131,184,184,53,131,6,2.2738533646,5379.6623628597,0.0693087194,0.0899560466,0.24480979,0,66,2.2210818402020678E-4,3.2354315E-4,3.2774548E-4,140,15,4,201,4,0.0199004975
388024089,felixhythlo,10,982,108,99,0,77,40.3619505937,40-49,594,5,10,14,24,24,10,14,7,2.7934382323,22.656376513,0.012218686,0.0742753623,0.25833333,0,66,8.106746815184422E-5,6.590694E-5,6.6762965E-5,140,6,0,201,0,0
388443126,AislinnElliott,10,474,333,320,0,33,41.5205497616,40-49,587,4,3,6,9,9,3,6,2,1.4,0.25,2.4663624377034235E-4,0.2083333333,0.6,2,183,8.742576660530252E-5,2.396616E-5,2.4277442E-5,322,16,0,198,0,0
389001407,faceless_corp,10,1478,174,972,0,193,37.1725221264,30-39,624,6,10,34,44,44,10,34,7,2.6468028122,752.9073589935,0.0120065833,0.1337209302,0.3159664,0,66,8.233171565708395E-5,6.590694E-5,6.6762965E-5,47,3,0,194,0,0
389052680,miki_lou,10,5153,197,62,4,576,46.5685720737,40-49,659,6,48,28,76,76,48,28,7,2.5895547372,386.8494402578,0.0735104333,0.1198245614,0.30677965,0,66,2.00929973446051E-4,2.9358547E-4,2.9739868E-4,47,30,0,201,0,0
389475975,FeffTheChef,10,7754,248,546,3,174,33.0142862706,30-39,693,7,21,38,59,59,21,38,7,2.5453632407,230.6473200892,0.0317888576,0.1014026885,0.3039867,0,66,1.0162491954928913E-4,1.3181388E-4,1.3352593E-4,47,6,0,200,0,0
389550963,NRoualec,10,440,132,109,3,0,44.1789747193,40-49,583,5,0,0,0,0,0,0,0,0,0,0,0,0,134,257,4.4780486537007367E-5,0,0,131,0,0,200,0,0
389648206,BinhoaAyesta,10,166607,5997,4809,50,3,52.890272277,50-59,736,10,4,2,6,6,4,2,8,3.9119517911,6119.4953804674,4.89867684760849E-4,0.0333333333,0.083333336,0,66,1.507256962817647E-4,2.99577E-5,3.0346804E-5,372,2,0,204,0,0
390127676,shannonmkelleyy,10,1696,110,272,0,117,25.5228096173,20-29,533,5,0,0,0,0,0,0,0,0,0,0,0,0,210,403,4.4780486537007367E-5,0,0,205,3,0,194,0,0
390142047,BrockCLS,10,690,320,260,10,46,45.9414638898,40-49,606,5,47,32,79,79,47,32,6,2.6846334114,1347.556294518,0.0349219149,0.0796819215,0.21741672,0,66,2.1346219500706216E-4,2.8759392E-4,2.913293E-4,390,72,1,200,1,0.005
390225936,TheFalconer2011,10,3557,148,345,2,26,39.5707257108,30-39,619,6,36,93,129,129,36,93,6,2.4713759625,217.3306845494,0.0600756787,0.2006419574,0.48841584,0,66,2.2346352208764763E-4,2.2168698E-4,2.2456635E-4,390,9,18,200,17,0.09
390696780,MFL1956,10,42881,847,789,23,6232,40.9081223653,40-49,741,9,4,6,10,10,4,6,7,3.3043187144,59.7859570584,8.550927661587073E-4,0.0888888889,0.35714287,0,66,7.858040826031464E-5,2.99577E-5,3.0346804E-5,47,5,0,202,0,0
390737393,MikeGuglielmin,10,220,98,328,1,3,16.7893855981,10-19,477,3,7,42,49,49,7,42,6,2.5657850686,23.2883013187,0.0077692268,0.244047619,0.47619048,0,66,6.005644742515216E-5,4.793232E-5,4.8554884E-5,140,3,3,200,3,0.015
391084315,AMacEwen,10,3470,430,519,14,5,53.5141653558,50-59,669,6,81,97,178,178,81,97,6,2.3558754603,5819.7361936939,0.0945010393,0.0506570177,0.20648916,0,66,3.614525750055207E-4,4.913063E-4,4.9768755E-4,390,49,0,200,0,0
391177648,DMJ_D,10,3089,67,113,0,183,27.6544495526,20-29,592,6,1,1,2,2,1,1,7,3.4887847338,0,0.0035424283,0.5,0.5,0,66,4.745703283487946E-5,1.198308E-5,1.2138721E-5,140,2,0,200,0,0
391400343,Sultan_H_Z,10,5223,149,234,0,48,41.5947495621,40-49,686,7,1,1,2,2,1,1,1,1,0,7.49471721243357E-5,0,0,113,227,2.9852402567743944E-4,1.198308E-5,1.2138721E-5,109,16,0,197,0,0
391553226,EricClevinger,10,220,18,53,0,4,31.7184712923,30-39,414,4,3,13,16,16,3,13,7,2.7087378641,26.105877108,0.0030711659,0.15,0.3525641,0,66,5.320870374534159E-5,2.396616E-5,2.4277442E-5,140,2,0,199,0,0
391743192,scum_tv,10,3943,281,240,9,2,45.2925574097,40-49,658,7,64,76,140,140,64,76,6,2.4074322062,1561.7506516494,0.0775078675,0.1065775951,0.27374834,0,66,2.144757911797878E-4,3.8945008E-4,3.9450845E-4,47,13,0,200,0,0
391760598,HobbesBruce,10,1357,77,233,4,31,40.732093577,40-49,634,6,7,15,22,22,7,15,7,2.8771342484,111.0099287943,0.0050890043,0.0865800866,0.25714287,0,66,6.864574659727764E-5,4.793232E-5,4.8554884E-5,372,10,0,200,0,0
391997276,Itson_anon,10,3000,363,1074,8,14,45.7487941354,40-49,665,6,59,134,193,193,59,134,6,2.2992969535,2888.7553435846,0.0871968416,0.0874892055,0.27440575,0,66,2.1940764093706966E-4,3.594924E-4,3.6416165E-4,47,15,0,200,0,0
392401248,AlfonsoToronto,10,4842,104,89,5,1,28.5754083739,20-29,508,7,1,3,4,4,1,3,7,3.1114830934,0.0605953931,0.0016095858,0,0,0,66,4.833448709276406E-5,1.198308E-5,1.2138721E-5,140,0,0,200,0,0
392538004,sonjay_1,10,7211,50,106,1,824,21.9739002993,20-29,507,7,2,4,6,6,2,4,7,3.0893873452,7.60800179,5.29310512076131E-4,0.2333333333,0.33333334,0,66,4.785463542257256E-5,1.797462E-5,1.8208082E-5,55,6,0,193,0,0
392880793,prab_the_man,10,2671,134,214,3,8,43.5350529348,40-49,683,6,3,3,6,6,3,3,7,3.1754268497,0.3311229789,0.0030576201,0.2666666667,0.55,0,66,6.291657190405784E-5,2.396616E-5,2.4277442E-5,140,8,0,201,0,0
393056809,nerdpoligirl,10,1598,94,146,2,2,24.6965205622,20-29,523,6,37,56,93,93,37,56,7,2.4606628724,194.7618784589,0.0532680671,0.1887564282,0.44724175,0,66,1.8824749453060963E-4,2.2767852E-4,2.306357E-4,390,0,13,200,12,0.065
393348427,RobertJensen2,10,36127,2343,381,55,45,42.0546538293,40-49,844,9,342,98,440,440,342,98,7,2.3903582189,17607.7191903178,0.3330926289,0.0786032305,0.15276203,0,66,0.0010326822,0.0020550983,0.0020817907,47,119,2,200,2,0.01
393486248,JuliannePaton,10,533,68,187,1,9,22.8793319529,20-29,527,4,0,0,0,0,0,0,0,0,0,0,0,0,394,713,4.4780486537007367E-5,0,0,405,0,0,200,0,0
393666869,xAaronMackenzie,10,2614,241,237,0,590,42.5218557727,40-49,712,6,0,0,0,0,0,0,0,0,0,0,0,0,407,731,4.4780486537007367E-5,0,0,418,3,0,196,0,0
394181481,L2HT,10,6708,159,216,2,625,47.7147365785,40-49,669,7,28,34,62,62,28,34,7,2.8342818882,148.1506065022,0.0217519512,0.1012691698,0.3878205,0,66,1.558633596086205E-4,1.7375466E-4,1.7601145E-4,47,25,0,200,0,0
394245906,1loriking,10,12426,580,922,25,4,51.394742344,50-59,722,8,51,60,111,111,51,60,6,2.4486106461,7957.5347088702,0.077072108,0.0836199836,0.23212026,0,66,2.5920504082614307E-4,3.1156008E-4,3.1560674E-4,140,13,10,199,8,0.0502512563
394838420,LLevsen,10,1480,66,189,3,3,38.7291366385,30-39,619,6,3,11,14,14,3,11,7,2.8603950452,24.5051037438,0.0053640422,0.1703296703,0.48181817,0,66,5.920836059684782E-5,2.396616E-5,2.4277442E-5,372,8,0,200,0,0
395292058,OConnorWRDSB,10,4442,343,468,10,244,48.7623548589,40-49,711,7,3,10,13,13,3,10,7,2.8553732842,83.779774178,0.0043748008,0.0833333333,0.2,0,66,5.911102844956324E-5,2.396616E-5,2.4277442E-5,390,6,0,200,0,0
395300100,SalomeAlexx,10,168,15,67,0,1,29.344984788,20-29,328,3,2,3,5,5,2,3,7,3.1064613324,3.083938671,0.0019564373,0.2,0.41666666,0,66,5.0218172863394E-5,1.797462E-5,1.8208082E-5,390,1,1,176,1,0.0056818182
395335392,GitchieCheechoo,10,1160,247,191,1,142,41.5924920212,40-49,631,5,19,15,34,34,19,15,7,2.8878473385,212.7074634799,0.0190907828,0.123885918,0.27635327,0,66,1.116867258962227E-4,1.198308E-4,1.2138722E-4,47,38,0,197,0,0
395446247,HenrikSandberg2,10,1861,10174,9901,69,0,42.229248097,40-49,695,6,3,3,6,6,3,3,8,4.0642785403,563.0331209716,2.7389606894786064E-4,0,0,0,66,1.7852637359809444E-4,2.396616E-5,2.4277442E-5,320,0,0,200,0,0
395452946,rfbest,10,38,0,0,0,0,12.8994027935,10-19,128,1,2,2,4,4,2,2,1,1,3101.1217948718,2.3483342487707747E-4,0.0833333333,0.16666667,0,1,8.093582176612495E-5,1.797462E-5,1.8208082E-5,390,0,0,38,0,0
395456938,nicktata88,10,648,120,191,0,515,30.3281842429,30-39,582,4,1,1,2,2,1,1,1,1,0,7.49471721243357E-5,0,0,375,686,2.9852402567743944E-4,1.198308E-5,1.2138721E-5,385,2,0,197,0,0
395475144,TreenDream,10,20,80,772,0,0,20.2352449031,20-29,311,3,1,24,25,25,1,24,7,2.8533645798,2.0911625781,0.0012920165,0.2533333333,0.42028984,0,66,5.205340031169462E-5,1.198308E-5,1.2138721E-5,372,0,1,20,1,0.05
395484715,BarryLoewen1,10,3209,256,501,15,12,42.8724775589,40-49,651,6,24,73,97,97,24,73,7,2.3916973552,365.4941128188,0.0373717867,0.1450816151,0.31668332,0,66,9.861491038219097E-5,1.497885E-4,1.5173401E-4,47,13,1,201,1,0.0049751244
395691956,_A_Singh,10,2048,280,486,15,2,43.0178754654,40-49,638,6,64,83,147,147,64,83,6,2.4626715768,784.7700164563,0.071152061,0.1290653248,0.37692747,0,66,2.9743510443570946E-4,3.8945008E-4,3.9450845E-4,140,19,2,200,2,0.01
395810455,Falconlady7,10,26702,1126,941,23,1651,37.8869336027,30-39,761,9,24,13,37,37,24,13,7,2.7231335788,46.6221924998,0.0359591734,0.1171171171,0.39384615,0,66,9.551716007610714E-5,1.497885E-4,1.5173401E-4,47,4,0,200,0,0
395853126,petjamwil,10,6309,377,758,5,128,43.6033604533,40-49,688,7,40,87,127,127,40,87,6,2.2618011383,852.3640247128,0.0651245635,0.1067991501,0.34696606,0,66,1.4426666316797777E-4,2.4565315E-4,2.4884377E-4,47,12,1,201,1,0.0049751244
396099486,HenrikSandberg3,10,1838,3683,4025,38,0,40.5343647636,40-49,642,6,2,2,4,4,2,2,8,4.109139605,287.1317794177,1.8623142476212776E-4,0,0,0,66,1.2653078673569365E-4,1.797462E-5,1.8208082E-5,320,0,0,200,0,0
396745864,GailRhyno,10,2834,182,320,4,595,38.5233366663,30-39,656,6,31,39,70,70,31,39,7,2.5734851021,317.7485457911,0.0468487956,0.0826086957,0.33942413,0,66,1.3233120768242786E-4,1.9172928E-4,1.9421954E-4,47,5,4,200,4,0.02
396794234,nickpoveda,10,3867,336,246,1,285,43.6400426254,40-49,708,6,0,0,0,0,0,0,0,0,0,0,0,0,350,641,4.4780486537007367E-5,0,0,359,3,0,199,0,0
397019549,GensofHope,10,874,735,873,6,34,44.7204301914,40-49,619,5,2,9,11,11,2,9,7,3.0388349515,41.6474146595,6.140793158030386E-4,0.0818181818,0.19444445,0,66,5.173160932728258E-5,1.797462E-5,1.8208082E-5,372,21,0,200,0,0
397232213,jaredjaywesley,10,65,16,111,0,0,18.1376993648,10-19,97,2,2,19,21,21,2,19,7,2.8724472715,0.5584896974,0.0070731747,0.3238095238,0.6403509,0,66,6.076479078357097E-5,1.797462E-5,1.8208082E-5,372,0,0,68,0,0
397288315,ChrisMcDonald__,10,1163,153,282,5,75,36.0207551348,30-39,558,5,22,49,71,71,22,49,7,2.5908938735,819.7059047796,0.024721136,0.1283702213,0.33236575,0,66,1.4149965789022663E-4,1.3780541E-4,1.395953E-4,390,1,0,200,0,0
397393302,rawaonca,10,168,6,67,0,38,20.7279208449,20-29,391,3,0,10,10,10,0,10,7,2.8527443106,0,0,0.3222222222,0.45555556,0,390,4.4780486537007367E-5,0,6.0693606E-6,140,0,0,172,0,0
397488530,BLacey12,10,2234,173,141,2,5,44.7767696108,40-49,638,6,24,16,40,40,24,16,6,2.8319383997,130.6699656326,0.0151537883,0.1423076923,0.41264367,0,66,1.3929866227402573E-4,1.497885E-4,1.5173401E-4,372,31,0,200,0,0
397543166,jragland96,10,14,48,70,0,0,21.346206605,20-29,320,1,2,1,3,3,2,1,2,1.5,0,1.514327029770266E-4,0.1666666667,1,110,224,2.985240256774394E-4,1.797462E-5,1.8208082E-5,106,6,0,18,0,0
397656856,alexalanegray,10,10285,397,450,0,1659,43.4052730684,40-49,715,7,4,4,8,8,4,4,2,1.3333333333,0,3.217667102775563E-4,0.1071428571,1,264,497,1.8139525519436552E-4,2.99577E-5,3.0346804E-5,261,32,0,201,0,0
398028301,Joncalon,10,1309,46,94,0,33,31.7972030723,30-39,623,6,1,2,3,3,1,2,8,3.437562772,0.3822427141,4.340938659049779E-4,0,0,0,66,4.8369062644149766E-5,1.198308E-5,1.2138721E-5,372,3,0,200,0,0
398307307,FrahmBahmb,10,1435,121,129,0,101,39.0190830795,30-39,625,5,1,1,2,2,1,1,1,1,0,7.49471721243357E-5,0,0,158,311,2.9852402567743944E-4,1.198308E-5,1.2138721E-5,159,18,0,200,0,0
398326897,meredth_seymour,10,1119,145,203,0,1561,34.5469686655,30-39,574,5,2,2,4,4,2,2,1,1,1,1.514327029770266E-4,0.0833333333,0.5,110,224,3.8755706676916064E-4,1.797462E-5,1.8208082E-5,106,7,0,199,0,0
398380924,DouglasDolores,10,38,7,50,0,0,12.0125759127,10-19,17,2,1,5,6,6,1,5,7,3.0890525611,0.6697289681,3.845771106898282E-4,0.4,0.6,0,66,4.8860267099825625E-5,1.198308E-5,1.2138721E-5,390,0,0,39,0,0
398688825,h_mulligan,10,4738,618,957,15,369,46.004833533,40-49,692,7,30,60,90,90,30,60,6,2.4445932374,932.8480147683,0.0436082228,0.0988764045,0.31721312,0,66,1.5572711994186537E-4,1.8573774E-4,1.8815018E-4,140,12,0,200,0,0
398778457,BrianStorsethMP,10,313,806,590,32,0,46.0888881899,40-49,637,4,85,71,156,156,85,71,6,2.6464680281,1663.0195340625,0.094723554,0.1256823821,0.27862078,0,66,7.547133561833384E-4,5.1527243E-4,5.1589566E-4,372,7,15,200,15,0.075
398897629,awanderingsky,10,2270,83,336,2,0,30.4299759843,30-39,599,6,0,3,3,3,0,3,7,3.280789826,0,0,0.3333333333,0.33333334,0,341,4.4780486537007367E-5,0,6.0693606E-6,140,0,0,200,0,0
399238624,FireMcGuinty,10,29,22,190,0,0,17.7660810424,10-19,152,2,4,32,36,36,4,32,7,2.7110813525,63.4744218527,0.002655438,0.3341269841,0.58235294,0,66,5.636751216370427E-5,2.99577E-5,3.0346804E-5,372,1,0,30,0,0
399253284,debbiepalm44,10,12046,377,590,10,42,49.2217389423,40-49,692,8,32,42,74,74,32,42,6,2.4670237697,341.8284695456,0.0388956628,0.0844131803,0.30357143,0,66,1.1490892922630905E-4,1.9772082E-4,2.0028891E-4,47,17,5,209,4,0.023923445
399360633,durhamndp,10,1098,312,79,7,0,44.7203886162,40-49,658,6,103,32,135,135,103,32,7,2.7529293606,1693.5054501128,0.1019115438,0.1551686014,0.29946604,0,66,4.235938659013685E-4,6.2312017E-4,6.2514417E-4,390,87,6,201,6,0.0298507463
399371605,VivianBell1,10,828,24,60,2,267,27.5854617462,20-29,407,5,0,4,4,4,0,4,7,3.1676706827,0,0,0.3333333333,0.5,0,645,4.4780486537007367E-5,0,6.0693606E-6,47,0,1,200,1,0.005
399714083,GLV213,10,2522,31,38,0,5,40.4752935455,40-49,656,6,2,2,4,4,2,2,7,3.8484848485,65,1.5312859926170088E-4,0,0,30,104,2.3749429115861408E-4,1.797462E-5,1.8208082E-5,315,43,0,203,0,0
399723827,j35baller,10,17141,1065,2001,28,36,35.1824068086,30-39,764,8,123,202,325,325,123,202,6,2.2058921995,14525.2384772917,0.1701277379,0.0708262108,0.22827914,0,66,4.046746672806705E-4,7.4295094E-4,7.526007E-4,47,18,0,199,0,0
400019874,vraicroyant,10,6136,213,572,4,2294,31.7274643388,30-39,614,7,0,1,1,1,0,1,7,3.0850066934,0,0,0,0,0,248,4.4780486537007367E-5,0,6.0693606E-6,47,2,0,198,0,0
400144770,thedrachms,10,31,6,13,1,0,14.1059510478,10-19,17,0,1,2,3,3,1,2,1,1,0,7.698416819939779E-5,0.1666666667,0.5,0,1,7.917821274201192E-5,1.198308E-5,1.2138721E-5,390,0,0,33,0,0
400419867,995mu,10,10040,31,29,0,472,29.7503205708,20-29,622,7,5,4,9,9,5,4,7,3.1603615668,5.6452597673,0.0106436353,0.2083333333,0.3472222,0,66,6.21272234474061E-5,3.594924E-5,3.6416164E-5,140,16,0,203,0,0
400768822,Spakwus,10,3776,529,1505,6,1829,46.0472558709,40-49,638,7,37,71,108,108,37,71,7,2.4991630398,1445.8241049644,0.0346042266,0.0739010038,0.2551308,0,66,1.8244634479808676E-4,2.2767852E-4,2.306357E-4,47,11,0,199,0,0
400836180,PatrickS71,10,5008,246,204,9,19,45.7138968583,40-49,651,7,55,61,116,116,55,61,6,2.4861064613,616.9343822216,0.0707404316,0.1288605697,0.37775493,0,66,2.3939034289448564E-4,3.3552625E-4,3.398842E-4,390,16,1,200,1,0.005
401614276,IAMAW2323,10,7497,395,387,2,0,38.9916248341,30-39,649,6,16,23,39,39,16,23,7,2.7227987948,1585.1040942142,0.0201412902,0.1018893387,0.26108375,0,66,1.0801843505859846E-4,1.0185618E-4,1.0317913E-4,390,10,0,200,0,0
401651305,Anon_GovWatchCA,10,31291,5749,3254,219,4405,55.5121096938,50-59,874,9,343,259,602,602,343,259,6,2.1499832608,83131.6349144322,0.3118361722,0.0391291369,0.14082117,0,66,0.0010824738,0.0020610897,0.0020878601,47,311,0,201,0,0
402042795,Wwilyman,10,2622,117,1037,1,191,27.0548992206,20-29,581,6,13,116,129,129,13,116,6,2.3264144627,447.4315602713,0.0200880425,0.1736918605,0.29183877,0,66,7.716061958630566E-5,8.388156E-5,8.497105E-5,140,0,0,200,0,0
402172664,KevinGDraper,10,167,48,138,1,1,38.8219322721,30-39,509,4,14,36,50,50,14,36,7,2.651155005,448.7375956462,0.0153503554,0.1640816327,0.3974359,0,66,8.409903629604683E-5,8.98731E-5,9.104041E-5,140,9,0,201,0,0
403007460,ZDuhaimeDMJ,10,7779,447,258,2,481,47.2333524769,40-49,698,7,0,1,1,1,0,1,1,1,0,0,0,0,37,119,4.4780486537007367E-5,0,6.0693606E-6,34,2,0,201,0,0
403372214,RiverdaleBoy,10,1349,45,59,0,31,41.4975465617,40-49,615,5,4,2,6,6,4,2,7,3.0980917308,0.5481022038,0.0034197524,0.3,0.33333334,0,66,5.064847961160404E-5,2.99577E-5,3.0346804E-5,140,15,0,200,0,0
403467578,FreedomTweetCA,10,2100,658,751,2,41,44.320724492,40-49,639,5,5,5,10,10,5,5,7,3.0462002009,128.1021994396,0.0036923273,0.0111111111,0.1,0,66,8.130511087871044E-5,3.594924E-5,3.6416164E-5,47,22,0,200,0,0
403689317,PatRonayne7,10,1552,165,174,0,113,41.3977159033,40-49,679,6,6,7,13,13,6,7,1,1,0,4.977388905364672E-4,0.1346153846,0.85714287,46,134,1.6498109788469208E-4,4.194078E-5,4.2485524E-5,102,28,0,197,0,0
403738810,NoRelishPlease,10,6885,387,932,7,152,47.5192186049,40-49,717,7,16,33,49,49,16,33,7,2.7408771342,353.4864488354,0.0125822962,0.1198979592,0.33888888,0,66,9.684545950102759E-5,1.0185618E-4,1.0317913E-4,140,17,0,200,0,0
403804341,TaushaMichaud,10,120,72,403,1,0,16.5109541068,10-19,222,3,4,21,25,25,4,21,6,2.7284901239,23.9240293072,0.0062056666,0.2183333333,0.49761903,0,66,6.182947233851763E-5,2.99577E-5,3.0346804E-5,372,0,0,120,0,0
403813939,LibFail99,10,6802,802,1034,20,102,48.3435157763,40-49,753,7,99,142,241,241,99,142,6,2.2942751925,19589.4964739233,0.0566828255,0.0502593361,0.19916345,0,66,4.5096801560423166E-4,5.99154E-4,6.0693605E-4,372,29,0,198,0,0
404349157,CascadeTessa,10,17270,571,1226,17,592,37.1612577577,30-39,733,8,51,102,153,153,51,102,7,2.3880147305,1445.1157700596,0.0710890562,0.08875129,0.235164,0,66,1.874630813598067E-4,3.1156008E-4,3.1560674E-4,47,4,0,201,0,0
404385781,Larry_Smithh,10,5848,335,371,1,1207,35.7726814074,30-39,729,7,8,6,14,14,8,6,8,4.6591898226,6085.8666666667,6.918425308192548E-4,0.1043956044,0.625,0,66,4.1535431548845084E-4,5.392386E-5,5.4624245E-5,31,60,0,202,0,0
404402803,SeoCustomer,10,1191,5626,5841,54,0,41.6572291234,40-49,670,6,4,4,8,8,4,4,8,4.0639437563,5535.6926182602,3.5052186364799883E-4,0.0178571429,0.16666667,0,66,2.3985127980863705E-4,2.99577E-5,3.0346804E-5,320,0,0,199,0,0
404420419,IMPAdvertising,10,7504,1009,842,14,410,38.8002931663,30-39,741,8,3,4,7,7,3,4,8,4.0425175762,942.7171568488,2.6702587155606576E-4,0.0238095238,0.16666667,0,66,1.485912273975616E-4,2.396616E-5,2.4277442E-5,320,81,0,201,0,0
404472305,randy_caine,10,551,61,114,0,9,26.278996385,20-29,528,5,2,5,7,7,2,5,7,3.0810177436,6.1632558739,2.5273856608949534E-4,0.1428571429,0.3,0,66,5.145644062078954E-5,1.797462E-5,1.8208082E-5,55,4,0,200,0,0
404689659,unitate_fortior,10,149,164,14,0,1,24.021687296,20-29,429,3,0,1,1,1,0,1,2,1.6666666667,0,0,0,0,0,605,4.4780486537007367E-5,0,6.0693606E-6,338,2,0,147,0,0
404973272,VanNewsWatcher,10,175,11,59,0,12,12.405003059,10-19,368,2,1,7,8,8,1,7,7,3.2035487111,0,0.0016863791,0.3392857143,0.48214287,0,66,4.553966086114525E-5,1.198308E-5,1.2138721E-5,55,0,0,174,0,0
405207165,PaddyMcHenry_7,10,7931,485,588,0,119,42.1060747267,40-49,715,7,5,7,12,12,5,7,2,1.3,5.8333333333,3.983746533075728E-4,0.1515151515,0.4642857,2,183,1.2923444806506432E-4,3.594924E-5,3.6416164E-5,322,4,0,197,0,0
405695721,Jenellsaphid,10,3839,90,266,4,20,28.4294592928,20-29,597,6,3,4,7,7,3,4,7,2.9474389019,0.5618448155,0.0051103252,0.1666666667,0.55,0,66,4.995319073491694E-5,2.396616E-5,2.4277442E-5,47,1,0,199,0,0
405986825,joanmuise,10,176,21,99,0,6,20.8986293265,20-29,312,4,1,4,5,5,1,4,7,3.3036491463,0.4858685766,1.431041613649883E-4,0.15,0.33333334,0,66,5.022489604991657E-5,1.198308E-5,1.2138721E-5,140,4,1,190,1,0.0052631579
406294981,RayMcLennan1,10,13116,671,1082,5,74,38.1868510643,30-39,664,7,9,15,24,24,9,15,7,2.6337462337,212.5270738291,0.0108368951,0.0507246377,0.16666667,0,66,7.436757069406228E-5,5.99154E-5,6.069361E-5,372,3,0,201,0,0
406579529,ArezooC,10,643,23,89,0,556,18.198372495,10-19,456,4,1,1,2,2,1,1,8,3.5413458319,0,6.442423900301305E-4,0.5,1,0,66,4.640878291292658E-5,1.198308E-5,1.2138721E-5,140,3,0,198,0,0
408143683,DylanFinlay,10,206,112,247,0,26,40.1586583415,40-49,499,4,7,22,29,29,7,22,7,2.7288249079,3527.0186823945,0.0062001132,0.1748768473,0.39130434,0,66,6.697333919355555E-5,4.793232E-5,4.8554884E-5,140,64,0,199,0,0
408257459,jackshope,10,1006,62,162,1,47,34.9603038601,30-39,577,5,8,20,28,28,8,20,7,2.6866421158,15.534940217,0.0147083138,0.0899470899,0.28421053,0,66,6.543884068344153E-5,5.392386E-5,5.4624245E-5,55,21,0,200,0,0
408765727,PJPartington,10,795,219,474,5,1,44.7635467062,40-49,621,5,25,40,65,65,25,40,7,2.4988282558,867.109616997,0.031302473,0.1072115385,0.2670068,0,66,2.5106925578600515E-4,1.5578004E-4,1.5780337E-4,55,18,0,200,0,0
408867671,BCummings945,10,1136,93,515,1,14,40.3798686347,40-49,571,6,21,61,82,82,21,61,7,2.4442584533,214.2136486675,0.0329500649,0.133092442,0.33579236,0,66,9.916578017497877E-5,1.3181388E-4,1.3352593E-4,47,3,3,201,3,0.0149253731
408952647,Eastofrockies,10,1798,938,1989,6,252,32.5687848586,30-39,643,6,7,17,24,24,7,17,7,2.8115165718,102.2790852052,0.006000795,0.0615942029,0.18014705,0,66,6.579144540457366E-5,4.793232E-5,4.8554884E-5,140,9,0,199,0,0
409401081,Progressivista,10,508,402,740,12,6,27.4700041175,20-29,577,5,70,107,177,177,70,107,6,2.380314697,2150.5258459452,0.0903208157,0.1153055984,0.32996824,0,66,3.095023545885693E-4,4.2539934E-4,4.309246E-4,390,5,1,200,1,0.005
409740980,_LCarlson,10,354,284,119,7,1,40.2141389974,40-49,610,4,31,22,53,53,31,22,6,2.8289253432,73.4003909658,0.0236981727,0.1669085631,0.514936,0,66,2.4256060627167434E-4,1.9172928E-4,1.9421954E-4,372,3,1,200,1,0.005
409886625,JanieceStaton,10,69227,611,742,37,130,42.8750288308,40-49,727,10,4,4,8,8,4,4,7,3.2199531302,228.7472915554,7.969711191613436E-4,0.0357142857,0.06666667,0,66,9.505472391790929E-5,2.99577E-5,3.0346804E-5,47,2,0,201,0,0
411294090,DylanParsons14,10,1551,5384,210,1,642,42.089302907,40-49,655,5,0,0,0,0,0,0,0,0,0,0,0,0,352,644,4.4780486537007367E-5,0,0,361,7,0,200,0,0
411413547,blueeyedmurder,10,1465,52,216,0,5,44.7624122359,40-49,618,6,8,21,29,29,8,21,7,2.6608637429,54.8322016596,0.00769679,0.1133004926,0.2518116,0,66,6.210442089425875E-5,5.392386E-5,5.4624245E-5,390,31,1,202,1,0.004950495
411611799,naxete1989,10,1915,117,153,0,21,36.825954305,30-39,667,6,0,0,0,0,0,0,0,0,0,0,0,0,366,666,4.4780486537007367E-5,0,0,376,26,0,198,0,0
411928135,CareyJacobs23,10,58,20,50,0,5,24.5011633034,20-29,290,2,2,1,3,3,2,1,2,1.5,0,1.514327029770266E-4,0.1666666667,1,320,579,2.9852402567743933E-4,1.797462E-5,1.8208082E-5,321,10,0,61,0,0
411940861,jd_nudo,10,932,38,122,0,8,26.6644277275,20-29,595,5,0,3,3,3,0,3,7,3.1365461847,0,0,0.5,0.8333333,0,369,4.4780486537007367E-5,0,6.0693606E-6,140,0,0,200,0,0
411965102,ashmartyn,10,2028,1154,243,4,9,50.5961575398,50-59,611,6,23,31,54,54,23,31,7,2.7522597924,662.9619439687,0.0424160589,0.1561844864,0.32875264,0,66,1.9602615835391591E-4,1.4379696E-4,1.4566466E-4,140,12,0,200,0,0
412343347,CPCami,10,9526,285,249,0,603,43.4523211325,40-49,688,7,1,1,2,2,1,1,1,1,0,7.49471721243357E-5,0,0,399,720,2.9852402567743944E-4,1.198308E-5,1.2138721E-5,416,7,0,201,0,0
412692285,ocd007,10,2383,1916,2025,17,8,48.3393047701,40-49,665,5,90,168,258,258,90,168,6,2.2202879143,9254.9479924533,0.1166419381,0.0710795403,0.25221878,0,66,2.960322477572525E-4,5.452301E-4,5.5231183E-4,47,17,2,200,2,0.01
412997002,DallasGarth,10,568,89,343,1,176,24.6661304622,20-29,457,4,0,0,0,0,0,0,0,0,0,0,0,0,62,154,4.4780486537007367E-5,0,0,54,0,0,200,0,0
413246876,aj_smartideas,10,977,55,158,0,122,23.7930447666,20-29,463,5,7,28,35,35,7,28,7,2.5855373284,7.9955925074,0.0110971052,0.2394957983,0.4862069,0,66,5.7614815710187724E-5,4.793232E-5,4.8554884E-5,47,2,0,200,0,0
413381411,nicole_xnicole,10,2010,144,363,0,68,26.7886335241,20-29,548,5,0,0,0,0,0,0,0,0,0,0,0,0,194,373,4.4780486537007367E-5,0,0,189,1,0,199,0,0
413423918,MPJoySmith,10,459,955,472,48,0,47.1088899219,40-49,705,4,49,29,78,78,49,29,7,2.8205557415,1995.7387696491,0.0434973499,0.1292041292,0.2642089,0,66,3.8850262583297994E-4,2.99577E-4,3.0346803E-4,372,67,13,199,13,0.0653266332
414186251,Cow_Palace,10,77,84,515,0,0,28.8648916143,20-29,393,3,1,9,10,10,1,9,7,3.0214261801,2.2545562652,1.461884730652521E-4,0.2666666667,0.5,0,66,4.7758066005273844E-5,1.198308E-5,1.2138721E-5,140,1,0,112,0,0
414199653,j_leckii,10,7042,248,554,0,597,42.7534460536,40-49,702,6,0,0,0,0,0,0,0,0,0,0,0,0,55,145,4.4780486537007367E-5,0,0,45,6,0,201,0,0
414261042,SeldomSmith,10,5037,510,1470,7,34,43.7013074465,40-49,677,7,85,206,291,291,85,206,6,2.1546702377,8382.3373417435,0.1236618274,0.0805664178,0.2249092,0,66,2.634307673129657E-4,5.1527243E-4,5.2196503E-4,47,8,1,200,1,0.005
415063003,BestShaneEver,10,927,62,213,1,70,27.5038645539,20-29,550,5,8,29,37,37,8,29,6,2.5085369936,420.1676815157,0.0188088289,0.1313813814,0.31034482,0,66,9.302787635525933E-5,5.392386E-5,5.4624245E-5,47,0,0,200,0,0
415064973,RyanMcC955,10,4036,397,601,0,563,42.3765813041,40-49,708,7,7,8,15,15,7,8,2,1.2,13.3333333333,5.515612844792898E-4,0.1333333333,0.42222223,2,183,1.5462891842825264E-4,4.793232E-5,4.8554884E-5,322,11,0,200,0,0
415086565,SHNaWz,10,646,235,254,0,277,22.3464977002,20-29,530,5,9,12,21,21,9,12,7,2.7281553398,138.3578959201,0.0141642406,0.0857142857,0.32692307,0,66,8.063481726032703E-5,5.99154E-5,6.069361E-5,372,3,0,199,0,0
415126004,Rolfe_,10,1818,84,430,0,0,29.652809524,20-29,596,6,11,32,43,43,11,32,7,2.5905590894,30.2875171083,0.0195808133,0.1400885936,0.342246,0,66,7.512028672496914E-5,7.189848E-5,7.283233E-5,390,6,2,199,2,0.0100502513
415141537,NoLongerMeSelf,10,9791,299,577,12,103,35.8051452678,30-39,730,8,76,139,215,215,76,139,6,2.2306662203,5605.59265117,0.1237427328,0.0988046077,0.2645731,0,66,2.3677073241885072E-4,4.6134857E-4,4.6734078E-4,47,1,3,200,3,0.015
416083105,AkifaKhan17,10,672,191,252,3,80,25.7984391856,20-29,570,5,0,0,0,0,0,0,0,0,0,0,0,0,196,376,4.4780486537007367E-5,0,0,191,2,0,197,0,0
416324285,HeritageFFA,10,275,85,21,0,0,31.4454957674,30-39,493,2,1,1,2,2,1,1,2,1.5,0,7.645535613750089E-5,0,0,288,537,2.29874507414389E-4,1.198308E-5,1.2138721E-5,332,6,0,200,0,0
416434193,NFSSmith,10,16904,659,1977,12,3961,39.157000957,30-39,708,8,73,107,180,180,73,107,6,2.364579846,2851.6679268175,0.1053298671,0.0862507759,0.2715484,0,66,2.230210864163772E-4,4.4337395E-4,4.491327E-4,47,11,1,201,1,0.0049751244
416699333,Lateralfade,10,429,6,42,0,106,16.3649968361,10-19,147,4,0,5,5,5,0,5,7,3.0438420348,0,0,0.35,0.55,0,171,4.4780486537007367E-5,0,6.0693606E-6,55,0,0,200,0,0
417150122,SharkDancing,10,11858,1270,1133,57,6906,44.6176838378,40-49,778,8,168,163,331,331,168,163,6,2.2785403415,16027.3471290176,0.1982849356,0.0359058867,0.24105382,0,66,5.328753102728459E-4,0.0010125702,0.0010257219,47,137,0,202,0,0
418032965,CPCDouches,10,1212,227,239,1,1,36.2729971574,30-39,612,5,99,78,177,177,99,78,6,2.3742885839,1447.9536005497,0.1220578713,0.1094953775,0.2512736,0,66,2.4527338210694234E-4,5.99154E-4,6.0693605E-4,47,5,3,200,3,0.015
420318827,DavidCarter52,10,731,292,627,25,0,45.3880224182,40-49,560,4,1,4,5,5,1,4,7,3.369936391,16.9836207096,2.5921031551874335E-4,0.1,0.25,0,66,5.69906247607208E-5,1.198308E-5,1.2138721E-5,55,0,1,200,1,0.005
420351613,wildwalkerwoman,10,48413,1371,792,77,1726,52.6527243275,50-59,779,9,21,17,38,38,21,17,7,2.8349514563,331.0644443439,0.0166930439,0.0568990043,0.1923077,0,66,1.321837556379307E-4,1.3181388E-4,1.3352593E-4,47,30,0,201,0,0
420665931,DeeDubbia,10,671,42,78,1,0,21.7431735868,20-29,456,5,2,5,7,7,2,5,7,3.2289923,0.3561643162,0.0043991679,0.3095238095,0.54761904,0,66,5.4983066193524124E-5,1.797462E-5,1.8208082E-5,372,0,0,200,0,0
421226526,MelansonSa,10,809,469,748,5,2,39.8403368771,30-39,621,5,100,133,233,233,100,133,7,2.4074322062,2627.1207450566,0.1213867094,0.1209301465,0.35022342,0,66,4.793330249727008E-4,6.051455E-4,6.130054E-4,390,25,7,200,7,0.035
421246147,munky18t,10,112,31,134,0,0,17.7973244891,10-19,230,2,1,4,5,5,1,4,7,2.968530298,0.283720279,0.0039162934,0.1,0.33333334,0,66,5.034065667458013E-5,1.198308E-5,1.2138721E-5,372,0,0,114,0,0
421369568,ShannanLittle,10,63,22,25,0,10,45.1449515977,40-49,566,4,18,18,36,36,18,18,7,2.7740207566,291.2403901673,0.0099562067,0.0619047619,0.19076923,0,66,1.0713447083249241E-4,1.1383926E-4,1.1531785E-4,390,82,1,205,1,0.0048780488
421482494,TorontoPost,10,17293,40378,2506,11,49,42.6871724849,40-49,763,8,22,22,44,44,22,22,6,2.4971543355,2279.297372894,0.0306881338,0.0359408034,0.2792208,0,66,1.1411714646872328E-4,1.3780541E-4,1.395953E-4,47,19,0,202,0,0
421714996,Joecass14,10,1285,421,279,0,41,40.5492408971,40-49,655,6,7,2,9,9,7,2,1,1,0.25,5.623820519268105E-4,0.3194444444,0.5535714,2,178,2.0633166934554148E-4,4.793232E-5,4.8554884E-5,322,11,0,197,0,0
422365641,Wanuskewin_FLA,10,838,314,541,7,5,42.0600356935,40-49,587,5,52,82,134,134,52,82,6,2.4131235353,1205.49208865,0.0715818169,0.1085175626,0.41162464,0,66,2.4465530043985684E-4,3.175516E-4,3.216761E-4,140,55,6,200,6,0.03
422773751,softgrasswalker,10,54405,762,572,18,152,43.3043560833,40-49,758,9,203,97,300,300,203,97,7,2.4087713425,12654.9159698672,0.248022493,0.0846488294,0.21446277,0,66,6.532173826449288E-4,0.0012222741,0.0012381496,47,120,1,227,1,0.0044052863
422937826,BobsInExile,10,1010,27,105,1,8,18.5257774064,10-19,375,5,3,15,18,18,3,15,7,2.7820555742,0.9752931593,0.0093496926,0.2614379085,0.42647058,0,66,5.627516904312703E-5,2.396616E-5,2.4277442E-5,140,0,2,200,2,0.01
423070189,Sammyvandrunen,10,1068,155,121,0,17,40.561168203,40-49,609,4,1,1,2,2,1,1,1,1,0,7.49471721243357E-5,0,0,180,342,2.9852402567743944E-4,1.198308E-5,1.2138721E-5,176,7,0,199,0,0
423598205,mspratt,10,3432,214,284,11,3,47.7450974598,40-49,690,6,14,21,35,35,14,21,7,2.8918647472,3430.5131865176,0.0220754008,0.1731092437,0.30107528,0,66,1.0176737125409703E-4,8.98731E-5,9.104041E-5,140,9,0,200,0,0
423699169,ToewsVic,10,277,5528,452,162,0,57.5258768244,50-59,873,3,366,60,426,426,366,60,6,2.7763642451,28070.5991531627,0.3111798532,0.0521623861,0.08159514,0,66,0.0023465432,0.0021988952,0.0021789004,372,444,4,200,4,0.02
423717475,Natalie_kelly_,10,2270,432,483,0,137,38.7810764352,30-39,672,6,4,5,9,9,4,5,2,1.5,2.5833333333,3.201507321950349E-4,0.125,0.6,2,183,9.427057794876205E-5,2.99577E-5,3.0346804E-5,322,13,0,199,0,0
423823137,TheRealDamany,10,38927,1214,1996,18,2539,48.6395036785,40-49,766,9,124,149,273,273,124,149,6,2.2838968865,9149.2985235657,0.1511906718,0.0549719888,0.27675918,0,66,3.6959130365509234E-4,7.489425E-4,7.586701E-4,47,442,2,388,2,0.0051546392
423891063,melissajanedube,10,667,151,252,1,148,31.4264376452,30-39,527,4,2,3,5,5,2,3,7,3.1191831269,3108.6816057952,2.0086085768630072E-4,0.05,0.33333334,0,66,1.288312954122692E-4,1.797462E-5,1.8208082E-5,390,1,0,200,0,0
424057610,Mike_Peake,10,38769,720,276,33,311,42.6370450807,40-49,740,9,12,5,17,17,12,5,7,2.9993304319,22.9414616608,0.0109608352,0.1176470588,0.30769232,0,66,8.424174309296387E-5,7.789002E-5,7.8901685E-5,47,15,0,203,0,0
424257469,libertycrucial,10,4004,1400,1896,36,1702,50.5270565675,50-59,733,7,9,9,18,18,9,9,7,2.9665215936,89.6411209984,0.0079372658,0.0392156863,0.121212125,0,66,6.976610450108004E-5,5.99154E-5,6.069361E-5,372,5,0,199,0,0
424265689,maevalebrusq,10,10389,552,379,3,150,37.2397544737,30-39,722,7,7,8,15,15,7,8,6,2.6363636364,102.8595238095,5.988501214017372E-4,0.0666666667,0.48214287,30,104,3.6280421670844404E-4,4.793232E-5,4.8554884E-5,315,10,0,200,0,0
425252248,ProfCyr,10,531,229,247,3,0,40.3477441686,40-49,573,4,13,23,36,36,13,23,7,2.6869768999,10.6941300674,0.0213500922,0.2531746032,0.5997537,0,66,1.0144338624269273E-4,8.388156E-5,8.497105E-5,390,10,1,200,1,0.005
426673015,CCS24h,10,435066,6871,40,103,0,40.2565440219,40-49,769,12,0,0,0,0,0,0,0,0,0,0,0,0,91,198,4.4780486537007367E-5,0,0,86,0,0,202,0,0
426707296,MattInJacques,10,2553,139,259,2,1287,37.7556044623,30-39,574,6,6,13,19,19,6,13,7,2.7147639772,10.7847148872,0.0077752093,0.1871345029,0.510989,0,66,5.779645912159371E-5,4.194078E-5,4.2485524E-5,47,1,0,200,0,0
426739723,wampidsilva,10,1910,75,160,1,70,16.5504634468,10-19,643,6,1,1,2,2,1,1,8,3.4057582859,0,1.7743583294401523E-4,0.5,0.5,0,66,5.0269977913473726E-5,1.198308E-5,1.2138721E-5,47,0,0,200,0,0
426888980,drknssonthedge,10,2351,138,498,0,103,27.3231906522,20-29,468,5,9,18,27,27,9,18,7,2.70840308,18.520598226,0.0138887371,0.1153846154,0.4738562,0,66,6.93140021903941E-5,5.99154E-5,6.069361E-5,47,0,0,200,0,0
426905638,lexyyluv,10,7805,487,709,2,1816,36.4951125221,30-39,714,6,3,3,6,6,3,3,1,1,2,2.310262261392526E-4,0.1,0.6666667,53,143,4.3033909587467686E-4,2.396616E-5,2.4277442E-5,257,23,0,201,0,0
427743419,jimmydawes107,10,123,2,58,0,2,13.4493879176,10-19,83,3,0,10,10,10,0,10,7,3.0066934404,0,0,0.3888888889,0.5222222,0,270,4.4780486537007367E-5,0,6.0693606E-6,140,0,0,157,0,0
427822638,dalesy17,10,209,31,121,0,20,25.5255224833,20-29,441,4,2,3,5,5,2,3,7,3.3327753599,1052.351681377,0.0011318427,0.05,0.33333334,0,66,5.009379781038065E-5,1.797462E-5,1.8208082E-5,390,7,0,200,0,0
427901944,NessaHamilton1,10,1692,768,1569,12,149,47.5620166677,40-49,677,6,169,369,538,538,169,369,6,2.0602611316,27826.6496539694,0.1846290137,0.0572746845,0.17833157,0,66,4.923677026133935E-4,0.0010185618,0.0010317913,47,39,0,200,0,0
428057122,ILiveHereBC,10,5687,275,515,7,67,46.82518399,40-49,686,7,57,79,136,136,57,79,7,2.4077669903,2397.1587108093,0.0662059826,0.0908496732,0.23970297,0,66,1.9070342564491986E-4,3.475093E-4,3.520229E-4,47,15,0,206,0,0
429182236,awjrector,10,585,105,101,4,86,40.5500584431,40-49,615,5,19,15,34,34,19,15,7,3.0703046535,40.9565681212,0.0119614312,0.1595365419,0.6304348,0,66,1.1752419760932737E-4,1.198308E-4,1.2138722E-4,372,7,0,199,0,0
429535598,valadka,10,140,49,115,0,0,15.531667525,10-19,398,3,5,7,12,12,5,7,7,2.7907599598,51.2144858107,0.0127175704,0.0984848485,0.47619048,0,66,6.426165024369353E-5,3.594924E-5,3.6416164E-5,140,0,0,141,0,0
429882018,CooperCeline,10,1508,430,686,8,234,45.3330479961,40-49,662,6,15,26,41,41,15,26,6,2.6893203883,215.3206808084,0.0158898286,0.1353658537,0.2579832,0,66,1.1591085982324415E-4,9.586464E-5,9.710977E-5,140,10,0,201,0,0
430570888,torngatmha,10,85,194,319,1,3,41.2931535827,40-49,516,3,10,13,23,23,10,13,7,3.0385001674,83.5847489736,0.0043391565,0.081027668,0.2857143,0,66,8.626278555428266E-5,6.590694E-5,6.6762965E-5,140,9,1,103,1,0.0097087379
430896247,Tii_Polow972,10,3199,378,323,0,44,47.0377929367,40-49,683,6,3,0,3,3,3,0,0,0,0,2.343914322176142E-4,0,0,30,103,1.9430393103457837E-4,2.396616E-5,0,315,6,0,200,0,0
431323952,MajaRabasovic,10,6637,176,496,2,893,38.2355036024,30-39,727,7,5,6,11,11,5,6,7,3.2919317041,46.7297178024,0.0047317974,0.1090909091,0.20833333,0,66,6.122531020542295E-5,3.594924E-5,3.6416164E-5,140,16,0,200,0,0
431504592,Russell_Barth,10,16262,294,338,7,440,19.7085571482,10-19,710,8,40,27,67,67,40,27,7,2.6581854704,2207.1347676288,0.0481193416,0.1223428313,0.31254902,0,66,1.4144715849948478E-4,2.4565315E-4,2.4884377E-4,47,47,0,227,0,0
431677460,MPeters74,10,1494,74,90,1,13,31.9203976879,30-39,592,5,12,22,34,34,12,22,7,2.8449949782,194.6301013654,0.0079205418,0.1221033868,0.35666665,0,66,9.252029376029987E-5,7.789002E-5,7.8901685E-5,372,0,0,200,0,0
431867067,allisoncorey,10,2305,230,770,1,257,42.222640512,40-49,628,5,18,87,105,105,18,87,6,2.41680616,2128.166915734,0.0136731591,0.1541208791,0.30187267,0,66,1.0210041975986707E-4,1.1383926E-4,1.1531785E-4,372,8,0,200,0,0
431886597,jacob_chalkley,10,1384,156,145,0,22,41.9958749948,40-49,651,5,6,7,13,13,6,7,1,1,0,4.977388905364672E-4,0.1346153846,0.85714287,46,134,1.6498109788469208E-4,4.194078E-5,4.2485524E-5,102,16,0,196,0,0
431971226,WhiteCoco80,10,3142,178,111,1,10,48.8017002206,40-49,702,7,14,8,22,22,14,8,7,3.3046534985,90.4941499944,0.0072876359,0.0714285714,0.1875,0,66,9.95428644921527E-5,8.98731E-5,9.104041E-5,390,43,0,201,0,0
432108764,mmbeau,10,997,185,267,0,243,41.3216096425,40-49,599,4,0,1,1,1,0,1,2,1.5,0,0,0,0,401,726,4.4780486537007367E-5,0,6.0693606E-6,413,20,0,198,0,0
432141753,goaliegirlmom31,10,236,91,148,1,14,20.2136591769,20-29,383,4,4,9,13,13,4,9,7,2.9059256779,30.9766064059,0.0028180228,0.108974359,0.33333334,0,66,5.748161970896257E-5,2.99577E-5,3.0346804E-5,390,1,0,200,0,0
432940862,blanca_ure,10,1373,182,221,0,51,40.5755636497,40-49,687,6,4,4,8,8,4,4,1,1,0,3.186255976075631E-4,0.1071428571,1,319,578,2.985240256774394E-4,2.99577E-5,3.0346804E-5,323,43,0,200,0,0
432957230,TFraser2,10,611,111,442,1,20,54.3387892098,50-59,493,5,1,7,8,8,1,7,7,2.9290257784,1021.3651226378,0.002419264,0.1428571429,0.23809524,0,66,4.794597780917101E-5,1.198308E-5,1.2138721E-5,140,0,0,199,0,0
433690691,dashriprock87,10,888,59,111,0,6,25.3780120253,20-29,606,5,4,2,6,6,4,2,8,3.1677268162,1.1820110372,0.0046351609,0.1333333333,0.4,0,66,5.075713307697882E-5,2.99577E-5,3.0346804E-5,390,2,0,200,0,0
433867215,JehCOh13,10,3554,401,541,3,1019,44.3188509182,40-49,710,6,47,69,116,116,47,69,6,2.3555406763,2118.4296119012,0.0434582425,0.0486506747,0.1952381,0,66,1.8036128046208333E-4,2.8759392E-4,2.913293E-4,47,10,1,200,1,0.005
435094631,Justmax360,10,185,4,26,0,0,11.5576855183,10-19,45,3,0,1,1,1,0,1,7,3.250669344,0,0,0,0,0,288,4.4780486537007367E-5,0,6.0693606E-6,47,0,0,194,0,0
435112555,iInfinite1D,10,5120,767,1120,3,4009,35.8197703933,30-39,704,7,4,4,8,8,4,4,1,1,0,3.186255976075631E-4,0.1071428571,1,319,578,2.985240256774394E-4,2.99577E-5,3.0346804E-5,323,84,0,200,0,0
435707754,Mikoshoes17,10,12779,388,787,4,375,37.4013851166,30-39,695,8,94,177,271,271,94,177,6,2.2159357215,4209.9687678066,0.1223338655,0.0949432828,0.28996968,0,66,2.635782475145261E-4,5.691963E-4,5.7658926E-4,47,29,0,207,0,0
436158344,SA_Ball,10,106,29,179,0,0,13.2918299397,10-19,254,3,1,3,4,4,1,3,7,3.6216125795,2988,7.49471721243357E-5,0.0833333333,0.33333334,0,71,1.0912479197109002E-4,1.198308E-5,1.2138721E-5,372,0,0,115,0,0
436366250,DanielleDozier,10,4038,1489,114,53,67,55.1916790334,50-59,739,6,0,0,0,0,0,0,0,0,0,0,0,0,362,660,4.4780486537007367E-5,0,0,371,1,0,200,0,0
436985128,PeteHelfrich,10,975,239,442,6,5,28.4148377055,20-29,606,5,19,43,62,62,19,43,7,2.5691329093,299.4998794067,0.0182873209,0.1084082496,0.3020202,0,66,1.1374668901943338E-4,1.198308E-4,1.2138722E-4,372,3,1,200,1,0.005
437055633,TylerPaquette19,10,227,73,82,0,3,30.9120322417,30-39,502,4,10,16,26,26,10,16,7,2.7716772682,8.4087080073,0.0110933116,0.2030769231,0.50789475,0,66,7.261488962148524E-5,6.590694E-5,6.6762965E-5,140,12,0,200,0,0
437673995,lorabruncke,10,29816,690,789,20,9501,44.5246300209,40-49,762,9,75,81,156,156,75,81,7,2.3719450954,3499.7454356731,0.106292886,0.0986352357,0.3204396,0,66,2.258892437745586E-4,4.5535705E-4,4.612714E-4,47,17,0,211,0,0
438398549,PJWillemsen,10,771,126,227,3,5,29.2534466998,20-29,471,5,1,1,2,2,1,1,1,1,0,7.49471721243357E-5,0,0,220,417,2.9852402567743944E-4,1.198308E-5,1.2138721E-5,219,5,0,200,0,0
438556331,rastalam,10,726,122,318,2,5,40.8984616751,40-49,565,4,24,57,81,81,24,57,7,2.5246066287,597.5950469113,0.0319878764,0.100617284,0.32456142,0,66,1.1010348046836157E-4,1.497885E-4,1.5173401E-4,47,20,0,200,0,0
438922660,CeibaGroup,10,79,65,151,0,0,18.4448838664,10-19,124,3,0,0,0,0,0,0,0,0,0,0,0,0,140,278,4.4780486537007367E-5,0,0,137,1,0,107,0,0
439313680,michaelcwheeler,10,3441,974,801,23,348,50.2301778141,50-59,694,6,20,51,71,71,20,51,7,2.5959156344,729.2063075533,0.0219483682,0.1561368209,0.30539396,0,66,1.1846173737158542E-4,1.2582233E-4,1.2745657E-4,390,22,1,200,1,0.005
441973833,TwitTwitCat,10,1145,93,170,1,37,40.8432314519,40-49,542,5,10,16,26,26,10,16,7,2.7388684299,260.2285529776,0.0098553426,0.1015384615,0.35661766,0,66,9.03989707963156E-5,6.590694E-5,6.6762965E-5,55,10,0,200,0,0
442249363,god_sucks,10,19245,3552,450,106,228,48.2521802749,40-49,865,9,20,9,29,29,20,9,7,2.9591563442,5673.3448543596,0.015632575,0.0369458128,0.1368421,0,66,2.0365963263390942E-4,1.2582233E-4,1.2138722E-4,47,62,0,201,0,0
442383920,OccupyNerds,10,19712,793,736,26,240,37.7332825731,30-39,659,8,45,36,81,81,45,36,6,2.494810847,1884.3646090515,0.0484751469,0.0612654321,0.22360483,0,66,1.8122473460474754E-4,2.7561083E-4,2.791906E-4,47,7,0,208,0,0
442407662,jetsshadow49,10,2329,97,450,1,38,42.6386525553,40-49,561,6,25,107,132,132,25,107,7,2.3933712755,861.7955499501,0.037566744,0.1509946796,0.30317637,0,66,1.1585799943944578E-4,1.5578004E-4,1.5780337E-4,47,14,0,199,0,0
442824167,LePoliticard,10,11806,600,600,5,46,34.8726269487,30-39,699,8,20,23,43,43,20,23,7,2.6213592233,1295.6649456263,0.0155207084,0.0897009967,0.24596775,0,66,1.307656748905158E-4,1.2582233E-4,1.2138722E-4,390,8,2,199,2,0.0100502513
442832919,LeblancMiguel,10,3178,106,380,2,8,45.3729994594,40-49,602,6,12,50,62,62,12,50,6,2.4944760629,293.6100669865,0.0260968935,0.2078265468,0.4709653,0,66,1.0214439473598057E-4,7.789002E-5,7.8901685E-5,390,15,0,200,0,0
442860890,LuciaSanchezF,10,11870,589,534,2,388,39.3948917219,30-39,747,7,2,2,4,4,2,2,2,1.7142857143,0,1.6074436856700487E-4,0.0833333333,1,52,142,1.7007939231578067E-4,1.797462E-5,1.8208082E-5,316,39,0,202,0,0
443347925,patthomson19,10,667,243,207,1,152,40.1977640717,40-49,629,5,4,4,8,8,4,4,7,2.9514563107,0.8601820361,0.0050167125,0.1071428571,0.5,0,66,6.361491487791058E-5,2.99577E-5,3.0346804E-5,372,17,1,196,1,0.0051020408
443448249,hanline_,10,691,44,144,1,2,36.0839071387,30-39,525,5,4,6,10,10,4,6,7,2.9370605959,5.5391209275,0.0035239221,0.1555555556,0.22222222,0,66,5.1426946959664815E-5,2.99577E-5,3.0346804E-5,390,14,2,200,2,0.01
443655020,CoyoteDreams,10,4002,211,259,4,916,33.1905498315,30-39,648,7,16,14,30,30,16,14,7,2.7726816204,357.1977803804,0.0190788348,0.1367816092,0.29166666,0,66,8.756766947860485E-5,1.0185618E-4,1.0317913E-4,47,2,0,200,0,0
443804372,mrwclarkson,10,9927,843,1065,11,39,47.6491971227,40-49,716,7,21,33,54,54,21,33,6,2.4914630064,181.9466000284,0.0325310865,0.1044723969,0.41443852,0,66,9.87893496886271E-5,1.3181388E-4,1.3352593E-4,140,8,0,202,0,0
444262205,BravoFourTwenty,10,7103,369,674,0,730,46.3599743796,40-49,735,7,75,78,153,153,75,78,6,2.3689320388,2232.1077437257,0.1054673393,0.073873409,0.36415884,0,66,2.278032403769364E-4,4.5535705E-4,4.612714E-4,47,46,1,203,1,0.0049261084
444788886,joeyspeigel,10,2992,365,254,0,631,33.8180451008,30-39,684,6,8,8,16,16,8,8,2,1.3846153846,13.9055555556,6.753563495161076E-4,0.0791666667,0.625,26,99,4.098447164967848E-4,5.392386E-5,5.4624245E-5,49,0,0,198,0,0
445580884,TUSKS71,10,1332,57,77,0,10,25.8978888829,20-29,582,5,0,2,2,2,0,2,7,3.344042838,0,0,0.5,0.5,0,434,4.4780486537007367E-5,0,6.0693606E-6,140,3,1,200,1,0.005
446445291,CandlishClown,10,984,52,106,0,5,25.8299215452,20-29,569,4,0,1,1,1,0,1,7,3.2014725569,0,0,0,0,0,275,4.4780486537007367E-5,0,6.0693606E-6,47,1,0,199,0,0
446524341,StraitShooter0,10,717,76,40,1,0,16.575934507,10-19,599,5,10,6,16,16,10,6,7,3.4382323401,33.9583733139,0.0037176254,0.2083333333,0.41666666,0,66,1.1424311494019987E-4,6.590694E-5,6.6762965E-5,372,1,3,200,3,0.015
446682479,PatDeRocH,10,270,108,443,2,0,42.5215626065,40-49,540,4,12,44,56,56,12,44,6,2.4512889186,142.7106190021,0.0169732118,0.212012987,0.35218704,0,66,7.780176816857693E-5,7.789002E-5,7.283233E-5,140,14,1,201,1,0.0049751244
447436221,jessi_jaja,10,571,188,396,0,36,22.8613874762,20-29,515,5,11,19,30,30,11,19,7,2.750251088,834.5354532021,0.008012516,0.0885057471,0.3,0,66,1.0968735500109812E-4,7.189848E-5,7.283233E-5,55,1,0,200,0,0
448278822,deepstaples,10,344,2,67,0,0,14.0610612502,10-19,325,4,1,2,3,3,1,2,7,3.3521928356,0.1265216851,9.686421906909032E-4,0,0,0,66,5.558289898184132E-5,1.198308E-5,1.2138721E-5,140,0,0,191,0,0
448319574,CSSA_CILA,10,116,278,26,8,0,44.241016424,40-49,647,2,16,5,21,21,16,5,7,3.6441245397,101.6165910352,0.0071313871,0.1452380952,0.26797387,0,66,1.8395491395129245E-4,1.0185618E-4,9.104041E-5,372,61,1,156,1,0.0064102564
448602773,sarapalafox96,10,1642,195,201,1,135,28.8838520496,20-29,573,5,0,0,0,0,0,0,0,0,0,0,0,0,347,634,4.4780486537007367E-5,0,0,356,10,0,193,0,0
448621919,IrenePfister,10,946,82,144,0,541,27.6959541494,20-29,529,4,1,1,2,2,1,1,2,1.5,0,7.645535613750089E-5,0,0,316,574,2.29874507414389E-4,1.198308E-5,1.2138721E-5,328,1,0,200,0,0
449849480,AdamskiPeter,10,2204,76,113,1,12,42.2499519501,40-49,613,5,18,19,37,37,18,19,7,2.7144291932,45.846239333,0.0215156075,0.1276276276,0.29064038,0,66,9.072085416041986E-5,1.1383926E-4,1.1531785E-4,47,20,0,200,0,0
449920911,IamHollySutton,10,13745,383,394,1,2854,21.1836553644,20-29,720,8,0,0,0,0,0,0,0,0,0,0,0,0,211,404,4.4780486537007367E-5,0,0,206,3,0,200,0,0
449955557,brynnbeard,10,4325,119,328,2,601,50.5034307461,50-59,657,7,3,12,15,15,3,12,7,2.8972212923,132.3095356736,0.0022822604,0.1619047619,0.4090909,0,66,6.426045325249627E-5,2.396616E-5,2.4277442E-5,140,25,0,202,0,0
451541694,Web_Analytix,10,23,26,50,0,0,17.2834874196,10-19,36,1,0,1,1,1,0,1,3,2,0,0,0,0,0,264,4.4780486537007367E-5,0,6.0693606E-6,320,0,0,28,0,0
451666832,NuckPup,10,4878,512,184,13,23,43.8699818234,40-49,750,7,0,1,1,1,0,1,1,1,0,0,0,0,0,360,4.4780486537007367E-5,0,6.0693606E-6,47,2,1,200,1,0.005
451714922,carolynhparrish,10,4407,768,967,24,2,39.4610999196,30-39,745,6,191,237,428,428,191,237,7,2.2199531302,20222.3166907719,0.2428835583,0.0406115258,0.19671507,0,66,6.336178208095549E-4,0.0011503757,0.0011653173,47,62,2,200,2,0.01
452957426,Ofarellpol,10,844,198,218,1,204,40.8528806338,40-49,598,5,0,0,0,0,0,0,0,0,0,0,0,0,235,454,4.4780486537007367E-5,0,0,231,18,0,200,0,0
454114632,smell3roses,10,6113,177,363,4,16,35.2921382426,30-39,644,7,75,96,171,171,75,96,6,2.3374623368,2105.0837914622,0.1061284087,0.0657378741,0.2944032,0,66,2.0959327265042732E-4,4.5535705E-4,4.612714E-4,47,31,2,214,2,0.0093457944
454472178,AgLocal30048,10,1180,89,171,0,18,40.4385886832,40-49,575,5,13,33,46,46,13,33,6,2.4921325745,349.3581507674,0.0152673827,0.1342995169,0.28876245,0,66,9.103006250292215E-5,8.388156E-5,8.497105E-5,390,7,0,202,0,0
455081049,anaseoanec,10,2834,94,80,1,36,40.7723447867,40-49,641,6,1,1,2,2,1,1,2,1.8571428571,0,8.262793464540283E-5,0,0,52,142,1.1102577028014864E-4,1.198308E-5,1.2138721E-5,316,11,0,199,0,0
455145030,DomenicShelley,10,805,61,282,0,10,43.2247268359,40-49,610,6,17,97,114,114,17,97,7,2.359558085,544.4982607671,0.0126167116,0.1060394349,0.22186427,0,66,8.345660126582117E-5,1.0784772E-4,1.0924849E-4,47,29,0,201,0,0
455306009,coarirae,10,6598,351,206,0,1709,34.028568002,30-39,719,7,2,2,4,4,2,2,1,1,0,1.529712617250445E-4,0.0833333333,1,365,663,2.985240256774393E-4,1.797462E-5,1.8208082E-5,375,27,0,200,0,0
455627762,SEO_Stream,10,6327,181,73,6,12,41.4104418092,40-49,546,4,0,0,0,0,0,0,0,0,0,0,0,0,388,705,4.4780486537007367E-5,0,0,399,0,0,200,0,0
456209002,RSMacPherson,10,1242,60,158,5,10,30.5760801736,30-39,480,5,3,2,5,5,3,2,7,3.1914964848,77.7380847094,0.0038212309,0.05,0.33333334,0,66,6.270558587581596E-5,2.396616E-5,2.4277442E-5,47,4,0,200,0,0
456776119,jorgedd_91,10,690,47,117,1,1,38.5819919118,30-39,594,5,0,1,1,1,0,1,1,1,0,0,0,0,0,355,4.4780486537007367E-5,0,6.0693606E-6,320,1,0,201,0,0
458053575,osamente,10,18690,1218,782,28,20452,42.5655539843,40-49,765,8,1,1,2,2,1,1,1,1,0,7.49471721243357E-5,0,0,315,570,2.9852402567743944E-4,1.198308E-5,1.2138721E-5,314,5,0,198,0,0
458789217,Desiree_McGraw,10,665,232,423,3,1,41.0658387833,40-49,552,5,19,43,62,62,19,43,7,2.6364245062,132.4161174425,0.0305774825,0.2091485986,0.4,0,66,2.1238761055046652E-4,1.198308E-4,1.2138722E-4,140,9,0,200,0,0
458909421,AlanWHKan,10,1925,83,103,0,84,46.5603656521,40-49,597,6,6,5,11,11,6,5,7,2.9417475728,9.9536788976,0.0100613587,0.0727272727,0.30952382,0,66,6.88280313584518E-5,4.194078E-5,4.2485524E-5,140,4,0,199,0,0
459245980,JaniceLutz,10,57,21,45,0,1,22.878102694,20-29,183,2,1,2,3,3,1,2,7,3.1134917978,0,0.0049463508,0.1666666667,0.5,0,66,5.370319470653586E-5,1.198308E-5,1.2138721E-5,390,3,0,80,0,0
459490133,JeffCorntassel,10,3443,1678,1205,58,45,53.2558689986,50-59,757,7,84,76,160,160,84,76,7,2.5738198862,6977.4799408325,0.0584341957,0.0378930818,0.18938786,0,66,6.220361735623668E-4,5.092809E-4,5.1589566E-4,47,77,0,198,0,0
459561197,Nells18,10,5178,205,355,1,1,43.7012857733,40-49,660,6,0,0,0,0,0,0,0,0,0,0,0,0,185,349,4.4780486537007367E-5,0,0,180,21,0,200,0,0
460172196,HaltonLiberal,10,1254,210,581,7,1,50.9697227515,50-59,591,6,25,62,87,87,25,62,7,2.5684633411,507.4008653033,0.0289766206,0.1475541299,0.38701922,0,66,1.2692037677526307E-4,1.5578004E-4,1.5780337E-4,140,7,4,200,4,0.02
460359684,RussFrey,10,6959,340,641,2,603,34.48695437,30-39,711,7,109,189,298,298,109,189,6,2.2286575159,9413.0511810144,0.1460202463,0.0746390075,0.26360032,0,66,3.162239750731662E-4,6.590694E-4,6.6762965E-4,47,23,0,199,0,0
460413702,SarahAndrews22,10,229,31,95,0,2,16.1096378685,10-19,210,4,12,32,44,44,12,32,7,2.6652159357,9.4947046478,0.014402249,0.2272727273,0.60784316,0,66,8.478287908623472E-5,7.789002E-5,7.8901685E-5,390,2,7,200,6,0.035
461286070,DramaQueencpc,10,1073,748,2000,4,17,40.5769976992,40-49,587,5,0,1,1,1,0,1,7,3.2667336011,0,0,0,0,0,696,4.4780486537007367E-5,0,6.0693606E-6,47,4,0,200,0,0
461633566,PeteSchwarzhoff,10,999,109,285,2,2,40.1441446644,40-49,585,5,23,67,90,90,23,67,7,2.4884499498,275.1068669141,0.0400893955,0.1433208489,0.3468813,0,66,1.3369827538470017E-4,1.4379696E-4,1.4566466E-4,140,9,0,200,0,0
462214859,hampton_stephen,10,2918,673,348,19,41,47.3620016353,40-49,668,6,114,63,177,177,114,63,7,2.5517241379,2825.4153989474,0.1156485694,0.1306497175,0.24577379,0,66,3.6645261242368443E-4,6.890271E-4,6.979765E-4,390,75,1,202,1,0.004950495
462273510,scmackay,10,184,21,174,0,3,32.5632776993,30-39,497,4,5,17,22,22,5,17,7,2.8292601272,50.7491609166,0.003838131,0.2121212121,0.4122807,0,66,7.427986935183217E-5,3.594924E-5,3.6416164E-5,140,7,0,187,0,0
462505887,NiagaraLabour,10,216,82,81,2,0,30.9504501637,30-39,408,4,11,7,18,18,11,7,7,3.0190826917,46.7987860719,0.0084442235,0.1535947712,0.32857144,0,66,9.191236164256597E-5,7.189848E-5,7.283233E-5,390,16,1,200,1,0.005
463015551,Magov25,10,773,138,608,0,6,28.2007999775,20-29,376,5,1,3,4,4,1,3,10,5.6012721794,2.6666666667,7.989890862925799E-5,0.25,0.6666667,0,66,7.391436124808641E-5,1.198308E-5,1.2138721E-5,320,0,0,200,0,0
463489747,APC_CPA,10,1769,1384,1530,42,49,54.8369555498,50-59,733,6,183,200,383,383,183,200,7,2.2731837965,24667.0663998522,0.1792068916,0.0367790795,0.17110428,0,66,6.891880095547062E-4,0.0011024433,0.0011167624,140,330,7,200,7,0.035
463569382,KeratanChiefo,10,2470,167,464,0,72,42.8537721532,40-49,622,6,1,2,3,3,1,2,1,1,1,7.797838132380596E-5,0,0,0,186,2.0086536655335947E-4,1.198308E-5,1.2138721E-5,55,33,0,199,0,0
463794634,guigorresen,10,2675,302,250,0,3,32.7306296197,30-39,693,6,1,1,2,2,1,1,3,2,0,8.111825549662472E-5,0,0,317,575,1.4281514119357714E-4,1.198308E-5,1.2138721E-5,318,1,0,201,0,0
464824122,kimberlygil97,10,1929,174,306,0,45,40.4499580084,40-49,654,6,1,1,2,2,1,1,1,1,0,7.49471721243357E-5,0,0,120,236,2.9852402567743944E-4,1.198308E-5,1.2138721E-5,119,117,0,198,0,0
464918785,TradeEthically,10,117274,2907,2908,85,6,50.7034248976,50-59,718,10,12,15,27,27,12,15,7,2.7288249079,267.5157239117,0.0121728505,0.0341880342,0.12865497,0,66,7.154945180344332E-5,7.789002E-5,7.8901685E-5,47,0,0,201,0,0
464983830,becca_joyyy,10,1283,218,340,1,919,40.8105381162,40-49,613,5,1,1,2,2,1,1,1,1,0,7.49471721243357E-5,0,0,272,515,2.9852402567743944E-4,1.198308E-5,1.2138721E-5,270,20,0,200,0,0
465200547,RangaMorlin,10,25,48,65,0,0,24.9697946373,20-29,327,3,0,1,1,1,0,1,8,3.671352075,0,0,0,0,0,162,4.4780486537007367E-5,0,6.0693606E-6,47,0,0,58,0,0
465446391,MohammedMAlanaz,10,134,16,62,0,0,22.9809264955,20-29,378,3,1,1,2,2,1,1,1,1,0,7.49471721243357E-5,0,0,113,227,2.9852402567743944E-4,1.198308E-5,1.2138721E-5,109,2,0,133,0,0
465539124,nickoszan,10,1684,142,443,0,0,41.0914442873,40-49,634,6,3,4,7,7,3,4,2,1.3333333333,0,2.294722290134075E-4,0.3571428571,0.6666667,250,479,7.486036425287252E-5,2.396616E-5,2.4277442E-5,248,11,0,200,0,0
465629292,DessaNeep_,10,1473,455,138,0,3,32.195795353,30-39,676,5,5,4,9,9,5,4,2,1.2,8.6666666667,3.888912770459726E-4,0.0833333333,0.5,317,575,4.613430376234753E-4,3.594924E-5,3.6416164E-5,318,30,0,200,0,0
466540679,andrewadamu8,10,2876,83,130,0,26,44.3311515802,40-49,664,6,0,0,0,0,0,0,0,0,0,0,0,0,273,518,4.4780486537007367E-5,0,0,271,8,0,200,0,0
466566898,d2mac420,10,4703,702,1038,7,288,33.6788321258,30-39,697,7,99,162,261,261,99,162,6,2.2226314027,3803.4996448296,0.133195124,0.0705128205,0.27708766,0,66,2.7934092334866027E-4,5.99154E-4,6.0693605E-4,47,12,0,199,0,0
466603103,Zircorn,10,1297,172,441,1,70,32.3820615268,30-39,400,5,0,1,1,1,0,1,8,3.4585006693,0,0,0,0,0,286,4.4780486537007367E-5,0,6.0693606E-6,47,2,0,200,0,0
466654340,MariaEspejel,10,2328,437,237,2,199,43.6373300813,40-49,703,6,4,4,8,8,4,4,1,1,0,3.186255976075631E-4,0.1071428571,1,319,578,2.985240256774394E-4,2.99577E-5,3.0346804E-5,323,78,0,200,0,0
466765912,GrittyGorg,10,5305,319,500,8,100,48.4753624884,40-49,707,6,35,62,97,97,35,62,7,2.5095413458,924.5708538156,0.0384638348,0.0842998282,0.29134664,0,66,1.4170763697108168E-4,2.1569544E-4,2.1849698E-4,140,22,1,200,1,0.005
466963666,cunningtonmatt,10,950,118,128,3,0,37.1971841076,30-39,580,5,8,7,15,15,8,7,7,3.156009374,2.5293218781,0.0063972523,0.280952381,0.57051283,0,66,6.809525599966694E-5,5.392386E-5,5.4624245E-5,140,27,2,200,2,0.01
467212067,markcheck99,10,2969,668,2000,6,62,37.816370527,30-39,592,6,51,139,190,190,51,139,6,2.3260796786,5828.857959221,0.0755933951,0.1049011417,0.30508736,0,66,2.352332733638716E-4,3.1156008E-4,3.1560674E-4,47,0,0,200,0,0
468128433,Packer_man,10,8644,708,1951,8,295,42.6045954001,40-49,737,8,14,31,45,45,14,31,7,2.7633076666,621.6610277647,0.0076806864,0.0651515152,0.2139785,0,66,1.181189018645248E-4,8.98731E-5,9.104041E-5,372,17,0,201,0,0
468732172,VanStreetDog,10,868,44,161,0,1,13.7467203342,10-19,349,5,0,0,0,0,0,0,0,0,0,0,0,0,43,128,4.4780486537007367E-5,0,0,36,0,0,199,0,0
468782243,PublishSphere,10,2192,125,420,2,26,39.8824063906,30-39,558,6,17,16,33,33,17,16,7,2.6645463676,59.4285172123,0.0222207242,0.146780303,0.35076922,0,66,8.532774102117754E-5,1.0784772E-4,1.0924849E-4,47,13,1,200,1,0.005
469538872,DBC68,10,53,4,111,0,9,22.3614395686,20-29,113,3,0,1,1,1,0,1,1,1,0,0,0,0,0,197,4.4780486537007367E-5,0,6.0693606E-6,55,0,0,70,0,0
469911910,CodyFields82,10,440,77,238,0,3,40.3553009797,40-49,560,4,0,0,0,0,0,0,0,0,0,0,0,0,144,292,4.4780486537007367E-5,0,0,141,0,0,200,0,0
470691248,BTDiasCAW1459,10,472,16,45,0,7,18.1833835818,10-19,137,4,3,5,8,8,3,5,7,3.046869769,0.2836238069,0.0027470288,0.2321428571,0.73333335,0,66,5.5775328054507096E-5,2.396616E-5,2.4277442E-5,390,0,0,200,0,0
470696857,raincoastmist,10,789,37,80,0,17,22.4585298579,20-29,521,5,6,10,16,16,6,10,7,2.8121861399,2.1562833252,0.0091280032,0.1208333333,0.3181818,0,66,5.815297842670152E-5,4.194078E-5,4.2485524E-5,47,2,0,200,0,0
471078603,msthorpe43,10,1832,128,240,3,0,42.0013362876,40-49,677,6,39,46,85,85,39,46,6,2.5148978909,538.1263319272,0.0684709088,0.1278711485,0.3675304,0,66,1.789318650002756E-4,2.396616E-4,2.4277443E-4,47,14,0,200,0,0
471373072,CarolynBuffalo,10,3494,595,749,13,19,44.6058610295,40-49,631,7,82,82,164,164,82,82,7,2.4630063609,3845.9524679932,0.0703912502,0.0666616789,0.23396227,0,66,3.989428385678955E-4,4.972978E-4,5.037569E-4,47,2,1,194,1,0.0051546392
471744253,Ripplewraith,10,8855,681,1206,12,704,36.2784815437,30-39,737,7,165,272,437,437,165,272,6,2.1526615333,12877.7785763599,0.2128889995,0.0599479353,0.22750223,0,66,4.565841784884832E-4,9.945956E-4,0.0010075138,47,15,0,200,0,0
471915675,SwaranSoftIndia,10,5581,1800,1385,16,8,36.6590759344,30-39,611,6,2,2,4,4,2,2,9,5.0123870104,0,1.6731409340180423E-4,0.0833333333,1,0,66,1.4429347136352738E-4,1.797462E-5,1.8208082E-5,320,40,0,200,0,0
472272419,JamieTFranklin,10,4411,254,678,4,3084,19.1202829618,10-19,580,7,0,0,0,0,0,0,0,0,0,0,0,0,286,535,4.4780486537007367E-5,0,0,282,0,0,200,0,0
472286193,ChrisKirouac,10,52880,488,819,10,11425,56.9173203255,50-59,748,9,91,128,219,219,91,128,6,2.3344492802,2991.4346493148,0.1074696874,0.0688282854,0.29004976,0,66,2.5630871319623933E-4,5.5122166E-4,5.583812E-4,47,91,0,223,0,0
472515859,LiberalCanuck,10,64816,2547,1585,66,6151,57.7863497949,50-59,890,9,61,65,126,126,61,65,6,2.4275192501,7462.689134284,0.0752880152,0.0737142857,0.25730202,0,66,2.4697324114171195E-4,3.7147547E-4,3.7630036E-4,140,86,0,201,0,0
473116327,KeirsteadWin,10,1104,47,95,0,267,40.1299251321,40-49,639,6,2,1,3,3,2,1,7,3.3746233679,3.8358230453,0.0045307165,0,0,0,66,5.386737515611327E-5,1.797462E-5,1.8208082E-5,372,7,0,200,0,0
473169001,jimmyyadig,10,36939,510,1040,2,67,41.6503565301,40-49,778,8,2,8,10,10,2,8,7,2.8754603281,0.0866527409,0.003295012,0.2666666667,0.45833334,0,66,4.7552819304927756E-5,1.797462E-5,1.8208082E-5,47,8,0,201,0,0
473449200,g_e13,10,4750,169,533,6,131,40.6040228277,40-49,622,7,55,146,201,201,55,146,6,2.307331771,1674.3005677577,0.0808518461,0.1004228856,0.28507078,0,66,1.8291407118499123E-4,3.3552625E-4,3.398842E-4,47,14,1,205,1,0.0048780488
473482276,BradLafortune,10,3829,463,876,12,283,48.5163606386,40-49,697,7,90,153,243,243,90,153,6,2.2601272179,10328.3754170598,0.0958878379,0.0751794035,0.22267513,0,66,3.574875055102489E-4,5.452301E-4,5.5231183E-4,390,55,0,200,0,0
473689699,Anonymiss_News,10,30129,13420,110,180,44,48.4757142726,40-49,891,8,16,1,17,17,16,1,1,1,23.4411087773,0.0087953756,0.1397058824,0.2375,0,28,8.776906856735587E-4,1.0185618E-4,9.710977E-5,47,22,0,201,0,0
474510878,westcoastlegion,10,3232,1157,830,16,1505,54.4610881257,50-59,757,7,35,28,63,63,35,28,7,2.7043856712,1979.4286502729,0.026774578,0.069124424,0.3002699,0,66,2.060564962512706E-4,2.1569544E-4,2.1849698E-4,47,42,0,198,0,0
474546826,CharleyCanucky,10,22849,724,1785,5,1092,41.7450497176,40-49,784,9,25,74,99,99,25,74,6,2.4834281888,941.1343662826,0.0256045891,0.1258503401,0.3044466,0,66,1.805930909200322E-4,1.5578004E-4,1.5780337E-4,372,66,36,205,36,0.1756097561
474986645,foodethosfarm,10,614,351,839,12,1,42.462363321,40-49,554,5,3,6,9,9,3,6,7,3.0549045865,32.3167819148,0.0018154725,0.0555555556,0.13333334,0,66,5.34427861415813E-5,2.396616E-5,2.4277442E-5,55,0,0,200,0,0
475223296,zeptepe,10,1759,347,922,12,90,45.64581198,40-49,653,5,15,42,57,57,15,42,7,2.5175761634,2459.0562948479,0.0208115146,0.1484962406,0.4425087,0,66,9.351013020029163E-5,9.586464E-5,9.710977E-5,47,3,0,200,0,0
475308891,iChinadian,10,12997,445,205,22,0,41.5462941251,40-49,735,8,11,7,18,18,11,7,7,2.9360562437,61.8811626798,0.0119020747,0.045751634,0.17424242,0,66,7.329699973660596E-5,7.189848E-5,7.283233E-5,140,17,0,208,0,0
475865837,l4zyl3m0n,10,5424,453,627,7,832,36.1118227971,30-39,694,7,118,144,262,262,118,144,6,2.3344492802,4376.908725426,0.1531075375,0.08743529,0.3130719,0,66,3.184935806090799E-4,7.1299326E-4,7.222539E-4,47,39,0,200,0,0
477043749,AnnTByrne,10,154,1,5,0,0,10.6708586376,10-19,21,3,0,0,0,0,0,0,0,0,0,0,0,0,233,452,4.4780486537007367E-5,0,0,229,0,0,156,0,0
478115584,MattieLemieux,10,584,42,186,1,9,24.3957681927,20-29,462,4,7,42,49,49,7,42,6,2.5882156009,86.5858603731,0.0095143265,0.1840986395,0.3164251,0,66,7.024666148920589E-5,4.793232E-5,4.8554884E-5,390,5,2,200,2,0.01
478862368,CEPinfoSCEP,10,925,714,484,15,0,48.7172792755,40-49,673,4,88,64,152,152,88,64,7,2.510210914,3255.6025454695,0.0814429749,0.0758975253,0.22282797,0,66,3.57326834354466E-4,5.332471E-4,5.401731E-4,390,91,0,200,0,0
479174961,RayleenK,10,13704,338,443,8,2713,37.3702842414,30-39,713,8,35,47,82,82,35,47,6,2.5239370606,245.9561115019,0.0468130349,0.0716651611,0.3180272,0,66,1.1931096581209192E-4,2.1569544E-4,2.1849698E-4,47,9,0,201,0,0
479759692,Marie_Saara,10,5410,463,183,0,59,43.8378990973,40-49,706,6,11,9,20,20,11,9,7,3.0909090909,88.0031746032,9.256181454754797E-4,0.0710526316,0.4090909,30,104,6.035113145857291E-4,7.189848E-5,6.6762965E-5,315,27,0,200,0,0
479771607,NDPHoC_NPDCdC,10,323,1368,194,31,5,44.6257629774,40-49,703,3,262,71,333,333,262,71,7,2.5533980583,3692.8987125245,0.2746496673,0.0929302797,0.18694335,0,66,0.0012738653,0.001575775,0.0015901725,390,53,57,200,56,0.285
480280640,fouadbey,10,149,42,92,1,0,19.247094058,10-19,368,2,0,0,0,0,0,0,0,0,0,0,0,0,368,669,4.4780486537007367E-5,0,0,378,0,0,154,0,0
480897676,shortstuff521,10,577,11,154,0,376,29.7198114896,20-29,495,5,0,10,10,10,0,10,7,3.1151271754,0,0,0.2888888889,0.41111112,0,335,4.4780486537007367E-5,0,6.0693606E-6,55,1,3,201,3,0.0149253731
481033058,CraigerPequeno,10,1564,322,1176,0,150,45.6697253793,40-49,634,6,91,285,376,376,91,285,6,2.1258788082,16502.1657019586,0.1162666773,0.0718865248,0.17967398,0,66,2.5961562891513204E-4,5.5122166E-4,5.583812E-4,47,30,10,199,6,0.0502512563
483577756,daphlipside,10,4590,184,211,4,275,30.2941068949,30-39,680,7,64,36,100,100,64,36,7,2.5189152996,506.7733536336,0.0772946042,0.1470707071,0.27220482,0,66,2.0529115198843355E-4,3.8945008E-4,3.9450845E-4,47,10,2,199,2,0.0100502513
484065654,KuShMaNz,10,315,219,644,1,13,33.4538752896,30-39,530,4,4,7,11,11,4,7,8,3.4198192166,3.8911109887,0.0014836283,0.1181818182,0.5952381,0,66,6.70683382178823E-5,2.99577E-5,3.0346804E-5,47,1,0,200,0,0
484317938,YoTonyCPC,10,209,95,259,3,1,37.9208880195,30-39,450,4,45,121,166,166,45,121,6,2.3324405758,1143.0028694349,0.0579529846,0.0804673238,0.23147383,0,66,1.5137258059374123E-4,2.7561083E-4,2.791906E-4,47,11,2,199,2,0.0100502513
484399810,DaveJHL,10,6,8,96,0,2,12.1265715677,10-19,8,1,2,27,29,29,2,27,7,2.7532641446,10.0554744016,0.0042436938,0.3706896552,0.64021164,0,66,5.278267107099271E-5,1.797462E-5,1.8208082E-5,390,0,1,9,1,0.1111111111
485043632,1_Car_Guy,10,17046,924,2000,16,1129,39.1541407478,30-39,763,8,25,71,96,96,25,71,6,2.4057582859,1500.0007293191,0.0311485431,0.145504386,0.34017545,0,66,1.478350734971075E-4,1.5578004E-4,1.5780337E-4,140,13,0,200,0,0
485063311,PaulaCornell5,10,1171,503,1287,10,106,48.2211897906,40-49,642,5,6,17,23,23,6,17,7,2.828255775,26.1383595965,0.0052022501,0.0909090909,0.25735295,0,66,6.509753254594524E-5,4.194078E-5,4.2485524E-5,372,2,0,200,0,0
485164245,cook_erika,10,302,142,316,1,0,33.2648751357,30-39,511,4,14,32,46,46,14,32,6,2.7673250753,47.6586784078,0.0126973349,0.1792270531,0.5392157,0,66,1.1586809529983754E-4,8.98731E-5,9.104041E-5,372,17,2,200,2,0.01
485425161,SparksLiam,10,229,67,257,0,3,14.0694883297,10-19,433,3,4,25,29,29,4,25,6,2.7080682959,43.2797793547,0.0047609836,0.171182266,0.29692307,0,66,5.478951651318825E-5,2.99577E-5,3.0346804E-5,372,6,0,200,0,0
486147303,UMacLeod1,10,3689,86,321,1,0,42.0268486135,40-49,649,7,13,40,53,53,13,40,7,2.5252761969,535.8618086949,0.0132050043,0.087808418,0.19279908,0,66,7.038956781530799E-5,8.388156E-5,8.497105E-5,47,12,0,200,0,0
486194640,DarbyCar,10,13130,301,104,6,16,40.8029469368,40-49,767,8,109,42,151,151,109,42,7,2.5908938735,799.6196769475,0.1329131405,0.1091390728,0.28928035,0,66,2.8632016626334696E-4,6.590694E-4,6.6762965E-4,47,249,1,211,1,0.0047393365
487144919,rofoi,10,877,111,677,1,3,45.0222886363,40-49,572,5,11,0,11,11,11,0,0,0,0,0.0219016325,0.1090909091,0.17272727,0,7,1.2106584508191298E-4,7.189848E-5,0,140,1,0,201,0,0
487803136,Mii_Words_Speak,10,9475,770,751,1,7,37.3749718227,30-39,732,7,0,0,0,0,0,0,0,0,0,0,0,0,83,182,4.4780486537007367E-5,0,0,77,13,0,203,0,0
487811502,MichaelBroeders,10,636,90,288,1,2,39.8964284142,30-39,525,4,9,25,34,34,9,25,7,2.7820555742,99.6796365893,0.0151688963,0.1604278075,0.34757835,0,66,9.532966662364853E-5,5.99154E-5,6.069361E-5,140,7,0,199,0,0
487981280,notacons,10,645,13,111,0,16,24.6420193741,20-29,367,4,5,31,36,36,5,31,6,2.5554067626,49.0429876643,0.0117463608,0.2634920635,0.44474155,0,66,6.012078339232711E-5,3.594924E-5,3.6416164E-5,140,6,0,199,0,0
488916603,RonnieMemo,10,843,195,646,8,138,38.034057135,30-39,503,5,10,31,41,41,10,31,6,2.5704720455,616.2959105999,0.0158002976,0.1317073171,0.3268817,0,66,7.724445149431616E-5,6.590694E-5,6.6762965E-5,372,9,0,200,0,0
489609031,RobAlexandr,10,216,38,35,0,0,23.840214529,20-29,532,3,7,8,15,15,7,8,7,2.9424171409,463.8753129915,0.0050523723,0.1238095238,0.3888889,0,66,1.146922305219598E-4,4.793232E-5,4.8554884E-5,372,32,0,198,0,0
489914230,BonyMaroniPony,10,7473,251,595,3,31,42.6459889318,40-49,696,8,39,99,138,138,39,99,6,2.3136926682,5249.5740557157,0.0520699548,0.0800803978,0.22218987,0,66,1.544216158997469E-4,2.396616E-4,2.4277443E-4,47,30,1,201,1,0.0049751244
490376149,JarvisGoogoo,10,4742,324,307,2,887,43.5992395419,40-49,705,7,2,11,13,13,2,11,7,2.9507867426,25.6333385968,0.005196476,0.1666666667,0.3090909,0,66,5.827607561009861E-5,1.797462E-5,1.8208082E-5,390,2,0,200,0,0
490519631,PeterSymaniw,10,101,8,61,0,3,29.5294554173,20-29,413,5,0,2,2,2,0,2,8,3.7411371237,0,0,0.5,0.5,0,110,4.4780486537007367E-5,0,6.0693606E-6,140,16,0,204,0,0
490776451,bmichniak,10,596,159,464,1,10,27.4637022632,20-29,514,4,11,56,67,67,11,56,6,2.4067626381,190.6868228707,0.0170214084,0.1820443238,0.38283208,0,66,9.4312442759446E-5,7.189848E-5,7.283233E-5,140,1,0,200,0,0
490960022,alice_schipp,10,3302,486,714,5,261,46.3778745974,40-49,695,6,151,215,366,366,151,215,6,2.1319049213,14141.1774480674,0.197463633,0.0643910472,0.28580743,0,66,3.9982898538932994E-4,9.107141E-4,9.225428E-4,47,35,0,199,0,0
490997129,YukonHulk,10,4891,611,535,15,489,50.5744160361,50-59,735,7,62,17,79,79,62,17,7,2.7415467024,3454.9137462829,0.0471087188,0.08812074,0.1817988,0,66,2.9685458972985494E-4,3.7746702E-4,3.8236973E-4,47,75,1,201,1,0.0049751244
492378961,HeatherRenwick,10,57,7,27,0,1,16.3161565335,10-19,127,2,0,5,5,5,0,5,7,3.046519411,0,0,0.4,0.55,0,516,4.4780486537007367E-5,0,6.0693606E-6,140,0,0,66,0,0
492492626,christibelcourt,10,4178,1911,1345,30,2161,56.7273469765,50-59,772,7,167,112,279,279,167,112,7,2.4399062605,16470.3946451108,0.1222415635,0.0541631211,0.14912948,0,66,6.756664594930674E-4,0.0010065787,0.0010196526,47,341,0,199,0,0
492633469,CMDoze,10,160,8,49,0,30,20.7246452613,20-29,227,3,0,3,3,3,0,3,7,2.9722222222,0,0,0.3333333333,0.5,0,432,4.4780486537007367E-5,0,6.0693606E-6,55,0,1,191,1,0.0052356021
492873598,arswy,10,39,7,45,0,4,27.0140526012,20-29,272,3,0,5,5,5,0,5,7,3.0823293173,0,0,0.4,0.6,0,427,4.4780486537007367E-5,0,6.0693606E-6,140,0,0,79,0,0
493389719,mmecorrie,10,701,34,124,2,1,43.4577865367,40-49,548,5,7,19,26,26,7,19,7,2.8446601942,61.8867281523,0.0049806095,0.1492307692,0.2667984,0,66,6.354379959880862E-5,4.793232E-5,4.8554884E-5,140,9,3,200,3,0.015
493439413,justice499,10,11915,2539,1979,45,1980,40.8333607187,40-49,787,8,114,76,190,190,114,76,7,2.4907934382,12222.752611876,0.1120168489,0.0699805068,0.22685444,0,66,4.3112098980638524E-4,6.890271E-4,6.979765E-4,47,54,0,199,0,0
493463871,feralfrank,10,647,38,117,0,7,21.8821895874,20-29,552,4,14,34,48,48,14,34,7,2.6501506528,401.1877803156,0.0224397719,0.134751773,0.3179232,0,66,8.214670765407631E-5,8.98731E-5,9.104041E-5,47,3,0,200,0,0
493488747,L_MacAulayMP,10,614,727,409,23,1,44.7775977607,40-49,642,4,52,43,95,95,52,43,7,2.6779377302,723.1259504788,0.0867436525,0.1428891377,0.35641629,0,66,3.508972938402378E-4,3.175516E-4,3.216761E-4,140,34,5,200,5,0.025
493673019,McRae_ML,10,1130,147,824,3,28,36.7901976338,30-39,559,5,29,128,157,157,29,128,6,2.312353532,1115.1621342968,0.0432628283,0.1017066797,0.211422,0,66,1.1413516114367978E-4,1.797462E-4,1.8208082E-4,47,0,0,200,0,0
493730203,Big_Guy_Ty,10,4153,119,43,2,4,33.321038964,30-39,713,6,33,8,41,41,33,8,7,2.7623033144,15.4977162995,0.0489774551,0.2097560976,0.39900428,0,66,1.1839425773380502E-4,2.0371236E-4,2.0635827E-4,47,5,0,200,0,0
494252830,bates_gail,10,1325,113,202,2,4,40.4887057146,40-49,586,6,31,51,82,82,31,51,7,2.4713759625,532.7513690932,0.0411577778,0.091237579,0.34200603,0,66,1.3188707960461868E-4,1.9172928E-4,1.9421954E-4,47,8,1,202,1,0.004950495
494271016,MikeMcPickles,10,5242,416,1214,9,116,37.9749555972,30-39,732,7,153,259,412,412,153,259,6,2.1797790425,9474.5063890217,0.2119837729,0.0835105001,0.21378866,0,66,4.399335044699072E-4,9.2269713E-4,9.3468156E-4,47,29,0,200,0,0
494320156,grecoce,10,317,72,200,1,0,32.8369344337,30-39,445,4,14,26,40,40,14,26,7,2.812520924,24.1474446712,0.0155795356,0.1897435897,0.49770114,0,66,9.147846664784123E-5,8.98731E-5,9.104041E-5,390,3,3,200,3,0.015
494327659,wheinzie,10,10,6,13,0,2,12.6327888949,10-19,67,2,2,3,5,5,2,3,7,2.9852695012,6.9829969293,8.235205549602655E-4,0.35,0.5,0,66,5.142456581429312E-5,1.797462E-5,1.8208082E-5,55,0,0,15,0,0
494329128,ShaneMiersch,10,29,18,50,0,1,22.9921796915,20-29,169,3,0,1,1,1,0,1,7,3.1860776439,0,0,0,0,0,347,4.4780486537007367E-5,0,6.0693606E-6,390,0,1,31,1,0.0322580645
494331490,Rhino_Bob,10,14828,247,215,7,250,51.1225700937,50-59,756,8,15,12,27,27,15,12,7,2.843990626,85.5077170381,0.0150749454,0.0997150997,0.2099567,0,66,8.46336558002605E-5,9.586464E-5,9.710977E-5,390,60,0,201,0,0
494454468,MuffysMusings,10,1368,171,314,0,230,42.3148568285,40-49,658,5,84,122,206,206,84,122,6,2.2932708403,4521.5173423747,0.1197747885,0.0915226143,0.3091992,0,66,2.4328462722016773E-4,5.092809E-4,5.1589566E-4,47,32,2,200,2,0.01
494580521,etherproject,10,317,36,124,0,301,31.2139088011,30-39,551,4,9,25,34,34,9,25,7,2.7043856712,137.8036938967,0.0094821616,0.0971479501,0.21937323,0,66,6.54465301673366E-5,5.99154E-5,6.069361E-5,47,10,1,202,1,0.004950495
494582291,KatherineRoosev,10,52,1,13,0,37,10.6708586376,10-19,21,2,0,4,4,4,0,4,7,3.0036813922,0,0,0.5,0.6666667,0,573,4.4780486537007367E-5,0,6.0693606E-6,55,1,0,65,0,0
494609110,RougeMenace,10,3340,207,244,5,405,47.3135595905,40-49,673,6,28,28,56,56,28,28,7,2.567458989,332.9668984967,0.035774404,0.0801948052,0.31764707,0,66,1.1296917086443558E-4,1.7375466E-4,1.7601145E-4,47,62,0,202,0,0
495058610,macleodmarkd,10,2554,275,216,7,14,42.707532328,40-49,693,6,7,14,21,21,7,14,6,2.6742551055,24.3882140185,0.0092074624,0.2642857143,0.53267974,0,66,5.866338139985475E-5,4.793232E-5,4.8554884E-5,140,4,0,200,0,0
495066576,GadflyQuebec,10,21433,697,777,13,1640,36.7305805578,30-39,757,8,145,134,279,279,145,134,6,2.2772012052,5909.0481656269,0.2075689904,0.0875041902,0.324807,0,66,4.5220667312708226E-4,8.747648E-4,8.8612665E-4,47,3,1,200,1,0.005
495139374,rexbanner24,10,558,74,405,0,10,41.7561520362,40-49,522,5,3,5,8,8,3,5,7,2.9173083361,13.9221902719,0.0039638308,0.1428571429,0.33333334,0,66,5.676719020611344E-5,2.396616E-5,2.4277442E-5,47,13,0,200,0,0
495386969,solelineros,10,3281,1442,1761,4,2200,48.9916303972,40-49,716,6,3,7,10,10,3,7,9,4.6036156679,8072.6,2.7049602318472194E-4,0.0555555556,0.14285715,0,66,1.7233237902918806E-4,2.396616E-5,2.4277442E-5,320,14,0,200,0,0
495680721,CoreyGordan,10,1080,45,124,0,48,25.4213616188,20-29,601,5,4,4,8,8,4,4,7,2.9628389689,0.6479570193,0.0047540139,0.125,0.55,0,66,5.122959437710535E-5,2.99577E-5,3.0346804E-5,47,18,0,199,0,0
495905313,HarpersCanada1,10,980,62,6,1,7,21.4514281702,20-29,599,4,14,2,16,16,14,2,7,3.2490793438,0.6237344039,0.0148038752,0.2375,0.3,0,66,8.970050578055326E-5,8.98731E-5,9.104041E-5,47,14,2,199,2,0.0100502513
496075854,anandaandika3,10,7614,131,242,0,64,46.670516676,40-49,696,7,1,1,2,2,1,1,1,1,0,7.49471721243357E-5,0,0,132,255,2.9852402567743944E-4,1.198308E-5,1.2138721E-5,129,20,0,201,0,0
496192309,Urban_Su,10,35469,1298,1276,24,1993,46.9397326057,40-49,790,9,403,412,815,815,403,412,6,2.0662872447,73839.9585823867,0.4164909633,0.0398697638,0.14092341,0,66,0.001215669,0.002420582,0.002439883,47,798,10,261,9,0.0383141762
496253544,KcwhyteC,10,1101,34,67,0,80,24.1670129837,20-29,395,6,1,4,5,5,1,4,7,2.9983260797,0,9.736086593524744E-4,0.3,0.75,0,66,4.5771838259536714E-5,1.198308E-5,1.2138721E-5,390,0,2,201,2,0.0099502488
497084291,savingthepeace,10,2532,113,138,1,7,45.3222712404,40-49,619,6,22,34,56,56,22,34,7,2.6431201875,243.5929517868,0.0229010622,0.0863636364,0.2651822,0,66,9.105732062791116E-5,1.3780541E-4,1.395953E-4,47,19,0,200,0,0
497114732,BarbaraXLow,10,1560,454,518,9,227,46.1662628902,40-49,671,6,48,34,82,82,48,34,7,2.7458988952,2954.930392994,0.045594507,0.0847636254,0.28013468,0,66,4.697420580934679E-4,2.9358547E-4,2.9739868E-4,47,28,0,200,0,0
497122064,Silviaa_mg,10,5513,238,197,0,32,43.1350350985,40-49,715,6,5,4,9,9,5,4,2,1.2,0.5,4.0157977950504276E-4,0.125,0.9,167,321,3.1819331780856254E-4,3.594924E-5,3.6416164E-5,289,113,0,200,0,0
497213370,HeadlineNewsBC,10,8577,327,327,0,0,40.4944616942,40-49,615,4,3,3,6,6,3,3,7,3.1536658855,4.0435280955,0.0011399565,0.0666666667,0.6666667,0,66,5.077473061525102E-5,2.396616E-5,2.4277442E-5,55,2,0,201,0,0
497360864,FabioT_V1,10,1103,33,122,0,1,33.0129677206,30-39,544,5,7,16,23,23,7,16,7,2.6702376967,2.2084376502,0.0137993437,0.162055336,0.5541667,0,66,6.1173681374175E-5,4.793232E-5,4.8554884E-5,47,1,1,200,1,0.005
497410944,NafizNDP,10,3438,408,1601,4,2,34.7408838561,30-39,611,6,104,275,379,379,104,275,6,2.1466354202,14321.3256154597,0.1272355336,0.0864011392,0.22267026,0,66,4.2174669121556745E-4,6.291117E-4,6.3728285E-4,390,47,2,200,2,0.01
497731840,Avalon709,10,37295,313,495,8,2412,38.3540813231,30-39,742,9,50,55,105,105,50,55,6,2.4442584533,3512.6315106734,0.0567046192,0.0902930403,0.23093152,0,66,2.1847084667904045E-4,3.0556854E-4,3.095374E-4,47,54,0,211,0,0
497952624,IamACanRadical,10,3203,255,110,8,338,48.1355687341,40-49,703,6,5,4,9,9,5,4,7,3.0970873786,8.9085789036,0.0027715745,0.2083333333,0.2777778,0,66,5.6287706175350914E-5,3.594924E-5,3.6416164E-5,47,3,0,199,0,0
498154944,margaretresin,10,5163,370,452,8,146,40.0676941175,40-49,711,7,159,188,347,347,159,188,6,2.2008704386,7038.5055048509,0.2007059162,0.0675734204,0.25713697,0,66,4.113066620943112E-4,9.586464E-4,9.7109773E-4,47,118,1,207,1,0.0048309179
498188801,ClaudeCPoirier,10,895,154,266,6,1,40.6544260269,40-49,581,5,15,28,43,43,15,28,6,2.5671242049,168.0744738303,0.0278715676,0.119047619,0.4510582,0,66,1.1872804371598448E-4,9.586464E-5,9.710977E-5,390,8,0,200,0,0
498230889,TimSanchez2,10,3449,76,343,1,21,41.0511004525,40-49,610,6,16,64,80,80,16,64,6,2.4623367928,152.0858441072,0.0324606031,0.2118670886,0.43563512,0,66,1.2637938255313406E-4,1.0185618E-4,1.0317913E-4,140,10,2,200,2,0.01
498909753,JoanneDNLIB,10,1471,331,492,9,4,47.9641699016,40-49,677,5,22,37,59,59,22,37,7,2.7512554402,409.7561283194,0.0170190228,0.0900058445,0.2804878,0,66,1.28900287475313E-4,1.3780541E-4,1.395953E-4,140,28,0,199,0,0
498940924,BrianEdey,10,441,6,26,0,31,17.767894248,10-19,454,4,1,5,6,6,1,5,7,3.1329092735,0,3.2883206586879467E-4,0.4,0.53333336,0,66,4.5677515201501E-5,1.198308E-5,1.2138721E-5,140,0,0,200,0,0
499366511,WillenborgEmily,10,5055,386,436,0,2313,42.6055909036,40-49,715,6,8,11,19,19,8,11,2,1.1538461538,41.619047619,6.54661654562188E-4,0.0643274854,0.3909091,26,99,4.064475805543674E-4,5.392386E-5,5.4624245E-5,49,6,0,201,0,0
499449099,JulianCWolfe,10,215,26,65,0,1,13.1153710366,10-19,470,3,2,8,10,10,2,8,7,2.916638768,54.6208099964,8.802308752690748E-4,0.1777777778,0.42857143,0,66,6.538647824457544E-5,1.797462E-5,1.8208082E-5,140,29,0,199,0,0
499819985,dghartley1959,10,4046,258,957,3,168,47.5137530355,40-49,681,7,16,33,49,49,16,33,6,2.546702377,609.6703565167,0.0167374528,0.0871598639,0.27272728,0,66,8.425590841064526E-5,1.0185618E-4,1.0317913E-4,47,7,0,201,0,0
500001852,Alex_Huet,10,1011,443,1204,3,37,39.9815002311,30-39,625,5,89,194,283,283,89,194,6,2.2537663207,3540.2198102797,0.1115215922,0.0971480841,0.28642073,0,66,3.500981215159851E-4,5.392386E-4,5.4624246E-4,390,17,7,200,7,0.035
500297431,mccxv,10,3320,83,212,3,1,33.0402177464,30-39,451,6,4,9,13,13,4,9,7,2.6213592233,11.7646172115,0.0091674248,0.1474358974,0.5277778,0,66,5.7193999123869704E-5,2.99577E-5,3.0346804E-5,47,0,0,197,0,0
500664166,CitizensPlatNG,10,25106,9524,33,34,1,62.0114975174,60-69,861,6,4,0,4,4,4,0,0,0,0,2.9981905891299617E-4,0,0,0,185,2.026609634700362E-4,2.99577E-5,0,55,1,0,201,0,0
501188833,sheila_info,10,2570,415,1072,4,28,48.2524272218,40-49,624,6,75,156,231,231,75,156,6,2.2283227318,5013.3579954887,0.1099953569,0.0745906268,0.23679756,0,66,2.831736150776652E-4,4.5535705E-4,4.612714E-4,47,11,2,200,2,0.01
501192516,6Bronwyn,10,653,89,78,0,25,26.3179300509,20-29,544,4,0,0,0,0,0,0,0,0,0,0,0,0,64,157,4.4780486537007367E-5,0,0,56,9,0,199,0,0
501380555,Nonanon_anon,10,23043,1183,806,22,2942,55.6801913202,50-59,792,9,343,231,574,574,343,231,6,2.2176096418,27188.7172173375,0.3318659276,0.0525931737,0.16016632,0,66,9.421376459361791E-4,0.0020610897,0.0020817907,47,940,0,268,0,0
501433802,ClaudineJacques,10,5371,689,2001,20,150,53.4223720324,50-59,728,6,77,63,140,140,77,63,6,2.5025108805,1387.3249508859,0.099075002,0.1155704008,0.27930683,0,66,2.9131174010026313E-4,4.673401E-4,4.7341012E-4,390,124,19,247,19,0.0769230769
501454405,metacanada,10,67,32,61,1,6,33.2922720092,30-39,411,3,5,12,17,17,5,12,6,2.7639772347,59.9894753134,0.0075694424,0.1433823529,0.35897437,0,66,6.426827331856196E-5,3.594924E-5,3.6416164E-5,140,3,1,90,1,0.0111111111
501845170,BadScienceWatch,10,316,740,131,31,1,48.5705827514,40-49,645,3,19,6,25,25,19,6,7,3.1319049213,250.8183729906,0.0157056668,0.0816666667,0.15019763,0,66,1.832619170804917E-4,1.198308E-4,1.2138722E-4,55,22,0,200,0,0
501910165,DenisSalter,10,340,119,543,3,2,22.3899236917,20-29,378,4,2,12,14,14,2,12,7,2.9045865417,1.0711555567,0.0016662902,0.2252747253,0.45454547,0,66,5.111343450918407E-5,1.797462E-5,1.8208082E-5,390,1,0,199,0,0
501954782,Laforest35,10,7,65,35,1,2,30.9981594967,30-39,450,1,5,4,9,9,5,4,8,4.6605289588,0.1666666667,4.4716903557635753E-4,0.125,0.85,0,66,2.3213598175901622E-4,3.594924E-5,3.6416164E-5,31,2,0,9,0,0
502004635,rockyp9nes,10,1802,120,216,5,7,39.077258643,30-39,497,6,21,22,43,43,21,22,7,2.6581854704,69.1943521453,0.0210581039,0.096345515,0.3045977,0,66,9.867223562199153E-5,1.3181388E-4,1.3352593E-4,47,1,0,200,0,0
502163458,ClimateVoters,10,669,272,43,14,11,48.4940619179,40-49,649,5,27,2,29,29,27,2,7,3.4435888852,203.5524507823,0.0181981379,0.0849753695,0.15954416,0,66,1.3298983652834523E-4,1.6776312E-4,1.699421E-4,55,40,0,200,0,0
503693698,reddogcw,10,5896,143,383,2,5188,45.3032563061,40-49,648,7,14,22,36,36,14,22,7,2.6273853365,165.6697559979,0.0229737741,0.1166666667,0.3123077,0,66,8.638685618809717E-5,8.98731E-5,9.104041E-5,47,15,0,203,0,0
503754930,oldschooldookie,10,4667,1289,1893,1,216,40.7873580982,40-49,589,7,2,2,4,4,2,2,9,4.6069635085,1977.6333333333,1.9551587194602748E-4,0.0833333333,0.5,0,66,1.1648178928206347E-4,1.797462E-5,1.8208082E-5,320,0,0,200,0,0
503827583,Relayer76,10,1390,134,165,2,11,44.8760453484,40-49,663,5,59,67,126,126,59,67,6,2.4027452293,855.2007070639,0.0843296708,0.1133968254,0.2875,0,66,2.0382279210455481E-4,3.594924E-4,3.6416165E-4,47,52,2,200,2,0.01
506492079,dommythekid,10,1565,134,118,1,1179,41.0540622842,40-49,604,5,0,0,0,0,0,0,0,0,0,0,0,0,357,650,4.4780486537007367E-5,0,0,366,3,0,200,0,0
506496611,VC_Ocean,10,469,185,308,3,26,52.1313300118,50-59,570,5,15,26,41,41,15,26,7,2.6524941413,138.0477506173,0.0226208601,0.1396341463,0.40640393,0,66,9.249750352023166E-5,9.586464E-5,9.710977E-5,140,7,0,200,0,0
507494424,SteveSlep,10,603,185,580,4,6,39.1058783143,30-39,561,5,50,104,154,154,50,104,6,2.3893538668,1596.8100560007,0.0583579734,0.1371700195,0.4345912,0,66,2.3163136218316716E-4,3.0556854E-4,3.095374E-4,390,11,4,199,4,0.0201005025
508063405,NoeliaHoran_,10,5823,659,1260,2,206,32.2193736631,30-39,711,7,4,4,8,8,4,4,1,1,0,3.186255976075631E-4,0.1071428571,1,319,578,2.985240256774394E-4,2.99577E-5,3.0346804E-5,323,69,0,200,0,0
508785291,_BlaackDiamond,10,23270,616,358,2,396,39.4549198108,30-39,775,8,4,4,8,8,4,4,7,3.1515151515,143.9238095238,3.2566557037812195E-4,0.0178571429,0.16666667,30,104,2.255048039329575E-4,2.99577E-5,3.0346804E-5,315,24,0,201,0,0
508876374,margiebarkley,10,389,32,71,0,5,21.5248991517,20-29,492,4,4,4,8,8,4,4,7,3.2042182792,0.4958026447,0.0047222318,0.2321428571,0.2857143,0,66,5.486659497723304E-5,2.99577E-5,3.0346804E-5,47,2,0,199,0,0
509633597,DavidScottson,10,153,100,292,1,10,21.6334094435,20-29,372,3,1,7,8,8,1,7,7,3.1496484767,7.3276862627,2.884482868388584E-4,0.2321428571,0.54761904,0,66,4.9285300708083014E-5,1.198308E-5,1.2138721E-5,140,2,0,153,0,0
510831727,nolansnolan,10,113,16,184,0,16,12.6209713021,10-19,115,4,2,2,4,4,2,2,7,3.5269501172,0,0.0015518979,0.25,0.8333333,0,66,5.417645440906808E-5,1.797462E-5,1.8208082E-5,372,0,0,147,0,0
510942432,mrsinisterlefty,10,6168,206,136,9,10,37.937147249,30-39,709,7,68,45,113,113,68,45,6,2.4851021091,469.6797963972,0.1070177091,0.1431731985,0.3475485,0,66,2.4375390671905128E-4,4.1341624E-4,4.1878587E-4,47,52,1,200,1,0.005
511399796,hellis6,10,488,153,492,1,7,31.2870794745,30-39,521,5,5,26,31,31,5,26,7,2.5112152662,84.0095836537,0.0093840106,0.1688172043,0.3276923,0,66,6.848566268734194E-5,3.594924E-5,3.6416164E-5,47,3,0,200,0,0
513354952,1nfinitezer0,10,313,256,1339,5,15,34.6169071823,30-39,491,4,0,6,6,6,0,6,7,2.9120107059,0,0,0.1666666667,0.26666668,0,280,4.4780486537007367E-5,0,6.0693606E-6,47,1,0,200,0,0
513739938,chuddles11,10,19093,1064,1955,19,84,54.5727484911,50-59,678,8,207,274,481,481,207,274,6,2.2360227653,29907.2294772,0.1858765378,0.0368243243,0.16151392,0,66,6.572686041287968E-4,0.0012462403,0.001262427,47,19,0,235,0,0
513824018,MeetCaseyB,10,4185,5575,6120,24,9,47.736882462,40-49,686,5,2,2,4,4,2,2,8,4.8473384667,0,1.7162325494590017E-4,0.0833333333,1,0,66,1.2781885145429095E-4,1.797462E-5,1.8208082E-5,320,0,0,204,0,0
514642261,Reyitaas,10,3035,176,162,0,6,40.54988497,40-49,684,6,5,5,10,10,5,5,1,1,0.75,4.0157977950504276E-4,0.1,0.85,167,321,3.29751550043913E-4,3.594924E-5,3.6416164E-5,289,46,0,200,0,0
514818535,Andy_Fila,10,44203,475,338,1,1234,41.0042954916,40-49,794,8,10,10,20,20,10,10,5,2.303030303,534.9634920635,8.405418434576753E-4,0.0368421053,0.2888889,30,104,5.809521152581806E-4,6.590694E-5,6.6762965E-5,315,56,0,201,0,0
514845467,JayIMG,10,6352,308,889,8,2,36.8402716976,30-39,709,7,54,78,132,132,54,78,7,2.5125544024,1442.620639314,0.0710935973,0.1380985427,0.3649274,0,66,1.9949950589896663E-4,3.295347E-4,3.3381482E-4,140,42,0,201,0,0
514960977,auleduc,10,3558,506,2000,3,20,42.9308791087,40-49,566,6,17,129,146,146,17,129,6,2.3762972882,513.6717344612,0.0369572162,0.1851204535,0.33259284,0,66,1.1578991352250308E-4,1.0784772E-4,1.0924849E-4,140,1,0,201,0,0
515638983,MacIntyreCheryl,10,1239,108,115,2,285,41.9420795721,40-49,594,5,56,38,94,94,56,38,7,2.4934717107,377.6960843867,0.0698426628,0.1301761611,0.33782697,0,66,1.5382149849574642E-4,3.4151776E-4,3.4595357E-4,47,15,1,200,1,0.005
515732918,LinneaEldred,10,932,76,135,2,12,41.0571837309,40-49,482,5,3,12,15,15,3,12,7,3.0629394041,2.502382792,0.0023877942,0.219047619,0.6363636,0,66,6.145797760111869E-5,2.396616E-5,2.4277442E-5,372,2,1,200,1,0.005
515986093,LondonWestNDP,10,460,194,260,6,1,42.7136741577,40-49,543,5,49,60,109,109,49,60,7,2.6722464011,771.7631263209,0.0434435334,0.1674311927,0.4257716,0,66,2.201544552623001E-4,2.99577E-4,2.9739868E-4,390,20,1,200,1,0.005
516074406,ThomasNishantha,10,932,253,651,1,2,48.2275478109,40-49,511,5,1,1,2,2,1,1,8,4.4204887847,0,8.270926887873718E-5,0,0,0,66,1.0207987623313145E-4,1.198308E-5,1.2138721E-5,320,0,0,200,0,0
516583662,Jkhourystfx,10,2015,135,346,5,2,42.036800662,40-49,548,6,21,61,82,82,21,61,6,2.4763977235,1348.6477326354,0.0295034321,0.1681722373,0.3692899,0,66,1.372438722799168E-4,1.3181388E-4,1.3352593E-4,140,8,1,200,1,0.005
516634980,zak_f_r,10,933,157,386,1,19,30.4523663338,30-39,478,4,22,57,79,79,22,57,7,2.5664546368,75.1607827804,0.0336478787,0.20593963,0.4767025,0,66,1.193755788072185E-4,1.3780541E-4,1.395953E-4,390,4,0,198,0,0
517065252,clubrelation,10,53852,35,0,0,0,12.1685557516,10-19,418,3,0,0,0,0,0,0,0,0,0,0,0,0,333,600,4.4780486537007367E-5,0,0,339,0,0,201,0,0
517121805,MemersBooth,10,6726,531,1203,9,5289,49.9047542383,40-49,732,7,38,81,119,119,38,81,7,2.4928021426,7799.2537597549,0.0271276945,0.0665859564,0.19537815,0,66,1.9898385040466546E-4,2.3367006E-4,2.3670506E-4,47,81,0,188,0,0
517159398,Crimethought,10,4,21,0,0,15,31.1984222593,30-39,535,5,9,0,9,9,9,0,0,0,0,0.0130838881,0.2222222222,0.3888889,0,4,6.329772751199695E-5,5.99154E-5,0,47,8,0,3,0,0
517212252,midddlemiss,10,384,19,8,0,4,12.8994027935,10-19,559,3,4,1,5,5,4,1,7,3.2748577168,0.1897178339,0.0079147346,0.35,0.45,0,66,5.216722293203918E-5,2.99577E-5,3.0346804E-5,47,4,3,200,3,0.015
517664013,CarolAnnAudet,10,1893,89,150,1,11,36.5947001977,30-39,570,6,17,20,37,37,17,20,7,2.7592902578,76.973483473,0.0177417463,0.1786786787,0.40574712,0,66,1.234163947985674E-4,1.0784772E-4,1.0924849E-4,47,7,1,199,1,0.0050251256
517877177,Sindical_cl,10,694,205,302,1,2,42.0052422154,40-49,542,4,1,5,6,6,1,5,9,4.6049548042,0,1.1057485856814353E-4,0.1333333333,0.25,0,66,6.79464955354548E-5,1.198308E-5,1.2138721E-5,320,14,0,199,0,0
517905077,Gibsons_Rare,10,253,19,34,0,14,31.8976771126,30-39,457,4,2,6,8,8,2,6,7,2.8814864412,2.3004728287,0.0010948568,0.1964285714,0.26785713,0,66,4.828203442393243E-5,1.797462E-5,1.8208082E-5,47,10,2,202,2,0.0099009901
518011368,effyes,10,1205,98,146,0,31,37.1666813092,30-39,597,5,5,4,9,9,5,4,7,3.2567793773,2.6007058597,0.0033083608,0.1666666667,0.5,0,66,7.073809953424697E-5,3.594924E-5,3.6416164E-5,372,3,0,200,0,0
518046429,RZaichkowski,10,969,172,276,0,10,48.8076891516,40-49,588,5,24,32,56,56,24,32,6,2.5925677938,608.806441168,0.0364907057,0.1214285714,0.38813815,0,66,1.5820668682052201E-4,1.497885E-4,1.5173401E-4,390,24,0,200,0,0
519000338,DuffCaledonNDP,10,10,55,156,5,1,24.5053668014,20-29,112,2,16,66,82,82,16,66,7,2.5423501841,50.7588100055,0.0247301483,0.2946401686,0.61247486,0,66,1.1164637914042336E-4,1.0185618E-4,1.0317913E-4,390,0,0,20,0,0
519571848,Blissful_hell,10,1509,121,162,2,3,27.0508091765,20-29,609,6,6,14,20,20,6,14,7,2.7017073987,13.7587116794,0.0078897387,0.2105263158,0.4227941,0,66,5.868367900377784E-5,4.194078E-5,4.2485524E-5,47,2,0,200,0,0
519737251,reppinca,10,5928,714,2002,0,1657,49.3280307101,40-49,693,7,100,232,332,332,100,232,6,2.1680616003,17801.7524016178,0.1039935869,0.0614148437,0.18288834,0,66,3.208994772832364E-4,6.051455E-4,6.130054E-4,47,76,0,215,0,0
519750654,ianpottawa,10,682,81,50,4,16,42.2215482708,40-49,542,5,38,22,60,60,38,22,7,2.7100770003,175.0420878978,0.0608763521,0.156779661,0.3922294,0,66,2.5577446125534746E-4,2.3367006E-4,2.3670506E-4,140,35,2,199,2,0.0100502513
520820898,poormansmedia,10,9341,1162,428,46,454,48.1115368427,40-49,773,7,282,102,384,384,282,102,7,2.3582189488,11560.4117855994,0.2824366609,0.0756228242,0.17581852,0,66,7.645601754850329E-4,0.0016956058,0.001717629,47,464,1,215,1,0.0046511628
521628578,grahamgeoff,10,171,77,151,2,161,23.0882596943,20-29,507,4,11,17,28,28,11,17,7,2.7047204553,94.5216877319,0.0127021504,0.1626984127,0.38311687,0,66,7.840680562066312E-5,7.189848E-5,7.283233E-5,390,10,1,174,1,0.0057471264
521654689,RachelTaylor_3,10,1438,191,177,0,158,35.0638555335,30-39,621,5,4,5,9,9,4,5,2,1.1666666667,0.6666666667,3.217667102775563E-4,0.1111111111,0.7,264,497,1.8798441438917248E-4,2.99577E-5,3.0346804E-5,261,20,0,200,0,0
521738852,ChrisMadih,10,11076,96,79,0,18,32.3812402806,30-39,733,7,0,0,0,0,0,0,0,0,0,0,0,0,179,340,4.4780486537007367E-5,0,0,174,4,0,200,0,0
521879347,DiscourseMag,10,220,560,530,10,8,42.3419703412,40-49,574,3,41,62,103,103,41,62,6,2.4358888517,6506.0964039376,0.0508211942,0.0901389682,0.20941357,0,66,2.247620534408752E-4,2.5164467E-4,2.5491315E-4,390,40,1,200,1,0.005
522269341,DanTurner84,10,4553,65,141,0,1924,42.4495504706,40-49,671,7,3,4,7,7,3,4,7,2.947773686,90.3260809717,0.0085292089,0.119047619,0.45,0,66,6.319560310061268E-5,2.396616E-5,2.4277442E-5,140,4,4,200,4,0.02
522452889,NadineLumley,10,11429,556,203,9,4599,55.674403645,50-59,743,8,206,65,271,271,206,65,7,2.4399062605,5043.566766158,0.2100274231,0.1028153615,0.20789552,0,66,5.389779508948001E-4,0.0012402488,0.0012502883,47,370,2,253,2,0.0079051383
522620461,lisagrandetang,10,662,43,116,0,40,27.3431726878,20-29,527,5,2,6,8,8,2,6,7,3.0545698025,3.1186218374,0.0012934299,0.0892857143,0.2,0,66,4.766265961963238E-5,1.797462E-5,1.8208082E-5,47,0,0,199,0,0
522827444,WilliamYetman,10,3114,350,1118,2,336,43.2055007615,40-49,674,6,103,293,396,396,103,293,6,2.1288918647,14774.8753259244,0.1357369728,0.0765694924,0.19895077,0,66,3.417245510097099E-4,6.2312017E-4,6.312135E-4,390,24,0,200,0,0
522842112,LindaBesseling,10,1580,327,590,3,10,45.292370282,40-49,635,6,95,157,252,252,95,157,6,2.1958486776,6100.0201226837,0.130406159,0.0715076203,0.28225544,0,66,2.8202906768260946E-4,5.7518785E-4,5.826586E-4,47,47,3,200,3,0.015
523219348,Rocknrollfoolz,10,3974,279,508,6,487,44.1989878804,40-49,654,7,58,97,155,155,58,97,6,2.307331771,2747.0977780268,0.0881721196,0.0871386678,0.32732674,0,66,1.9964640808515827E-4,3.5350086E-4,3.5809228E-4,47,43,1,197,1,0.0050761421
523849647,huckabee972,10,5695,120,121,0,161,44.3536959705,40-49,721,7,0,0,0,0,0,0,0,0,0,0,0,0,208,398,4.4780486537007367E-5,0,0,204,3,0,201,0,0
524730862,tabithatb,10,601,152,734,1,10,33.7962623317,30-39,557,5,56,157,213,213,56,157,6,2.3779712086,991.3086573065,0.068074365,0.1525378687,0.3672949,0,66,2.6410190863176606E-4,3.4151776E-4,3.4595357E-4,390,21,6,200,6,0.03
524754019,MaryPChipman,10,3035,361,578,3,3044,46.0445760287,40-49,656,6,57,84,141,141,57,84,6,2.3357884165,2049.2141452105,0.0892427619,0.0712765957,0.3178428,0,66,1.945427399187001E-4,3.475093E-4,3.520229E-4,47,68,6,207,5,0.0289855072
524791202,Stacey0891,10,240,56,84,0,4,22.5101518236,20-29,462,4,5,7,12,12,5,7,7,2.9069300301,8.0488619935,0.0057611188,0.1212121212,0.29166666,0,66,5.39908881398768E-5,3.594924E-5,3.6416164E-5,47,2,3,200,2,0.015
524792313,Your__Dream__,10,9466,92,90,1,85,41.3731761199,40-49,688,6,3,3,6,6,3,3,7,3.1515151515,14.7448412698,2.5713093787444347E-4,0.0666666667,0.6666667,30,104,1.6842343851373906E-4,2.396616E-5,2.4277442E-5,315,2,0,201,0,0
526913370,AMoses4,10,1280,31,30,0,0,41.4841198394,40-49,540,2,6,6,12,12,6,6,7,2.6960160696,16.0090005643,0.0142853968,0.053030303,0.43333334,0,66,6.137434445823673E-5,4.194078E-5,4.2485524E-5,47,27,0,203,0,0
526919381,Anonchimp,10,28411,1778,950,57,5348,61.23087957,60-69,815,9,34,23,57,57,34,23,7,2.7398727821,2239.4456374059,0.0244460626,0.0494987469,0.23440285,0,66,2.1034982244699172E-4,2.097039E-4,2.1242762E-4,47,134,0,201,0,0
527170087,Lena__Rose,10,620,47,167,0,25,23.7469139114,20-29,445,5,3,4,7,7,3,4,7,3.1436223636,14.8836400701,0.0043849076,0.0952380952,0.41666666,0,66,6.480847151972055E-5,2.396616E-5,2.4277442E-5,47,0,0,200,0,0
528006485,TrentDryad,10,341,10,16,0,0,12.3207895825,10-19,443,3,1,6,7,7,1,6,7,2.9698694342,0.1127901403,6.370376567611468E-4,0.3571428571,0.47619048,0,66,4.714170574410645E-5,1.198308E-5,1.2138721E-5,390,2,1,200,1,0.005
528820859,MetroGraham,10,1941,210,80,14,0,45.7937994816,40-49,605,4,6,6,12,12,6,6,7,3.0438567124,10.4633293426,0.0028654063,0.0681818182,0.11111111,0,66,5.920452454510088E-5,4.194078E-5,4.2485524E-5,140,4,0,200,0,0
529784722,Bacon604,10,543,31,112,1,5,16.9417068801,10-19,421,4,1,4,5,5,1,4,7,2.9668563776,0.0145497486,0.0012727459,0.25,0.8333333,0,66,4.719077607448976E-5,1.198308E-5,1.2138721E-5,47,1,0,192,0,0
529786217,dylanxpowell,10,6929,451,384,9,4216,49.2718965787,40-49,723,7,15,11,26,26,15,11,7,2.7693337797,508.6796776227,0.0133428486,0.0923076923,0.2,0,66,1.4392899921327693E-4,9.586464E-5,9.710977E-5,47,8,0,201,0,0
532460250,SteveHLeDrew,10,27,51,63,1,0,19.4012522743,10-19,151,2,1,1,2,2,1,1,8,3.9809173083,0,1.1074907308662401E-4,0,0,0,66,5.062817101684591E-5,1.198308E-5,1.2138721E-5,390,0,0,28,0,0
532841420,stkenzie,10,3961,93,150,3,209,40.4235960572,40-49,581,7,12,17,29,29,12,17,7,2.6913290927,197.7770215618,0.0137265627,0.1379310345,0.31422925,0,66,7.616505704922389E-5,7.789002E-5,7.8901685E-5,47,11,0,185,0,0
533253197,ThatsSOReilly,10,1471,260,318,3,149,51.8985070825,50-59,610,6,12,15,27,27,12,15,7,2.8463341145,489.8099340558,0.0086147463,0.0427350427,0.175,0,66,1.1234394768747632E-4,7.789002E-5,7.8901685E-5,390,2,0,201,0,0
533635897,stefanjpguy,10,2280,98,244,0,4,36.6913016617,30-39,545,6,30,73,103,103,30,73,6,2.3394710412,1615.5444904929,0.0497874082,0.1007995431,0.27369368,0,66,1.5883316756922208E-4,1.8573774E-4,1.8815018E-4,390,12,0,199,0,0
534790063,MarilynGMurray,10,557,31,157,0,0,13.4129683904,10-19,341,5,5,16,21,21,5,16,7,2.8563776364,24.7399875841,0.0067681546,0.2476190476,0.44117647,0,66,5.4755031691375564E-5,3.594924E-5,3.6416164E-5,390,0,1,200,1,0.005
534827153,usernamehere,10,829,343,279,2,39,44.5112222834,40-49,592,5,3,10,13,13,3,10,7,3.0177435554,32.5021523961,0.0019727693,0.1474358974,0.27272728,0,66,5.982451938423053E-5,2.396616E-5,2.4277442E-5,372,13,1,201,1,0.0049751244
535486548,bionicliberal,10,9284,362,332,3,3,51.7499606333,50-59,704,7,131,126,257,257,131,126,6,2.265483763,11824.5250423188,0.1658708289,0.0390473006,0.2427308,0,66,4.212298034794511E-4,7.9088326E-4,7.9508626E-4,140,326,1,259,1,0.0038610039
537369806,ArturoReina,10,702,216,481,0,76,40.5053332502,40-49,587,4,2,3,5,5,2,3,1,1,0,1.560794569841572E-4,0.15,1,383,697,2.3261649057882062E-4,1.797462E-5,1.8208082E-5,397,63,0,200,0,0
537867910,Getchell_a,10,2584,336,378,1,656,32.8376912449,30-39,656,6,2,3,5,5,2,3,1,1,0,1.5452525836627266E-4,0.15,0.8333333,53,143,2.3261649057882062E-4,1.797462E-5,1.8208082E-5,257,53,0,198,0,0
538111610,mesarroc,10,422,232,472,1,5,33.0188472066,30-39,530,4,1,4,5,5,1,4,9,4.6052895882,0,7.645754735556161E-5,0.25,0.5,0,66,5.8747053000460315E-5,1.198308E-5,1.2138721E-5,320,9,0,200,0,0
538148973,Trillium_Party,10,1456,119,105,2,71,40.0961788307,40-49,634,5,14,16,30,30,14,16,6,2.5785068631,589.3895200512,0.0106960078,0.0896551724,0.3026316,0,66,8.429948146955292E-5,8.98731E-5,9.104041E-5,372,8,2,199,2,0.0100502513
538262738,johncmerriman,10,831,49,163,1,225,32.2560549802,30-39,471,5,15,26,41,41,15,26,7,2.5671242049,184.5898744514,0.0225295738,0.106097561,0.34391534,0,66,1.0054508500030311E-4,9.586464E-5,9.710977E-5,390,3,2,200,1,0.01
538458120,ConnorNorcott,10,913,152,283,0,20,40.2571317381,40-49,584,5,3,6,9,9,3,6,2,1.4,0.8333333333,2.4509648275300813E-4,0.1805555556,0.56666666,2,183,8.775901043010341E-5,2.396616E-5,2.4277442E-5,322,13,0,198,0,0
538475365,bconnolly00,10,9447,132,137,4,1097,49.5283703024,40-49,704,8,23,9,32,32,23,9,7,2.9809173083,62.8452133635,0.020688375,0.0715725806,0.18666667,0,66,1.2242724596676175E-4,1.4379696E-4,1.4566466E-4,390,73,0,205,0,0
539656934,freehorse68,10,8896,386,446,3,95,42.7434811522,40-49,718,8,48,56,104,104,48,56,6,2.4509541346,4099.2937729634,0.0455691819,0.0542382375,0.2373512,0,66,2.4761589506407415E-4,2.9358547E-4,2.9739868E-4,372,78,0,199,0,0
539865919,DonallPurvis,10,704,250,225,0,117,41.7928576176,40-49,615,5,0,0,0,0,0,0,0,0,0,0,0,0,296,549,4.4780486537007367E-5,0,0,293,13,0,199,0,0
540194655,krafty747,10,873,138,1021,2,125,26.4062107872,20-29,500,5,19,62,81,81,19,62,7,2.4703716103,236.4560836035,0.0224983863,0.1429012346,0.32115385,0,66,8.309160794310029E-5,1.198308E-4,1.2138722E-4,47,3,0,200,0,0
541201580,Fortitude_1,10,6539,524,907,27,60,40.902932126,40-49,717,7,19,42,61,61,19,42,7,2.5721459659,1385.3654506253,0.0265712711,0.081420765,0.25900117,0,66,9.929667604897743E-5,1.198308E-4,1.2138722E-4,47,4,0,200,0,0
541239060,alvarot98,10,238,107,150,0,0,41.2038941918,40-49,551,3,4,5,9,9,4,5,1,1,0.5,3.218916834918828E-4,0.125,0.9,167,321,2.719603888671609E-4,2.99577E-5,3.0346804E-5,289,24,0,200,0,0
541252471,AndreaLoken,10,7970,453,177,14,275,40.5290533606,40-49,738,7,61,19,80,80,61,19,7,2.7934382323,6326.0543253521,0.0544149054,0.0700949367,0.15058275,0,66,3.041695134936156E-4,3.7147547E-4,3.7630036E-4,390,110,1,202,1,0.004950495
541390165,joel_1067,10,307,23,73,1,12,30.2978441788,30-39,506,4,5,11,16,16,5,11,7,2.8085035152,18.3479518266,0.0087094692,0.1708333333,0.5272727,0,66,6.487349637491868E-5,3.594924E-5,3.6416164E-5,47,2,1,200,1,0.005
541582069,OpSharePanda,10,4535,2576,1726,59,4080,39.2579486471,30-39,780,8,26,21,47,47,26,21,7,2.8767994643,889.695847417,0.0186275477,0.0698427382,0.3227513,0,66,1.7481719778097895E-4,1.6177158E-4,1.6387274E-4,47,11,0,198,0,0
541927759,alanna_newman,10,2251,418,746,8,686,48.4718814767,40-49,673,6,32,60,92,92,32,60,6,2.5557415467,3123.6025723601,0.0217801672,0.0942427138,0.2690972,0,66,1.8072209006553443E-4,1.9772082E-4,2.0028891E-4,372,152,2,201,2,0.0099502488
542162326,mparadis004,10,281,41,139,2,3,35.5553988678,30-39,449,4,1,7,8,8,1,7,7,2.791429528,6.8457782989,1.2562023458722557E-4,0.2142857143,0.4047619,0,66,4.683525430804407E-5,1.198308E-5,1.2138721E-5,390,10,3,199,3,0.0150753769
542169141,altaMike,10,501,76,147,0,22,44.0168845782,40-49,569,5,4,12,16,16,4,12,7,2.8600602611,17.4085373424,0.0018182531,0.1291666667,0.28846154,0,66,5.645365053036296E-5,2.99577E-5,3.0346804E-5,372,18,0,202,0,0
542706706,UONDP,10,6662,418,919,7,1,40.3937023661,40-49,553,7,93,127,220,220,93,127,6,2.3290927352,4928.6510030838,0.1057649788,0.0820257368,0.29287875,0,66,3.3887176617658E-4,5.6320475E-4,5.705199E-4,390,13,30,271,28,0.110701107
542744338,TynaMcNair,10,1354,213,565,2,117,42.6151857259,40-49,575,6,25,52,77,77,25,52,6,2.4399062605,606.6056051031,0.0329163352,0.0816814764,0.23689727,0,66,1.196108193344884E-4,1.5578004E-4,1.5780337E-4,47,5,0,200,0,0
542898267,MassBucketry,10,15787,525,1398,26,1190,40.7053145926,40-49,731,7,29,60,89,89,29,60,7,2.4546367593,473.4171744813,0.0415567232,0.1244892748,0.2891348,0,66,1.1777538504174866E-4,1.797462E-4,1.8208082E-4,47,7,0,200,0,0
542967914,CarooowM,10,9591,285,146,2,220,35.9283591803,30-39,742,7,8,7,15,15,8,7,7,3.3333333333,4.525,6.970870435386025E-4,0.1095238095,0.71428573,30,104,4.892771068841905E-4,5.392386E-5,5.4624245E-5,315,25,0,200,0,0
543394473,crvallotton,10,2904,503,1411,8,45,50.0344166709,50-59,693,7,32,85,117,117,32,85,7,2.3552058922,236.7425692813,0.0467228158,0.1540671972,0.42685476,0,66,1.096394051007155E-4,1.9772082E-4,2.0028891E-4,47,37,0,201,0,0
543579866,biltongandgame,10,2353,144,298,2,99,25.766202068,20-29,576,6,0,0,0,0,0,0,0,0,0,0,0,0,244,471,4.4780486537007367E-5,0,0,240,1,0,200,0,0
543799267,TorranceCoste,10,1147,255,400,4,26,60.3534667141,60-69,660,6,45,61,106,106,45,61,6,2.4519584868,11982.9462123097,0.0463759364,0.0631626235,0.21930946,0,66,2.942005939663252E-4,2.7561083E-4,2.791906E-4,55,130,4,210,3,0.019047619
543844268,Johnvanbergeijk,10,460,189,187,9,11,40.7994508365,40-49,508,5,1,3,4,4,1,3,7,3.7577785212,4.4421742993,7.49471721243357E-5,0.0833333333,0.16666667,0,399,7.25482083614257E-5,1.198308E-5,1.2138721E-5,372,8,0,200,0,0
543895677,NootkaRose1,10,1019,107,195,1,6,38.9288542779,30-39,600,5,33,49,82,82,33,49,6,2.4599933043,368.4128101995,0.0586253816,0.1096055405,0.35488215,0,66,1.4105049823322102E-4,2.0371236E-4,2.0635827E-4,390,32,2,200,2,0.01
543906798,irenecasasg,10,3524,1236,1269,2,322,33.7749561888,30-39,699,6,4,4,8,8,4,4,1,1,0,3.186255976075631E-4,0.1071428571,1,319,578,2.985240256774394E-4,2.99577E-5,3.0346804E-5,323,78,0,200,0,0
544158224,thehelmetmag,10,51512,1275,1996,32,0,50.9189014207,50-59,701,9,4,1,5,5,4,1,2,1.6666666667,9303,0.0027524489,0.15,0.3,0,33,5.4724855663500774E-5,2.99577E-5,3.0346804E-5,47,2,0,202,0,0
544713449,RockinRobin2012,10,593,10,13,0,12,21.3060917858,20-29,340,5,1,0,1,1,1,0,0,0,0,4.8091669168733183E-4,0,0,0,58,4.563965479756169E-5,1.198308E-5,0,47,0,0,200,0,0
545144439,sarah_jordison,10,400,78,208,0,75,37.9824574936,30-39,467,4,7,23,30,30,7,23,7,2.7100770003,94.754252985,0.0055104308,0.191954023,0.42333335,0,66,8.364588436004088E-5,4.793232E-5,4.8554884E-5,390,14,1,200,1,0.005
545311971,HeyIamDavey,10,5486,344,292,0,2,47.5451611978,40-49,713,6,2,2,4,4,2,2,1,1,0,1.529712617250445E-4,0.0833333333,1,63,155,2.985240256774393E-4,1.797462E-5,1.8208082E-5,72,28,0,201,0,0
545801629,PauliticalEye,10,12326,84,119,5,146,28.14274658,20-29,558,8,4,6,10,10,4,6,7,3.0184131235,0.2888307789,0.0038705879,0.2777777778,0.5,0,66,5.1778437083346646E-5,2.99577E-5,3.0346804E-5,47,1,0,201,0,0
546030512,jschut_online,10,452,65,70,0,8,28.9782855273,20-29,489,4,1,1,2,2,1,1,7,3.1774355541,0,0.0016095858,0,0,0,66,4.833448709276406E-5,1.198308E-5,1.2138721E-5,140,1,0,200,0,0
546424088,FredFord46,10,4629,157,484,0,6,40.3975460622,40-49,624,7,7,30,37,37,7,30,7,2.5915634416,285.4962064018,0.0091577784,0.1869369369,0.3380682,0,66,8.942555729368718E-5,4.793232E-5,4.8554884E-5,140,6,0,200,0,0
547119953,OlveraJulian,10,9003,301,315,1,4738,47.2816470799,40-49,735,7,0,0,0,0,0,0,0,0,0,0,0,0,298,551,4.4780486537007367E-5,0,0,295,6,0,202,0,0
547611286,Jah_Nyce,10,3543,106,109,0,17,41.0348949556,40-49,679,6,2,2,4,4,2,2,8,4.1515151515,101.1666666667,1.5451083465480118E-4,0,0,30,104,1.821334296097246E-4,1.797462E-5,1.8208082E-5,315,49,0,201,0,0
547888856,cupplacoppers,10,367,33,40,1,1,28.5290152044,20-29,519,4,2,0,2,2,2,0,0,0,0,0.002627824,0,0,0,63,5.378108641614841E-5,1.797462E-5,0,55,4,1,200,1,0.005
548472253,miriam_fdezgar,10,1677,197,179,0,1,41.8377174206,40-49,671,5,5,5,10,10,5,5,1,1,0.75,4.0157977950504276E-4,0.1,0.85,167,321,3.29751550043913E-4,3.594924E-5,3.6416164E-5,289,110,0,200,0,0
550250082,SheilaGunnReid,10,44021,2193,1112,70,9710,56.2634633675,50-59,852,9,139,134,273,273,139,134,6,2.6006026113,12101.9616806662,0.063581801,0.0467032967,0.17635658,0,66,7.401361406100789E-4,8.388156E-4,8.497105E-4,372,1035,3,207,3,0.0144927536
550534777,DustinJMGriffin,10,504,95,71,0,1,38.9381085998,30-39,564,4,15,12,27,27,15,12,7,2.9286909943,42.9997654876,0.012669365,0.1339031339,0.35263157,0,66,9.595444554139587E-5,9.586464E-5,9.710977E-5,140,13,4,199,4,0.0201005025
552080063,paulapeps,10,2727,286,254,1,184,42.4731262792,40-49,685,6,0,0,0,0,0,0,0,0,0,0,0,0,97,205,4.4780486537007367E-5,0,0,92,23,0,199,0,0
552119609,legant66,10,9266,263,367,5,1,38.7428871638,30-39,678,8,9,6,15,15,9,6,7,2.9631737529,6.409485053,0.0162820832,0.2,0.40384614,0,66,7.831116804097498E-5,5.99154E-5,6.069361E-5,140,41,0,225,0,0
552494270,wastedsundays,10,249,13,44,0,4,27.9495641806,20-29,420,4,0,1,1,1,0,1,8,3.7412985274,0,0,0,0,0,702,4.4780486537007367E-5,0,6.0693606E-6,372,0,0,200,0,0
552642409,hurtucarl,10,1023,531,1172,5,45,43.3618076445,40-49,629,5,12,36,48,48,12,36,7,2.5687981252,6507.6842868093,0.0156887245,0.0780141844,0.21666667,0,66,8.68083190138169E-5,7.789002E-5,7.8901685E-5,390,5,0,200,0,0
552830823,Eh_riick,10,6704,85,67,0,64,43.050931167,40-49,705,7,1,1,2,2,1,1,9,4.9696969697,0,7.650200111535447E-5,0,0,30,104,9.35838373612677E-5,1.198308E-5,1.2138721E-5,315,10,0,201,0,0
553215041,DonCapriccioso,10,4388,771,1768,5,6,44.8905532779,40-49,664,6,14,33,47,47,14,33,6,2.5734851021,676.3642905104,0.0223302315,0.0878815911,0.30208334,0,66,8.25079175305417E-5,8.98731E-5,9.104041E-5,47,5,0,200,0,0
553315935,AlCatJDP,10,946,71,188,1,205,25.4392699796,20-29,563,5,7,14,21,21,7,14,7,2.7090726481,3562.34681431,0.010167075,0.0857142857,0.31868133,0,66,7.878010208324064E-5,4.793232E-5,4.8554884E-5,47,4,0,200,0,0
553601544,Logigron,10,71,28,276,0,112,13.2590185118,10-19,68,3,5,25,30,30,5,25,7,2.7157683294,11.2436343323,0.0078873565,0.2528735632,0.5061538,0,66,5.883369805967391E-5,3.594924E-5,3.6416164E-5,140,0,0,89,0,0
553747738,IanRGillespie,10,1228,524,874,8,1,49.0767501356,40-49,633,5,165,179,344,344,165,179,6,2.317710077,5055.2924631159,0.2235915061,0.1059478609,0.2711431,0,66,9.261716326598034E-4,9.945956E-4,0.0010075138,390,43,11,200,11,0.055
554476689,st3v3turn3r,10,2109,221,265,7,29,46.7069803913,40-49,658,6,12,14,26,26,12,14,7,2.9534650151,120.045390458,0.0085099246,0.0938461538,0.35833332,0,66,1.2502968236275584E-4,7.789002E-5,7.8901685E-5,140,12,0,200,0,0
554872086,RunForTheEarth,10,83,256,336,5,2,36.879647956,30-39,446,3,2,4,6,6,2,4,7,3.0532306662,0.2494318182,6.756112725519808E-4,0.2333333333,0.5,0,66,4.785366834423614E-5,1.797462E-5,1.8208082E-5,47,1,0,175,0,0
556301825,UNYANews,10,252,244,393,5,145,40.6568880958,40-49,513,4,7,9,16,16,7,9,7,3.0528958822,370.5932346387,0.011288709,0.1208333333,0.34545454,0,66,9.795873255082137E-5,4.793232E-5,4.8554884E-5,47,7,0,200,0,0
556331089,NZFoWL,10,14288,650,1988,25,250,40.7350930336,40-49,637,8,9,14,23,23,9,14,7,2.8024774021,89.9470243513,0.008727931,0.0691699605,0.24583334,0,66,7.604336073818154E-5,5.99154E-5,6.069361E-5,47,1,0,201,0,0
556880621,lilypad3516,10,969,64,120,0,25,21.9820844514,20-29,474,5,5,9,14,14,5,9,7,2.7854034148,3106.300653927,0.0054828993,0.1703296703,0.3181818,0,66,5.697448445625195E-5,3.594924E-5,3.6416164E-5,47,1,1,200,1,0.005
557444928,DDesBaillets,10,2674,586,1903,5,36,43.5533872126,40-49,627,6,47,214,261,261,47,214,6,2.1988617342,3017.4951571087,0.0678796948,0.1169171824,0.24998903,0,66,2.0500069955064817E-4,2.8759392E-4,2.913293E-4,390,19,1,200,1,0.005
557449649,truthmashup,10,8530,598,636,14,340,40.8729230761,40-49,722,7,125,153,278,278,125,153,6,2.2661533311,9420.160275596,0.1565223047,0.0551905046,0.2441885,0,66,3.776862836530558E-4,7.5493404E-4,7.6473947E-4,47,67,40,202,40,0.198019802
557995848,BradTapson,10,265,27,107,1,105,27.2886864532,20-29,388,4,0,1,1,1,0,1,8,3.6462516734,0,0,0,0,0,672,4.4780486537007367E-5,0,6.0693606E-6,390,2,2,200,1,0.01
558030678,stitchxp626,10,25,7,10,0,0,15.7754814346,10-19,127,0,0,0,0,0,0,0,0,0,0,0,0,0,328,593,4.4780486537007367E-5,0,0,333,0,0,28,0,0
558827088,mike4mla,10,1338,750,1547,12,19,54.6803818435,50-59,628,5,21,53,74,74,21,53,6,2.463675929,1072.2370902445,0.0204755807,0.1079229915,0.26525974,0,66,1.401876763571519E-4,1.3181388E-4,1.3352593E-4,372,17,0,200,0,0
558965990,PhilipHogan1,10,266,42,79,3,7,30.7127737382,30-39,299,3,2,6,8,8,2,6,7,3.1305657851,1.1157427969,0.0032466726,0.2142857143,0.53333336,0,66,6.200024288120118E-5,1.797462E-5,1.8208082E-5,47,0,0,200,0,0
559014346,pmccann83,10,639,96,230,0,278,24.6896491883,20-29,577,5,0,0,0,0,0,0,0,0,0,0,0,0,261,492,4.4780486537007367E-5,0,0,258,6,0,198,0,0
559049672,jlynnda60,10,37227,470,620,12,15819,39.3020934162,30-39,744,9,15,16,31,31,15,16,7,2.8861734181,30.7962075075,0.0109582411,0.1322580645,0.42857143,0,66,9.450996158583506E-5,9.586464E-5,9.710977E-5,47,104,0,197,0,0
559146347,Manzell_mata,10,7572,237,246,0,57,47.2766958538,40-49,714,7,2,3,5,5,2,3,8,4,68.2666666667,1.546855607836965E-4,0,0,30,104,1.7224671998761069E-4,1.797462E-5,1.8208082E-5,315,38,0,201,0,0
559466563,Donness,10,127,40,95,1,0,30.331271059,30-39,567,4,2,3,5,5,2,3,8,3.3746233679,1.1051602702,3.054642787657531E-4,0.1,0.6666667,0,66,7.007930727725485E-5,1.797462E-5,1.8208082E-5,47,8,0,155,0,0
559819013,Diidys_B,10,29491,197,117,0,148,48.1025003668,40-49,766,8,3,3,6,6,3,3,6,2.9393939394,157,2.456136905096451E-4,0,0,30,104,2.4301674083680646E-4,2.396616E-5,2.4277442E-5,315,29,0,201,0,0
559830210,lestebug10,10,10312,516,416,0,2465,35.2076311147,30-39,740,7,0,0,0,0,0,0,0,0,0,0,0,0,297,550,4.4780486537007367E-5,0,0,294,14,0,200,0,0
559888611,Bendods1,10,673,121,125,0,99,37.1605694631,30-39,614,4,6,7,13,13,6,7,1,1,0,4.977388905364672E-4,0.1346153846,0.85714287,46,134,1.6498109788469208E-4,4.194078E-5,4.2485524E-5,102,17,0,200,0,0
559903099,wayneglenwood,10,268,144,189,8,14,36.614746722,30-39,739,8,21,27,48,48,21,27,6,2.5969199866,376.9941532865,0.0279375511,0.0784574468,0.30322582,0,66,1.0183626067923557E-4,1.3181388E-4,1.3352593E-4,47,11,0,201,0,0
559995442,MacDougall1165,10,1865,251,1082,1,16,40.2214381681,40-49,569,6,42,165,207,207,42,165,6,2.1914964848,9856.1908183494,0.0630543588,0.1037943811,0.2315595,0,66,1.6242105964020876E-4,2.5763622E-4,2.6098252E-4,390,13,0,200,0,0
560765411,36Emmet,10,155,5,9,0,1,17.4414173747,10-19,383,3,1,1,2,2,1,1,7,3.3113491798,0,5.757145679003668E-4,0,0,0,66,4.6998751278856705E-5,1.198308E-5,1.2138721E-5,47,0,0,155,0,0
561028136,Staarky,10,222,17,28,0,7,22.4234821074,20-29,421,4,2,8,10,10,2,8,7,2.9926347506,6.640642953,0.0028463994,0.2333333333,0.3611111,0,66,6.114333838801465E-5,1.797462E-5,1.8208082E-5,47,4,0,199,0,0
561264121,Kayvee1000,10,12001,845,1179,4,578,39.4048188207,30-39,764,8,227,256,483,483,227,256,6,2.1369266823,16815.5131080161,0.2808322303,0.0456388581,0.24850015,0,66,5.797897879945383E-4,0.001366071,0.0013838143,47,127,0,220,0,0
561387460,melissaburke85,10,155,37,91,2,16,29.2760203205,20-29,426,3,0,2,2,2,0,2,7,3.2489959839,0,0,0.5,0.5,0,439,4.4780486537007367E-5,0,6.0693606E-6,55,0,0,187,0,0
561603919,WHHYLs,10,259,173,162,3,0,26.3215542029,20-29,507,4,30,19,49,49,30,19,7,2.8459993304,172.9979921265,0.0351596529,0.1930272109,0.5022523,0,66,1.4979875607223605E-4,1.8573774E-4,1.8815018E-4,140,18,1,198,1,0.0050505051
562628806,MrSharpe24,10,40,14,15,0,0,12.2285441559,10-19,124,0,0,0,0,0,0,0,0,0,0,0,0,0,15,87,4.4780486537007367E-5,0,0,11,0,0,40,0,0
563166754,WildRoseCanada,10,25,86,193,3,1,30.6105811791,30-39,499,2,18,40,58,58,18,40,6,2.6451288919,1128.0397381138,0.0354699568,0.1397459165,0.2657143,0,66,1.5452771642531453E-4,1.1383926E-4,1.1531785E-4,372,3,0,26,0,0
563293589,TeamBertschi,10,937,513,1466,11,4,39.2955144023,30-39,602,5,102,231,333,333,102,231,6,2.213592233,10541.3884774414,0.133918501,0.0924961106,0.21800523,0,66,5.015692508707618E-4,6.171286E-4,6.2514417E-4,140,15,0,200,0,0
563759499,stanczykowski,10,2970,368,564,22,16,51.9449419308,50-59,630,6,3,10,13,13,3,10,7,3.0237696686,17.5665935893,0.0011289526,0.1923076923,0.43636364,0,66,5.936850104859263E-5,2.396616E-5,2.4277442E-5,140,4,0,200,0,0
563849409,MartinPatriquin,10,3217,2340,270,63,20,61.9447600212,60-69,744,6,209,23,232,232,209,23,6,2.6642115835,2037.580295344,0.2765787261,0.0952940737,0.15952797,0,66,0.0016081209,0.0012582234,0.001262427,140,114,2,200,2,0.01
564037933,DArcy_McGee_,10,1328,61,112,3,12,35.306674972,30-39,467,5,14,25,39,39,14,25,6,2.5637763642,362.0705130559,0.0328243217,0.1363022942,0.35632184,0,66,1.2167914491872716E-4,8.98731E-5,9.104041E-5,140,1,2,200,2,0.01
564212349,ElliotAustinH,10,1124,38,67,1,0,34.068912418,30-39,549,5,0,5,5,5,0,5,7,3.1532797858,0,0,0.2,0.25,0,632,4.4780486537007367E-5,0,6.0693606E-6,372,2,2,199,2,0.0100502513
564920924,tsuOECTA,10,265,101,6,1,0,24.4876100198,20-29,473,3,4,1,5,5,4,1,8,3.4137931034,0.9074147155,0.0010525153,0.1,0.16666667,0,66,7.113266888486271E-5,2.99577E-5,2.4277442E-5,390,29,0,197,0,0
565131608,Cromsdottir,10,1511,197,652,4,469,35.0206132725,30-39,498,5,7,20,27,27,7,20,7,2.619685303,18.0745616938,0.0134503506,0.1524216524,0.42894736,0,66,6.415477109569071E-5,4.793232E-5,4.8554884E-5,47,2,0,199,0,0
565405613,DCProfessor1,10,34486,1229,2000,41,5613,56.2269349874,50-59,787,9,13,6,19,19,13,6,7,3.0632741881,565.0928845143,0.0043957119,0.0204678363,0.045833334,0,66,1.4198681673109487E-4,8.388156E-5,8.497105E-5,47,37,0,202,0,0
566058786,Dswagon,10,472,20,165,0,24,17.0305594176,10-19,312,4,0,13,13,13,0,13,7,2.8815261044,0,0,0.4166666667,0.6602564,0,621,4.4780486537007367E-5,0,6.0693606E-6,140,0,0,200,0,0
566579915,samdinicol,10,849,566,1996,9,9,50.9645860566,50-59,652,6,133,277,410,410,133,277,6,2.197857382,10378.3006567029,0.1521873773,0.0832130717,0.2387069,0,66,5.974597037694965E-4,8.0286636E-4,8.132943E-4,390,281,33,237,33,0.1392405063
567663996,StopHarperBot,10,7528,262,0,6,0,38.1929357699,30-39,718,6,63,0,63,63,63,0,0,0,0,0.0606719275,0.1338965694,0.22606246,0,9,1.6786816134632543E-4,3.8345857E-4,0,47,70,2,212,2,0.0094339623
567814795,BryanLCrockett,10,6866,460,831,14,18,62.2498752194,60-69,733,7,87,145,232,232,87,145,6,2.3003013057,4512.0353072255,0.1104237154,0.0824936558,0.2691622,0,66,3.103918494347897E-4,5.272555E-4,5.341037E-4,140,65,5,209,5,0.023923445
568394674,IanDBruce,10,459,229,262,12,7,46.7744950357,40-49,610,5,11,17,28,28,11,17,7,2.9588215601,37.930772735,0.0109018342,0.1507936508,0.33982685,0,66,9.251868047126206E-5,7.189848E-5,7.283233E-5,55,10,0,200,0,0
569445382,CCA_Chair,10,455,199,250,9,43,41.4403802548,40-49,588,4,11,12,23,23,11,12,7,3.2564445932,3097.7775541777,0.0032599201,0.0415019763,0.18131869,0,66,1.981503756041026E-4,7.189848E-5,7.283233E-5,372,15,0,200,0,0
570144609,theLLivingstone,10,1115,270,281,8,24,,,641,5,35,26,61,61,35,26,6,2.8275862069,324.9634226674,0.0238175993,0.1428961749,0.4030303,0,66,2.3854665759503711E-4,2.1569544E-4,2.1849698E-4,372,30,2,200,2,0.01
570611285,BanditShooter,10,265,25,194,0,0,37.7225610901,30-39,500,4,0,2,2,2,0,2,7,3.0227576975,0,0,0.5,1,0,229,4.4780486537007367E-5,0,6.0693606E-6,47,0,0,200,0,0
573076951,thom_roland,10,16278,609,874,16,2405,41.4119338518,40-49,771,8,23,50,73,73,23,50,7,2.5614328758,1224.897176379,0.0356876954,0.1240487062,0.34107745,0,66,1.0298142873082686E-4,1.4379696E-4,1.4566466E-4,47,42,0,198,0,0
574132457,GwynethMPrice,10,2826,85,223,1,350,26.3184609124,20-29,606,6,24,64,88,88,24,64,6,2.4117843991,583.9298157952,0.0385899995,0.1236938349,0.34424603,0,66,1.2239838316852142E-4,1.497885E-4,1.5173401E-4,390,5,5,200,5,0.025
574279451,Quaker_Diane,10,25267,450,1830,6,958,36.7938828504,30-39,638,8,27,79,106,106,27,79,7,2.3933712755,4209.5154724305,0.0329842473,0.1350404313,0.2831766,0,66,1.0410249838715716E-4,1.6776312E-4,1.699421E-4,47,16,0,206,0,0
575511770,TedNOpitzCPC,10,290,161,442,4,2,33.3373712204,30-39,530,4,47,154,201,201,47,154,6,2.2825577503,6336.3223862401,0.0612964314,0.0798507463,0.20712191,0,66,1.556609947180221E-4,2.8759392E-4,2.913293E-4,47,18,1,197,1,0.0050761421
575574447,sylviaray5,10,91,19,71,0,6,18.2272270932,10-19,335,3,2,15,17,17,2,15,7,2.7857381989,7.8988001924,8.577435560994363E-4,0.2830882353,0.48333332,0,66,4.870197150345055E-5,1.797462E-5,1.8208082E-5,140,4,1,94,1,0.0106382979
575858975,RyanChatterjee,10,1252,140,262,2,21,36.7617115225,30-39,572,5,14,22,36,36,14,22,6,2.8577167727,146.2090341561,0.0085722048,0.1277777778,0.36615384,0,66,9.254773400828993E-5,8.98731E-5,9.104041E-5,372,7,0,199,0,0
576155831,MaiaWildwood,10,446,68,336,1,36,35.4964721256,30-39,494,4,5,22,27,27,5,22,7,2.8356210244,81.269106409,0.0035144942,0.1068376068,0.20158103,0,66,5.8162855332192026E-5,3.594924E-5,3.6416164E-5,47,11,0,200,0,0
576929601,PrairieNDP,10,638,384,386,10,14,43.1306412916,40-49,657,5,96,97,193,193,96,97,6,2.4121191831,4029.0717597902,0.1034395679,0.0967184801,0.28612494,0,66,4.283912129980885E-4,5.811794E-4,5.88728E-4,390,60,2,200,1,0.01
577083469,GreensN_A,10,252,106,155,2,7,26.5115032282,20-29,475,4,5,9,14,14,5,9,7,2.8640776699,45.1120317223,0.0044208673,0.1098901099,0.37777779,0,66,6.412636651310935E-5,3.594924E-5,3.6416164E-5,55,7,1,200,1,0.005
579490823,yorkuliberals,10,218,183,492,5,0,25.8731891273,20-29,461,3,17,59,76,76,17,59,7,2.5544024104,633.3473050339,0.0266074967,0.2285964912,0.44391677,0,66,1.2702766553916476E-4,1.0784772E-4,1.0924849E-4,140,3,6,200,6,0.03
580105810,LiiliieNutellah,10,906,54,84,0,3,41.2015518473,40-49,615,5,1,1,2,2,1,1,8,4,0,7.34391852452689E-5,0.5,0.5,30,571,6.38121941004466E-5,1.198308E-5,6.0693606E-6,315,23,0,200,0,0
581131583,douglaslaforme,10,315,3,39,0,2,13.2962348455,10-19,352,4,0,0,0,0,0,0,0,0,0,0,0,0,146,295,4.4780486537007367E-5,0,0,143,1,0,200,0,0
581438207,BenDayle,10,3853,95,195,2,27,31.5106776914,30-39,547,7,20,28,48,48,20,28,7,2.6478071644,415.0543156642,0.0210122071,0.1134751773,0.2777778,0,66,9.469687742277924E-5,1.2582233E-4,1.2745657E-4,47,6,8,204,8,0.0392156863
581803888,kyrauvrml,10,38,12,349,0,0,,,14,2,0,0,0,0,0,0,0,0,0,0,0,0,331,597,4.4780486537007367E-5,0,0,336,0,0,201,0,0
581863095,manuelelejog46,10,734,209,329,0,58,39.9993897263,30-39,608,5,1,1,2,2,1,1,1,1,0,7.49471721243357E-5,0,0,120,236,2.9852402567743944E-4,1.198308E-5,1.2138721E-5,119,46,0,200,0,0
583022820,Truck_daBea5t,10,9091,284,268,0,11,34.1989201543,30-39,691,6,1,1,2,2,1,1,1,1,0,7.49471721243357E-5,0,0,200,381,2.9852402567743944E-4,1.198308E-5,1.2138721E-5,194,9,0,201,0,0
583550400,RyuIkan,10,4495,117,131,1,665,32.3734617273,30-39,631,6,2,10,12,12,2,10,7,3.0020087044,0.359758367,0.0012044013,0.2954545455,0.56666666,0,66,5.199494790661027E-5,1.797462E-5,1.8208082E-5,390,2,2,200,2,0.01
584380180,Ricardo_shire,10,2961,452,123,0,1,33.4012943736,30-39,658,5,1,1,2,2,1,1,1,1,0,7.49471721243357E-5,0,0,123,240,2.9852402567743944E-4,1.198308E-5,1.2138721E-5,121,29,0,200,0,0
585434206,JillianLeBlanc4,10,116,46,121,0,53,19.3553062833,10-19,446,3,0,4,4,4,0,4,8,3.2925033467,0,0,0.4166666667,0.6666667,0,430,4.4780486537007367E-5,0,6.0693606E-6,390,0,0,126,0,0
585885675,TotalPolicing,10,2462,186,299,2,638,45.6098119438,40-49,620,6,2,2,4,4,2,2,7,3.0950786743,0.4921998948,0.002657238,0.0833333333,0.5,0,66,5.0822371887202947E-5,1.797462E-5,1.8208082E-5,47,4,0,200,0,0
586185825,Greg__V,10,34312,398,142,1,1,38.5209166949,30-39,785,8,11,7,18,18,11,7,6,2.8181818182,76.4150793651,9.42981265879494E-4,0.1045751634,0.5272727,30,104,5.99313163458045E-4,7.189848E-5,7.283233E-5,315,44,0,203,0,0
587138551,GwynAdam,10,9574,338,327,8,1286,36.9998928336,30-39,650,8,62,60,122,122,62,60,6,2.3893538668,2394.8367844772,0.0807347143,0.0590028451,0.32270467,0,66,1.8980003483034098E-4,3.7746702E-4,3.8236973E-4,47,18,1,207,1,0.0048309179
587512782,NanahMeenah,10,11905,770,412,5,119,47.5004776373,40-49,759,7,2,2,4,4,2,2,1,1,2,1.4992441991589235E-4,0,0,397,716,4.3582306220354E-4,1.797462E-5,1.8208082E-5,408,143,0,201,0,0
587673918,GardinerGavin,10,151,164,193,2,5,40.6391362998,40-49,521,3,16,20,36,36,16,20,7,2.8838299297,82.519024803,0.0102290007,0.123015873,0.3723077,0,66,1.003494308201178E-4,1.0185618E-4,1.0317913E-4,390,3,0,158,0,0
587725384,LaIraPopular,10,1377,131,99,1,18,29.8820588626,20-29,541,5,0,0,0,0,0,0,0,0,0,0,0,0,212,405,4.4780486537007367E-5,0,0,207,6,0,202,0,0
587873748,SaveTheELA,10,903,706,687,25,4,57.1303143186,50-59,730,5,144,151,295,295,144,151,7,2.3739537998,54875.3758860656,0.1285569514,0.0419116799,0.12495025,0,66,7.058775178018821E-4,8.687733E-4,8.5577986E-4,55,640,1,201,1,0.0049751244
588017994,JohnKleinRegina,10,5794,471,593,17,2864,38.7057508519,30-39,728,7,44,46,90,90,44,46,6,2.5738198862,1855.6886939737,0.0419240555,0.0453183521,0.18585859,0,66,2.0339244617804887E-4,2.696193E-4,2.7312123E-4,390,51,0,200,0,0
590003661,caro_caron,10,3965,611,755,5,31,52.7373577643,50-59,719,7,12,17,29,29,12,17,7,2.6521593572,156.2087303814,0.0163666907,0.0603448276,0.32352942,0,66,8.597212396560315E-5,7.789002E-5,7.8901685E-5,47,5,0,201,0,0
590528384,antiillumi,10,5740,253,318,3,55,45.4847589773,40-49,643,6,6,8,14,14,6,8,7,2.8212253097,66.7926441733,0.0088689244,0.0549450549,0.3392857,0,66,7.268988934074358E-5,4.194078E-5,4.2485524E-5,390,9,0,201,0,0
590650380,BradLeeSev,10,2170,114,243,0,111,44.3696720286,40-49,576,5,35,58,93,93,35,58,7,2.5507197857,1082.6827439326,0.0336639315,0.0797101449,0.24627976,0,66,1.4058025208163718E-4,2.1569544E-4,2.1849698E-4,47,31,1,212,1,0.0047169811
591150170,COPEthunderbay,10,119,31,66,0,0,17.3445602746,10-19,152,4,5,6,11,11,5,6,7,2.9119517911,19.10999626,0.0047416432,0.0818181818,0.53333336,0,66,5.790806592544397E-5,3.594924E-5,3.6416164E-5,390,0,0,160,0,0
591378710,HChandia,10,112,13,94,0,176,12.405003059,10-19,11,4,0,1,1,1,0,1,10,5.6050870147,0,0,0,0,0,368,4.4780486537007367E-5,0,6.0693606E-6,320,0,0,201,0,0
591457191,MiamiSeoCompany,10,504,96,75,0,26,42.7309136892,40-49,598,5,0,1,1,1,0,1,1,1,0,0,0,0,0,709,4.4780486537007367E-5,0,6.0693606E-6,320,7,0,200,0,0
591461998,smosonyi,10,2026,268,502,6,158,44.2270687932,40-49,635,6,31,60,91,91,31,60,6,2.4951456311,1394.6243567102,0.0330777376,0.1207570208,0.3071185,0,66,1.9804371899468664E-4,1.9172928E-4,1.9421954E-4,372,18,1,200,1,0.005
591973680,AngelaRomer01,10,2060,298,217,0,16,42.2039265722,40-49,627,4,4,4,8,8,4,4,2,1.2,0.25,3.2341590948101786E-4,0.1071428571,0.9166667,167,321,2.7074367365054316E-4,2.99577E-5,3.0346804E-5,289,41,0,200,0,0
592461813,CatholicMouse,10,3024,311,317,8,1,33.5175250931,30-39,639,6,11,19,30,30,11,19,7,3.23970539,278.2666776752,0.0016452739,0.0873563218,0.32368422,0,66,1.22664324800977E-4,7.189848E-5,7.283233E-5,372,27,3,200,3,0.015
593940488,SmallToffee,10,16745,391,298,1,975,36.8678016122,30-39,743,7,3,7,10,10,3,7,7,3.1515151515,16.0285714286,2.6339033853498857E-4,0.1666666667,0.6904762,30,104,1.897265784102486E-4,2.396616E-5,2.4277442E-5,315,43,0,200,0,0
593946790,Jclar672Jmc,10,210,34,199,0,2,16.6131938017,10-19,108,3,1,18,19,19,1,18,7,2.750251088,4.4531991822,6.51798925476034E-4,0.283625731,0.47712418,0,66,4.6289777447431015E-5,1.198308E-5,1.2138721E-5,140,1,0,200,0,0
594212211,lilyliveredlib,10,410,70,79,1,3,40.9994273903,40-49,549,4,20,30,50,50,20,30,7,2.703046535,21.4519783228,0.0261409291,0.1681632653,0.53109246,0,66,1.0229615272952221E-4,1.2582233E-4,1.2745657E-4,140,10,1,200,1,0.005
594525433,Maestria_OMG,10,462,179,205,1,20,40.1595673077,40-49,550,4,0,0,0,0,0,0,0,0,0,0,0,0,40,124,4.4780486537007367E-5,0,0,32,45,0,200,0,0
594844518,chimera_mary,10,196,18,102,0,141,23.6743859829,20-29,298,4,0,5,5,5,0,5,7,2.8878848728,0,0,0.4,0.65,0,619,4.4780486537007367E-5,0,6.0693606E-6,390,0,0,200,0,0
594984816,noneofitwastrue,10,8346,157,189,2,9,35.4215654213,30-39,715,7,15,16,31,31,15,16,7,2.9886173418,87.9518028324,0.0125873925,0.1247311828,0.285,0,66,8.612204420673587E-5,9.586464E-5,9.710977E-5,372,68,0,200,0,0
595193381,ChazzChazz4,10,10511,535,428,0,613,48.2104406687,40-49,712,7,0,0,0,0,0,0,0,0,0,0,0,0,349,640,4.4780486537007367E-5,0,0,358,1,0,201,0,0
595562971,RyanMuddy1,10,170,17,111,0,9,24.5370068431,20-29,379,4,1,1,2,2,1,1,7,3.6287244727,0,5.208729309595926E-4,0.5,0.5,0,66,4.731630191670526E-5,1.198308E-5,1.2138721E-5,372,1,0,182,0,0
595774618,BannockHammock,10,806,104,111,1,126,40.7329951553,40-49,608,4,10,15,25,25,10,15,7,2.8875125544,79.6944077219,0.0126244925,0.0866666667,0.33809525,0,66,9.045684635608425E-5,6.590694E-5,6.6762965E-5,47,10,0,201,0,0
595832255,RP_67,10,3378,320,912,1,6,34.0393747291,30-39,503,6,23,46,69,69,23,46,7,2.5651155005,446.6846793281,0.0318264184,0.0937766411,0.31914893,0,66,9.896548925527937E-5,1.4379696E-4,1.4566466E-4,47,2,1,199,1,0.0050251256
596080947,KimKimy3,10,25050,415,179,0,540,38.1016257911,30-39,762,8,11,8,19,19,11,8,6,2.7878787879,88.8765873016,9.270571662759828E-4,0.0730994152,0.4090909,30,104,5.445462530741334E-4,7.189848E-5,7.283233E-5,315,20,0,202,0,0
596527769,Sasquacht,10,32812,234,15,0,0,40.4521496179,40-49,588,5,1,4,5,5,1,4,1,1,2,7.49471721243357E-5,0.05,0.083333336,36,117,7.014737994708823E-5,1.198308E-5,1.2138721E-5,29,0,0,202,0,0
596610030,scriven42,10,2653,203,431,0,36,42.4696267923,40-49,611,6,8,22,30,30,8,22,7,2.7997991296,1547.9510497449,0.0050979289,0.0885057471,0.22943723,0,66,9.045636558256375E-5,5.392386E-5,5.4624245E-5,140,5,2,197,2,0.0101522843
596734648,PDAAZ,10,3531,250,508,8,0,38.0929691542,30-39,653,6,6,4,10,10,6,4,8,3.650820221,61.3011363882,7.784539350433019E-4,0.0555555556,0.26666668,0,66,1.6193320913786833E-4,4.194078E-5,4.2485524E-5,47,20,0,201,0,0
597569522,Mes2Cents,10,190,6,36,0,0,19.8788762157,10-19,106,3,0,2,2,2,0,2,7,3.3875502008,0,0,0,0,0,657,4.4780486537007367E-5,0,6.0693606E-6,390,2,6,200,6,0.03
597939859,Baarbiiye_Gmb,10,12271,288,116,0,47,45.4734376731,40-49,723,7,3,3,6,6,3,3,8,3.7575757576,80.2333333333,2.2950260863648667E-4,0.0333333333,0.33333334,30,104,2.180141531467771E-4,2.396616E-5,2.4277442E-5,315,40,0,204,0,0
597968245,cosmicpoutine,10,32220,3183,2283,19,15112,43.0894681647,40-49,787,8,6,5,11,11,6,5,7,3.0080348175,184.9447943997,0.0059530332,0.0454545455,0.3,0,66,6.465426197155841E-5,4.194078E-5,4.2485524E-5,47,32,0,200,0,0
598497297,cormier1027,10,1316,85,324,0,12,31.3748053464,30-39,564,6,0,2,2,2,0,2,7,3.3892235609,0,0,0.5,0.5,0,638,4.4780486537007367E-5,0,6.0693606E-6,140,7,0,200,0,0
599188522,jaimegs89,10,1926,148,292,0,14,39.9568988369,30-39,636,6,1,2,3,3,1,2,2,1.3333333333,2,7.49471721243357E-5,0,0,121,238,1.2969692065828504E-4,1.198308E-5,1.2138721E-5,117,3,0,199,0,0
599313676,mixedbagmag,10,2154,689,2000,8,214,45.2930484599,40-49,639,6,5,14,19,19,5,14,7,2.8547037161,949.9329769122,0.0093662375,0.1023391813,0.225,0,66,7.045551174030772E-5,3.594924E-5,3.6416164E-5,47,8,0,199,0,0
599375374,Oldunionist,10,1832,75,237,0,25,36.6022342711,30-39,533,6,13,33,46,46,13,33,6,2.4315366589,350.0256291891,0.0171874981,0.1125603865,0.31155303,0,66,8.111372763705442E-5,8.388156E-5,8.497105E-5,390,4,0,200,0,0
599679507,CodingNotes,10,1041,360,460,7,71,45.7025877605,40-49,643,5,4,4,8,8,4,4,1,1,6.5,3.0763416384958954E-4,0.0535714286,0.41666666,169,323,4.6143805912641166E-4,2.99577E-5,3.0346804E-5,342,26,0,200,0,0
600348686,JosephDubonnet,10,463,126,365,1,6,43.1204781997,40-49,526,4,8,20,28,28,8,20,7,2.8597254771,1664.1501412558,0.0087206792,0.1150793651,0.27380952,0,66,7.638895017153032E-5,5.392386E-5,5.4624245E-5,390,23,0,200,0,0
602446013,marshall_rita,10,2290,222,461,2,297,47.1373017678,40-49,624,6,38,81,119,119,38,81,7,2.453297623,2659.571410951,0.0367803744,0.0809001567,0.23596826,0,66,2.0264290481754197E-4,2.3367006E-4,2.3670506E-4,47,49,0,193,0,0
603053240,shouldbesaidcan,10,6664,333,530,7,8,36.562493145,30-39,709,7,64,85,149,149,64,85,6,2.6052895882,2748.8916278716,0.0293004635,0.0721023036,0.24848485,0,66,2.852119289594701E-4,3.8945008E-4,3.9450845E-4,372,41,0,199,0,0
603227316,wallin_r,10,6077,255,486,3,1269,44.4102272208,40-49,718,7,3,4,7,7,3,4,7,3.0043521928,54.4380514263,0.002398265,0,0,0,66,7.954543926474572E-5,2.396616E-5,2.4277442E-5,372,16,0,201,0,0
603341720,bfaparsons,10,1501,210,409,7,23,55.2254235127,50-59,640,6,40,54,94,94,40,54,6,2.6083026448,6650.0687399959,0.0618728521,0.1307481126,0.4236111,0,66,2.625081751925473E-4,2.4565315E-4,2.4884377E-4,140,14,0,200,0,0
603719194,Colin_m_Brown,10,2558,375,715,8,769,47.1767729134,40-49,650,6,42,68,110,110,42,68,6,2.458319384,673.4927095006,0.0473456553,0.1582151793,0.36853626,0,66,2.1590077873717963E-4,2.5763622E-4,2.6098252E-4,140,32,1,200,1,0.005
604655008,YoungLiberalsPE,10,238,248,599,4,57,42.378527725,40-49,542,4,26,37,63,63,26,37,7,2.6133244058,313.0531269865,0.0262827992,0.1093189964,0.38414633,0,66,1.6652814273891163E-4,1.6177158E-4,1.6387274E-4,140,36,1,200,1,0.005
604806474,EkaCoop,10,3519,235,425,6,385,45.2891110333,40-49,633,7,35,60,95,95,35,60,6,2.395714764,1297.8329671778,0.0511827637,0.074356103,0.2423077,0,66,1.4802748891217047E-4,2.1569544E-4,2.1849698E-4,47,36,0,203,0,0
604842373,A_Wall2,10,826,59,179,1,65,41.269495477,40-49,516,5,11,21,32,32,11,21,7,2.7820555742,425.2984934214,0.0056078414,0.1129032258,0.42857143,0,66,1.3590160861002824E-4,7.189848E-5,7.283233E-5,55,33,0,200,0,0
605940304,pearsonsghost,10,1875,252,609,1,23,19.0372792479,10-19,595,6,90,174,264,264,90,174,7,2.2624707064,4230.5154629058,0.1316618796,0.0975342781,0.26546308,0,66,2.4027975383647152E-4,5.452301E-4,5.5231183E-4,47,1,4,200,4,0.02
606076956,mkayy_sweezy,10,2574,158,214,0,679,32.3554098918,30-39,667,6,1,1,2,2,1,1,1,1,0,7.49471721243357E-5,0,0,390,707,2.9852402567743944E-4,1.198308E-5,1.2138721E-5,402,15,0,199,0,0
606430476,kierakerr12,10,171,95,115,0,22,24.2106288041,20-29,466,3,2,2,4,4,2,2,3,1.9,0,1.6547046095682466E-4,0.0833333333,1,2,183,7.690256532503898E-5,1.797462E-5,1.8208082E-5,322,1,0,192,0,0
606492249,peterongilford,10,646,85,133,1,6,40.472177542,40-49,544,5,7,14,21,21,7,14,7,2.8530297958,87.3601728368,0.0061421747,0.0785714286,0.2857143,0,66,7.98625722469912E-5,4.793232E-5,4.8554884E-5,390,11,0,200,0,0
606564909,Ottawa_Andrew,10,129,35,192,1,5,33.4406210347,30-39,329,3,0,10,10,10,0,10,7,2.7791164659,0,0,0.4666666667,0.74444443,0,266,4.4780486537007367E-5,0,6.0693606E-6,140,4,13,180,10,0.0722222222
606653450,Infospress,10,14171,4,10,0,0,11.5576855183,10-19,352,4,1,2,3,3,1,2,2,1.5,0,7.49471721243357E-5,0.1666666667,0.5,36,117,5.9686805425790906E-5,1.198308E-5,1.2138721E-5,29,0,0,293,0,0
606759900,CarolynMLB,10,131,13,35,0,13,19.731608251,10-19,143,3,2,2,4,4,2,2,7,3.1205222631,0,0.0050627363,0.0833333333,1,0,66,8.243867784171844E-5,1.797462E-5,1.8208082E-5,390,1,0,136,0,0
607054668,HenryMcRandall1,10,1314,689,1992,14,1,40.8065512158,40-49,626,5,7,19,26,26,7,19,7,2.8590559089,485.5157735012,0.0033868068,0.0369230769,0.07368421,0,66,5.900594277364418E-5,4.793232E-5,4.8554884E-5,47,0,0,200,0,0
607531851,vansopinion8ted,10,12705,313,306,11,105,37.6611022949,30-39,665,8,74,62,136,136,74,62,6,2.3987278206,1978.885129569,0.074491735,0.0756535948,0.25085792,0,66,2.0586366691238944E-4,4.493655E-4,4.5520204E-4,47,35,0,221,0,0
607871339,lumiere022,10,39602,892,896,22,1138,43.2735884542,40-49,761,9,29,27,56,56,29,27,7,2.7020421828,401.0197006545,0.0254736531,0.0746753247,0.19767442,0,66,1.4178670942374997E-4,1.797462E-4,1.8208082E-4,390,18,1,207,1,0.0048309179
607874997,enuff_is_enough,10,226,19,125,0,0,12.9916482201,10-19,127,4,4,9,13,13,4,9,7,2.7438901908,5.5838838838,0.004695136,0.2435897436,0.5090909,0,66,5.78434005091395E-5,2.99577E-5,3.0346804E-5,140,0,1,200,1,0.005
608283021,cdn_media,10,1196,157,242,0,6,44.5210587772,40-49,645,6,50,79,129,129,50,79,7,2.4127887513,7267.5568704437,0.0561654678,0.1008357558,0.24040404,0,66,1.8241127361650199E-4,3.0556854E-4,3.0346803E-4,47,114,0,200,0,0
608395920,teesock,10,2314,120,332,1,438,38.4738638908,30-39,600,6,16,28,44,44,16,28,6,2.4757281553,495.7029662043,0.025480824,0.1220930233,0.41502464,0,66,9.853651028600077E-5,1.0185618E-4,1.0317913E-4,390,4,0,198,0,0
608467477,opamp99,10,2995,2,35,0,0,16.0632857838,10-19,87,4,0,0,0,0,0,0,0,0,0,0,0,0,358,651,4.4780486537007367E-5,0,0,367,0,0,200,0,0
608835608,joan_rollins,10,798,45,107,1,59,42.5966783529,40-49,573,6,5,6,11,11,5,6,7,2.932373619,299.3070179372,0.0048433478,0.0818181818,0.2857143,0,66,5.9991269830456964E-5,3.594924E-5,3.6416164E-5,47,4,0,203,0,0
609037714,tnbertelsen,10,547,143,309,3,1,30.8325514022,30-39,433,4,0,1,1,1,0,1,2,1.5,0,0,0,0,0,139,4.4780486537007367E-5,0,6.0693606E-6,372,0,0,201,0,0
609603108,RobPaulX,10,3346,87,296,0,954,43.743790845,40-49,649,7,8,24,32,32,8,24,7,2.6863073318,51.0255880844,0.0122677607,0.1290322581,0.36413044,0,66,6.406013151587261E-5,5.392386E-5,5.4624245E-5,47,12,0,201,0,0
609720071,tj__07,10,766,237,332,2,38,33.3949432789,30-39,570,5,2,1,3,3,2,1,1,1,1,1.4840129616071793E-4,0,0,401,722,4.3582306220354E-4,1.797462E-5,1.2138721E-5,413,16,0,199,0,0
610195349,Vav_j,10,1914,148,402,3,222,41.666984004,40-49,584,6,21,54,75,75,21,54,7,2.4348844995,525.3752150809,0.030685425,0.1027027027,0.2851852,0,66,1.1324103908864216E-4,1.3181388E-4,1.3352593E-4,372,16,0,200,0,0
610370629,davidstuckless,10,135,9,25,0,0,22.5711650578,20-29,340,3,1,1,2,2,1,1,8,3.6916638768,0,1.473603107770633E-4,0,0,0,66,5.036056706056615E-5,1.198308E-5,1.2138721E-5,47,0,0,141,0,0
610589750,md_laolu,10,16327,335,260,1,15,46.5481207758,40-49,772,8,2,2,4,4,2,2,2,1.3333333333,0,1.560489793243037E-4,0.0833333333,1,168,322,2.4453587828285984E-4,1.797462E-5,1.8208082E-5,163,46,0,201,0,0
611297227,GamerDad42,10,8,42,23,1,4,26.8763341249,20-29,594,5,2,2,4,4,2,2,7,3.3518580516,0.4374160235,4.5774205258723564E-4,0.1666666667,0.5,0,66,5.02064244352889E-5,1.797462E-5,1.8208082E-5,390,0,0,21,0,0
612019451,nicoldesign2012,10,1734,29,74,0,5,36.464265152,30-39,538,6,3,3,6,6,3,3,7,2.9979912956,0.0360248447,0.0054906491,0.3,0.6,0,66,5.156536677218207E-5,2.396616E-5,2.4277442E-5,47,14,0,202,0,0
612496685,speakup4sci,10,2421,262,184,17,6,49.6490869365,40-49,639,6,44,17,61,61,44,17,7,2.9390693003,2437.2068859372,0.0385527898,0.0718579235,0.21464646,0,66,3.591142451839886E-4,2.696193E-4,2.6098252E-4,55,125,1,206,1,0.0048543689
613822232,BeesEyeView,10,771,307,526,2,68,43.084351138,40-49,592,5,69,117,186,186,69,117,6,2.3197187814,2453.8219750074,0.0961948308,0.0797442604,0.30740258,0,66,2.178079496650018E-4,4.194078E-4,4.2485524E-4,47,25,0,200,0,0
614436248,Kauly_97,10,8265,199,175,0,1,43.7212963736,40-49,722,7,2,2,4,4,2,2,7,3.696969697,65,1.5309719459450686E-4,0,0,30,104,2.16825276720144E-4,1.797462E-5,1.8208082E-5,315,35,0,201,0,0
614523222,LindaLoth1,10,30,1,9,0,1,20.105064403,20-29,72,2,0,5,5,5,0,5,7,2.9902945114,0,0,0.2,0.35,0,512,4.4780486537007367E-5,0,6.0693606E-6,140,3,0,38,0,0
614784729,FunFanWebs,10,20744,253,10,0,0,19.4799355281,10-19,281,5,2,0,2,2,2,0,0,0,0,1.498943442486715E-4,0.5,1,36,116,8.505369883587177E-5,1.797462E-5,0,29,0,0,201,0,0
615702478,angelovallejosf,10,1934,295,816,0,0,20.8514194501,20-29,536,6,0,4,4,4,0,4,9,4.6044176707,0,0,0.25,0.33333334,0,354,4.4780486537007367E-5,0,6.0693606E-6,320,1,0,199,0,0
615793000,markabel5,10,592,69,163,1,122,37.0239606695,30-39,555,4,4,18,22,22,4,18,6,2.7766990291,126.4280650497,0.0065318339,0.145021645,0.33006537,0,66,5.79067086432532E-5,2.99577E-5,3.0346804E-5,372,11,22,201,22,0.1094527363
616429626,mikeradan,10,1514,97,234,3,2,41.7044397093,40-49,577,6,22,40,62,62,22,40,7,2.4907934382,384.6212589995,0.0371040871,0.1766261237,0.4481383,0,66,1.1044833500418896E-4,1.3780541E-4,1.395953E-4,140,16,3,200,3,0.015
616587294,ComanderSlander,10,394,161,134,0,211,29.8444148673,20-29,579,4,3,1,4,4,3,1,2,1.6666666667,0,2.310262261392526E-4,0.25,1,53,143,2.985240256774394E-4,2.396616E-5,2.4277442E-5,257,13,0,198,0,0
617241899,SteveReynolds_,10,733,156,235,0,36,40.0431349716,40-49,619,5,6,7,13,13,6,7,1,1,0,4.977388905364672E-4,0.1346153846,0.85714287,46,134,1.6498109788469208E-4,4.194078E-5,4.2485524E-5,102,12,0,197,0,0
618163102,Bobby_B44,10,276,59,113,0,0,27.806687422,20-29,528,4,2,4,6,6,2,4,7,3.4248409776,2986.27896707,2.4756264874053715E-4,0.1,0.33333334,0,66,1.1686021338716388E-4,1.797462E-5,1.8208082E-5,372,8,0,200,0,0
618286828,CritikMystique,10,92,9,52,0,3,25.226104314,20-29,283,4,0,0,0,0,0,0,0,0,0,0,0,0,58,150,4.4780486537007367E-5,0,0,50,0,0,184,0,0
619105419,CindyTurner12,10,15,5,19,0,0,16.6202243016,10-19,6,1,0,0,0,0,0,0,0,0,0,0,0,0,8,76,4.4780486537007367E-5,0,0,5,0,0,19,0,0
619815732,Bii_Boune,10,5451,287,264,1,102,49.3749419732,40-49,719,7,3,4,7,7,3,4,6,2.7878787879,308.5333333333,2.423921216023213E-4,0,0,30,104,2.618946774521599E-4,2.396616E-5,2.4277442E-5,315,20,0,201,0,0
620365771,Madie_Verschoor,10,284,455,748,0,109,31.7211321804,30-39,498,4,1,2,3,3,1,2,1,1,0,7.64703944502054E-5,0.1666666667,1,320,579,2.0949098458571808E-4,1.198308E-5,1.2138721E-5,321,8,0,200,0,0
620453067,NokitaOh,10,27232,279,1682,0,0,40.9257422492,40-49,630,6,1,0,1,1,1,0,0,0,0,7.49471721243357E-5,0,0,36,115,5.9686805425790906E-5,1.198308E-5,0,29,0,0,202,0,0
621406056,mmail8,10,16,2,12,0,2,14.9690845959,10-19,32,1,0,0,0,0,0,0,0,0,0,0,0,0,371,677,4.4780486537007367E-5,0,0,381,0,0,17,0,0
621924412,AviGoldberg,10,5601,335,323,13,204,50.5780638996,50-59,724,7,14,15,29,29,14,15,6,2.6923334449,728.8472288867,0.0212476024,0.0554187192,0.34761906,0,66,1.0190248690666367E-4,8.98731E-5,9.104041E-5,390,19,0,202,0,0
622198555,MRBeavis,10,843,43,185,0,11,20.0250087065,20-29,486,4,3,17,20,20,3,17,7,2.6725811851,4.5984319499,0.0059472781,0.2789473684,0.5882353,0,66,5.4548463274752463E-5,2.396616E-5,2.4277442E-5,140,0,0,200,0,0
622367096,tlmporter,10,990,147,286,2,468,36.287263852,30-39,538,5,17,25,42,42,17,25,7,2.6645463676,593.9184072136,0.0161887375,0.106271777,0.42615384,0,66,1.2714390163213644E-4,1.0784772E-4,1.0924849E-4,47,10,0,199,0,0
622384821,ryanjamula,10,296,194,231,3,8,40.4671811604,40-49,600,4,33,43,76,76,33,43,7,2.7378640777,645.1827958499,0.0276317684,0.140877193,0.3787561,0,66,1.7534042968167803E-4,2.0371236E-4,2.0635827E-4,390,23,0,201,0,0
622525029,TheKnerdKingTM,10,23425,660,913,18,4,44.1867917492,40-49,774,9,40,54,94,94,40,54,7,2.5179109474,1478.6042355111,0.0506408478,0.0824754061,0.3035519,0,66,1.9804423678755962E-4,2.4565315E-4,2.4884377E-4,47,47,0,1,0,0
623174642,EmraldKatie,10,502,36,348,0,10,26.9260191948,20-29,377,5,3,8,11,11,3,8,7,3.1128222297,0.148230729,0.0062448372,0.3090909091,0.64444447,0,66,6.065364118003917E-5,2.396616E-5,2.4277442E-5,372,0,2,200,2,0.01
624022720,BeautifulRed7,10,2946,173,200,3,274,46.8894994686,40-49,678,6,63,77,140,140,63,77,7,2.374958152,872.6329395,0.0854651663,0.1102261048,0.36582017,0,66,1.9045424929845238E-4,3.8345857E-4,3.8843908E-4,47,53,0,203,0,0
624500661,V_of_tReason,10,886,63,72,1,44,44.1164489367,40-49,610,5,25,16,41,41,25,16,7,2.8085035152,960.9292857145,0.0263130426,0.1414634146,0.29327732,0,66,1.0137372541618985E-4,1.5578004E-4,1.5780337E-4,47,25,1,200,1,0.005
624961616,mrmichaelbrodie,10,371,20,106,0,44,18.325121574,10-19,330,4,1,7,8,8,1,7,7,2.8701037831,0.0285714286,0.0014657356,0.4107142857,0.58928573,0,66,4.5845875479401925E-5,1.198308E-5,1.2138721E-5,390,0,2,199,2,0.0100502513
625039826,heff_andrew,10,472,146,144,2,61,36.2867747626,30-39,515,4,1,5,6,6,1,5,7,3.1536658855,0.1335528062,0.0014721909,0.2666666667,0.36666667,0,66,4.6114985185253634E-5,1.198308E-5,1.2138721E-5,140,3,0,200,0,0
626183808,GuildwoodNDP,10,1030,344,1336,7,2,41.2331980014,40-49,539,5,97,242,339,339,97,242,6,2.1580180783,8655.7175320688,0.1115577421,0.0950498333,0.24990284,0,66,3.47454906161486E-4,5.8717094E-4,5.9479737E-4,390,17,3,200,3,0.015
626639419,politicalpoints,10,2188,808,671,10,1,51.2228437082,50-59,675,5,113,227,340,340,113,227,6,2.1493136927,18085.0926869022,0.1267523143,0.0694603505,0.15080369,0,66,3.7598755752461804E-4,6.830355E-4,6.9190713E-4,140,55,2,200,2,0.01
627055000,DianeOrihel,10,488,195,330,5,8,53.4648848954,50-59,690,5,74,97,171,171,74,97,7,2.4312018748,27276.3504203717,0.0658694542,0.0466460268,0.16251297,0,66,5.145873075441259E-4,4.493655E-4,4.5520204E-4,55,437,4,203,4,0.0197044335
627598217,IainTRankin,10,99,104,217,0,0,33.4507534806,30-39,405,3,5,11,16,16,5,11,7,2.9233344493,33.0860223,0.0062551523,0.1375,0.44545454,0,66,7.047855460542234E-5,3.594924E-5,3.6416164E-5,140,4,1,100,1,0.01
628605608,bigbobby53,10,3164,247,244,6,76,45.684127844,40-49,709,7,25,27,52,52,25,27,7,2.755272849,4830.194687349,0.0147818244,0.0539215686,0.16984127,0,66,1.7553904287769684E-4,1.5578004E-4,1.5780337E-4,390,38,0,200,0,0
629007862,PhDerping,10,609,83,127,2,3,39.9844890442,30-39,502,4,8,12,20,20,8,12,7,2.6739203214,27.3207860708,0.0132356122,0.1763157895,0.47142857,0,66,6.622286499939124E-5,5.392386E-5,5.4624245E-5,47,3,2,200,2,0.01
629768935,MassCrafter,10,1063,58,196,3,143,29.6157741734,20-29,517,5,3,4,7,7,3,4,7,2.8821560094,6.9705764425,0.0048840143,0.0952380952,0.25,0,66,6.075012402162314E-5,2.396616E-5,2.4277442E-5,47,0,0,198,0,0
629785384,lefty_religion,10,924,385,75,6,43,44.594253291,40-49,618,6,28,21,49,49,28,21,7,2.833277536,234.0399743408,0.0127737808,0.1352040816,0.4876894,0,66,1.490977004083795E-4,1.7375466E-4,1.7601145E-4,372,49,0,200,0,0
632160153,BruceMHicks,10,2273,325,109,12,0,43.2065436997,40-49,661,6,44,24,68,68,44,24,7,2.7546032809,321.2016385988,0.0833970112,0.1714223003,0.36278194,0,66,4.187904541834068E-4,2.696193E-4,2.7312123E-4,140,2,2,200,2,0.01
632320063,hex_hut,10,843,328,1108,3,10,44.1934238208,40-49,509,5,2,3,5,5,2,3,7,3.255105457,334.4518187126,0.0010153734,0.1,0.25,0,66,6.216936293350532E-5,1.797462E-5,1.2138721E-5,372,2,0,200,0,0
632592632,not_Klaatu,10,1737,285,650,8,42,50.1790706012,50-59,670,6,47,61,108,108,47,61,7,2.5483762973,6899.9963185565,0.0475954917,0.0560747664,0.19799659,0,66,3.1626080425754284E-4,2.8759392E-4,2.913293E-4,55,123,0,200,0,0
633057774,BeaverCanuck,10,85,11,35,0,5,21.219250479,20-29,377,2,5,12,17,17,5,12,7,2.7766990291,3371.9095800761,0.0063806806,0.1213235294,0.32575756,0,66,7.421644288420873E-5,3.594924E-5,3.6416164E-5,47,3,0,88,0,0
633806492,GagganGill,10,811,220,304,1,5,41.9341728342,40-49,530,5,16,23,39,39,16,23,6,2.7412119183,145.397199359,0.0121773752,0.1214574899,0.33068782,0,66,1.1441311593160187E-4,1.0185618E-4,1.0317913E-4,372,8,0,196,0,0
633839714,luresaregood,10,927,81,134,0,5,25.8477509641,20-29,590,5,13,27,40,40,13,27,6,2.6066287245,275.6883219864,0.0097288022,0.0961538462,0.33475783,0,66,9.523770200756586E-5,8.388156E-5,8.497105E-5,372,5,3,200,3,0.015
634080059,RachelAnnSnow,10,16777,1074,890,30,172,52.2999233756,50-59,787,8,93,80,173,173,93,80,7,2.4837629729,3050.8329789745,0.0811232928,0.0567616615,0.24742769,0,66,4.567654864752056E-4,5.6320475E-4,5.705199E-4,47,128,0,202,0,0
634874281,KaraArdan,10,955,83,186,0,107,42.6979624317,40-49,594,5,27,58,85,85,27,58,6,2.4797455641,529.7952455307,0.0339360547,0.0806722689,0.24926943,0,66,1.0787394520083853E-4,1.6776312E-4,1.699421E-4,47,29,0,200,0,0
635074627,larouxb,10,2536,103,447,4,309,39.1951511605,30-39,636,5,16,24,40,40,16,24,6,2.5751590224,88.6317392506,0.0302500908,0.1166666667,0.31650245,0,66,8.632082637205774E-5,1.0185618E-4,1.0317913E-4,47,9,0,200,0,0
635207814,nikkiskuce,10,320,143,175,4,30,44.1555595462,40-49,601,4,18,15,33,33,18,15,7,2.7398727821,33.4204639351,0.0214232348,0.1827651515,0.3584656,0,66,1.1054664391435354E-4,1.1383926E-4,1.1531785E-4,55,9,0,200,0,0
635598734,AlleyHen,10,939,139,497,0,1259,35.0642760401,30-39,425,5,13,35,48,48,13,35,7,2.5621024439,65.0671076697,0.0136389025,0.140070922,0.34352773,0,66,8.434852295780555E-5,8.388156E-5,8.497105E-5,47,0,0,199,0,0
636188420,benjalunaguti,10,1987,866,327,0,4,36.8214124538,30-39,507,5,1,2,3,3,1,2,10,5.6052895882,0,1.1057485856814353E-4,0.3333333333,0.5,0,66,6.79464955354548E-5,1.198308E-5,1.2138721E-5,320,0,0,201,0,0
700306736,EverythingElse4,10,1505,61,399,1,0,25.2778051297,20-29,582,6,4,16,20,20,4,16,7,2.7057248075,97.0642180943,0.0024070935,0.15,0.23856209,0,66,5.5310551557435315E-5,2.99577E-5,3.0346804E-5,390,3,0,196,0,0
703722876,ThomasHall17,10,1511,143,65,2,0,47.8707444869,40-49,654,6,27,18,45,45,27,18,7,2.8868429863,39.2052270899,0.0408015725,0.1535353535,0.30855855,0,66,2.3641704946597182E-4,1.6776312E-4,1.699421E-4,140,31,14,201,13,0.0696517413
703965512,DinoRancho,10,221,11,12,0,0,25.4261326272,20-29,329,3,2,2,4,4,2,2,7,2.942751925,1.6704962895,0.0046269056,0,0,0,66,5.1208119790535E-5,1.797462E-5,1.8208082E-5,390,5,2,200,2,0.01
704055756,OrlandoMisfit,10,6379,42,194,2,12,38.6087220119,30-39,485,7,2,1,3,3,2,1,8,3.6832942752,0,5.334367052277976E-4,0.1666666667,1,0,66,6.185020090348513E-5,1.797462E-5,1.8208082E-5,47,0,0,201,0,0
705370724,SettlerColonial,10,6854,3319,271,64,205,66.7727600344,60-69,820,7,220,36,256,256,220,36,7,2.7833947104,5073.8650972977,0.1731190266,0.0640471814,0.12373879,0,66,0.0011488585,0.0013241303,0.0013352593,47,761,0,201,0,0
705490496,kenlister1,10,332,33,89,0,4,36.9518139847,30-39,498,4,9,18,27,27,9,18,7,2.8841647138,14.7837589381,0.0124745805,0.141025641,0.42105263,0,66,9.110676340042895E-5,5.99154E-5,6.069361E-5,140,11,1,200,1,0.005
705987434,KarenSainteLuce,10,3826,426,240,2,45,37.2917442797,30-39,712,6,12,13,25,25,12,13,6,2.5757575758,203.4916666667,0.0010150018,0.0616666667,0.41025642,30,104,6.121819184744287E-4,7.789002E-5,7.8901685E-5,315,26,0,200,0,0
706036914,lbastura,10,149,6,116,0,6,35.8001405383,30-39,507,4,2,25,27,27,2,25,6,2.7495815199,5.9431443094,0.0106633719,0.3076923077,0.61333334,0,66,6.369871111938029E-5,1.797462E-5,1.8208082E-5,372,17,0,200,0,0
707226692,HMCBV,10,64,27,33,0,0,19.7087516881,10-19,217,2,0,0,0,0,0,0,0,0,0,0,0,0,162,315,4.4780486537007367E-5,0,0,158,7,0,79,0,0
707512603,Smoker420Kush,10,241,116,324,1,12,34.5991087877,30-39,424,4,1,2,3,3,1,2,7,3.2474054235,0,9.361589144561228E-4,0.1666666667,1,0,66,4.8517769716958163E-5,1.198308E-5,1.2138721E-5,47,3,0,196,0,0
708079987,RobFordSearch,10,970,403,817,10,27,43.8411104148,40-49,595,4,17,33,50,50,17,33,7,2.692668229,7377.1885601749,0.0119715841,0.0869387755,0.17051283,0,66,9.723711845336809E-5,1.0784772E-4,1.0317913E-4,140,21,0,200,0,0
708214501,michellebear1,10,9,20,44,0,3,15.6581760777,10-19,354,1,1,2,3,3,1,2,1,1,0,7.64703944502054E-5,0.1666666667,1,275,520,2.0949098458571808E-4,1.198308E-5,1.2138721E-5,297,1,0,7,0,0
708424146,Local617,10,1171,268,331,3,1,42.4011602303,40-49,625,5,14,28,42,42,14,28,7,2.7462336793,1762.5845906884,0.0111890989,0.0900116144,0.21875,0,66,7.562371719687328E-5,8.98731E-5,9.104041E-5,390,9,0,199,0,0
709766389,HoboWally,10,33,10,26,0,0,18.9670330971,10-19,290,1,0,3,3,3,0,3,7,3.297523427,0,0,0.1666666667,0.33333334,0,692,4.4780486537007367E-5,0,6.0693606E-6,390,1,0,34,0,0
710248489,Emily_Jean_12,10,964,187,188,0,503,39.9599190221,30-39,600,5,2,2,4,4,2,2,1,1,0,1.529712617250445E-4,0.0833333333,1,365,663,2.985240256774393E-4,1.797462E-5,1.8208082E-5,375,28,0,200,0,0
711063583,NDPLondon,10,540,129,128,4,1,35.96089704,30-39,513,5,31,32,63,63,31,32,6,2.6240374958,308.6562825569,0.0262379991,0.194828469,0.42734694,0,66,1.518067569381629E-4,1.9172928E-4,1.8815018E-4,390,14,8,200,8,0.04
713308196,reesespeaksblog,10,111,4,14,0,0,20.1395213733,20-29,167,2,1,2,3,3,1,2,7,3.4315366589,0,8.398060755305321E-5,0.1666666667,1,0,66,5.754211563577795E-5,1.198308E-5,1.2138721E-5,390,2,0,163,0,0
713387070,ToryBluest,10,1322,96,689,2,1,18.0626913353,10-19,621,6,10,75,85,85,10,75,6,2.4623367928,1414.6971042193,0.0113953653,0.2019607843,0.3116368,0,66,9.290008603586696E-5,6.590694E-5,6.6762965E-5,372,4,0,199,0,0
713563368,ballneverstop5,10,2805,114,74,1,320,,,683,6,2,2,4,4,2,2,3,1.8571428571,0,1.608064070291406E-4,0.0833333333,1,0,53,1.0573736370420982E-4,1.797462E-5,1.8208082E-5,352,41,0,200,0,0
714467522,DrJulieGosselin,10,263,39,90,0,2,19.7183853558,10-19,393,4,3,12,15,15,3,12,7,2.7693337797,5.9882875545,0.0080054713,0.2285714286,0.4679487,0,66,8.824254053903965E-5,2.396616E-5,2.4277442E-5,140,2,1,200,1,0.005
714987132,AnaPleguezuelos,10,426,107,233,3,31,40.5783457199,40-49,546,4,1,1,2,2,1,1,1,1,0,7.49471721243357E-5,0,0,265,498,2.9852402567743944E-4,1.198308E-5,1.2138721E-5,262,23,0,200,0,0
716197484,G_Baby67,10,2974,287,251,0,1991,43.3252881373,40-49,687,6,2,2,4,4,2,2,3,2,0,1.6423650732305477E-4,0.0833333333,1,26,99,1.1274967873956999E-4,1.797462E-5,1.8208082E-5,49,8,0,189,0,0
716501756,CopperBronzed,10,12531,281,157,4,471,53.0517993968,50-59,748,8,40,23,63,63,40,23,7,2.6468028122,804.0971543822,0.0567216266,0.105734767,0.30917874,0,66,2.6843727478085763E-4,2.4565315E-4,2.4884377E-4,47,57,0,202,0,0
717701984,RetroHardGamer,10,572,1122,1169,13,3,48.8883233665,40-49,613,4,1,1,2,2,1,1,1,1,0,7.49471721243357E-5,0,0,114,228,2.9852402567743944E-4,1.198308E-5,1.2138721E-5,110,11,0,200,0,0
718369310,rivasoi,10,55,23,532,0,0,16.9973566537,10-19,43,2,0,0,0,0,0,0,0,0,0,0,0,0,327,592,4.4780486537007367E-5,0,0,331,0,2,201,2,0.0099502488
719442583,edahelp1,10,38,43,220,0,2,18.0536410551,10-19,275,2,8,35,43,43,8,35,6,2.6089722129,140.2958022371,0.0123746408,0.2198228128,0.46470588,0,66,7.022518570248374E-5,5.392386E-5,5.4624245E-5,372,15,0,44,0,0
721201848,Morganovitch_,10,34453,695,139,4,323,41.962825981,40-49,787,8,7,3,10,10,7,3,7,3.6363636364,0.65,5.996810890707789E-4,0.1666666667,0.64285713,30,104,3.565397147892313E-4,4.793232E-5,4.8554884E-5,315,20,0,201,0,0
723293880,ModelCDN,10,2387,2965,3227,38,208,49.8770553836,40-49,652,6,38,52,90,90,38,52,6,2.7803816538,560.9261031539,0.0199518535,0.0882646692,0.4077441,0,66,1.720232663701787E-4,2.3367006E-4,2.3670506E-4,372,19,0,200,0,0
726718814,MPSCHM,10,9587,941,1976,9,2831,51.7343099017,50-59,718,8,0,3,3,3,0,3,7,3.3701472557,0,0,0,0,0,259,4.4780486537007367E-5,0,6.0693606E-6,320,19,0,201,0,0
727353728,Loriane972,10,9173,251,148,1,336,43.2306068556,40-49,683,6,2,2,4,4,2,2,7,3.6060606061,183,1.5624038529247559E-4,0,0,30,104,1.9922096627174774E-4,1.797462E-5,1.8208082E-5,315,9,0,200,0,0
727776997,MrUptimeNinja,10,202490,658,10,9,0,41.0532060193,40-49,615,11,0,0,0,0,0,0,0,0,0,0,0,0,251,480,4.4780486537007367E-5,0,0,246,0,0,201,0,0
729134036,christendfsanto,10,104,28,492,0,0,16.9852522565,10-19,29,2,0,0,0,0,0,0,0,0,0,0,0,0,10,79,4.4780486537007367E-5,0,0,7,0,0,1,0,0
729460368,ChechaLpda,10,14000,296,224,1,42,45.4179787059,40-49,707,6,1,1,2,2,1,1,1,1,0,7.49471721243357E-5,0,0,399,720,2.9852402567743944E-4,1.198308E-5,1.2138721E-5,416,18,0,201,0,0
731817787,stormtrackersb,10,3910,27,212,0,281,27.9711744292,20-29,530,6,0,1,1,1,0,1,1,1,0,0,0,0,37,121,4.4780486537007367E-5,0,6.0693606E-6,34,0,0,201,0,0
731941633,eviehanna,10,4339,2114,1967,1,1209,46.8948365184,40-49,698,6,0,0,0,0,0,0,0,0,0,0,0,0,236,456,4.4780486537007367E-5,0,0,232,5,0,201,0,0
732493945,jeanettezbcisol,10,128,31,495,0,0,13.0758616966,10-19,30,2,0,0,0,0,0,0,0,0,0,0,0,0,115,231,4.4780486537007367E-5,0,0,112,0,0,199,0,0
732658308,latrinazgziegle,10,102,25,482,0,0,,,49,2,0,0,0,0,0,0,0,0,0,0,0,0,161,314,4.4780486537007367E-5,0,0,157,0,0,106,0,0
732951152,MohawkWorkers,10,707,712,1485,13,230,49.698403027,40-49,658,5,114,202,316,316,114,202,7,2.2219618346,13099.9394774883,0.1180038377,0.0591320072,0.20573206,0,66,4.345418836512814E-4,6.890271E-4,6.979765E-4,47,29,0,200,0,0
733527702,electionquebec,10,90,22,0,2,0,21.1983448627,20-29,404,3,1,0,1,1,1,0,0,0,0,1.7956815627953587E-4,0,0,0,50,4.683012808773789E-5,1.198308E-5,0,390,13,0,155,0,0
735752629,Leyton_ttomas,10,1053,632,637,1,267,27.95430574,20-29,486,5,0,0,0,0,0,0,0,0,0,0,0,0,189,363,4.4780486537007367E-5,0,0,185,4,0,200,0,0
736130144,jlynnz7,10,291,34,112,0,0,19.8026559485,10-19,338,4,1,4,5,5,1,4,7,3.3752929361,1.3128850172,0.0010472111,0.2,0.41666666,0,66,5.03848497503507E-5,1.198308E-5,1.2138721E-5,372,0,0,200,0,0
737364186,DontDoDinosaurs,10,660,106,325,2,283,37.7780670596,30-39,511,4,5,17,22,22,5,17,7,2.7679946435,47.1159577115,0.0049105695,0.2272727273,0.42894736,0,66,6.195904747580434E-5,3.594924E-5,3.6416164E-5,372,9,0,200,0,0
740994812,sgrdirect,10,21,0,0,0,0,13.3936304817,10-19,20,0,0,0,0,0,0,0,0,0,0,0,0,0,133,256,4.4780486537007367E-5,0,0,130,26,0,176,0,0
741659616,stefanodimeran,10,184,19,49,0,0,26.9362496537,20-29,208,3,0,0,0,0,0,0,0,0,0,0,0,0,163,316,4.4780486537007367E-5,0,0,160,0,0,200,0,0
743129088,FrankDrouin1,10,3,4,46,0,0,12.5850434429,10-19,4,0,0,3,3,3,0,3,7,3.3514056225,0,0,0.5,1,0,80,4.4780486537007367E-5,0,6.0693606E-6,140,0,0,3,0,0
745649389,AdamOsborne77,10,100,34,205,0,0,17.62859422,10-19,138,2,4,13,17,17,4,13,7,2.8627385336,23.2284064544,0.0046034665,0.1507352941,0.31868133,0,66,6.364863449974524E-5,2.99577E-5,3.0346804E-5,372,0,0,111,0,0
745795364,MusingGma,10,1452,30,38,0,1347,40.9906318247,40-49,556,6,7,9,16,16,7,9,7,2.8339471041,51.0271780548,0.0064746277,0.225,0.53846157,0,66,6.903318061116266E-5,4.793232E-5,4.8554884E-5,372,8,0,201,0,0
745799070,NCFFAProbz,10,3468,1894,123,2,1430,48.5123895672,40-49,747,6,1,1,2,2,1,1,2,1.5,0,7.645535613750089E-5,0,0,288,537,2.29874507414389E-4,1.198308E-5,1.2138721E-5,332,24,0,199,0,0
746959880,Potriote,10,1383,87,191,1,63,41.4366626297,40-49,484,5,9,26,35,35,9,26,6,2.6317375293,67.4156476064,0.0119316503,0.1529411765,0.4523077,0,66,7.106502730225685E-5,5.99154E-5,6.069361E-5,390,13,8,200,8,0.04
747000386,Star_temps,10,14,11,67,0,0,17.9273937892,10-19,29,1,0,0,0,0,0,0,0,0,0,0,0,0,18,91,4.4780486537007367E-5,0,0,14,0,0,23,0,0
748080476,GTAAdvocate,10,1655,646,1531,11,4,43.5970331479,40-49,626,5,4,8,12,12,4,8,7,2.864412454,7.0472473517,0.0020170829,0.1515151515,0.32222223,0,66,5.215564841798475E-5,2.99577E-5,3.0346804E-5,47,0,0,200,0,0
751791666,Adigence,10,1328,644,605,8,1,44.1294840335,40-49,593,6,0,0,0,0,0,0,0,0,0,0,0,0,150,301,4.4780486537007367E-5,0,0,147,1,0,200,0,0
753378097,Celia1_Gorda,10,1878,196,233,0,7,41.4189727048,40-49,680,6,3,3,6,6,3,3,1,1,0.5,2.3259576264053933E-4,0.1,0.8333333,383,697,3.3147779322674866E-4,2.396616E-5,2.4277442E-5,397,164,0,200,0,0
754052142,DickieAnginson,10,1199,70,210,1,42,44.0117232782,40-49,609,5,32,67,99,99,32,67,6,2.4040843656,386.6205028384,0.0538956189,0.1217274789,0.32469454,0,66,1.235331346359902E-4,1.9772082E-4,2.0028891E-4,47,44,64,199,63,0.3216080402
755672683,RogerPalfree,10,138,11,38,1,3,29.0324371191,20-29,348,3,0,4,4,4,0,4,7,3.0860107095,0,0,0.5,0.8333333,0,587,4.4780486537007367E-5,0,6.0693606E-6,140,4,0,144,0,0
756085640,twilasinger,10,1195,265,600,1,65,39.4561301605,30-39,591,5,37,51,88,88,37,51,7,2.5373284232,648.4230851843,0.0347542431,0.078369906,0.36651585,0,66,1.7865732240563873E-4,2.2767852E-4,2.306357E-4,47,15,0,198,0,0
756913038,lgfc2,10,1093,23,14,0,84,26.3747119243,20-29,529,4,9,4,13,13,9,4,7,3.0328088383,0.4342871181,0.0200668231,0.3846153846,0.61538464,0,66,6.685215211545008E-5,5.99154E-5,6.069361E-5,47,11,6,200,6,0.03
757072891,CpcUTT,10,14,93,239,1,0,23.4916977431,20-29,174,1,0,0,0,0,0,0,0,0,0,0,0,0,392,710,4.4780486537007367E-5,0,0,403,0,0,15,0,0
758049516,PPT_Search,10,205340,5,0,0,0,14.3847822671,10-19,115,4,0,0,0,0,0,0,0,0,0,0,0,0,59,151,4.4780486537007367E-5,0,0,51,0,1,201,1,0.0049751244
758299892,CloudEther,10,2324,59,73,1,183,36.4203731939,30-39,597,6,1,2,3,3,1,2,7,3.4224974891,0.1248560295,4.6153187660005296E-4,0,0,0,66,4.9711911383749325E-5,1.198308E-5,1.2138721E-5,47,2,0,199,0,0
759031160,TimDFowler,10,1357,87,139,0,151,40.3119103504,40-49,620,5,4,5,9,9,4,5,7,3.1740877134,5.2631329323,0.0058500818,0.1666666667,0.45238096,0,66,5.5810698578089855E-5,2.99577E-5,3.0346804E-5,390,12,0,200,0,0
760462104,HaifischGeweint,10,6465,273,307,6,2550,45.3127231479,40-49,688,7,27,27,54,54,27,27,6,2.6277201205,682.0226507082,0.0258662505,0.0468204053,0.20967741,0,66,1.439649542866795E-4,1.6776312E-4,1.699421E-4,47,8,0,200,0,0
767540082,Pixxiedust666,10,5727,220,435,1,846,42.7422470422,40-49,577,7,11,12,23,23,11,12,7,2.8978908604,487.7528884638,0.0057481768,0.0652173913,0.2747253,0,66,9.408832830889317E-5,7.189848E-5,7.283233E-5,47,5,0,200,0,0
770671867,ChilliwackNDP1,10,10856,374,499,8,96,49.8079773092,40-49,690,8,57,74,131,131,57,74,6,2.4040843656,2626.7845362724,0.0527909259,0.0464474457,0.19719298,0,66,2.1118099427667441E-4,3.475093E-4,3.520229E-4,390,75,0,202,0,0
771076922,NeutralEthnic,10,1414,164,452,3,84,40.4928006444,40-49,586,6,19,37,56,56,19,37,6,2.4747238031,547.4411087633,0.0304864337,0.1016233766,0.23282829,0,66,1.0495929424732962E-4,1.198308E-4,1.2138722E-4,47,3,1,198,1,0.0050505051
772708915,Dan_Man_10,10,723,169,129,0,815,41.5980042996,40-49,643,5,7,6,13,13,7,6,3,1.6923076923,6.373015873,5.92365986962147E-4,0.0961538462,0.6666667,26,99,3.5380400967090334E-4,4.793232E-5,4.8554884E-5,49,44,0,198,0,0
772919785,myfriendbatman,10,1284,213,219,4,129,40.9689402816,40-49,569,5,38,43,81,81,38,43,6,2.5410110479,598.0327752426,0.0375515523,0.0475308642,0.28294572,0,66,1.6132709661855775E-4,2.3367006E-4,2.3670506E-4,47,11,0,200,0,0
773659566,ichannels_Mel,10,486,309,763,4,1,36.4691479697,30-39,537,5,74,178,252,252,74,178,6,2.2089052561,5232.406321743,0.0948625001,0.0653259976,0.19857232,0,66,2.668817915993237E-4,4.493655E-4,4.5520204E-4,47,37,1,200,1,0.005
774519661,andrewkidd83s,10,169,18,36,0,0,26.4382135272,20-29,299,1,0,0,0,0,0,0,0,0,0,0,0,0,102,212,4.4780486537007367E-5,0,0,97,0,0,200,0,0
775030206,cassidyaugust96,10,1628,250,180,0,831,40.6818270403,40-49,659,5,2,2,4,4,2,2,1,1,1,1.514327029770266E-4,0.0833333333,0.5,275,520,3.875570667691606E-4,1.797462E-5,1.8208082E-5,297,42,0,200,0,0
776270952,hempsterbc,10,7820,937,1907,9,7561,51.0764637629,50-59,679,7,105,185,290,290,105,185,6,2.2303314362,16244.7857946795,0.1105695752,0.0562224078,0.20542724,0,66,3.31996591347161E-4,6.351032E-4,6.433522E-4,47,65,0,209,0,0
776556378,GregGinYYC,10,320,35,63,3,6,42.4261814202,40-49,546,4,2,5,7,7,2,5,7,3.1155005022,1.4759570464,0.0015271435,0.1904761905,0.3,0,66,5.299043332792726E-5,1.797462E-5,1.8208082E-5,372,6,0,200,0,0
780844903,LizHexham,10,577,36,102,0,2,13.4948067874,10-19,333,5,3,7,10,10,3,7,7,2.843655842,1.1019523922,0.0051411482,0.2,0.6666667,0,66,5.477277479227954E-5,2.396616E-5,2.4277442E-5,140,0,1,200,1,0.005
781055977,sasquatchdene,10,290,32,235,0,3,33.8686881917,30-39,411,5,7,33,40,40,7,33,7,2.5590893873,75.1960118728,0.007311682,0.1544871795,0.3314394,0,66,6.819059427949963E-5,4.793232E-5,4.8554884E-5,47,5,0,195,0,0
785739980,Dianora_1,10,4613,530,914,17,47,50.7849822306,50-59,622,5,14,21,35,35,14,21,7,2.7264814195,141.1194348392,0.021640361,0.0470588235,0.22857143,0,66,8.347141003892385E-5,8.98731E-5,9.104041E-5,47,2,0,201,0,0
786944546,wadedossp,10,190,31,196,0,0,30.7852583113,30-39,345,2,0,0,0,0,0,0,0,0,0,0,0,0,314,569,4.4780486537007367E-5,0,0,313,0,0,200,0,0
787861291,Tamsen_Creative,10,2480,76,1181,0,45,40.1552210028,40-49,468,5,2,20,22,22,2,20,7,2.7117509207,7.1194476464,0.003533852,0.1818181818,0.2952381,0,66,4.8603352068158225E-5,1.797462E-5,1.8208082E-5,140,2,0,201,0,0
790139850,asbinvancity,10,1900,49,49,0,108,43.5836946668,40-49,588,5,3,3,6,6,3,3,7,3.161365919,1.913822011,0.0019511108,0.0666666667,0.6666667,0,66,5.571548743515662E-5,2.396616E-5,2.4277442E-5,47,3,0,200,0,0
791995963,philYama,10,1787,1200,1095,17,183,48.7167336769,40-49,656,6,83,81,164,164,83,81,6,2.3290927352,12286.4228452639,0.1054195096,0.0460870866,0.3015048,0,66,2.621631083503252E-4,5.0328934E-4,5.098263E-4,47,16,0,200,0,0
792044107,mcnoble_11,10,1952,84,68,0,10,36.7366190612,30-39,643,4,0,0,0,0,0,0,0,0,0,0,0,0,70,166,4.4780486537007367E-5,0,0,62,3,0,200,0,0
793079546,AllanTiSirai,10,252,134,178,0,2,30.7039508684,30-39,443,2,2,2,4,4,2,2,9,5.3636363636,65,1.5144804581980297E-4,0,0,30,104,3.0093038622527044E-4,1.797462E-5,1.8208082E-5,315,3,0,200,0,0
796675838,MurrayRankin,10,515,1613,1154,50,5,52.6787710678,50-59,729,4,186,95,281,281,186,95,7,2.4328757951,15540.5174913257,0.2149080456,0.0731189629,0.20351759,0,66,9.714131634391687E-4,0.001120418,0.001128901,390,123,5,200,5,0.025
796706216,mecollicott,10,1394,118,252,3,2,43.9634622729,40-49,609,5,5,18,23,23,5,18,6,2.5918982256,37.6793855156,0.0120715893,0.2055335968,0.47368422,0,66,6.053228585658387E-5,3.594924E-5,3.6416164E-5,140,0,0,200,0,0
800913169,LeaMacKenzie1,10,12,15,28,0,0,18.7919337076,10-19,124,1,0,1,1,1,0,1,8,3.7617135207,0,0,0,0,0,415,4.4780486537007367E-5,0,6.0693606E-6,47,0,0,13,0,0
801743592,v_diz,10,3473,124,235,5,2390,45.2188042443,40-49,633,6,1,3,4,4,1,3,7,3.0706394376,1.6169467545,1.9492676527673364E-4,0.0833333333,0.33333334,0,66,4.760373178111833E-5,1.198308E-5,1.2138721E-5,140,2,0,200,0,0
805784827,mark_luimes,10,316,44,52,0,35,29.9639385075,20-29,523,4,1,3,4,4,1,3,7,3.5821894878,160.2022314505,0.0039162934,0.3333333333,0.5,0,66,5.034065667458013E-5,1.198308E-5,1.2138721E-5,372,5,0,199,0,0
805996554,gsdenton,10,412,105,286,2,112,37.6998596942,30-39,522,3,8,27,35,35,8,27,7,2.7070639438,30.4170467172,0.0123956317,0.1848739496,0.4985755,0,66,7.918023409005826E-5,5.392386E-5,5.4624245E-5,390,3,0,200,0,0
807441157,caireanne,10,82,35,95,0,167,30.095400683,30-39,454,5,10,16,26,26,10,16,7,2.6839638433,6.4956678987,0.0195894748,0.2076923077,0.66374266,0,66,7.365616656717802E-5,6.590694E-5,6.6762965E-5,47,1,0,111,0,0
808031126,GraceontheCoast,10,16,20,159,0,0,18.3072107072,10-19,135,2,1,4,5,5,1,4,8,3.3367927687,120.1752139766,8.04175021582288E-5,0.2,0.5833333,0,66,5.7811038796388525E-5,1.198308E-5,1.2138721E-5,372,1,0,28,0,0
808979192,ogfdsgdsgdf,10,4718,0,1,0,0,,,0,0,0,0,0,0,0,0,0,0,0,0,0,0,396,715,4.4780486537007367E-5,0,0,407,0,0,200,0,0
809099172,MittenBuster,10,36,15,207,0,6,15.1091396809,10-19,62,2,0,25,25,25,0,25,7,2.7520080321,0,0,0.43,0.76,0,164,4.4780486537007367E-5,0,6.0693606E-6,140,0,0,47,0,0
809810088,happyiggy,10,688,142,246,2,228,44.1728468174,40-49,631,5,32,44,76,76,32,44,7,2.5952460663,3808.1164081442,0.0349302736,0.0698245614,0.32077295,0,66,1.4960810907287822E-4,1.9772082E-4,2.0028891E-4,47,29,0,197,0,0
811236194,stratdemwatch,10,891,107,205,2,12,41.5447118389,40-49,562,5,29,39,68,68,29,39,6,2.5088717777,225.3872165477,0.0461128737,0.0906496927,0.4500675,0,66,1.358510712589843E-4,1.797462E-4,1.8208082E-4,47,42,0,200,0,0
811289166,TxAnon,10,6516,833,1141,11,4105,53.215295598,50-59,739,7,140,155,295,295,140,155,6,2.2581185136,52686.4979319231,0.1217125508,0.036457973,0.17386007,0,66,6.81504332072574E-4,8.4480713E-4,8.5577986E-4,47,247,0,289,0,0
814062072,ShitNewsNetwork,10,33,11,48,0,0,16.9066178591,10-19,41,2,5,20,25,25,5,20,7,2.7057248075,49.6950278265,0.0071294182,0.2066666667,0.46190476,0,66,5.7605003293792934E-5,3.594924E-5,3.6416164E-5,47,3,0,32,0,0
814665444,haileybretee,10,3108,143,173,0,869,43.1548313052,40-49,644,6,4,5,9,9,4,5,1,1,0.25,3.2182929738269154E-4,0.125,0.85,209,402,2.701198379081004E-4,2.99577E-5,3.0346804E-5,341,45,0,200,0,0
818034576,writepaintlove,10,11107,964,1441,25,7283,56.7226038416,50-59,765,8,41,65,106,106,41,65,7,2.640776699,3210.852994984,0.0323772303,0.0737646002,0.30769232,0,66,2.474723020218718E-4,2.5164467E-4,2.5491315E-4,47,64,0,201,0,0
818131350,ROVCCalgary,10,48,16,11,0,0,19.4457468082,10-19,168,1,1,1,2,2,1,1,8,4.6212780194,0,7.49471721243357E-5,0,0,0,71,7.569917912644684E-5,1.198308E-5,1.2138721E-5,372,7,0,52,0,0
818707315,sean_theguard,10,164,118,148,1,2,30.4970057597,30-39,441,3,6,6,12,12,6,6,7,3.1168396384,98.6084398421,0.00455293,0.25,0.5222222,0,66,6.370409668070063E-5,4.194078E-5,4.2485524E-5,390,3,1,181,1,0.0055248619
820019167,LGrayinVan,10,987,189,313,3,307,42.5917533498,40-49,594,5,4,6,10,10,4,6,7,3.031469702,17.6331354986,0.004160897,0.1111111111,0.5,0,66,6.639817027646414E-5,2.99577E-5,3.0346804E-5,47,4,0,186,0,0
820865316,mIzEsTeLlA,10,4331,769,1614,0,28,43.5893719907,40-49,606,6,1,1,2,2,1,1,9,4.911617007,0,8.067619451840979E-5,0,0,0,66,1.0883891314946082E-4,1.198308E-5,1.2138721E-5,372,2,0,201,0,0
820890391,ChavoDeIOcho,10,128062,2250,479,10,756,24.2877227485,20-29,760,11,1,0,1,1,1,0,0,0,0,7.690168871622538E-5,0,0,0,23,5.8924708258098824E-5,1.198308E-5,0,320,0,0,201,0,0
821734045,good_robyn,10,704,27,67,1,10,43.1666477596,40-49,615,6,7,19,26,26,7,19,6,2.849012387,124.8327715802,0.0067683102,0.1538461538,0.45614034,0,66,1.0113117151654499E-4,4.793232E-5,4.8554884E-5,372,59,5,238,5,0.0210084034
822198745,moombashley,10,1065,167,581,0,1077,41.5293989339,40-49,570,6,0,2,2,2,0,2,7,3.109437751,0,0,0.5,0.5,0,287,4.4780486537007367E-5,0,6.0693606E-6,140,7,0,200,0,0
822263544,courtneystodd,10,7,7,31,0,0,17.6350146565,10-19,27,1,0,1,1,1,0,1,7,3.1208165997,0,0,0,0,0,711,4.4780486537007367E-5,0,6.0693606E-6,390,0,0,8,0,0
823992356,Sophlight,10,2462,518,790,7,301,50.5155151733,50-59,677,6,11,16,27,27,11,16,7,2.6869768999,147.039418897,0.0163852282,0.066951567,0.2757353,0,66,8.026769488661426E-5,7.189848E-5,7.283233E-5,390,28,0,201,0,0
824473112,MrMysteries_,10,4157,807,190,13,944,47.3489088048,40-49,728,7,10,6,16,16,10,6,7,3.2102443924,24.7412491429,0.0034888214,0.1208333333,0.34848484,0,66,9.047569674973457E-5,6.590694E-5,6.6762965E-5,47,2,0,1,0,0
827452826,RCIisLeaking,10,8171,1116,1999,17,576,53.433109836,50-59,743,7,229,347,576,576,229,347,6,2.1021091396,51829.4719147972,0.2228407973,0.0422524155,0.17704462,0,66,6.629309730940683E-4,0.0013780541,0.001395953,47,220,0,238,0,0
829418706,bdubs06,10,1215,108,241,3,26,44.180226731,40-49,673,6,7,14,21,21,7,14,7,2.9447606294,80.2120105771,0.0042732622,0.0666666667,0.2032967,0,66,7.93126873888398E-5,4.793232E-5,4.8554884E-5,390,8,0,200,0,0
829767386,YosheLeigh1,10,127,14,68,0,0,19.3782400852,10-19,312,3,1,4,5,5,1,4,7,3.0602611316,3.0127104219,2.3387005089214142E-4,0.1,0.33333334,0,66,5.0579432359531754E-5,1.198308E-5,1.2138721E-5,390,3,0,131,0,0
831767154,CycleTOMidtown,10,172,113,168,8,5,38.091332614,30-39,510,3,6,7,13,13,6,7,7,2.8821560094,14.3729770475,0.0041633952,0.0641025641,0.30357143,0,66,6.326627436103244E-5,4.194078E-5,4.2485524E-5,140,7,0,177,0,0
832349402,ndp_vinorth,10,2877,65,68,6,8,27.9838363215,20-29,359,6,24,28,52,52,24,28,7,2.8044861065,60.9040062918,0.0285133746,0.2443438914,0.4695652,0,66,1.2352658911244323E-4,1.497885E-4,1.5173401E-4,390,3,5,216,5,0.0231481481
832466628,Alma_Academy,10,135,106,74,1,1,37.4842961154,30-39,494,2,4,6,10,10,4,6,2,1.1428571429,3106.8166666667,3.202107821919501E-4,0.1222222222,0.53333336,0,53,1.7967112446511116E-4,2.99577E-5,3.0346804E-5,352,12,0,160,0,0
833513995,lfay_lorraine,10,7210,408,2001,7,1050,49.619584645,40-49,612,8,1,26,27,27,1,26,7,2.9574824238,28.1396001702,1.5718535117807876E-4,0.2378917379,0.3723077,0,66,5.663405276729366E-5,1.198308E-5,1.2138721E-5,140,1,0,202,0,0
833988769,CandiceBergenMP,10,336,896,416,24,5,49.5121816276,40-49,654,4,118,63,181,181,118,63,6,2.6943421493,3690.7623476253,0.1197243712,0.091160221,0.2080821,0,66,9.158040738099111E-4,7.1299326E-4,7.1618456E-4,372,88,1,200,1,0.005
836517360,TheManda27,10,74,24,59,0,0,20.8277929394,20-29,156,3,2,5,7,7,2,5,7,3.1399397389,6.0909224506,8.497246685072704E-4,0.2142857143,0.55,0,66,5.56483342313255E-5,1.797462E-5,1.8208082E-5,390,4,0,105,0,0
836907222,VireshRaghubeer,10,620,41,176,0,1,27.5119252008,20-29,492,5,7,41,48,48,7,41,7,2.5336457985,93.4145925915,0.0115154006,0.2708333333,0.50830567,0,66,1.3811444250032599E-4,4.793232E-5,4.8554884E-5,390,12,0,200,0,0
837676586,_dylanabel,10,2646,158,268,1,1595,40.6378302462,40-49,630,6,0,0,0,0,0,0,0,0,0,0,0,0,381,693,4.4780486537007367E-5,0,0,392,8,0,200,0,0
839357312,cdn_genWhy,10,579,6,59,0,2,13.7975231035,10-19,86,5,1,12,13,13,1,12,7,2.9832607968,0.2598506317,3.5363245171579437E-4,0.2884615385,0.530303,0,66,4.7108683956464697E-5,1.198308E-5,1.2138721E-5,390,0,4,200,3,0.02
840925669,missmaplesleafs,10,517,41,213,1,235,26.2404633375,20-29,455,5,2,10,12,12,2,10,7,2.9072648142,3.272409525,0.001221568,0.2727272727,0.46363637,0,66,5.019494915922081E-5,1.797462E-5,1.8208082E-5,47,5,0,199,0,0
842768190,MarnaNightingal,10,4237,111,281,1,13,44.3463544889,40-49,643,7,2,11,13,13,2,11,7,2.9273518581,2.8100810614,7.916397112093228E-4,0.2884615385,0.5681818,0,66,5.154124330943574E-5,1.797462E-5,1.8208082E-5,390,1,0,200,0,0
842788621,Fedefruta,10,102,300,27,4,0,42.9402305354,40-49,512,1,1,0,1,1,1,0,0,0,0,7.34391852452689E-5,0,0,0,357,5.239316956238307E-5,1.198308E-5,0,320,2,0,108,0,0
843842581,NSAOhio,10,996,360,362,2,0,41.3843921895,40-49,507,4,1,1,2,2,1,1,7,3.2855708068,0,7.177348030874163E-4,0,0,0,66,4.828105566339335E-5,1.198308E-5,1.2138721E-5,372,0,0,200,0,0
843843476,JimHillyerMP,10,178,139,167,9,0,45.503705427,40-49,555,3,15,20,35,35,15,20,7,2.7854034148,204.6467311415,0.025005265,0.2521008403,0.42137095,0,66,2.02646657152352E-4,9.586464E-5,9.710977E-5,372,50,9,198,9,0.0454545455
844099489,crazedmountie,10,2414,89,185,0,5,46.572530525,40-49,595,6,14,25,39,39,14,25,6,2.5959156344,445.2981408349,0.0198190817,0.0944669366,0.26353276,0,66,8.456190720035231E-5,8.98731E-5,9.104041E-5,372,12,1,202,1,0.004950495
844180087,brmf_rm,10,722,245,241,4,1,44.4930055616,40-49,630,5,18,25,43,43,18,25,7,2.7150987613,2573.5511189852,0.0087881921,0.0598006645,0.21509972,0,66,1.1898781763490813E-4,1.1383926E-4,1.1531785E-4,390,13,0,200,0,0
844495087,uOStudents4Life,10,166,100,136,0,12,36.4683570539,30-39,485,3,11,18,29,29,11,18,7,3.0374958152,268.6409284076,0.0024876895,0.092364532,0.3627451,0,66,1.0420398606237699E-4,7.189848E-5,7.283233E-5,372,2,2,177,2,0.011299435
844825399,Can_Limnology,10,1585,446,716,18,40,52.0113427247,50-59,673,6,27,31,58,58,27,31,7,2.8557080683,4341.3837256713,0.0115611004,0.0496067756,0.21596639,0,66,2.3364972614983427E-4,1.6776312E-4,1.699421E-4,55,151,1,202,1,0.004950495
848955582,Jeff98926622,10,796,93,547,0,11,42.2608854146,40-49,567,5,14,56,70,70,14,56,6,2.5128891865,1192.5246418642,0.012945516,0.1469979296,0.26912567,0,66,9.981546783405075E-5,8.98731E-5,9.104041E-5,372,10,1,199,1,0.0050251256
849729062,TonyMcEnery,10,514,202,164,14,85,44.9801460819,40-49,586,4,0,0,0,0,0,0,0,0,0,0,0,0,301,556,4.4780486537007367E-5,0,0,300,3,0,201,0,0
851744330,StrghtBlk,10,442,26,151,4,11,29.3119934701,20-29,537,5,0,1,1,1,0,1,1,1,0,0,0,0,0,221,4.4780486537007367E-5,0,6.0693606E-6,43,1,0,200,0,0
851805686,jim_mochuk,10,1686,90,316,0,2,41.3085771069,40-49,548,6,13,35,48,48,13,35,7,2.619685303,131.73187162,0.0149975357,0.1148049645,0.31932774,0,66,7.494029665517869E-5,8.388156E-5,8.497105E-5,390,3,0,201,0,0
851819298,JamesSanyshyn,10,655,231,998,1,51,43.5240724488,40-49,555,5,17,47,64,64,17,47,7,2.6156678942,399.318336985,0.0130855953,0.1344246032,0.32610545,0,66,9.805973222935177E-5,1.0784772E-4,1.0924849E-4,390,13,1,200,1,0.005
851843886,DSharpComms,10,70,17,70,0,0,17.146559443,10-19,96,2,2,8,10,10,2,8,7,3.021091396,0.1658840299,0.0022028271,0.2555555556,0.6964286,0,66,8.150761879052249E-5,1.797462E-5,1.8208082E-5,140,0,0,77,0,0
852052230,richellebenoit,10,317,67,282,0,20,33.7402581819,30-39,485,4,2,7,9,9,2,7,7,2.864747238,1.7969196591,0.0052978668,0.1111111111,0.21428572,0,66,5.384359899980077E-5,1.797462E-5,1.8208082E-5,55,17,0,201,0,0
853288416,Oenema666,10,257,20,154,0,3,17.8547541134,10-19,108,4,0,6,6,6,0,6,7,2.9615127175,0,0,0.3666666667,0.53333336,0,397,4.4780486537007367E-5,0,6.0693606E-6,55,0,0,199,0,0
854562582,SKSMediaLondres,10,96980,496,1174,40,0,44.3657362181,40-49,601,10,0,1,1,1,0,1,1,1,0,0,0,0,0,267,4.4780486537007367E-5,0,6.0693606E-6,140,0,0,201,0,0
855136358,TeamJPJT,10,2662,1383,611,16,0,55.8697921457,50-59,708,6,152,64,216,216,152,64,7,2.5420154001,24743.382505581,0.1258852932,0.0437984496,0.12133995,0,66,8.133576263667933E-4,9.167056E-4,9.104041E-4,140,337,0,200,0,0
855146994,JudithRenaud,10,4272,446,974,11,3,46.7918067798,40-49,633,6,29,70,99,99,29,70,7,2.4911282223,1427.3899323991,0.0371078723,0.1230674088,0.24741824,0,66,1.7840477951525102E-4,1.797462E-4,1.8208082E-4,140,30,0,200,0,0
855360626,trishqualtrough,10,596,88,220,0,19,38.0065553949,30-39,512,5,16,32,48,48,16,32,7,2.7318379645,194.1916717304,0.0123335787,0.1015070922,0.32670453,0,66,8.821019395854009E-5,1.0185618E-4,1.0317913E-4,390,22,0,200,0,0
856448304,CuartAnfiteatro,10,3829,466,699,1,7,45.0333902796,40-49,688,6,2,1,3,3,2,1,1,1,2,1.4990938160501415E-4,0,0,121,237,4.971463702468208E-4,1.797462E-5,1.8208082E-5,117,15,0,201,0,0
856928725,CpcBallycastle,10,49,187,13,0,0,41.3331300318,40-49,518,2,11,0,11,11,11,0,0,0,0,8.732981006210109E-4,0.2454545455,0.36363637,2,3,3.861754640442089E-4,7.189848E-5,0,322,45,0,69,0,0
857278716,SkepticCritic,10,20,2,7,0,0,12.3543574036,10-19,12,1,0,2,2,2,0,2,7,3.1726907631,0,0,0.5,1,0,82,4.4780486537007367E-5,0,6.0693606E-6,55,0,0,26,0,0
857342886,rkocis94,10,185,80,152,0,30,19.5928429759,10-19,402,3,1,9,10,10,1,9,6,2.8915299632,0.3893684727,0.0039162934,0.2555555556,0.5833333,0,66,5.034065667458013E-5,1.198308E-5,1.2138721E-5,372,3,1,188,1,0.0053191489
858827341,NextGenTrudeau,10,125,23,156,1,1,25.5339698189,20-29,422,4,14,49,63,63,14,49,6,2.4241714094,239.4159466747,0.029070599,0.1574500768,0.36,0,66,9.426539591415081E-5,8.98731E-5,9.104041E-5,140,5,4,168,3,0.0238095238
859029968,patricklpc,10,2993,480,1000,7,45,47.0433089606,40-49,591,6,34,79,113,113,34,79,7,2.4402410445,1362.0447628393,0.0471391442,0.1076169406,0.3339506,0,66,1.3343827560787668E-4,2.097039E-4,2.1242762E-4,47,6,0,205,0,0
860099179,FremontJuan,10,452,17,44,0,7,26.2170842455,20-29,528,5,3,9,12,12,3,9,7,3.2045530633,1.5584212855,9.128493092859563E-4,0.1893939394,0.4861111,0,66,5.296902962079738E-5,2.396616E-5,2.4277442E-5,372,8,7,200,7,0.035
860135372,AntotoBlue,10,1476,532,370,0,16,41.8807072433,40-49,615,5,2,2,4,4,2,2,8,4.4545454545,126,1.529878364774788E-4,0,0,30,104,2.573415194161958E-4,1.797462E-5,1.8208082E-5,315,13,0,199,0,0
860415787,83Cindylee,10,5209,1516,1534,41,599,56.2365109335,50-59,697,7,11,13,24,24,11,13,7,3.0113826582,99.2919425952,0.0027065063,0.097826087,0.6282051,0,66,1.440616508295392E-4,7.189848E-5,7.283233E-5,47,2,0,200,0,0
860654623,Johnwboyko,10,958,276,682,1,8,52.2825664132,50-59,616,5,61,137,198,198,61,137,6,2.2534315367,17545.396533288,0.0876643056,0.0710916269,0.22229174,0,66,2.4326203831752637E-4,3.7147547E-4,3.7630036E-4,47,39,0,203,0,0
861557418,vaughndobson,10,657,140,1005,0,15,25.9856630144,20-29,397,4,7,116,123,123,7,116,6,2.3160361567,433.8183886207,0.0124896388,0.1928561909,0.31611693,0,66,7.076597562458815E-5,4.793232E-5,4.8554884E-5,372,2,0,200,0,0
861645158,drovenny,10,15597,203,3,0,0,22.5717333372,20-29,266,3,1,0,1,1,1,0,0,0,0,7.49471721243357E-5,0,0,36,114,5.9686805425790906E-5,1.198308E-5,0,29,4,0,572,0,0
863580548,mforden2,10,8211,288,409,4,507,55.3121587091,50-59,677,8,33,45,78,78,33,45,6,2.5634415802,4903.1914992203,0.030894867,0.0574425574,0.273358,0,66,1.5779941836669908E-4,2.0371236E-4,2.0635827E-4,47,42,0,203,0,0
865536330,LdnOntRealty,10,2458,309,770,8,47,50.889079398,50-59,693,6,7,36,43,43,7,36,6,2.807164379,382.0052939836,0.0075073864,0.1849390919,0.31848854,0,66,6.46694025634006E-5,4.793232E-5,4.8554884E-5,372,40,0,202,0,0
865633705,EnergyAlberta,10,467,147,217,2,1,33.438307458,30-39,414,6,2,4,6,6,2,4,7,3.2828925343,0.0565117791,0.0020061178,0.2,0.6,0,66,5.73391858360039E-5,1.797462E-5,1.8208082E-5,372,0,0,203,0,0
867034092,mizzstich,10,1033,83,138,0,239,30.1083379353,30-39,531,5,2,2,4,4,2,2,1,1,1,1.514327029770266E-4,0.0833333333,0.5,320,579,3.875570667691606E-4,1.797462E-5,1.8208082E-5,321,3,0,203,0,0
867117816,mateu_ebooks,10,4321,66,2,4,0,41.4672841506,40-49,646,5,1,1,2,2,1,1,1,1,0,7.49471721243357E-5,0,0,355,648,2.9852402567743944E-4,1.198308E-5,1.2138721E-5,364,1,0,200,0,0
868595665,songsjml,10,4915,802,1974,7,168,48.551917287,40-49,641,7,7,11,18,18,7,11,7,2.9578172079,240.920076108,0.0043155615,0.0032679739,0.009090909,0,66,8.439582214010783E-5,4.793232E-5,4.8554884E-5,55,10,0,200,0,0
868966099,Shatta_Pat,10,1526,32,90,0,11,42.1467498144,40-49,672,6,0,2,2,2,0,2,8,3.9142857143,0,0,0.5,0.5,30,572,4.4780486537007367E-5,0,6.0693606E-6,315,20,0,201,0,0
870165780,MarieJazvac,10,13,8,76,0,0,14.1202465551,10-19,18,0,2,15,17,17,2,15,7,2.9430867091,0.0052083333,0.0015474055,0.4264705882,0.775,0,66,5.005354573177374E-5,1.797462E-5,1.8208082E-5,390,0,0,14,0,0
872059213,EC_Kosters,10,628,67,145,2,3,42.9657706808,40-49,510,5,10,7,17,17,10,7,7,3.12520924,80.1393902793,0.00255511,0.1433823529,0.42307693,0,66,1.1635676620924108E-4,6.590694E-5,6.6762965E-5,55,22,1,201,1,0.0049751244
872639550,billg1963,10,4357,585,1015,4,77,52.6044950628,50-59,659,7,12,22,34,34,12,22,7,2.6360897221,194.8645693176,0.0160383488,0.0739750446,0.2792208,0,66,7.598813643336887E-5,7.789002E-5,7.8901685E-5,47,6,0,200,0,0
874887668,ninnygoat,10,331,63,230,0,69,32.5955688332,30-39,479,4,1,14,15,15,1,14,7,2.9126213592,4.0130658284,0.0021123298,0.219047619,0.35714287,0,66,4.952210990120778E-5,1.198308E-5,1.2138721E-5,390,1,2,196,2,0.0102040816
875907876,AndersonforMLA,10,858,107,180,10,1,49.1631021303,40-49,657,6,9,21,30,30,9,21,7,2.8617341815,90.8350893678,0.0102871789,0.2183908046,0.43833333,0,66,8.654650136439959E-5,5.99154E-5,6.069361E-5,55,182,0,200,0,0
876252438,senate2020,10,2339,141,161,0,9,47.2309847524,40-49,686,6,1,1,2,2,1,1,2,1.5,0,7.645535613750089E-5,0,0,397,716,2.29874507414389E-4,1.198308E-5,1.2138721E-5,408,5,0,200,0,0
877623170,kitchen_ryan,10,827,36,168,0,0,34.3451868379,30-39,631,5,2,7,9,9,2,7,7,2.9424171409,24.7898238666,0.0025536612,0.0833333333,0.1904762,0,66,5.440302572270092E-5,1.797462E-5,1.8208082E-5,390,1,0,200,0,0
878546018,wjgreen_,10,4121,1180,1612,16,173,53.5059893386,50-59,703,7,1,3,4,4,1,3,7,3.3311014396,0,4.7802997806535753E-4,0.25,1,0,66,4.900707065209591E-5,1.198308E-5,1.2138721E-5,372,1,1,201,1,0.0049751244
879136458,Mamie_Careyn,10,140,52,158,0,0,25.9755965193,20-29,264,2,0,0,0,0,0,0,0,0,0,0,0,0,152,304,4.4780486537007367E-5,0,0,149,0,0,194,0,0
879209971,pdesilva1,10,3522,468,1181,10,164,46.5886525851,40-49,624,6,31,71,102,102,31,71,7,2.5473719451,2593.3737094464,0.030105042,0.0739662202,0.22792998,0,66,1.6024789513143287E-4,1.9172928E-4,1.9421954E-4,47,7,1,199,1,0.0050251256
879938671,ZacharyRDM,10,6417,124,98,0,1963,53.3230134714,50-59,736,7,12,12,24,24,12,12,6,2.6789420824,72.9241522539,0.0162687863,0.0887681159,0.21637426,0,66,7.587860510691081E-5,7.789002E-5,7.8901685E-5,47,112,0,203,0,0
880770732,mscreefeather,10,574,207,526,4,122,42.7234685418,40-49,565,5,32,53,85,85,32,53,7,2.5413458319,1106.0438606661,0.0255773943,0.0771708683,0.2955975,0,66,1.5739911684344309E-4,1.9772082E-4,2.0028891E-4,47,7,1,200,1,0.005
880810860,Coco68274Cp,10,1091,121,135,1,4,40.9722087099,40-49,582,5,0,0,0,0,0,0,0,0,0,0,0,0,127,244,4.4780486537007367E-5,0,0,124,3,0,200,0,0
881505384,MrDanielGilman,10,472,284,340,8,46,44.6778654065,40-49,593,4,17,20,37,37,17,20,6,2.9240040174,15193.1450239934,0.0035952019,0.0660660661,0.21833333,0,66,2.4440011221558365E-4,1.0784772E-4,1.0924849E-4,372,58,1,199,1,0.0050251256
883423585,Anon0psCanada,10,1000,125,21,3,16,45.1488154668,40-49,592,5,10,1,11,11,10,1,7,3.2577837295,0,0.0031975998,0.1181818182,0.22222222,0,66,8.626206561358264E-5,6.590694E-5,6.6762965E-5,47,18,0,198,0,0
887025247,miguelful2,10,5916,1307,1568,4,93,47.7528615296,40-49,721,7,4,6,10,10,4,6,8,4.0585872112,910.5127491048,3.5500875511318826E-4,0,0,0,66,2.156487316970673E-4,2.99577E-5,3.0346804E-5,320,9,0,201,0,0
887037044,4oclockwhistle,10,1200,607,1999,10,89,44.3203449599,40-49,613,6,23,62,85,85,23,62,7,2.4924673586,882.4101147714,0.026222178,0.0900560224,0.22891866,0,66,1.1294528582276123E-4,1.4379696E-4,1.4566466E-4,47,9,0,200,0,0
887333558,Thewhizzzzzzzz,10,16,46,50,0,8,30.3634391638,30-39,491,3,0,0,0,0,0,0,0,0,0,0,0,0,72,169,4.4780486537007367E-5,0,0,64,1,0,104,0,0
887461274,ArthurPPrice,10,19,2,18,0,0,16.0632857838,10-19,2,1,0,1,1,1,0,1,7,3.2904953146,0,0,0,0,0,67,4.4780486537007367E-5,0,6.0693606E-6,55,0,0,19,0,0
887825390,DanJMeades,10,595,628,1150,8,1,44.5115703023,40-49,700,5,106,146,252,252,106,146,6,2.3702711751,10517.929208069,0.1183961197,0.081230633,0.2209331,0,66,5.582427859057552E-4,6.4109475E-4,6.494216E-4,390,36,1,200,1,0.005
888682813,2013talk,10,1295,301,987,0,1,26.968191454,20-29,477,6,0,0,0,0,0,0,0,0,0,0,0,0,367,667,4.4780486537007367E-5,0,0,377,0,0,196,0,0
890753468,DebbySimms,10,879,90,318,0,593,26.105875457,20-29,463,5,10,49,59,59,10,49,6,2.603950452,83.5153892364,0.0146406823,0.21157218,0.41289592,0,66,1.1276298764109911E-4,6.590694E-5,6.6762965E-5,372,0,2,200,2,0.01
891259729,oosakaoosaka1,10,2603,41,26,0,0,38.3379217751,30-39,592,0,0,0,0,0,0,0,0,0,0,0,0,0,386,701,4.4780486537007367E-5,0,0,396,0,0,200,0,0
894588307,MeyFung_,10,130,30,47,0,5,30.920356203,30-39,452,3,7,10,17,17,7,10,7,3.349179779,7.5895633902,0.0021484015,0.1470588235,0.4909091,0,66,6.953339820714255E-5,4.793232E-5,4.8554884E-5,372,20,3,141,3,0.0212765957
896105796,jeremyj_schmidt,10,1011,178,212,9,88,48.2292808887,40-49,598,5,17,14,31,31,17,14,7,2.7840642785,542.3701313343,0.0154138272,0.0698924731,0.23809524,0,66,1.2749223417913522E-4,1.0784772E-4,1.0924849E-4,55,17,0,200,0,0
897074468,Mioratoria,10,23,23,128,0,1,19.9663513632,10-19,382,2,0,0,0,0,0,0,0,0,0,0,0,0,379,690,4.4780486537007367E-5,0,0,389,3,0,23,0,0
898819561,AdrienneLKing,10,313,125,132,2,5,42.8892144335,40-49,553,4,16,16,32,32,16,16,7,3.0324740542,74.588368583,0.0125813076,0.1038306452,0.47368422,0,66,1.4863945004064285E-4,1.0185618E-4,1.0317913E-4,372,33,0,200,0,0
900494527,DrDDOM,10,13,4,25,0,1,14.6555225743,10-19,75,2,1,5,6,6,1,5,7,2.9209909608,0.064933687,7.075248612256472E-4,0.2333333333,0.55,0,66,4.646118971401038E-5,1.198308E-5,1.2138721E-5,372,0,0,25,0,0
900604650,Cajun_Fury,10,4136,1144,1121,14,17,51.7970678068,50-59,717,6,7,7,14,14,7,7,7,3.2440575829,430.0303887417,0.0022431433,0.0274725275,0.23809524,0,66,1.1479807191568629E-4,4.793232E-5,4.8554884E-5,372,5,0,201,0,0
900667856,OkanaganD_anon,10,3600,735,1535,6,619,42.9848350724,40-49,682,7,65,102,167,167,65,102,7,2.4462671577,3040.16068971,0.0781620238,0.0700887382,0.2866933,0,66,2.2286637260782445E-4,3.9544163E-4,4.0057782E-4,47,14,1,202,1,0.004950495
900693096,Airstream001,10,12,5,20,0,1,11.7341444214,10-19,85,1,0,2,2,2,0,2,7,3.3862115127,0,0,0.5,0.5,0,73,4.4780486537007367E-5,0,6.0693606E-6,140,1,0,15,0,0
902773724,smebulok,10,2925,1248,1763,30,1742,51.9184262505,50-59,719,7,11,17,28,28,11,17,7,2.8701037831,656.6619961162,0.0031721073,0.0687830688,0.31617647,0,66,1.3678307453360297E-4,7.189848E-5,7.283233E-5,47,2,0,201,0,0
906466254,wjthompson99,10,264,90,402,0,4,29.1961383125,20-29,333,4,5,14,19,19,5,14,7,2.8737864078,73.2728172601,0.0048115636,0.1666666667,0.40952381,0,66,6.54659909020361E-5,3.594924E-5,3.6416164E-5,55,1,1,199,1,0.0050251256
906560450,RaffaHacks,10,78,32,253,0,0,19.6961663343,10-19,135,3,0,1,1,1,0,1,1,1,0,0,0,0,0,431,4.4780486537007367E-5,0,6.0693606E-6,47,1,0,85,0,0
907722638,PVSJK,10,251,343,1174,7,86,42.4924861298,40-49,522,4,134,311,445,445,134,311,6,2.1583528624,23278.2624043528,0.1418980148,0.0571161049,0.1543115,0,66,4.174402270537285E-4,8.088579E-4,8.193637E-4,47,6,2,198,2,0.0101010101
908380028,kayla_woodlock,10,4229,353,469,0,604,44.4469135747,40-49,665,6,0,0,0,0,0,0,0,0,0,0,0,0,252,482,4.4780486537007367E-5,0,0,247,1,0,201,0,0
909289290,Planet350,10,696,313,778,4,198,46.2685843792,40-49,557,5,24,59,83,83,24,59,7,2.3970539002,4269.6466670793,0.0352254287,0.1156332648,0.30056325,0,66,1.1947595890738954E-4,1.497885E-4,1.5173401E-4,47,12,0,199,0,0
911582797,CrossingTheT,10,649,184,687,0,41,30.1834021039,30-39,473,5,6,15,21,21,6,15,7,2.9005691329,129.1983698684,0.0046112951,0.0547619048,0.14285715,0,66,7.828396947845113E-5,4.194078E-5,4.2485524E-5,47,2,0,200,0,0
912448819,TrishVx,10,77,18,48,0,1,20.4744131217,20-29,248,2,0,4,4,4,0,4,7,3.0244310576,0,0,0.4166666667,0.6666667,0,277,4.4780486537007367E-5,0,6.0693606E-6,55,0,0,84,0,0
914886920,RickARoth,10,928,669,968,17,0,54.3855662968,50-59,655,5,77,105,182,182,77,105,6,2.5343153666,1505.2108698268,0.1334504871,0.1198470038,0.29107162,0,66,7.517212569608385E-4,4.673401E-4,4.7341012E-4,372,67,3,200,3,0.015
915413804,AIMInternetMktg,10,59,36,122,0,0,18.2883285546,10-19,84,2,0,0,0,0,0,0,0,0,0,0,0,0,191,370,4.4780486537007367E-5,0,0,187,0,0,65,0,0
915477338,Banks_Todd,10,636,32,79,0,16,35.6940640244,30-39,571,5,7,20,27,27,7,20,6,2.8195513894,110.8191515798,0.0059689195,0.1296296296,0.33571428,0,66,6.701222977345561E-5,4.793232E-5,4.8554884E-5,372,34,8,208,8,0.0384615385
916993710,Yannick_strong,10,3294,134,130,0,5,41.4766964885,40-49,603,6,6,8,14,14,6,8,6,2.7878787879,15.6257936508,5.353779678902895E-4,0.1208791209,0.76785713,30,104,3.6270088139101766E-4,4.194078E-5,4.2485524E-5,315,17,0,199,0,0
917466355,MasonCui,10,350,22,60,1,12,30.9871156955,30-39,525,5,9,13,22,22,9,13,7,2.911282223,28.3918974662,0.0081038195,0.0930735931,0.35714287,0,66,7.218811379507398E-5,5.99154E-5,6.069361E-5,372,14,1,202,1,0.004950495
919156579,Bruce_LePage,10,162,29,67,0,1,21.7035237489,20-29,305,3,2,3,5,5,2,3,7,3.1627050552,0,7.225167671953446E-4,0.15,0.6666667,0,66,5.141614730061203E-5,1.797462E-5,1.8208082E-5,390,1,0,187,0,0
919226346,OttawapiskatBot,10,73,2,21,0,0,13.9481264984,10-19,22,3,4,9,13,13,4,9,7,2.8624037496,5.3851784133,0.0072661348,0.141025641,0.3888889,0,66,5.65966892173306E-5,2.99577E-5,3.0346804E-5,47,0,0,77,0,0
919815234,youngdejan,10,80,77,122,0,55,39.4069160094,30-39,448,3,1,1,2,2,1,1,1,1,0,7.49471721243357E-5,0,0,158,311,2.9852402567743944E-4,1.198308E-5,1.2138721E-5,159,15,0,131,0,0
923744418,HuronbruceNDP,10,80,157,721,7,0,27.6529589042,20-29,348,3,23,88,111,111,23,88,6,2.4315366589,308.4896527672,0.0233572967,0.2244062244,0.42278782,0,66,9.715400766862627E-5,1.4379696E-4,1.4566466E-4,390,3,0,90,0,0
924456414,asderi90,10,557,38,95,0,31,22.5273978351,20-29,397,3,0,0,0,0,0,0,0,0,0,0,0,0,398,719,4.4780486537007367E-5,0,0,409,1,0,200,0,0
926125051,brin_jones,10,61,16,40,0,0,13.8833241606,10-19,76,1,0,1,1,1,0,1,7,3.1208165997,0,0,0,0,0,674,4.4780486537007367E-5,0,6.0693606E-6,390,0,0,61,0,0
926620136,AP_President,10,212,109,232,2,1,40.715204587,40-49,533,4,15,28,43,43,15,28,7,2.7418814864,179.7866948157,0.0123735503,0.1157253599,0.30241936,0,66,1.1174923589865853E-4,9.586464E-5,9.710977E-5,372,5,2,199,2,0.0100502513
926791760,juelzmai,10,278,57,158,0,16,32.4204478599,30-39,496,4,0,11,11,11,0,11,7,2.8226238286,0,0,0.4363636364,0.76363635,0,617,4.4780486537007367E-5,0,6.0693606E-6,390,14,2,199,2,0.0100502513
927949176,tara_taylor,10,186,42,109,0,15,23.7200098665,20-29,355,3,3,3,6,6,3,3,7,2.8640776699,9.8588642368,0.0082635274,0.0666666667,0.6666667,0,66,5.789187202949618E-5,2.396616E-5,2.4277442E-5,390,0,0,183,0,0
929557369,Carli_maLpar,10,169,125,325,1,1,35.6646888943,30-39,498,3,0,0,0,0,0,0,0,0,0,0,0,0,85,188,4.4780486537007367E-5,0,0,79,0,0,182,0,0
930386257,MinPeterMacKay,10,279,2320,279,57,0,61.7138949439,60-69,709,3,142,30,172,172,142,30,7,2.8724472715,4314.9209121304,0.1341632101,0.0864273086,0.14541388,0,66,0.0011120783,8.567902E-4,8.618492E-4,372,203,1,201,1,0.0049751244
931039604,UnbrokenSpirit2,10,1403,529,637,4,414,46.3362876915,40-49,567,5,10,11,21,21,10,11,7,3.0502176096,6055.9625953394,0.0040115207,0.0833333333,0.56363636,0,66,1.5326326427188224E-4,6.590694E-5,6.6762965E-5,47,2,0,199,0,0
934620770,PatBigGeorge,10,563,46,87,1,15,38.2832650061,30-39,470,5,14,16,30,30,14,16,7,2.7854034148,60.073901418,0.0143051372,0.1643678161,0.33833334,0,66,8.881540620080615E-5,8.98731E-5,9.104041E-5,47,4,0,200,0,0
935377976,Lachelagrappe,10,2869,72,80,0,16,41.7187698214,40-49,656,6,2,2,4,4,2,2,6,3.1818181818,0,1.804277783239052E-4,0.0833333333,1,30,104,1.520200398329523E-4,1.797462E-5,1.8208082E-5,315,10,0,200,0,0
935732234,_Tracey_S,10,2782,151,387,0,98,47.2248922226,40-49,694,7,72,154,226,226,72,154,7,2.2601272179,9124.3005589156,0.0904110637,0.0820058997,0.25546384,0,66,2.3491909404907402E-4,4.373824E-4,4.4306333E-4,47,255,1,313,1,0.0031948882
937513957,adamdasilva3,10,4,0,2,0,0,10,10-19,0,0,0,0,0,0,0,0,0,0,0,0,0,0,4,70,4.4780486537007367E-5,0,0,1,1,0,5,0,0
938268962,treeline_b,10,89,125,218,7,22,44.4645128056,40-49,566,5,17,17,34,34,17,17,7,2.7663207231,74.7935468096,0.0207141358,0.0445632799,0.2631579,0,66,9.36255311913271E-5,1.0784772E-4,1.0924849E-4,47,1,0,62,0,0
939500785,Humboldt_FLA,10,210,61,122,1,0,38.677423641,30-39,487,4,12,39,51,51,12,39,7,2.6253766321,22.9320277308,0.0138989453,0.2666666667,0.5813953,0,66,1.037647561126481E-4,7.789002E-5,7.8901685E-5,140,26,1,200,1,0.005
939998528,TheNationalEric,10,769,60,105,1,31,40.4534412693,40-49,610,5,14,9,23,23,14,9,7,2.9651824573,185.5520247168,0.0216729482,0.2312252964,0.35714287,0,66,8.966697589055204E-5,8.98731E-5,9.104041E-5,140,23,0,200,0,0
940055154,_MarkCameron_,10,746,87,253,0,0,28.5593573225,20-29,416,5,14,32,46,46,14,32,7,2.5236022765,309.3145576211,0.012934142,0.1314009662,0.3655303,0,66,7.881993887427443E-5,8.98731E-5,9.104041E-5,390,3,0,200,0,0
940324717,mj52046600,10,173,1,8,0,0,41.6469577782,40-49,510,5,2,1,3,3,2,1,7,3.4603280884,0,0.0020910194,0.3333333333,0.33333334,0,66,4.9880384396875296E-5,1.797462E-5,1.8208082E-5,140,48,0,200,0,0
942627236,JennGreenTea,10,278,132,491,0,159,36.4917714566,30-39,537,4,2,2,4,4,2,2,1,1,2,1.4992441991589235E-4,0,0,197,378,4.3582306220354E-4,1.797462E-5,1.8208082E-5,197,35,0,199,0,0
943203804,Ari_Prayoga2,10,313,158,188,0,2,28.7151801696,20-29,460,4,0,0,0,0,0,0,0,0,0,0,0,0,79,177,4.4780486537007367E-5,0,0,71,12,0,198,0,0
944264166,Transition_LDN,10,702,212,497,5,0,41.0878988158,40-49,474,5,4,8,12,12,4,8,7,2.7097422163,240.2259934141,0.0029552896,0.0681818182,0.25,0,66,7.501753596862371E-5,2.99577E-5,3.0346804E-5,55,5,0,200,0,0
944396432,PIPSC_IPFPC,10,598,143,68,4,0,43.9140359501,40-49,580,4,17,17,34,34,17,17,7,2.8138600603,366.6783697645,0.0180342426,0.1016042781,0.27666667,0,66,1.5063669553220206E-4,1.0784772E-4,1.0924849E-4,390,67,2,200,2,0.01
944576364,StateCentury,10,269,56,172,1,0,30.6925782614,30-39,439,4,1,5,6,6,1,5,7,3.338466689,0,1.1787420823712496E-4,0.1666666667,0.25,0,66,4.736809328748044E-5,1.198308E-5,1.2138721E-5,140,23,0,200,0,0
944615180,LalaneLm,10,4470,190,103,0,58,45.0539773206,40-49,636,5,7,6,13,13,7,6,6,2.8484848485,15.7507936508,6.107458044155037E-4,0.0897435897,0.64285713,30,104,3.828825330814431E-4,4.793232E-5,4.8554884E-5,315,32,0,201,0,0
945068773,DLeowinata,10,230,47,171,0,15,31.0342933093,30-39,453,3,1,2,3,3,1,2,7,3.2286575159,0,6.197878061457962E-4,0.1666666667,1,0,66,4.9114587888461136E-5,1.198308E-5,1.2138721E-5,55,4,0,200,0,0
945691729,TruthVanguard87,10,861,71,153,0,44,40.1086821897,40-49,558,5,1,1,2,2,1,1,8,4.0040174088,0,1.09663451489758E-4,0,0,0,66,5.61740161837842E-5,1.198308E-5,1.2138721E-5,47,0,0,201,0,0
946498220,OTICProforma,10,730,278,645,0,2,39.3411473734,30-39,552,3,0,5,5,5,0,5,9,4.6040829987,0,0,0.2,0.25,0,418,4.4780486537007367E-5,0,6.0693606E-6,320,2,0,200,0,0
948163202,genbydayr,10,135,49,22,0,0,24.8403702993,20-29,213,3,0,0,0,0,0,0,0,0,0,0,0,0,35,113,4.4780486537007367E-5,0,0,28,0,0,200,0,0
948394051,KenGuilford2,10,22,1,12,0,0,15.6708586376,10-19,11,1,0,0,0,0,0,0,0,0,0,0,0,0,231,450,4.4780486537007367E-5,0,0,227,3,0,27,0,0
950291354,RateMyGovt,10,1019,7742,11694,27,0,46.5133383973,40-49,674,6,264,878,1142,1142,264,878,6,1.8262470706,268061.032430953,0.2277017737,0.0379241486,0.083776906,0,66,7.841819062902127E-4,0.0015877581,0.0016083806,372,15,0,200,0,0
951406202,ILOVEMELSMYTH,10,3247,208,2001,0,1,29.9187103221,20-29,605,6,2,13,15,15,2,13,7,2.9146300636,25.0617812585,8.040827286139333E-4,0.2238095238,0.41025642,0,66,5.10507863272777E-5,1.797462E-5,1.8208082E-5,55,18,0,200,0,0
951839304,Omarheaps,10,1090,72,124,2,919,38.7537689305,30-39,568,5,2,2,4,4,2,2,8,3.2112487446,0,0.0010463996,0.0833333333,1,0,66,4.778696976397694E-5,1.797462E-5,1.8208082E-5,47,4,0,188,0,0
951841164,andrewjackpei,10,133,15,82,0,5,36.0396722884,30-39,456,3,0,2,2,2,0,2,8,4.1288487282,0,0,0,0,0,192,4.4780486537007367E-5,0,6.0693606E-6,55,2,0,198,0,0
952101181,Cree8Dawn,10,1220,141,122,7,246,48.8644561188,40-49,630,6,34,22,56,56,34,22,7,2.7482423837,236.7009096057,0.0274020349,0.1116883117,0.3596154,0,66,1.546372107749203E-4,2.097039E-4,2.1242762E-4,47,81,0,198,0,0
952184484,Veterans4LPC,10,97,115,375,2,2,35.2401851808,30-39,530,3,41,108,149,149,41,108,7,2.4539671912,913.3302710856,0.0470413525,0.1634772356,0.3873416,0,66,1.8701092605880203E-4,2.5164467E-4,2.5491315E-4,140,17,0,105,0,0
952580750,Erkin_TO,10,186,15,32,0,0,42.3376298321,40-49,560,4,4,3,7,7,4,3,7,3.2795446937,0.0959989647,0.0057777494,0.2857142857,0.53333336,0,66,8.468084169521435E-5,2.99577E-5,3.0346804E-5,140,75,0,200,0,0
952619623,BaronOldsfield,10,300,14,46,0,9,21.8024823457,20-29,508,4,4,7,11,11,4,7,7,2.8821560094,8.0942726924,0.0049133683,0.1636363636,0.5714286,0,66,5.793600286367986E-5,2.99577E-5,3.0346804E-5,372,18,3,203,3,0.0147783251
952641019,rjfitz66,10,4560,1222,1266,4,905,52.620305965,50-59,697,6,13,13,26,26,13,13,7,2.8925343154,164.4841720303,0.007785634,0.0461538462,0.37820512,0,66,1.0110028112560929E-4,8.388156E-5,8.497105E-5,372,28,2,196,2,0.0102040816
953027875,law_knowledge,10,11045,932,1035,6,0,43.7437033864,40-49,579,9,1,1,2,2,1,1,8,4.0559089387,0,1.1312632851865244E-4,0,0,0,66,7.54503506542261E-5,1.198308E-5,1.2138721E-5,320,0,0,201,0,0
957344324,DHChelmsford,10,88,57,82,4,0,35.8189296541,30-39,388,3,1,1,2,2,1,1,1,1,0,7.49471721243357E-5,0,0,48,136,2.9852402567743944E-4,1.198308E-5,1.2138721E-5,39,0,0,117,0,0
959017472,PhilJFBoychuk,10,346,94,372,1,2,41.9702140717,40-49,579,4,20,51,71,71,20,51,7,2.4713759625,603.4361803224,0.0248620336,0.1269617706,0.2653419,0,66,1.1396660114703814E-4,1.2582233E-4,1.2745657E-4,390,32,0,200,0,0
960221840,ZE_CAN,10,1834,72,90,1,134,39.6830212714,30-39,568,6,16,20,36,36,16,20,7,2.7673250753,305.1580470061,0.0142004435,0.0920634921,0.2923077,0,66,9.888452263375596E-5,1.0185618E-4,1.0317913E-4,47,30,0,199,0,0
962044404,46nd2,10,7049,384,596,9,416,59.0816607515,50-59,740,7,53,32,85,85,53,32,7,2.6414462672,2589.4014318836,0.0562081541,0.1039215686,0.27529138,0,66,1.9591164413832932E-4,3.2354315E-4,3.2774548E-4,47,131,0,231,0,0
963122683,LadyofYork,10,10783,748,1991,6,500,51.5616848934,50-59,692,8,89,156,245,245,89,156,7,2.2748577168,10202.8638075678,0.0941552495,0.0713114754,0.21933265,0,66,3.054503839531233E-4,5.392386E-4,5.4624246E-4,47,70,0,209,0,0
963460488,janiebeenyc,10,260,8,59,0,16,17.8488717925,10-19,94,4,1,1,2,2,1,1,8,3.6832942752,0,3.0280442900443825E-4,0,0,0,66,5.8129038212847856E-5,1.198308E-5,1.2138721E-5,47,0,0,200,0,0
966467131,ParalegalOnt,10,1309,135,279,0,0,43.7602692971,40-49,634,5,29,50,79,79,29,50,7,2.4338801473,2152.7684671832,0.0413982776,0.0806556313,0.2703193,0,66,1.2024280935203829E-4,1.797462E-4,1.8208082E-4,47,34,0,198,0,0
967227373,VE7KPM,10,3397,489,245,14,99,49.4748052713,40-49,706,7,26,29,55,55,26,29,6,2.817877469,503.6184272092,0.0146588637,0.1127946128,0.34102565,0,66,1.46045025814368E-4,1.6177158E-4,1.6387274E-4,372,45,0,205,0,0
968015432,NoToBill115,10,1767,305,147,2,19,44.7794666397,40-49,671,6,30,26,56,56,30,26,7,2.7582859056,5889.61069986,0.0215606148,0.0392857143,0.13650794,0,66,1.7737946599831808E-4,1.8573774E-4,1.8815018E-4,390,67,1,199,1,0.0050251256
969591588,tjbtories,10,64,74,289,1,0,22.4432183721,20-29,232,3,20,42,62,62,20,42,6,2.5992634751,1148.2512187238,0.0161427922,0.1348492861,0.38925803,0,66,1.4664834798072E-4,1.2582233E-4,1.2745657E-4,372,13,10,83,6,0.1204819277
973670803,MilneJudi,10,136,60,247,1,3,24.972355909,20-29,283,3,2,10,12,12,2,10,7,2.8965517241,1.2682676087,0.0069650267,0.4242424242,0.70454544,0,66,5.2616918548074475E-5,1.797462E-5,1.8208082E-5,140,0,3,154,3,0.0194805195
974785080,VisionGRAMintl,10,130,19,63,0,8,41.0434443063,40-49,521,6,1,4,5,5,1,4,7,3.0903916974,1.5549999354,1.3717255532438697E-4,0.1,0.16666667,0,66,4.657606218139627E-5,1.198308E-5,1.2138721E-5,55,29,0,201,0,0
976111975,zinniaz4bees,10,176,15,81,1,27,25.123184475,20-29,88,3,2,6,8,8,2,6,7,2.9464345497,0.3877390305,0.0026480746,0.1428571429,0.43333334,0,66,5.175249015735946E-5,1.797462E-5,1.8208082E-5,55,0,0,192,0,0
976734595,PolitJunkieM,10,1128,957,1078,19,74,45.5040286844,40-49,553,6,7,7,14,14,7,7,7,3.2162705055,8.8118821068,0.0022204391,0.0989010989,0.85714287,0,66,1.0187586217472178E-4,4.793232E-5,4.8554884E-5,47,0,0,199,0,0
976907744,progpatriot,10,1931,5502,5361,79,242,57.3188474878,50-59,737,7,30,0,30,30,30,0,0,0,0,0.0160890163,0.1137931034,0.22068965,0,10,2.1745477602923546E-4,1.8573774E-4,0,47,10,0,200,0,0
977630929,Astutelypoli,10,247,104,512,0,6,31.6788367423,30-39,428,4,7,64,71,71,7,64,6,2.4245061935,217.5097476673,0.011397092,0.1647887324,0.29191467,0,66,6.31987199302067E-5,4.793232E-5,4.8554884E-5,372,1,2,200,2,0.01
978426805,TheRobNickerson,10,344,52,392,0,8,30.5443417877,30-39,505,4,8,19,27,27,8,19,7,2.718781386,185.1630026199,0.014542403,0.1267806268,0.36578947,0,66,1.279427921728582E-4,5.392386E-5,5.4624245E-5,47,8,1,200,1,0.005
981391872,Common_Causes,10,274,624,498,20,1,50.1713597552,50-59,633,4,103,53,156,156,103,53,7,2.5892199531,5608.1460596056,0.0870722302,0.0665012407,0.13848269,0,66,4.778103177249229E-4,6.2312017E-4,6.190748E-4,390,73,0,200,0,0
981418604,juju_tOo_court,10,1935,34,33,0,22,38.1119480171,30-39,640,5,1,1,2,2,1,1,8,4.8181818182,0,7.64866499607056E-5,0,0,30,104,1.4571567381377996E-4,1.198308E-5,1.2138721E-5,315,20,0,200,0,0
983481974,AngAngieAngela,10,4578,423,681,13,209,54.6204204296,50-59,676,7,2,2,4,4,2,2,7,3.7120857047,128.7320188516,2.837209110016493E-4,0,0,0,66,9.372583724690415E-5,1.797462E-5,1.8208082E-5,47,4,0,209,0,0
985409348,TOrumlu,10,0,1,7,0,0,,,1,0,0,0,0,0,0,0,0,0,0,0,0,0,19,92,4.4780486537007367E-5,0,0,15,0,0,1,0,0
988707360,MichEdReform,10,2195,133,0,7,0,43.8739344467,40-49,586,6,0,0,0,0,0,0,0,0,0,0,0,0,249,477,4.4780486537007367E-5,0,0,245,0,0,201,0,0
989106043,x3jennax3,10,2930,299,944,2,42,48.3063393243,40-49,681,7,6,13,19,19,6,13,7,2.9233344493,71.1922369813,0.0035485526,0.0730994152,0.1952381,0,66,6.478652004222204E-5,4.194078E-5,4.2485524E-5,47,10,0,201,0,0
989309642,shaneezymybeezy,10,304,86,113,0,218,32.9636399172,30-39,554,4,2,3,5,5,2,3,1,1,0,1.5452525836627266E-4,0.15,0.8333333,53,143,2.3261649057882062E-4,1.797462E-5,1.8208082E-5,257,62,0,199,0,0
989666251,peterrgibbs,10,9,2,12,0,0,16.0632857838,10-19,37,1,1,2,3,3,1,2,7,3.0478741212,0,0.0016863791,0.5,0.6666667,0,66,4.553966086114525E-5,1.198308E-5,1.2138721E-5,55,0,0,10,0,0
991559018,Portal_Elite,10,5334,9987,620,7,1,49.1131986918,40-49,669,4,0,3,3,3,0,3,9,4.6057563588,0,0,0.3333333333,0.5,0,364,4.4780486537007367E-5,0,6.0693606E-6,320,0,0,202,0,0
991670881,shedancestibet,10,2943,863,830,26,8265,58.492627304,50-59,749,7,11,11,22,22,11,11,7,3.0046869769,121.2993280657,0.0046998661,0.0497835498,0.4,0,66,9.203011725024548E-5,7.189848E-5,7.283233E-5,47,41,0,201,0,0
991803612,tammie_kelly,10,48,29,50,0,0,25.0616140066,20-29,437,2,0,0,0,0,0,0,0,0,0,0,0,0,216,409,4.4780486537007367E-5,0,0,210,0,0,59,0,0
993020562,GaryCar69543942,10,3985,1850,1934,54,793,55.2196400604,50-59,687,6,16,17,33,33,16,17,7,2.8774690325,1502.7759777732,0.0079673185,0.0691287879,0.4019608,0,66,1.6149078476920725E-4,1.0185618E-4,1.0317913E-4,47,1,0,201,0,0
995002429,intandjockey,10,521,156,73,0,1,45.849150565,40-49,646,5,1,1,2,2,1,1,1,1,0,7.49471721243357E-5,0,0,132,255,2.9852402567743944E-4,1.198308E-5,1.2138721E-5,129,7,0,201,0,0
995325540,githahardictan3,10,10,37,158,0,10,19.941758684,10-19,117,2,0,0,0,0,0,0,0,0,0,0,0,0,182,345,4.4780486537007367E-5,0,0,177,0,0,12,0,0
996042944,AnonTeach,10,606,104,250,0,46,40.1150079845,40-49,558,4,24,66,90,90,24,66,6,2.4402410445,3796.228288463,0.0361832993,0.0799001248,0.23706293,0,66,1.0718015836486555E-4,1.497885E-4,1.5173401E-4,47,8,0,198,0,0
996478027,TeamNewman2013,10,51,39,229,0,1,33.7661449954,30-39,462,4,13,50,63,63,13,50,6,2.7261466354,1456.0681297227,0.0093830625,0.156938044,0.3555102,0,66,1.0822464335707081E-4,8.388156E-5,8.497105E-5,372,22,0,150,0,0
998331242,abuaysha007,10,13,9,52,0,2,13.2677859755,10-19,59,1,0,2,2,2,0,2,8,3.4989959839,0,0,0.5,1,0,77,4.4780486537007367E-5,0,6.0693606E-6,390,1,0,13,0,0
998659356,ProFeministBro,10,1152,176,53,0,40,44.8405131902,40-49,618,5,0,1,1,1,0,1,8,4.2580321285,0,0,0,0,0,700,4.4780486537007367E-5,0,6.0693606E-6,47,12,0,198,0,0
1001077782,freechimchim,10,3884,182,2001,1,0,33.2250080867,30-39,640,6,2,15,17,17,2,15,7,2.6963508537,97.6967702236,0.0017671239,0.2647058824,0.46666667,0,66,4.8877597188101595E-5,1.797462E-5,1.8208082E-5,55,88,0,201,0,0
1004484314,dcbarrett_,10,772,65,227,0,86,38.2128872269,30-39,589,5,4,11,15,15,4,11,7,3.0398393036,63.9325239617,0.001290076,0.1047619048,0.3,0,66,6.045702796571224E-5,2.99577E-5,3.0346804E-5,55,8,0,200,0,0
1004515592,GrowtheRight,10,569,73,166,0,151,40.3375526998,40-49,508,5,13,21,34,34,13,21,7,3.1600267827,234.113622781,0.0035509057,0.0962566845,0.37380952,0,66,9.651109090146447E-5,8.388156E-5,8.497105E-5,372,19,0,200,0,0
1005209094,pgrahammtl,10,1002,463,1769,10,69,46.1088550093,40-49,544,5,88,262,350,350,88,262,6,2.109139605,3367.7915917335,0.1358294004,0.110487106,0.29592487,0,66,2.642546930211207E-4,5.332471E-4,5.401731E-4,47,5,0,199,0,0
1005258452,bearclannation,10,2279,595,329,17,91,54.73379768,50-59,735,6,94,66,160,160,94,66,7,2.5222631403,3962.4208103371,0.07673768,0.0852201258,0.22318758,0,66,5.856291794110004E-4,5.691963E-4,5.705199E-4,47,291,2,203,2,0.0098522167
1005583597,GwitchinKris,10,980,527,482,9,781,51.5089981319,50-59,691,5,54,32,86,86,54,32,7,2.8550385002,462.6479487494,0.0422098351,0.1280437756,0.29326513,0,66,2.3048536723448577E-4,3.295347E-4,3.3381482E-4,47,71,0,200,0,0
1007314507,beaverclan1,10,2829,106,313,2,19,41.0757069737,40-49,500,7,31,33,64,64,31,33,7,2.8714429193,382.4599959944,0.0221957091,0.0944940476,0.3682927,0,66,1.6489897216648438E-4,1.9172928E-4,1.9421954E-4,47,4,0,201,0,0
1007615486,Creesharpshootr,10,155,48,211,0,22,23.149291327,20-29,219,4,2,6,8,8,2,6,8,3.29159692,0,0.003347226,0.3035714286,0.5714286,0,66,5.709705617852713E-5,1.797462E-5,1.8208082E-5,47,1,0,199,0,0
1009127808,MonicaBALLUCB,10,692,34,76,0,20,35.9452747351,30-39,348,5,5,8,13,13,5,8,6,2.8476732508,3.5275538212,0.0062207557,0.1346153846,0.35555556,0,66,5.360572524539934E-5,3.594924E-5,3.6416164E-5,47,3,3,201,3,0.0149253731
1012122006,nativeadvocate,10,12267,234,425,5,1714,50.0377829385,50-59,700,8,11,7,18,18,11,7,7,2.947773686,118.2644428555,0.0114541507,0.1013071895,0.25824177,0,66,8.968660401449514E-5,7.189848E-5,7.283233E-5,47,30,0,201,0,0
1013316650,paulajavaloyes,10,737,94,118,0,19,39.2394622415,30-39,620,4,3,2,5,5,3,2,2,1.3333333333,0,2.3259576264053933E-4,0.15,1,383,697,2.9852402567743933E-4,2.396616E-5,2.4277442E-5,397,181,0,200,0,0
1013523684,Daniel_Nikpayuk,10,1967,354,423,5,109,48.8546100314,40-49,668,6,59,67,126,126,59,67,6,2.4445932374,4840.9858961394,0.0613106099,0.0444444444,0.25,0,66,2.356354255016566E-4,3.594924E-4,3.6416165E-4,47,89,0,203,0,0
1013858485,MCPACanada,10,94,43,98,0,3,25.5900103754,20-29,365,3,4,11,15,15,4,11,6,2.6919986609,18.7252209277,0.0051166849,0.1666666667,0.45454547,0,66,5.6424275825335825E-5,2.99577E-5,3.0346804E-5,55,3,5,103,5,0.0485436893
1014532460,IdleNoMore4,10,2763,11818,5227,165,699,64.2770291466,60-69,801,6,401,153,554,554,401,153,7,2.4070974222,88526.2810689656,0.2582439085,0.0296903663,0.072941855,0,66,0.0020128289,0.002408599,0.0023973975,47,346,0,200,0,0
1015951808,tomgrinnellzw,10,243,29,63,0,0,34.8792796979,30-39,518,4,6,8,14,14,6,8,7,3.0023434884,23.9470989198,0.0088724865,0.0879120879,0.4027778,0,66,8.282971247315404E-5,4.194078E-5,4.2485524E-5,390,23,2,199,1,0.0100502513
1018772598,mccwpg,10,388,36,93,0,3,30.7017278993,30-39,460,4,10,18,28,28,10,18,7,2.7756946769,48.4124382079,0.009216545,0.1164021164,0.42105263,0,66,7.696035259250136E-5,6.590694E-5,6.6762965E-5,47,2,0,200,0,0
1019411000,LuettaFoster,10,31,4,182,0,0,,,14,1,0,0,0,0,0,0,0,0,0,0,0,0,282,530,4.4780486537007367E-5,0,0,279,0,0,35,0,0
1019724050,RikkiWolfe3,10,17,2,164,0,0,11.0632857838,10-19,12,1,0,0,0,0,0,0,0,0,0,0,0,0,302,557,4.4780486537007367E-5,0,0,301,0,0,24,0,0
1020248611,MGreywolfV,10,9,3,10,0,0,11.3417172752,10-19,23,0,0,2,2,2,0,2,7,3.7730923695,0,0,0.5,0.5,0,84,4.4780486537007367E-5,0,6.0693606E-6,372,0,0,10,0,0
1022240827,ZubieZorn,10,487,11,118,0,0,35.980751933,30-39,471,5,0,11,11,11,0,11,7,3.0133868809,0,0,0.3090909091,0.45454547,0,464,4.4780486537007367E-5,0,6.0693606E-6,140,1,0,200,0,0
1022666976,MWRiop,10,477,39,67,0,7,34.1937574312,30-39,592,5,8,8,16,16,8,8,7,2.8744559759,7.1986376645,0.0074590163,0.125,0.4181818,0,66,7.054134513545802E-5,5.392386E-5,5.4624245E-5,372,24,1,200,1,0.005
1023659581,Terry24681865,10,6231,201,841,8,10693,50.5920736403,50-59,655,7,8,15,23,23,8,15,6,2.7669902913,36.4555128246,0.0079618917,0.0948616601,0.27083334,0,66,6.429769578384189E-5,5.392386E-5,5.4624245E-5,47,6,0,199,0,0
1025227592,KadsEdu,10,2312,69,88,1,120,42.839270022,40-49,603,6,8,7,15,15,8,7,7,3.0880482089,52.8679694599,0.0033208838,0.1285714286,0.18131869,0,66,7.160961050610265E-5,5.392386E-5,5.4624245E-5,390,12,0,200,0,0
1026385562,moosemosesy,10,2355,235,478,3,7,48.4598511745,40-49,685,6,59,73,132,132,59,73,6,2.3779712086,1363.313199365,0.0736882807,0.0717672912,0.3449123,0,66,2.1979432899743736E-4,3.594924E-4,3.6416165E-4,47,27,1,204,1,0.0049019608
1027658838,mloewen6,10,215,24,57,0,8,34.1972986062,30-39,417,4,0,1,1,1,0,1,1,1,0,0,0,0,0,425,4.4780486537007367E-5,0,6.0693606E-6,390,1,0,200,0,0
1028667224,TomFortington,10,1389,115,262,1,161,46.8255890625,40-49,602,6,26,43,69,69,26,43,7,2.6551724138,345.5809727458,0.0149385584,0.0865302643,0.28235817,0,66,1.3141004314125003E-4,1.6177158E-4,1.6387274E-4,47,21,0,199,0,0
1032840745,LOSO727,10,57,5,32,0,0,13.582865138,10-19,80,3,0,0,0,0,0,0,0,0,0,0,0,0,271,511,4.4780486537007367E-5,0,0,269,0,0,88,0,0
1033285939,duckpondmedia,10,252,40,180,0,7,30.1569401195,30-39,383,5,3,14,17,17,3,14,7,2.8667559424,2.0465859859,0.0024439457,0.2683823529,0.5,0,66,5.4474886818034684E-5,2.396616E-5,2.4277442E-5,140,3,1,200,1,0.005
1033371643,jumisupa,10,42,15,144,0,2,23.374529937,20-29,150,2,0,0,0,0,0,0,0,0,0,0,0,0,369,670,4.4780486537007367E-5,0,0,379,0,0,52,0,0
1033928792,Los_Indio,10,952,542,927,8,511,48.0284199114,40-49,676,5,79,110,189,189,79,110,7,2.526280549,8333.7312529568,0.0561628574,0.0487729371,0.18933797,0,66,3.5030246516252626E-4,4.793232E-4,4.8554887E-4,47,33,0,200,0,0
1038301598,ChantingWoman,10,6335,279,664,4,41,47.2707740349,40-49,630,7,51,81,132,132,51,81,6,2.4623367928,1520.4259652396,0.0518869587,0.0730395559,0.30185184,0,66,2.3911596554946818E-4,3.1156008E-4,3.1560674E-4,47,20,0,212,0,0
1038618348,nathandueck,10,73,9,19,0,0,22.4985591915,20-29,229,3,0,1,1,1,0,1,7,3.7754350736,0,0,0,0,0,302,4.4780486537007367E-5,0,6.0693606E-6,372,3,0,90,0,0
1040925522,HQ_Anon,10,520,679,386,7,12,44.642879527,40-49,622,4,9,9,18,18,9,9,7,3.0140609307,77.8633399486,0.0060449477,0.1633986928,0.3857143,0,66,9.444536390843463E-5,5.99154E-5,6.069361E-5,47,6,0,198,0,0
1041121530,ShnickKing,10,528,67,212,0,192,24.4838029154,20-29,403,5,6,20,26,26,6,20,7,2.739537998,23.582514499,0.0049539049,0.1753846154,0.4526316,0,66,6.845771587426957E-5,4.194078E-5,4.2485524E-5,47,2,0,199,0,0
1041906002,OrganicSocial,10,2295,509,465,11,530,55.8160319846,50-59,663,6,1,1,2,2,1,1,9,4.8694342149,0,8.422120682784922E-5,0,0,0,66,7.927442740923612E-5,1.198308E-5,1.2138721E-5,320,2,0,201,0,0
1042548955,liberalhills,10,122,22,133,0,0,18.3360274803,10-19,93,3,6,29,35,35,6,29,7,2.6206896552,25.2436889113,0.0049028251,0.231092437,0.49384236,0,66,5.920064319292223E-5,4.194078E-5,4.2485524E-5,140,2,1,156,1,0.0064102564
1042940202,NeedOfJustice,10,516,28,94,0,22,29.2673751232,20-29,393,5,7,6,13,13,7,6,7,3.1027787077,123.182024121,0.0067909976,0.0833333333,0.375,0,66,7.77522698195554E-5,4.793232E-5,4.8554884E-5,47,5,0,201,0,0
1043296272,anoncdn,10,2151,217,325,0,94,50.8192549519,50-59,668,7,9,13,22,22,9,13,7,2.9129561433,6405.0808131604,0.0014757588,0.0606060606,0.13235295,0,66,1.3795332133394422E-4,5.99154E-5,6.069361E-5,47,76,0,204,0,0
1048447759,Tenaciousceeee,10,4,1,18,0,0,34.98955094,30-39,429,4,7,27,34,34,7,27,7,2.6695681286,17.3743657679,0.0110721237,0.2281639929,0.39462367,0,66,5.6369375095576556E-5,4.793232E-5,4.8554884E-5,140,24,69,210,67,0.3285714286
1049199278,rufus_lingo,10,44,155,690,1,71,45.4806333053,40-49,630,6,4,20,24,24,4,20,7,2.6491463006,183.1387000107,0.0043145285,0.097826087,0.18571429,0,66,5.2012334338297156E-5,2.99577E-5,3.0346804E-5,47,3,0,201,0,0
1049348168,SqueakyCleanDV,10,343,19,49,2,5,19.8568075747,10-19,241,2,0,0,0,0,0,0,0,0,0,0,0,0,34,112,4.4780486537007367E-5,0,0,26,0,0,199,0,0
1049560369,cheezwitham,10,3231,187,291,0,1587,48.0101610774,40-49,619,7,8,8,16,16,8,8,7,2.9447606294,165.5859681948,0.0043468131,0.0208333333,0.17857143,0,66,8.360801241502366E-5,5.392386E-5,5.4624245E-5,47,2,0,201,0,0
1050717998,jpcole70,10,8,4,8,0,0,17.4113347389,10-19,74,0,0,0,0,0,0,0,0,0,0,0,0,0,257,487,4.4780486537007367E-5,0,0,252,0,0,10,0,0
1051948640,BCPolitico,10,96,142,551,0,0,20.2484776959,20-29,243,4,9,53,62,62,9,53,7,2.5266153331,201.5452811155,0.0055227789,0.2070333157,0.36868685,0,66,6.24244698224075E-5,5.99154E-5,6.069361E-5,55,0,0,109,0,0
1056066385,Anonymous44cana,10,1914,784,1484,11,246,50.3321614454,50-59,753,7,1,36,37,37,1,36,7,2.8859913073,69.7157022559,7.49471721243357E-5,0.0705705706,0.11587302,0,246,4.707508571488513E-5,1.198308E-5,1.2138721E-5,47,40,0,201,0,0
1056665060,JeromePolenz6,10,138,1083,33,11,4,50.7075924036,50-59,689,3,6,2,8,8,6,2,1,1,0,4.729144854588212E-4,0.2678571429,0.6333333,250,478,6.050919732274689E-4,4.194078E-5,4.2485524E-5,248,41,0,151,0,0
1058370912,FletJan,10,1579,38,48,0,9,47.66713388,40-49,613,5,21,19,40,40,21,19,7,2.6735855373,396.3724332395,0.0233066462,0.0833333333,0.25498575,0,66,1.0689192565502808E-4,1.3181388E-4,1.3352593E-4,47,117,0,299,0,0
1058502702,CAnneRogers,10,1117,71,231,3,429,45.1631576669,40-49,584,5,25,58,83,83,25,58,6,2.4144626716,428.1057612653,0.0373912126,0.1100499559,0.34392014,0,66,1.3682794156842564E-4,1.5578004E-4,1.5780337E-4,140,24,0,200,0,0
1058709871,Bill_Templeton,10,469,39,196,1,263,31.7958403914,30-39,430,4,0,1,1,1,0,1,1,1,0,0,0,0,0,626,4.4780486537007367E-5,0,6.0693606E-6,390,0,0,200,0,0
1060875288,GEJ_4MoreYears,10,946,126,542,0,46,49.0190683089,40-49,643,6,1,3,4,4,1,3,2,1.25,3,7.49471721243357E-5,0,0,0,187,1.0912479197109002E-4,1.198308E-5,1.2138721E-5,55,14,0,204,0,0
1063688797,Synonomous1,10,18,6,58,0,0,20.6486347106,20-29,102,2,4,6,10,10,4,6,7,3.2102443924,4.6890919866,0.0019574293,0.1777777778,0.5952381,0,66,6.916161610462765E-5,2.99577E-5,3.0346804E-5,47,2,0,18,0,0
1066150808,8consu8,10,367,44,31,0,1,37.5331380979,30-39,607,5,3,3,6,6,3,3,1,1,0.5,2.3259576264053933E-4,0.1,0.8333333,383,697,3.3147779322674866E-4,2.396616E-5,2.4277442E-5,397,180,0,200,0,0
1066176374,cdnpoli_Jav,10,509,846,1212,11,0,53.7894293429,50-59,665,5,281,369,650,650,281,369,6,2.0830264479,84801.0821625488,0.2392723172,0.024923551,0.11601508,0,66,8.222449496590532E-4,0.0016896143,0.0017115597,47,167,4,217,4,0.0184331797
1066611444,oharaxx,10,25,65,167,0,0,20.1411079381,20-29,197,1,0,0,0,0,0,0,0,0,0,0,0,0,295,547,4.4780486537007367E-5,0,0,292,0,0,28,0,0
1071955452,Wendego1763,10,1700,529,185,6,325,49.4151110944,40-49,667,6,78,19,97,97,78,19,7,2.8085035152,1678.3476902621,0.0520829805,0.0922465636,0.18543418,0,66,3.2219872778063247E-4,4.7333166E-4,4.7341012E-4,47,75,0,196,0,0
1072009236,Polkameister,10,2810,120,136,1,1,51.6923716987,50-59,699,6,19,19,38,38,19,19,7,2.7422162705,3291.2104278609,0.0125021927,0.1699857752,0.35987905,0,66,1.512993852287787E-4,1.198308E-4,1.1531785E-4,372,215,3,214,3,0.0140186916
1072032300,ikwew_III,10,18355,828,1259,9,12721,55.4912653621,50-59,755,8,0,0,0,0,0,0,0,0,0,0,0,0,5,72,4.4780486537007367E-5,0,0,2,87,0,7,0,0
1072851218,codprocommunity,10,0,1,0,0,0,10,10-19,2,0,0,0,0,0,0,0,0,0,0,0,0,0,7,75,4.4780486537007367E-5,0,0,4,0,0,4,0,0
1074278209,BilboBagman,10,4739,2694,2941,58,3,55.3054330375,50-59,667,7,18,22,40,40,18,22,7,2.9039169736,814.2305773979,0.0078843012,0.0615384615,0.36147186,0,66,1.7981126733298766E-4,1.1383926E-4,1.1531785E-4,47,14,0,201,0,0
1075087957,YaWhatHeSaid,10,286,18,69,0,0,39.7181005404,30-39,475,4,7,30,37,37,7,30,7,2.5815199197,226.7441662267,0.0089296757,0.2334834835,0.45866936,0,66,7.273940371364342E-5,4.793232E-5,4.8554884E-5,47,12,0,200,0,0
1076505421,Mwindtalker,10,1737,286,738,1,597,50.213049451,50-59,631,6,63,143,206,206,63,143,6,2.3039839304,7874.2514518829,0.0730569843,0.0838503434,0.24859422,0,66,2.1174053491560977E-4,3.8345857E-4,3.8843908E-4,47,69,0,235,0,0
1076711600,MexicoCompanies,10,64665,0,0,0,0,14.8992979188,10-19,30,3,0,0,0,0,0,0,0,0,0,0,0,0,228,445,4.4780486537007367E-5,0,0,223,0,0,201,0,0
1077759668,thehillcat,10,252,103,410,2,1,33.5029998579,30-39,389,4,28,81,109,109,28,81,7,2.5758285906,181.7971721853,0.0326479891,0.1833163439,0.48310316,0,66,1.4003837607224007E-4,1.7375466E-4,1.7601145E-4,390,6,1,200,1,0.005
1078538047,katemcinturff,10,428,167,367,6,4,47.280782494,40-49,591,4,15,23,38,38,15,23,7,2.671911617,354.9912038459,0.0125219816,0.2119487909,0.43850806,0,66,1.350802489225333E-4,9.586464E-5,9.710977E-5,390,31,0,200,0,0
1079162658,DriverTraining7,10,22,58,247,0,0,17.2831686011,10-19,197,1,1,0,1,1,1,0,0,0,0,7.34391852452689E-5,0,0,12,83,8.284390166388585E-5,1.198308E-5,0,111,2,0,24,0,0
1080115680,CArgyleOFL,10,366,66,84,2,0,29.6307691493,20-29,167,5,9,11,20,20,9,11,7,2.8838299297,10.7572539261,0.0071919361,0.1631578947,0.56593406,0,66,7.677257545733362E-5,5.99154E-5,6.069361E-5,390,0,0,203,0,0
1081371031,Gump130,10,106,14,46,0,1,15.2151686011,10-19,74,3,1,6,7,7,1,6,8,3.2695011717,0,9.740279855778901E-4,0.2380952381,0.53333336,0,66,4.990831526219965E-5,1.198308E-5,1.2138721E-5,47,0,0,146,0,0
1083627469,Ibrah_OvaarMarz,10,2829,111,120,0,84,43.5133648386,40-49,627,6,2,6,8,8,2,6,7,3.187479076,2.9753504561,0.0040371316,0.1785714286,0.4,0,66,6.942536013097153E-5,1.797462E-5,1.8208082E-5,390,10,0,201,0,0
1084243386,hogarty_ciara,10,19,13,73,0,3,12.7421097528,10-19,46,2,0,1,1,1,0,1,1,1,0,0,0,0,2,533,4.4780486537007367E-5,0,6.0693606E-6,322,0,0,21,0,0
1084556630,WanderingEel,10,2290,156,200,0,195,45.0887631409,40-49,719,7,3,6,9,9,3,6,1,1,3,2.294722290134075E-4,0.2083333333,0.6,250,479,7.950498557182188E-5,2.396616E-5,2.4277442E-5,248,28,0,201,0,0
1084878776,PhatSra,10,317,19,81,0,10,35.7551991806,30-39,498,4,1,5,6,6,1,5,7,3.0026782725,0.520535769,0.0037729466,0.3,0.55,0,66,6.600586911204107E-5,1.198308E-5,1.2138721E-5,140,4,0,200,0,0
1087315136,DeSmogCanada,10,84,482,1199,21,3,49.1495486611,40-49,597,4,56,105,161,161,56,105,7,2.3769668564,5473.1007857088,0.0458805172,0.0625388199,0.20860806,0,66,3.2147814111519325E-4,3.4151776E-4,3.4595357E-4,55,33,1,109,1,0.0091743119
1089369409,tenfourpr,10,111,73,252,0,10,32.8810002825,30-39,377,3,0,0,0,0,0,0,0,0,0,0,0,0,337,608,4.4780486537007367E-5,0,0,345,2,0,124,0,0
1089520260,Kaitlyn_Abel,10,41,24,75,0,0,18.9211587405,10-19,102,2,0,3,3,3,0,3,7,3.3771753681,0,0,0,0,0,506,4.4780486537007367E-5,0,6.0693606E-6,140,0,0,61,0,0
1089926084,MonetteScott,10,1394,24,225,0,66,44.7877053658,40-49,563,6,0,9,9,9,0,9,7,2.9354082999,0,0,0.3611111111,0.5972222,0,665,4.4780486537007367E-5,0,6.0693606E-6,140,40,0,201,0,0
1090036602,ProLifeGuy,10,353,519,536,7,0,43.8638623954,40-49,523,4,2,2,4,4,2,2,7,3.5299631738,0,4.7661807516977177E-4,0.0833333333,1,0,66,6.387814258470701E-5,1.797462E-5,1.8208082E-5,372,14,0,200,0,0
1090069562,ellewist,10,1875,128,345,0,105,35.776874828,30-39,465,6,2,11,13,13,2,11,6,2.8814864412,6.2679662355,0.0040522193,0.2564102564,0.6363636,0,66,5.6951062240813304E-5,1.797462E-5,1.8208082E-5,372,4,0,201,0,0
1093740716,AmauriAAmador,10,686,69,93,1,69,41.3546581859,40-49,598,5,1,1,2,2,1,1,1,1,0,7.49471721243357E-5,0,0,405,728,2.9852402567743944E-4,1.198308E-5,1.2138721E-5,415,39,0,201,0,0
1094058062,bc7rocks,10,354,14,9,0,45,44.803022416,40-49,598,5,11,14,25,25,11,14,7,2.7301640442,353.631909684,0.0111040931,0.115,0.31578946,0,66,6.830048842681828E-5,7.189848E-5,7.283233E-5,47,78,0,203,0,0
1095333092,JordanNReid,10,5,24,181,0,0,16.6229289464,10-19,60,2,12,68,80,80,12,68,7,2.5942417141,23.8161635487,0.0188966931,0.2628164557,0.582748,0,66,1.2952568906481624E-4,7.789002E-5,7.8901685E-5,390,1,0,5,0,0
1097270467,Idlenomoreyeg,10,5813,950,1480,22,0,57.166457919,50-59,737,4,75,70,145,145,75,70,7,2.4328757951,17232.4780543522,0.0604117324,0.0455938697,0.18807456,0,66,3.6276446607440364E-4,4.5535705E-4,4.612714E-4,47,219,1,208,1,0.0048076923
1098099410,Devin_Campbell7,10,90,120,119,1,36,30.0112870311,30-39,461,3,7,9,16,16,7,9,7,3.6628724473,9775.0044656612,8.159457432992978E-4,0.1,0.6111111,0,66,3.0505215348968965E-4,4.793232E-5,4.8554884E-5,31,19,0,113,0,0
1098266563,Bigcitylib2,10,825,123,119,8,3,54.1543316828,50-59,638,5,43,39,82,82,43,39,6,2.4968195514,359.9808277072,0.066474623,0.1398675098,0.3609831,0,66,2.2278715667091526E-4,2.6362776E-4,2.5491315E-4,140,68,0,200,0,0
1099121384,bsnomore,10,282,200,884,0,8,42.5383602599,40-49,511,4,10,111,121,121,10,111,6,2.4007365249,512.7058696421,0.0104925842,0.195523416,0.35618347,0,66,7.997652052183486E-5,6.590694E-5,6.6762965E-5,372,3,1,198,1,0.0050505051
1099809654,thunderdrums75,10,3393,346,454,7,621,52.7341199675,50-59,725,7,85,103,188,188,85,103,7,2.4402410445,5861.4470934015,0.0711817551,0.0540448288,0.24728169,0,66,3.636414803703437E-4,5.1527243E-4,5.2196503E-4,47,320,0,201,0,0
1100601469,CannondaleBram,10,32,18,26,0,0,20.9919190395,20-29,109,1,0,0,0,0,0,0,0,0,0,0,0,0,290,539,4.4780486537007367E-5,0,0,286,1,0,36,0,0
1102098822,ErinDaleMariner,10,210,65,144,2,20,32.561547789,30-39,400,3,0,0,0,0,0,0,0,0,0,0,0,0,199,380,4.4780486537007367E-5,0,0,193,5,0,200,0,0
1102468592,mogrant61,10,425,77,185,2,1,42.5001641189,40-49,514,5,25,49,74,74,25,49,7,2.8470036826,106.2406140267,0.0122377445,0.118474639,0.4502551,0,66,1.4000211907870254E-4,1.5578004E-4,1.5780337E-4,372,7,2,200,2,0.01
1103795653,dkslogcarving,10,117,6,16,0,6,14.0588760157,10-19,47,3,1,4,5,5,1,4,7,3.2825577503,0.7421090284,9.419342586916661E-4,0.15,0.41666666,0,66,4.9481557891212485E-5,1.198308E-5,1.2138721E-5,372,0,4,157,4,0.025477707
1106614572,bulkdiscount,10,51253,460,10,3,0,44.7362312444,40-49,615,9,0,0,0,0,0,0,0,0,0,0,0,0,138,272,4.4780486537007367E-5,0,0,135,0,0,195,0,0
1108718324,whoisGeorgeD,10,39,4,106,0,1,12.1265715677,10-19,18,3,0,1,1,1,0,1,1,1,0,0,0,0,0,217,4.4780486537007367E-5,0,6.0693606E-6,43,0,0,93,0,0
1109187241,RHFLA,10,12,12,45,0,0,20.421019073,20-29,71,1,2,13,15,15,2,13,7,2.8202209575,2.3925862883,0.0014249711,0.3428571429,0.62637365,0,66,5.010510701803951E-5,1.797462E-5,1.8208082E-5,140,3,0,21,0,0
1109797962,RonMcKinnon3,10,28,4,152,0,1,14.9414911194,10-19,27,2,1,27,28,28,1,27,7,2.7000334784,5.6844742883,6.029102385012865E-4,0.3306878307,0.53988606,0,66,4.7321570694625844E-5,1.198308E-5,1.2138721E-5,140,0,0,40,0,0
1110761798,Thatcherist,10,81,17,36,0,5,17.9145535175,10-19,176,3,0,1,1,1,0,1,7,3.6121151272,0,0,0,0,0,675,4.4780486537007367E-5,0,6.0693606E-6,372,3,1,88,1,0.0113636364
1112892476,jeffreyawhiteca,10,15,8,14,0,0,12.1265715677,10-19,8,1,0,3,3,3,0,3,8,3.4655287818,0,0,0.1666666667,0.33333334,0,283,4.4780486537007367E-5,0,6.0693606E-6,390,0,0,20,0,0
1114250790,MomberTraining,10,61,73,236,1,0,31.6802954552,30-39,338,2,0,1,1,1,0,1,1,1,0,0,0,0,12,230,4.4780486537007367E-5,0,6.0693606E-6,111,1,0,84,0,0
1114582147,Easyconferences,10,19,25,70,0,0,25.4444116146,20-29,263,1,0,0,0,0,0,0,0,0,0,0,0,0,335,604,4.4780486537007367E-5,0,0,343,6,0,22,0,0
1116102128,Dexplorar,10,428,121,89,1,41,40.2433694231,40-49,441,3,0,0,0,0,0,0,0,0,0,0,0,0,170,325,4.4780486537007367E-5,0,0,164,0,0,200,0,0
1117017337,Canada_Bikes,10,134,120,178,3,0,40.2865832277,40-49,426,3,2,7,9,9,2,7,7,2.9099430867,15.106840423,0.0020605195,0.1944444444,0.5,0,66,5.526371413847151E-5,1.797462E-5,1.8208082E-5,55,2,0,136,0,0
1117861206,casr_ca,10,70,13,110,0,1,13.9120429219,10-19,94,2,0,4,4,4,0,4,7,3.0190763052,0,0,0.4166666667,0.6666667,0,729,4.4780486537007367E-5,0,6.0693606E-6,372,1,0,76,0,0
1124513556,canuckfan16,10,550,28,149,0,0,36.7034554288,30-39,516,6,1,6,7,7,1,6,7,3.2310010044,6.3997140685,4.8055231417383937E-4,0.0476190476,0.06666667,0,66,4.891256269731482E-5,1.198308E-5,1.2138721E-5,55,13,0,200,0,0
1126806397,Queen8Bees,10,400,12,14,0,40,43.2110086046,40-49,592,5,14,19,33,33,14,19,7,2.7000334784,22.4926511192,0.01812126,0.1429924242,0.43083003,0,66,7.122427108158914E-5,8.98731E-5,9.104041E-5,47,55,0,205,0,0
1128592190,Web2Roi,10,36,189,1045,0,0,32.8192097617,30-39,371,3,1,7,8,8,1,7,9,4.8541318167,2979.6666666667,7.49471721243357E-5,0.1428571429,0.33333334,0,263,5.9515922919722364E-5,1.198308E-5,1.2138721E-5,320,11,0,40,0,0
1130110310,C_heikkinen,10,137,141,160,1,87,39.8132373519,30-39,513,3,5,5,10,10,5,5,1,1,1.75,3.999777216712776E-4,0.1,0.8,209,402,3.6480046380589677E-4,3.594924E-5,3.6416164E-5,341,21,0,150,0,0
1130448013,Interstate_WSW,10,164,139,110,1,34,40.6953757654,40-49,557,4,2,5,7,7,2,5,2,1.1666666667,0,1.5298649862196788E-4,0.3571428571,0.6666667,250,479,6.398321690140619E-5,1.797462E-5,1.8208082E-5,248,27,0,174,0,0
1130456989,rikobrinkman,10,295,64,63,3,26,42.7107536405,40-49,495,5,18,27,45,45,18,27,7,2.7094074322,106.351375098,0.0188483698,0.1333333333,0.26458037,0,66,1.0043098831433215E-4,1.1383926E-4,1.1531785E-4,140,7,3,200,3,0.015
1132300357,Ibrahber,10,934,41,132,0,3,39.6572946641,30-39,607,5,4,22,26,26,4,22,6,2.5969199866,12.1157252121,0.0053655169,0.2184615385,0.42885375,0,66,5.523886504851264E-5,2.99577E-5,3.0346804E-5,140,5,0,200,0,0
1132363542,Duaardi_0722,10,77,51,199,0,21,27.839725852,20-29,432,3,1,1,2,2,1,1,1,1,0,7.49471721243357E-5,0,0,405,728,2.9852402567743944E-4,1.198308E-5,1.2138721E-5,415,12,0,129,0,0
1135401164,DEG_1,10,352,8,41,0,0,37.2123206171,30-39,512,4,1,11,12,12,1,11,7,3.0297957817,0.6944855774,2.9850479162879783E-4,0.2651515152,0.54545456,0,66,4.7155515793881623E-5,1.198308E-5,1.2138721E-5,140,11,2,200,2,0.01
1137791304,butthunder,10,279,12,19,0,69,13.4410238165,10-19,533,4,16,6,22,22,16,6,7,2.9246735855,20.1409479065,0.017817035,0.132034632,0.2602339,0,66,8.075066321915018E-5,1.0185618E-4,1.0317913E-4,47,36,0,208,0,0
1138077696,MightyGreen1,10,1055,152,310,0,227,44.3009304955,40-49,567,6,23,54,77,77,23,54,6,2.3943756277,152.8797528033,0.0337877691,0.1365345181,0.466457,0,66,9.127706055233843E-5,1.4379696E-4,1.4566466E-4,47,38,0,203,0,0
1138100232,wrychrd,10,808,148,396,5,17,46.7810714971,40-49,581,5,7,12,19,19,7,12,7,2.7880816873,179.8388628211,0.0049801055,0.0789473684,0.18131869,0,66,7.74165254905639E-5,4.793232E-5,4.8554884E-5,55,13,0,200,0,0
1140070970,DougTbay,10,58,11,40,0,8,29.3199278513,20-29,397,3,0,2,2,2,0,2,7,3.1194779116,0,0,0.5,0.5,0,161,4.4780486537007367E-5,0,6.0693606E-6,140,4,0,78,0,0
1140100759,greene1388,10,49928,562,8,9,0,52.1279182766,50-59,664,9,3,0,3,3,3,0,0,0,0,0.0018485257,0.1666666667,0.33333334,0,54,5.4148436880342027E-5,2.396616E-5,0,372,0,0,201,0,0
1141224883,InterculturalSK,10,84,10,24,1,0,18.3779454967,10-19,49,3,0,2,2,2,0,2,7,3.1596385542,0,0,0.5,1,0,400,4.4780486537007367E-5,0,6.0693606E-6,390,0,0,111,0,0
1146007034,iziqpaul,10,335,33,77,0,6,38.8251723651,30-39,556,4,1,1,2,2,1,1,8,4.5337341349,0,7.645535613750089E-5,0,0,0,505,6.734277591528606E-5,1.198308E-5,1.2138721E-5,55,13,0,199,0,0
1149028724,RoariBC,10,35,57,184,0,0,17.654164154,10-19,152,2,28,63,91,91,28,63,7,2.698024774,222.6914960789,0.0387496505,0.2052503053,0.56782264,0,66,1.809962301671608E-4,1.7375466E-4,1.7601145E-4,390,4,0,36,0,0
1149032365,RwkXdc,10,2132,202,450,0,35,45.467262558,40-49,612,6,1,17,18,18,1,17,7,2.8950183885,15.6147677035,7.49471721243357E-5,0.1111111111,0.18014705,0,246,4.58919816623078E-5,1.198308E-5,1.2138721E-5,47,6,0,202,0,0
1149139530,Steve_o_Reno,10,190,40,89,0,79,41.0001012284,40-49,505,4,1,4,5,5,1,4,7,2.9762303314,0.3259476958,6.110270894785525E-4,0.2,0.5,0,66,4.760600506570529E-5,1.198308E-5,1.2138721E-5,390,2,0,200,0,0
1149274476,ST_Phelan,10,245,108,483,2,0,43.7561131665,40-49,502,4,23,75,98,98,23,75,6,2.6384332106,557.9555703228,0.0468330391,0.1880917315,0.40921408,0,66,3.019056747474896E-4,1.4379696E-4,1.4566466E-4,372,1,3,200,2,0.015
1151108563,igarashiorico,10,12260,644,696,1,0,45.6016247434,40-49,588,7,1,1,2,2,1,1,8,4.0559089387,0,1.1312632851865244E-4,0,0,0,66,7.54503506542261E-5,1.198308E-5,1.2138721E-5,320,0,0,202,0,0
1152981883,votecarefully,10,24,2,7,0,25,21.3630434841,20-29,126,3,1,5,6,6,1,5,7,2.9691998661,0.4926448639,3.062190456933958E-4,0.3,0.6,0,66,4.650175098890308E-5,1.198308E-5,1.2138721E-5,55,1,0,77,0,0
1153290691,kogisdgsdfg,10,1977,0,1,0,0,,,25,0,0,0,0,0,0,0,0,0,0,0,0,0,173,329,4.4780486537007367E-5,0,0,167,0,0,201,0,0
1154111378,NanticokeNDN,10,2269,108,266,3,540,43.8497469333,40-49,543,6,19,32,51,51,19,32,7,2.7860729829,230.396815739,0.0133005319,0.1141176471,0.45262095,0,66,1.2007385558705344E-4,1.198308E-4,1.2138722E-4,47,3,0,201,0,0
1155341306,McAfeeConor49,10,169,148,222,0,23,30.2148331019,30-39,509,4,2,6,8,8,2,6,2,1.4,0.5833333333,1.6083732783589698E-4,0.2321428571,0.53333336,2,183,7.132968692329396E-5,1.797462E-5,1.8208082E-5,322,7,0,200,0,0
1156300052,XAVIERFISHER03,10,679,170,834,0,25,31.0495611415,30-39,419,5,13,40,53,53,13,40,7,2.640441915,77.0036620321,0.0112563879,0.135341074,0.32560974,0,66,9.138525999659192E-5,8.388156E-5,8.497105E-5,47,1,1,196,1,0.0051020408
1157726496,newgenparty,10,28,64,40,0,9,26.4950036125,20-29,320,1,4,4,8,8,4,4,7,2.9722129227,53.1610998923,0.0087231499,0.1071428571,0.2,0,66,1.1935649640801285E-4,2.99577E-5,3.0346804E-5,140,5,0,33,0,0
1158739338,Fillthehill13,10,1665,628,1981,6,12,49.5240681075,40-49,647,6,35,105,140,140,35,105,7,2.3146970204,2305.430381351,0.0387462997,0.1125899281,0.26346955,0,66,1.4838781046125905E-4,2.1569544E-4,2.1849698E-4,47,71,1,205,1,0.0048780488
1159995445,booklifeislife,10,7220,686,738,1,0,42.6532011918,40-49,534,7,0,0,0,0,0,0,0,0,0,0,0,0,299,554,4.4780486537007367E-5,0,0,298,0,0,201,0,0
1160587963,BlvlMoore,10,198,22,61,0,1,33.9500787528,30-39,483,3,3,8,11,11,3,8,7,2.895882156,0.1125420071,0.0046478414,0.4090909091,0.57272726,0,66,4.996899812518858E-5,2.396616E-5,2.4277442E-5,140,17,0,200,0,0
1164339799,theMcBane,10,5083,432,789,11,4239,56.5838854239,50-59,741,7,14,26,40,40,14,26,6,2.7756946769,508.1526117282,0.0112361729,0.0455128205,0.18769231,0,66,9.803953592233545E-5,8.98731E-5,9.104041E-5,47,18,0,205,0,0
1164511201,EgmontNDP,10,98,27,47,3,0,30.2775148756,30-39,199,3,5,8,13,13,5,8,7,3.0716437898,5.7430303168,0.0034074501,0.2115384615,0.38181818,0,66,5.723407492594904E-5,3.594924E-5,3.6416164E-5,390,5,1,127,1,0.0078740157
1169215122,webmasterx13,10,24332,160,50,4,0,44.0634207901,40-49,590,9,0,0,0,0,0,0,0,0,0,0,0,0,98,207,4.4780486537007367E-5,0,0,93,5,0,201,0,0
1170530546,CUPE129,10,224,88,406,2,7,42.3193317589,40-49,519,5,15,54,69,69,15,54,7,2.6725811851,3339.9121415208,0.0099096972,0.139599318,0.30227274,0,66,1.20843402350371E-4,9.586464E-5,9.104041E-5,390,102,0,201,0,0
1170723684,edtanas65,10,510,17,18,0,0,40.7274038558,40-49,531,4,7,3,10,10,7,3,7,2.9966521594,0.9877622925,0.0069900979,0.2222222222,0.35555556,0,66,5.533129636531451E-5,4.793232E-5,4.8554884E-5,47,13,0,200,0,0
1173231918,E4Dca,10,100,176,311,8,0,52.4275983959,50-59,651,3,60,75,135,135,60,75,6,2.3471710747,13163.8012729095,0.0524399063,0.0773908237,0.19208072,0,66,4.4827532763138067E-4,3.6548392E-4,3.5809228E-4,55,142,0,115,0,0
1177019420,Mrezramacdonald,10,89,58,227,0,1,25.0579862643,20-29,346,3,2,15,17,17,2,15,7,2.7288249079,2249.5646659841,0.001254076,0.1691176471,0.34285715,0,66,5.292896724327566E-5,1.797462E-5,1.8208082E-5,372,2,0,101,0,0
1177213375,WildErinRose,10,149,29,107,1,0,28.8214337619,20-29,324,4,3,14,17,17,3,14,7,3.0455306327,4.6906119555,0.0014149959,0.2058823529,0.4945055,0,66,6.025554850021583E-5,2.396616E-5,2.4277442E-5,372,4,2,187,2,0.0106951872
1179520423,8BitGamerbot,10,2501,5232,3484,3,53,42.5482015726,40-49,575,6,0,0,0,0,0,0,0,0,0,0,0,0,395,714,4.4780486537007367E-5,0,0,406,0,0,201,0,0
1179642390,GeosciencesEd,10,670,346,1114,9,3,47.1672570537,40-49,527,6,1,4,5,5,1,4,8,3.421827921,67.9435910357,5.38334873479667E-4,0.15,0.5,0,66,4.92897591374447E-5,1.198308E-5,1.2138721E-5,55,0,0,201,0,0
1181695452,YOUkniel,10,1922,82,133,0,9,29.2186615447,20-29,506,3,0,0,0,0,0,0,0,0,0,0,0,0,278,525,4.4780486537007367E-5,0,0,275,0,0,201,0,0
1184156005,LPC338,10,89,45,234,0,18,42.2205270424,40-49,562,3,38,113,151,151,38,113,6,2.3860060261,1392.1433023322,0.0320348469,0.1245033113,0.3197693,0,66,1.3540593956436339E-4,2.3367006E-4,2.3670506E-4,140,60,0,200,0,0
1184200088,WowIvanTweets,10,360,12,110,0,58,24.6246914539,20-29,225,4,2,8,10,10,2,8,7,2.82289923,1.6032235367,0.0052413063,0.1777777778,0.33333334,0,66,5.036611457069258E-5,1.797462E-5,1.8208082E-5,55,3,7,200,7,0.035
1186454012,TrueGrit_,10,323,29,130,0,2,45.6031130984,40-49,524,4,18,58,76,76,18,58,7,2.5316370941,488.5838649564,0.0270560754,0.1850877193,0.42728716,0,66,1.4269264666597666E-4,1.1383926E-4,1.1531785E-4,140,44,0,200,0,0
1187048804,naonao5d,10,7092,703,755,0,0,41.5897546186,40-49,534,7,1,1,2,2,1,1,8,4.0559089387,0,1.1312632851865244E-4,0,0,0,66,7.54503506542261E-5,1.198308E-5,1.2138721E-5,320,0,0,201,0,0
1187398310,emariegriffin,10,14,27,56,0,8,26.5969314997,20-29,222,2,1,2,3,3,1,2,1,1,0,7.64703944502054E-5,0.1666666667,1,110,224,2.094909845857181E-4,1.198308E-5,1.2138721E-5,106,9,0,28,0,0
1187507545,SmithChadley,10,70,78,355,2,3,40.6482136206,40-49,442,3,4,14,18,18,4,14,7,3.0006695681,53.2192526088,0.0012603739,0.1503267974,0.33516484,0,66,5.9551322199954033E-5,2.99577E-5,3.0346804E-5,390,13,0,79,0,0
1190178762,futurecpleaders,10,8,26,225,0,0,16.5723021556,10-19,79,2,1,8,9,9,1,8,7,2.7549380649,19.4191513694,2.7873130973807405E-4,0.4305555556,0.6944444,0,66,4.8201210683774905E-5,1.198308E-5,1.2138721E-5,372,0,6,29,6,0.2068965517
1191396000,Mxelle_Axelle,10,228,39,62,0,1,40.1766520351,40-49,555,4,2,4,6,6,2,4,7,3.0606060606,63.9,1.5451002051869458E-4,0.0666666667,0.33333334,30,104,1.6690965191385452E-4,1.797462E-5,1.8208082E-5,315,19,0,199,0,0
1191666822,dexterpbj,10,276,118,396,0,113,45.5039750184,40-49,597,4,2,4,6,6,2,4,7,3.0743220623,4.4293522587,0.0018780291,0.0333333333,0.083333336,0,66,5.024690254223004E-5,1.797462E-5,1.8208082E-5,140,4,0,200,0,0
1192013226,loo2404,10,47,5,19,0,0,12.3207895825,10-19,71,4,0,1,1,1,0,1,8,3.671686747,0,0,0,0,0,293,4.4780486537007367E-5,0,6.0693606E-6,390,1,0,143,0,0
1194130064,GFYSuckMonkeys,10,80,12,63,0,0,16.4666797829,10-19,104,2,0,0,0,0,0,0,0,0,0,0,0,0,124,241,4.4780486537007367E-5,0,0,120,0,0,131,0,0
1194989221,EoinWC,10,59,37,64,2,0,41.6728597014,40-49,487,3,5,9,14,14,5,9,7,3.0649481085,157.256865061,0.0016401386,0.1813186813,0.33333334,0,66,1.1258163275769024E-4,3.594924E-5,3.6416164E-5,55,18,0,68,0,0
1195118856,saleamen,10,62,17,128,0,2,25.128241004,20-29,135,2,0,11,11,11,0,11,7,2.9698795181,0,0,0.4181818182,0.6,0,656,4.4780486537007367E-5,0,6.0693606E-6,390,2,0,65,0,0
1195737266,LucasFacelina,10,1050,85,72,0,1,41.5695438043,40-49,629,4,1,1,2,2,1,1,10,6.3333333333,0,7.647049448437245E-5,0,0,30,104,1.7267363141546682E-4,1.198308E-5,1.2138721E-5,315,3,0,201,0,0
1195903140,Bobopolis,10,49,18,37,0,5,23.2239296771,20-29,292,2,0,4,4,4,0,4,7,3.3219544846,0,0,0.4166666667,0.5833333,0,703,4.4780486537007367E-5,0,6.0693606E-6,390,1,0,57,0,0
1195945369,SICKOFSPINNERS,10,73,2,17,0,0,15.0957851927,10-19,60,3,0,5,5,5,0,5,7,3.3018741633,0,0,0.3,0.5,0,643,4.4780486537007367E-5,0,6.0693606E-6,140,0,0,96,0,0
1197136231,KinchhutLatrish,10,15,7,81,0,0,14.4389478168,10-19,37,1,0,0,0,0,0,0,0,0,0,0,0,0,145,294,4.4780486537007367E-5,0,0,142,1,0,18,0,0
1198006309,SlusherksyCelia,10,11,4,77,0,0,,,14,0,0,0,0,0,0,0,0,0,0,0,0,0,243,470,4.4780486537007367E-5,0,0,239,0,0,12,0,0
1198862300,AnnieClaudeLaim,10,472,29,39,0,2,37.4084961019,30-39,542,4,0,0,0,0,0,0,0,0,0,0,0,0,247,475,4.4780486537007367E-5,0,0,243,9,0,201,0,0
1198946628,JohnZwicker1,10,1251,197,554,2,214,47.7878462285,40-49,606,6,1,3,4,4,1,3,7,3.1479745564,0,3.8166105063552484E-4,0.1666666667,0.5,0,66,4.993837400203766E-5,1.198308E-5,1.2138721E-5,372,5,1,201,1,0.0049751244
1199108329,AnonOpsNow,10,2,26649,203,1,5,42.1101257161,40-49,714,3,0,2,2,2,0,2,1,1,0,0,0.5,1,0,718,4.4780486537007367E-5,0,6.0693606E-6,47,3,0,7,0,0
1200627678,EganzgkKimberle,10,5,4,63,0,0,,,6,0,0,0,0,0,0,0,0,0,0,0,0,0,82,181,4.4780486537007367E-5,0,0,76,0,0,10,0,0
1201207338,JaimesnutEliana,10,1,2,0,0,0,,,2,0,0,0,0,0,0,0,0,0,0,0,0,0,268,502,4.4780486537007367E-5,0,0,265,0,0,7,0,0
1202055853,chrisdarimont,10,10,49,39,0,0,39.5289954612,30-39,416,2,2,2,4,4,2,2,7,3.4449280214,0,5.446620596905056E-4,0.0833333333,1,0,66,6.098567990188838E-5,1.797462E-5,1.8208082E-5,55,5,0,21,0,0
1202110940,IamRedBrown,10,295,30,88,1,16,36.0012439003,30-39,388,4,9,15,24,24,9,15,7,2.9223300971,97.1353061185,0.0038994641,0.1014492754,0.32916668,0,66,7.550724117746996E-5,5.99154E-5,6.069361E-5,47,6,0,198,0,0
1202254177,LeiilyD,10,1932,46,48,0,8,41.8113666216,40-49,661,6,1,1,2,2,1,1,8,4.6666666667,0,7.648644644148607E-5,0,0,30,104,1.3693132358905425E-4,1.198308E-5,1.2138721E-5,315,22,0,201,0,0
1203590904,SilveykkgHolli,10,3,1,6,0,0,,,2,0,0,0,0,0,0,0,0,0,0,0,0,0,373,682,4.4780486537007367E-5,0,0,383,0,0,9,0,0
1204117964,PensionMatters,10,15228,407,58,10,0,50.9948939829,50-59,646,8,2,0,2,2,2,0,0,0,0,4.6920378047207717E-4,0,0,0,13,5.004884455150075E-5,1.797462E-5,0,390,1,0,201,0,0
1204587288,GroovereqoArdit,10,33,11,93,0,0,11.7341444214,10-19,11,1,0,0,0,0,0,0,0,0,0,0,0,0,377,688,4.4780486537007367E-5,0,0,387,0,0,33,0,0
1206181339,PetitPandaChou,10,28673,564,1,0,138,50.2592916648,50-59,672,9,1,0,1,1,1,0,0,0,0,8.854435729639748E-4,0,0,0,64,4.737358737227889E-5,1.198308E-5,0,390,15,0,202,0,0
1207063184,IggyPosh,10,126,64,206,0,89,40.8947907231,40-49,509,4,2,2,4,4,2,2,2,1.75,0,1.720745070324517E-4,0.0833333333,1,214,407,1.3418960891622365E-4,1.797462E-5,1.8208082E-5,266,13,0,199,0,0
1208959315,QuietOakFarm,10,30,17,87,0,0,23.4152386492,20-29,68,3,1,2,3,3,1,2,8,3.6269655403,14.3929872099,7.49471721243357E-5,0,0,0,399,6.533581315393133E-5,1.198308E-5,1.2138721E-5,372,1,0,65,0,0
1209622626,EnviroExposed,10,30,25,63,0,0,21.6805310953,20-29,133,1,0,5,5,5,0,5,7,2.9923025435,0,0,0.2,0.3,0,441,4.4780486537007367E-5,0,6.0693606E-6,55,1,0,33,0,0
1210051994,Mwadden_cheer,10,137,33,74,0,27,18.2212069328,10-19,279,2,0,0,0,0,0,0,0,0,0,0,0,0,221,421,4.4780486537007367E-5,0,0,215,4,0,161,0,0
1212389454,DorothyCStaley,10,1875,125,375,1,75,44.3313585773,40-49,581,7,2,6,8,8,2,6,7,3.4211583529,16.4352940251,3.4255811050055545E-4,0.0357142857,0.1,0,66,5.6028545136902605E-5,1.797462E-5,1.8208082E-5,47,7,0,201,0,0
1214075808,Manunu972,10,159,19,27,0,2,32.3777789875,30-39,559,5,0,0,0,0,0,0,0,0,0,0,0,0,260,491,4.4780486537007367E-5,0,0,256,5,0,202,0,0
1214680596,PLHSFlanny,10,126,75,82,0,67,57.4347593739,50-59,473,3,1,1,2,2,1,1,1,1,0,7.49471721243357E-5,0,0,39,123,2.9852402567743944E-4,1.198308E-5,1.2138721E-5,201,2,0,179,0,0
1218420457,iamchaseabana,10,19,3,8,0,0,18.8620946581,10-19,63,2,0,0,0,0,0,0,0,0,0,0,0,0,253,483,4.4780486537007367E-5,0,0,249,1,0,24,0,0
1218767424,erierixxchu,10,1109,323,339,0,0,39.9507881449,30-39,493,6,0,1,1,1,0,1,8,4.0552208835,0,0,0,0,0,330,4.4780486537007367E-5,0,6.0693606E-6,320,0,0,201,0,0
1218929485,kanako_day,10,2655,485,500,1,0,43.2507906627,40-49,520,6,2,2,4,4,2,2,7,2.9775694677,460.473115871,0.0032446929,0,0,0,66,7.857324766799657E-5,1.797462E-5,1.8208082E-5,320,0,0,201,0,0
1219831238,IanBaranov,10,155,38,131,0,1,40.3645072712,40-49,481,4,5,24,29,29,5,24,6,2.8115165718,7.7057615815,0.003800431,0.2783251232,0.6483333,0,66,7.033455147369856E-5,3.594924E-5,3.6416164E-5,372,9,7,156,7,0.0448717949
1222486399,CP_Culture,10,28,11,30,0,1,19.4020539509,10-19,82,1,0,0,0,0,0,0,0,0,0,0,0,0,280,527,4.4780486537007367E-5,0,0,277,2,0,32,0,0
1222500780,FabienLeonard,10,10,11,48,0,0,12.4824719478,10-19,10,1,0,0,0,0,0,0,0,0,0,0,0,0,364,662,4.4780486537007367E-5,0,0,374,0,0,13,0,0
1222620624,CanadianProg,10,446,27,133,0,16,26.2277917262,20-29,375,4,5,35,40,40,5,35,7,2.5148978909,10.0120383558,0.0072955392,0.3282051282,0.5640114,0,66,5.5472484711559966E-5,3.594924E-5,3.6416164E-5,390,4,0,201,0,0
1226601480,NovaLyceum,10,285,5,12,1,0,34.2320998246,30-39,504,5,0,1,1,1,0,1,8,3.6345381526,0,0,0,0,0,428,4.4780486537007367E-5,0,6.0693606E-6,140,5,0,201,0,0
1228713486,FranceMarion2,10,171,35,282,0,0,23.4764636169,20-29,337,4,1,6,7,7,1,6,7,3.0247740208,3.4575162298,0.001185233,0.2619047619,0.4,0,66,4.8767668038289396E-5,1.198308E-5,1.2138721E-5,390,1,0,200,0,0
1230330985,StephaneGroulx,10,15,11,102,0,0,53.3676645039,50-59,63,1,5,18,23,23,5,18,7,2.7328423167,8.1400994245,0.0102098966,0.2470355731,0.44761905,0,66,6.109817274677499E-5,3.594924E-5,3.6416164E-5,140,0,1,22,1,0.0454545455
1230441554,LeviINM,10,196,225,245,3,53,44.8380152847,40-49,597,4,62,63,125,125,62,63,7,2.583528624,1468.6567843718,0.0551782454,0.0563225806,0.2750503,0,66,2.4793185698462043E-4,3.7746702E-4,3.8236973E-4,47,44,0,196,0,0
1231844737,Jack__Wagon,10,118,23,349,0,1,32.9474406492,30-39,276,4,2,48,50,50,2,48,6,2.5788416471,16.1416814071,0.0036493266,0.2995918367,0.5514184,0,66,5.202746662459446E-5,1.797462E-5,1.8208082E-5,372,3,2,149,1,0.0134228188
1232241829,CalgaryLabour,10,43,24,77,0,1,21.5958857683,20-29,77,2,3,6,9,9,3,6,7,3.1536658855,1.8844371172,0.0017312019,0.1805555556,0.52380955,0,66,5.3858737459477347E-5,2.396616E-5,2.4277442E-5,390,3,0,48,0,0
1236477440,TobinCdnPoli,10,39,11,35,0,9,21.4543139108,20-29,113,2,1,4,5,5,1,4,7,3.3712755273,0.9051546583,5.177599820452043E-4,0.1,0.33333334,0,66,4.890456961082401E-5,1.198308E-5,1.2138721E-5,372,3,0,47,0,0
1237059938,TeamRevoltNow,10,3089,104,71,2,4,46.1539633465,40-49,610,9,38,16,54,54,38,16,7,2.9514563107,828.1020038755,0.0286833804,0.0555555556,0.16923077,0,66,1.5588127771434208E-4,2.3367006E-4,2.3670506E-4,47,5,0,238,0,0
1237156772,moneyerenda,10,5,4,5,0,0,14.7192575349,10-19,25,1,0,0,0,0,0,0,0,0,0,0,0,0,135,265,4.4780486537007367E-5,0,0,132,0,0,30,0,0
1238445726,hikarinspace,10,1593,434,463,0,0,40.3646786837,40-49,521,6,1,1,2,2,1,1,7,2.9956478072,0,0.0031315666,0,0,0,66,4.790338355077782E-5,1.198308E-5,1.2138721E-5,390,0,0,201,0,0
1239757610,CanConstitution,10,10,11,1,0,0,24.8040094374,20-29,293,0,3,1,4,4,3,1,7,3.2470706394,6.5766093636,0.0028312059,0.3333333333,0.5,0,66,1.6662230202262653E-4,2.396616E-5,2.4277442E-5,140,5,0,51,0,0
1240329889,Ms_Webshasha,10,18,42,107,0,0,17.3817105958,10-19,73,1,0,0,0,0,0,0,0,0,0,0,0,0,329,595,4.4780486537007367E-5,0,0,334,20,0,25,0,0
1241637859,yyukiko17,10,1585,412,430,0,0,39.2763043791,30-39,493,6,0,0,0,0,0,0,0,0,0,0,0,0,323,583,4.4780486537007367E-5,0,0,326,0,0,201,0,0
1242064148,InKorrrect,10,0,5,35,0,0,25.5288069222,20-29,407,2,2,12,14,14,2,12,7,2.8473384667,48.099061827,0.0030493132,0.1318681319,0.27272728,0,66,5.5027316895881816E-5,1.797462E-5,1.8208082E-5,140,5,5,50,5,0.1
1242439537,FilomenaFerraro,10,32,6,19,0,0,23.0746452114,20-29,86,2,0,2,2,2,0,2,8,3.4129852744,0,0,0.5,1,0,717,4.4780486537007367E-5,0,6.0693606E-6,390,0,0,32,0,0
1243510502,environnement_1,10,1407,37,1,4,0,47.2445374632,40-49,579,6,0,0,0,0,0,0,0,0,0,0,0,0,86,189,4.4780486537007367E-5,0,0,80,4,1,201,1,0.0049751244
1249794612,NDPInduNPD,10,6,12,5,0,0,22.7196314499,20-29,86,1,5,4,9,9,5,4,7,3.1349179779,0.5995233296,0.0096498931,0.125,0.56666666,0,66,1.0747430690300085E-4,3.594924E-5,3.6416164E-5,390,1,1,9,1,0.1111111111
1249867202,NakotaCreative,10,114,43,217,0,166,28.7357977398,20-29,342,4,4,9,13,13,4,9,7,3.1155005022,16.5230371033,0.0014554298,0.1153846154,0.3611111,0,66,6.76589531675786E-5,2.99577E-5,3.0346804E-5,47,3,0,146,0,0
1250116735,ottawa_rt,10,6043,110,0,3,0,41.3578237281,40-49,532,9,2,0,2,2,2,0,0,0,0,5.189202392842031E-4,0.5,1,0,44,4.7393183933105995E-5,1.797462E-5,0,372,2,0,210,0,0
1250141665,halifaxns_rt,10,9424,190,0,6,0,40.9552232924,40-49,520,8,2,0,2,2,2,0,0,0,0,3.536723345804649E-4,0,0,0,45,5.211736368691387E-5,1.797462E-5,0,140,2,0,202,0,0
1250157301,quebec_rt,10,3868,56,0,0,0,38.6576306853,30-39,503,8,1,0,1,1,1,0,0,0,0,5.611746121003873E-4,0,0,0,65,4.724175670871345E-5,1.198308E-5,0,390,0,1,202,1,0.004950495
1250238986,CanadianPoliKid,10,33,8,196,0,0,14.7207688667,10-19,31,2,0,58,58,58,0,58,7,2.6419009371,0,0,0.2108287961,0.32395643,0,69,4.4780486537007367E-5,0,6.0693606E-6,390,1,0,38,0,0
1250328126,just_usOkanagan,10,190,60,635,0,0,35.7596042558,30-39,445,4,5,51,56,56,5,51,7,2.5145631068,78.9598461762,0.0053794219,0.1769480519,0.29607844,0,66,5.365089393379928E-5,3.594924E-5,3.6416164E-5,55,2,0,200,0,0
1251825284,femke_storm,10,5,3,9,0,0,11.3417172752,10-19,3,0,1,3,4,4,1,3,1,1,2,7.79785798970118E-5,0.1666666667,0.5,22,95,2.550363331221934E-4,1.198308E-5,1.2138721E-5,182,0,0,5,0,0
1254880027,AlbertaActivist,10,103,18,127,0,7,36.4291922104,30-39,429,4,9,26,35,35,9,26,7,2.6334114496,142.3092086032,0.0105379082,0.0949579832,0.2723077,0,66,7.042958729983175E-5,5.99154E-5,6.069361E-5,372,20,0,184,0,0
1255891004,nettietraas,10,1,3,21,0,0,11.3417172752,10-19,3,0,0,0,0,0,0,0,0,0,0,0,0,0,21,94,4.4780486537007367E-5,0,0,17,0,0,1,0,0
1256231707,hal5464,10,17,1,14,0,4,16.6047033747,10-19,51,0,0,0,0,0,0,0,0,0,0,0,0,0,201,383,4.4780486537007367E-5,0,0,195,0,0,33,0,0
1257655196,anonGypsy,10,307,31,116,0,1,43.2626506991,40-49,532,5,1,3,4,4,1,3,7,3.1462516734,1.5837522472,7.49471721243357E-5,0.25,0.33333334,0,206,4.58919816623078E-5,1.198308E-5,1.2138721E-5,47,6,0,200,0,0
1260599725,AnaisArmede,10,49,12,18,0,0,40.6773610568,40-49,582,4,2,2,4,4,2,2,8,3.9393939394,0,1.5451002051869458E-4,0.0833333333,1,30,104,1.420195880440812E-4,1.797462E-5,1.8208082E-5,315,36,0,195,0,0
1260608046,thinktanker_,10,59,24,126,0,20,24.2383397295,20-29,267,3,4,18,22,22,4,18,7,2.9447606294,33.1657800839,0.0014814649,0.1406926407,0.31699347,0,66,6.333076039096569E-5,2.99577E-5,3.0346804E-5,47,4,0,90,0,0
1260813001,publicidadxaweb,10,19,44,83,1,0,29.6924689836,20-29,281,2,1,1,2,2,1,1,1,1,0,7.49471721243357E-5,0,0,265,498,2.9852402567743944E-4,1.198308E-5,1.2138721E-5,262,12,0,38,0,0
1262402966,cantbeeserious,10,39,3,18,0,0,22.905235186,20-29,186,3,2,4,6,6,2,4,7,3.1379310345,0.8676213952,0.0035047528,0.2,0.23333333,0,66,5.018247648201187E-5,1.797462E-5,1.8208082E-5,390,1,1,91,1,0.010989011
1262481170,Eva_HumanRights,10,617,20,285,0,3,44.5503508181,40-49,537,7,2,4,6,6,2,4,7,3.2547706729,0.3104803134,9.331110786907104E-4,0.1333333333,0.5833333,0,66,5.0485328149854005E-5,1.797462E-5,1.8208082E-5,47,0,0,203,0,0
1263333547,JacobNoseworthy,10,163,27,123,0,48,36.10286222,30-39,408,4,1,3,4,4,1,3,7,3.3930364915,0.0808446456,4.0598115395619347E-4,0.0833333333,0.16666667,0,66,4.6807489786043565E-5,1.198308E-5,1.2138721E-5,390,5,0,200,0,0
1264764085,Loopfanaatnl,10,4,2,11,0,0,11.0632857838,10-19,27,0,0,0,0,0,0,0,0,0,0,0,0,0,11,81,4.4780486537007367E-5,0,0,8,0,0,7,0,0
1264972752,MsMeganMack,10,129,30,192,0,20,26.2018979942,20-29,137,4,0,4,4,4,0,4,7,3.1706827309,0,0,0.25,0.33333334,0,659,4.4780486537007367E-5,0,6.0693606E-6,390,0,0,167,0,0
1265329136,FP_TopEnergy,10,19,9,29,0,7,24.3686086301,20-29,96,2,1,2,3,3,1,2,7,3.3203883495,0,9.419342586916661E-4,0.1666666667,0.5,0,66,4.9481557891212485E-5,1.198308E-5,1.2138721E-5,372,0,0,28,0,0
1265924923,Zsoom99,10,16,2,21,0,0,15.6708586376,10-19,1,2,0,0,0,0,0,0,0,0,0,0,0,0,187,359,4.4780486537007367E-5,0,0,183,0,0,24,0,0
1266638515,amdptrainingltd,10,5,14,129,0,0,18.1372199078,10-19,118,2,1,1,2,2,1,1,1,1,0,7.49471721243357E-5,0,0,285,534,2.9852402567743944E-4,1.198308E-5,1.2138721E-5,284,2,0,20,0,0
1267285542,seo899seo,10,3272,114,55,0,0,46.1399207733,40-49,576,7,0,0,0,0,0,0,0,0,0,0,0,0,125,242,4.4780486537007367E-5,0,0,122,0,0,201,0,0
1267401278,HagiazoHuios,10,8,6,27,0,0,14.6694107797,10-19,28,1,1,3,4,4,1,3,7,3.6799464345,52.7443212858,7.983484808699256E-5,0.0833333333,0.33333334,0,66,8.656879533355665E-5,1.198308E-5,1.2138721E-5,372,1,0,10,0,0
1267627562,DoctorT_D,10,79,26,70,0,0,40.3333448005,40-49,442,3,0,0,0,0,0,0,0,0,0,0,0,0,160,313,4.4780486537007367E-5,0,0,156,2,0,111,0,0
1267663496,Politicalog,10,8,37,212,0,0,17.2096651077,10-19,47,2,10,39,49,49,10,39,6,2.3739537998,323.2634574483,0.0059100996,0.0858843537,0.20897436,0,66,6.505272849418631E-5,6.590694E-5,6.6762965E-5,140,0,0,8,0,0
1268250757,JillianLCurtin,10,1,4,13,0,0,14.1518828172,10-19,25,1,3,5,8,8,3,5,7,2.8901908269,3391.8367320737,0.0012685438,0.0892857143,0.35,0,66,7.506839962053695E-5,2.396616E-5,2.4277442E-5,390,0,0,11,0,0
1268694740,tw88follow,10,1738,11,1,1,0,39.5236969392,30-39,464,8,0,0,0,0,0,0,0,0,0,0,0,0,99,208,4.4780486537007367E-5,0,0,94,0,0,201,0,0
1268953286,barry8ronald,10,0,0,14,0,0,,,0,0,0,0,0,0,0,0,0,0,0,0,0,0,20,93,4.4780486537007367E-5,0,0,16,0,0,1,0,0
1270694791,Tache_Alex,10,34,15,85,0,0,24.1019768134,20-29,94,2,1,8,9,9,1,8,6,2.7723468363,0.5924391885,0.0031315666,0.1805555556,0.26785713,0,66,4.790338355077782E-5,1.198308E-5,1.2138721E-5,390,0,0,50,0,0
1272293930,Civitatem_Civis,10,7,2,30,0,1,24.3680667981,20-29,317,1,0,9,9,9,0,9,7,2.889892905,0,0,0.375,0.6805556,0,629,4.4780486537007367E-5,0,6.0693606E-6,390,0,0,13,0,0
1272650227,ScareDeeCat2000,10,20,5,18,0,0,24.2228062601,20-29,276,3,0,2,2,2,0,2,7,3.0836680054,0,0,0.5,0.5,0,339,4.4780486537007367E-5,0,6.0693606E-6,390,1,1,82,1,0.012195122
1272977286,BoonevilleCPC,10,3,2,12,0,0,11.0632857838,10-19,6,1,1,1,2,2,1,1,1,1,0,7.49471721243357E-5,0,0,3,68,2.9852402567743944E-4,1.198308E-5,1.2138721E-5,83,0,0,30,0,0
1273148768,WarrenIDunlop,10,14,18,69,1,0,38.5445815374,30-39,401,3,4,7,11,11,4,7,7,3.1834616672,26.4506424743,0.0015707204,0.1636363636,0.7380952,0,66,7.371079031601867E-5,2.99577E-5,3.0346804E-5,55,9,0,65,0,0
1273559047,ReignFeral,10,90,4,23,0,13,42.8487866689,40-49,639,5,5,7,12,12,5,7,7,2.8597254771,9.7545165882,0.0041898862,0.1666666667,0.22727273,0,66,5.4331980804846125E-5,3.594924E-5,3.0346804E-5,47,352,2,214,2,0.0093457944
1275215894,JanineLexx,10,90,41,282,0,26,46.1868668588,40-49,568,4,12,21,33,33,12,21,7,2.7469032474,105.0199317866,0.0111193638,0.0880681818,0.24833333,0,66,7.45577630616436E-5,7.789002E-5,7.8901685E-5,372,14,0,200,0,0
1276460149,CladinaDawes,10,1,2,50,0,0,17.092575493,10-19,48,2,0,15,15,15,0,15,7,2.7583668005,0,0,0.3047619048,0.43809524,0,89,4.4780486537007367E-5,0,6.0693606E-6,55,1,0,19,0,0
1276647637,otcimow,10,124,23,144,0,37,55.7855244407,50-59,695,7,65,100,165,165,65,100,7,2.4489454302,2374.4914650557,0.060508489,0.0706208426,0.2441201,0,66,2.7078478585268337E-4,3.9544163E-4,4.0057782E-4,47,306,2,222,2,0.009009009
1276931240,everythingyeg,10,1135,121,544,1,2,43.2473053779,40-49,501,7,1,5,6,6,1,5,7,3.0893873452,0.1616767625,0.0010365274,0.3,0.85,0,66,4.782055726777915E-5,1.198308E-5,1.2138721E-5,372,3,0,200,0,0
1277092860,simoncott,10,79,25,241,1,20,30.7236705773,30-39,311,3,1,5,6,6,1,5,7,3.0351523267,4.9240226372,2.1864691970068613E-4,0.1,0.2,0,66,4.889964379825264E-5,1.198308E-5,1.2138721E-5,140,2,0,99,0,0
1278708559,1713eh,10,15,2,19,0,1,14.6323791312,10-19,75,3,0,3,3,3,0,3,7,3.1532797858,0,0,0.3333333333,0.33333334,0,514,4.4780486537007367E-5,0,6.0693606E-6,390,2,0,97,0,0
1278893274,sforsapo,10,67,10,66,0,12,15.7541340606,10-19,271,4,1,2,3,3,1,2,11,6.6002678273,5,1.0453218109003066E-4,0,0,0,66,1.6313647328630986E-4,1.198308E-5,1.2138721E-5,320,0,0,168,0,0
1284313915,RufusthaRed,10,17,4,30,0,0,14.480216282,10-19,46,1,0,0,0,0,0,0,0,0,0,0,0,0,336,606,4.4780486537007367E-5,0,0,344,0,0,29,0,0
1284971173,46005_CPC_EDA,10,1,2,11,0,0,,,2,0,3,9,12,12,3,9,7,3.2772012052,7.9237507164,0.0033331571,0.2045454545,0.5555556,0,66,9.586442175436398E-5,2.396616E-5,2.4277442E-5,372,0,0,1,0,0
1287167142,BrendanCalorie,10,24,7,43,0,0,16.7471707378,10-19,49,2,0,1,1,1,0,1,7,3.3216198126,0,0,0,0,0,504,4.4780486537007367E-5,0,6.0693606E-6,140,1,0,52,0,0
1290020496,Kool_aid_Kon,10,2,0,39,0,0,10,10-19,1,0,1,13,14,14,1,13,7,2.8526950117,0.4354454795,0.0013847579,0.1978021978,0.2820513,0,66,4.6361206780343715E-5,1.198308E-5,1.2138721E-5,47,0,0,5,0,0
1292431874,anythingbutlibs,10,4,0,3,0,0,10,10-19,30,1,0,0,0,0,0,0,0,0,0,0,0,0,324,584,4.4780486537007367E-5,0,0,327,0,0,3,0,0
1298548159,eto771,10,2,0,6,0,0,10,10-19,0,0,0,0,0,0,0,0,0,0,0,0,0,0,304,559,4.4780486537007367E-5,0,0,303,0,0,2,0,0
1298555100,lera_af_4481100,10,2,0,0,0,2,10,10-19,0,0,0,0,0,0,0,0,0,0,0,0,0,0,305,560,4.4780486537007367E-5,0,0,304,0,0,2,0,0
1298566278,inna_no_7492416,10,2,0,0,0,1,10,10-19,10,0,0,0,0,0,0,0,0,0,0,0,0,0,303,558,4.4780486537007367E-5,0,0,302,0,0,7,0,0
1298577012,vadim_ro_075951,10,2,0,0,0,1,10,10-19,0,0,0,0,0,0,0,0,0,0,0,0,0,0,306,561,4.4780486537007367E-5,0,0,305,0,0,6,0,0
1298580552,lena_la_5256382,10,3,0,0,0,1,10,10-19,10,0,0,0,0,0,0,0,0,0,0,0,0,0,308,563,4.4780486537007367E-5,0,0,307,0,0,2,0,0
1298610535,nikita_ni_76352,10,2,0,0,0,0,10,10-19,0,0,0,0,0,0,0,0,0,0,0,0,0,0,307,562,4.4780486537007367E-5,0,0,306,0,0,6,0,0
1298692566,olga_go_7481477,10,2,0,0,0,2,10,10-19,0,0,0,0,0,0,0,0,0,0,0,0,0,0,309,564,4.4780486537007367E-5,0,0,308,0,0,3,0,0
1298696424,3f127riejuzji91,10,0,0,0,0,2,10,10-19,0,0,0,0,0,0,0,0,0,0,0,0,0,0,23,96,4.4780486537007367E-5,0,0,18,0,0,1,0,0
1298711894,julija_is_22988,10,4,0,0,0,0,10,10-19,10,0,0,0,0,0,0,0,0,0,0,0,0,0,310,565,4.4780486537007367E-5,0,0,309,0,0,4,0,0
1298717598,663ftqstvle3mi1,10,2,0,0,0,1,10,10-19,0,0,0,0,0,0,0,0,0,0,0,0,0,0,311,566,4.4780486537007367E-5,0,0,310,0,0,6,0,0
1298733192,dasha_sa_471341,10,2,0,0,0,1,10,10-19,10,0,0,0,0,0,0,0,0,0,0,0,0,0,25,98,4.4780486537007367E-5,0,0,20,0,0,2,0,0
1298749087,oleg_dm_8857434,10,1,0,0,0,1,10,10-19,0,0,0,0,0,0,0,0,0,0,0,0,0,0,24,97,4.4780486537007367E-5,0,0,19,0,0,1,0,0
1298759239,vlad_af_7231101,10,3,0,0,0,0,10,10-19,0,0,0,0,0,0,0,0,0,0,0,0,0,0,312,567,4.4780486537007367E-5,0,0,311,0,0,8,0,0
1298763265,nina_go_6542410,10,2,0,0,0,0,10,10-19,0,0,0,0,0,0,0,0,0,0,0,0,0,0,313,568,4.4780486537007367E-5,0,0,312,0,0,2,0,0
1299662108,ArizonaCompanie,10,1127,0,0,0,0,,,0,0,0,0,0,0,0,0,0,0,0,0,0,0,341,615,4.4780486537007367E-5,0,0,349,0,0,201,0,0
1301486268,4thebirdiez,10,10,2,114,0,0,22.6780844369,20-29,90,3,0,47,47,47,0,47,7,2.4933065596,0,0,0.2987974098,0.5046253,0,681,4.4780486537007367E-5,0,6.0693606E-6,140,0,0,27,0,0
1304328403,DavidMacNam,10,3,0,31,0,0,10,10-19,10,0,0,8,8,8,0,8,7,3.046854083,0,0,0.1964285714,0.25,0,603,4.4780486537007367E-5,0,6.0693606E-6,390,0,0,3,0,0
