id,label,size,statuses_count,followers_count,friends_count,listed_count,favourites_count,klout_score,klout_score_bucket,kred_influence,kred_outreach,indegree,outdegree,degree,weighted degree,weighted indegree,weighted outdegree,eccentricity,closnesscentrality,betweenesscentrality,eigencentrality,newClusteringCoefficient,clustering,componentnumber,strongcompnum,pageranks,authority,hub,modularity_class,old_clustering,interaction_count,temp_term_score,num_tweets,term_score_distinct_tweets,final_term_score,cluster_diff
35965408,16jesse31,10,4329,357,485,1,970,41.8653041837,40-49,668,7,1,2,3,3,1,2,10,4.1210889882,0,0.0012923654,0.1666666667,1,0,135,5.02963348097726E-5,5.0330927E-5,5.1639556E-5,505,0.14285715,7,0,199,0,0,0.85714285
405986825,joanmuise,10,176,21,99,0,6,20.8986293265,20-29,312,4,1,2,3,3,1,2,11,4.544900447,0,0.0012276961,0.1666666667,1,0,135,5.022489604991657E-5,5.0330927E-5,5.1639556E-5,343,0.33333334,4,1,190,1,0.0052631579,0.66666666
829767386,YosheLeigh1,10,127,14,68,0,0,19.3782400852,10-19,312,3,1,2,3,3,1,2,11,4.2405526209,0,0.001482571,0.1666666667,1,0,135,5.0579432359531754E-5,5.0330927E-5,5.1639556E-5,257,0.33333334,3,0,131,0,0,0.66666666
1267401278,HagiazoHuios,10,8,6,27,0,0,14.6694107797,10-19,28,1,1,2,3,3,1,2,12,5.0451036164,0,3.772525221188337E-4,0.1666666667,1,0,135,8.656879533355665E-5,5.0330927E-5,5.1639556E-5,353,0.33333334,1,0,10,0,0,0.66666666
266225680,fyrwulf13,10,674,30,94,0,25,14.675146986,10-19,497,4,1,2,3,3,1,2,10,4.1515644047,0,0.0024285215,0.1666666667,1,0,135,5.407591541934201E-5,5.0330927E-5,5.1639556E-5,257,0.37121212,1,1,200,1,0.005,0.62878788
976111975,zinniaz4bees,10,176,15,81,1,27,25.123184475,20-29,88,3,1,2,3,3,1,2,11,4.0154408777,0,0.0039143912,0.1666666667,1,0,135,5.175249015735946E-5,5.0330927E-5,5.1639556E-5,283,0.43333334,0,0,192,0,0,0.56666666
31158134,rleisti,10,2725,216,316,11,17,28.719343032,20-29,495,6,1,2,3,3,1,2,10,3.9987809833,0,0.0050273053,0.1666666667,1,0,135,5.147322323127064E-5,5.0330927E-5,5.1639556E-5,505,0.45,0,0,199,0,0,0.55
508876374,margiebarkley,10,389,32,71,0,5,21.5248991517,20-29,492,4,3,0,3,3,3,0,0,0,0,0.0245746326,0.5,0.8333333,0,121,5.486659497723304E-5,1.00661855E-4,0,99,0.2857143,2,0,199,0,0,0.547619
545801629,PauliticalEye,10,12326,84,119,5,146,28.14274658,20-29,558,8,2,1,3,3,2,1,10,3.9744006501,0,0.0119053773,0.1666666667,1,0,135,5.1778437083346646E-5,7.549639E-5,7.7459335E-5,99,0.5,1,0,201,0,0,0.5
70693316,terrylo_calgary,10,20484,644,592,19,1143,63.8279857241,60-69,738,8,2,2,4,4,2,2,11,3.7716375457,0,0.0260361447,0.0833333333,1,0,135,5.145321836955657E-5,7.549639E-5,7.7459335E-5,353,0.5,8,0,201,0,0,0.5
1198946628,JohnZwicker1,10,1251,197,554,2,214,47.7878462285,40-49,606,6,1,2,3,3,1,2,11,4.2876879317,0,0.0050576403,0.1666666667,1,0,135,4.993837400203766E-5,5.0330927E-5,5.1639556E-5,353,0.5,5,1,201,1,0.0049751244,0.5
427743419,jimmydawes107,10,123,2,58,0,2,13.4493879176,10-19,83,3,0,2,2,2,0,2,10,3.9244516653,0,0,0.5,1,0,356,4.4780486537007367E-5,0,2.5819778E-5,283,0.5222222,0,0,157,0,0,0.4777778
311469815,unsilenced_majo,10,214,7,127,0,0,27.7482487343,20-29,400,4,1,1,2,2,1,1,10,4.0361641609,0,0.0044446574,0.5,1,0,135,5.464100699589477E-5,5.0330927E-5,5.1639556E-5,505,0.5471698,11,3,200,3,0.015,0.4528302
392880793,prab_the_man,10,2671,134,214,3,8,43.5350529348,40-49,683,6,2,1,3,3,2,1,10,4.0365704998,0,0.0119099896,0.1666666667,1,0,135,6.291657190405784E-5,7.549639E-5,7.7459335E-5,505,0.55,8,0,201,0,0,0.45
16438512,ArtTherapyPlus,10,147,49,146,0,2,16.0429048908,10-19,200,3,0,4,4,4,0,4,10,4.2266450041,0,0,0.5,0.9166667,0,471,4.4780486537007367E-5,0,2.5819778E-5,257,0.47777778,0,0,173,0,0,0.43888892
150293439,gaufredus,10,865,152,252,7,46,39.230371378,30-39,584,5,3,4,7,7,3,4,11,4.9853718001,14.59504807,0.0021345385,0.119047619,0.8333333,0,135,9.346057989983634E-5,1.00661855E-4,1.0327911E-4,267,0.4,5,0,200,0,0,0.4333333
1007615486,Creesharpshootr,10,155,48,211,0,22,23.149291327,20-29,219,4,0,2,2,2,0,2,10,3.9260763607,0,0,0.5,1,0,348,5.709705617852713E-5,0,2.5819778E-5,99,0.5714286,1,0,199,0,0,0.4285714
865633705,EnergyAlberta,10,467,147,217,2,1,33.438307458,30-39,414,6,1,2,3,3,1,2,11,3.8086143844,0,0.0241051796,0.1666666667,1,0,135,5.73391858360039E-5,5.0330927E-5,5.1639556E-5,353,0.6,0,0,203,0,0,0.4
33666565,profaucoin,10,441,96,101,1,0,25.2310961151,20-29,435,4,3,2,5,5,3,2,11,4.3892726534,0,0.0034628143,0.15,1,0,135,1.1009257661652729E-4,1.00661855E-4,1.0327911E-4,283,0.6,1,0,200,0,0,0.4
128676402,natcampbell92,10,849,89,158,1,160,37.4595841457,30-39,552,5,1,2,3,3,1,2,10,3.7809833401,0,0.0078290605,0.1666666667,1,0,135,5.173822998173059E-5,5.0330927E-5,5.1639556E-5,99,0.6,3,0,201,0,0,0.4
623174642,EmraldKatie,10,502,36,348,0,10,26.9260191948,20-29,377,5,0,2,2,2,0,2,11,4.3456539399,0,0,0.5,1,0,395,6.065364118003917E-5,0,2.5819778E-5,353,0.64444447,0,2,200,2,0.01,0.35555553
1250238986,CanadianPoliKid,10,33,8,196,0,0,14.7207688667,10-19,31,2,0,8,8,8,0,8,11,4.128757108,0,0,0.4285714286,0.66071427,0,137,4.4780486537007367E-5,0,2.5819778E-5,353,0.32395643,1,0,38,0,0,0.33675784
303853801,JensenMusicJMI,10,4235,521,566,13,2,44.1082279926,40-49,631,7,1,1,2,2,1,1,1,1,0,8.046619634557215E-4,0.5,0.5,0,117,5.286013865389503E-5,5.0330927E-5,5.1639556E-5,257,0.16666667,6,0,201,0,0,0.33333333
559466563,Donness,10,127,40,95,1,0,30.331271059,30-39,567,4,2,2,4,4,2,2,11,5.1015847217,0,0.0011808492,0.0833333333,1,0,135,7.007930727725485E-5,7.549639E-5,7.7459335E-5,99,0.6666667,8,0,155,0,0,0.3333333
266914729,Macktrocity,10,10,6,26,0,2,11.8833382982,10-19,26,1,2,2,4,4,2,2,11,4.7106867127,0,0.0017681248,0.0833333333,1,0,135,5.1682692711646634E-5,7.549639E-5,7.7459335E-5,99,0.6666667,0,1,12,1,0.0833333333,0.3333333
60116717,KT_Mtjoy,10,110,26,101,0,0,13.1898573515,10-19,176,3,2,2,4,4,2,2,10,3.9252336449,0,0.0096791933,0.25,1,0,135,5.316088631847294E-5,7.549639E-5,7.7459335E-5,283,0.6666667,0,0,118,0,0,0.3333333
235741775,74suited,10,406,101,472,0,5,20.3499977596,20-29,420,4,3,3,6,6,3,3,10,3.7687931735,0,0.0539833017,0.2,1,0,135,6.223728746255741E-5,1.00661855E-4,1.0327911E-4,353,0.6785714,1,0,200,0,0,0.3214286
16372926,BernieMason,10,44,12,86,0,0,18.9223777275,10-19,92,1,2,2,4,4,2,2,10,4.1194636327,0,0.002794929,0.0833333333,1,0,135,4.9358822703194175E-5,7.549639E-5,7.7459335E-5,257,0.6868132,3,0,42,0,0,0.3131868
299241117,michelle373737,10,1558,282,1064,5,67,42.3427068853,40-49,594,6,6,10,16,16,6,10,10,3.80292564,587.0397983674,0.0150961385,0.1291666667,0.6666667,0,135,8.050173538560402E-5,1.7615824E-4,1.8073844E-4,283,0.3809524,22,0,200,0,0,0.2857143
167156495,maggie172,10,2879,47,75,2,91,41.2771575148,40-49,633,6,3,1,4,4,3,1,11,4.3380739537,1.741084151,0.0212387621,0.1666666667,0.5,0,135,5.9633837560943835E-5,1.00661855E-4,1.0327911E-4,99,0.21428572,2,1,201,1,0.0049751244,0.28571428
395475144,TreenDream,10,20,80,772,0,0,20.2352449031,20-29,311,3,0,7,7,7,0,7,11,3.979285134,0,0,0.4047619048,0.6904762,0,774,5.205340031169462E-5,0,2.5819778E-5,353,0.42028984,0,1,20,1,0.05,0.27018636
23829086,JordicusMaximus,10,2208,118,325,1,54,37.2312559834,30-39,611,5,1,3,4,4,1,3,10,3.7643234458,0,0.0068719943,0.1666666667,0.5,0,135,5.082529066547927E-5,5.0330927E-5,5.1639556E-5,283,0.23333333,2,0,200,0,0,0.26666667
470691248,BTDiasCAW1459,10,472,16,45,0,7,18.1833835818,10-19,137,4,2,1,3,3,2,1,11,4.6972775295,0,0.0073462275,0.1666666667,1,0,135,5.5775328054507096E-5,7.549639E-5,7.7459335E-5,257,0.73333335,0,0,200,0,0,0.26666665
441973833,TwitTwitCat,10,1145,93,170,1,37,40.8432314519,40-49,542,5,7,6,13,13,7,6,10,3.8008939456,157.8417488547,0.0206403349,0.0833333333,0.61904764,0,135,9.03989707963156E-5,2.0132371E-4,2.0655822E-4,283,0.35661766,10,0,200,0,0,0.26242998
252443979,d_zels,10,997,200,285,2,110,35.7155109737,30-39,592,5,6,8,14,14,6,8,11,4.5465258025,28.9017067337,0.009343582,0.1428571429,0.85714287,0,135,9.507191944372717E-5,1.7615824E-4,1.8073844E-4,353,0.6,3,0,198,0,0,0.25714287
944576364,StateCentury,10,269,56,172,1,0,30.6925782614,30-39,439,4,1,2,3,3,1,2,12,4.6253555465,0,4.976011673408853E-4,0.1666666667,0.5,0,135,4.736809328748044E-5,5.0330927E-5,5.1639556E-5,505,0.25,23,0,200,0,0,0.25
1262481170,Eva_HumanRights,10,617,20,285,0,3,44.5503508181,40-49,537,7,2,3,5,5,2,3,10,3.8976026006,0,0.0072476145,0.15,0.8333333,0,135,5.0485328149854005E-5,7.549639E-5,7.7459335E-5,99,0.5833333,0,0,203,0,0,0.25
34275728,darrengenge,10,699,92,213,2,3,21.7765333992,20-29,529,4,0,3,3,3,0,3,11,4.5219333875,0,0,0.3333333333,0.5,0,411,4.4780486537007367E-5,0,2.5819778E-5,343,0.25,1,0,199,0,0,0.25
632320063,hex_hut,10,843,328,1108,3,10,44.1934238208,40-49,509,5,2,2,4,4,2,2,11,3.8086143844,995.7837752451,0.0243497868,0.1666666667,0.5,0,135,6.216936293350532E-5,7.549639E-5,5.1639556E-5,353,0.25,2,0,200,0,0,0.25
808031126,GraceontheCoast,10,16,20,159,0,0,18.3072107072,10-19,135,2,1,3,4,4,1,3,12,5.4693214141,0,3.788253482851782E-4,0.25,0.8333333,0,135,5.7811038796388525E-5,5.0330927E-5,5.1639556E-5,267,0.5833333,1,0,28,0,0,0.25
134889456,tbest8118,10,1627,767,837,3,4,26.9040716481,20-29,608,5,2,3,5,5,2,3,11,3.7342543681,0,0.0300426372,0.15,0.6666667,0,135,7.241632509801687E-5,7.549639E-5,7.7459335E-5,353,0.42857143,1,0,199,0,0,0.23809527
270088915,charlesmire,10,2665,129,189,7,80,41.3953181683,40-49,587,6,3,4,7,7,3,4,11,4.2673709874,10.0640034922,0.0068312189,0.119047619,0.6666667,0,135,1.1118441275425131E-4,1.00661855E-4,1.0327911E-4,283,0.43333334,7,0,200,0,0,0.23333336
208678180,kcthegood,10,204,87,132,1,0,34.4287895607,30-39,457,4,5,5,10,10,5,5,11,4.3181633482,90.17030185,0.0078064729,0.2,0.60714287,0,135,8.211340399685854E-5,1.5099278E-4,1.5491867E-4,353,0.37916666,15,11,200,11,0.055,0.22797621
15338360,nomad411,10,24847,1299,1968,48,147,66.576499175,60-69,718,8,2,3,5,5,2,3,9,4.2824055262,12.0170447037,0.0024179963,0.1,0.6666667,0,135,1.6049799266591955E-4,7.549639E-5,7.7459335E-5,267,0.44545454,2,0,201,0,0,0.22121216
382330069,KellyDowdell,10,1112,180,256,3,30,40.0380781455,40-49,580,5,3,5,8,8,3,5,11,3.9370174726,10.0145405576,0.0152687797,0.1964285714,0.56666666,0,135,6.597398321283336E-5,1.00661855E-4,1.0327911E-4,353,0.34615386,1,1,199,1,0.0050251256,0.2205128
606492249,peterongilford,10,646,85,133,1,6,40.472177542,40-49,544,5,5,5,10,10,5,5,10,3.7826086957,269.2479727658,0.0121163656,0.0555555556,0.5,0,135,7.98625722469912E-5,1.5099278E-4,1.5491867E-4,71,0.2857143,11,0,200,0,0,0.2142857
1013858485,MCPACanada,10,94,43,98,0,3,25.5900103754,20-29,365,3,3,3,6,6,3,3,10,3.8821617229,15.3069438651,0.0047657058,0.1,0.6666667,0,135,5.6424275825335825E-5,1.00661855E-4,1.0327911E-4,505,0.45454547,3,5,103,5,0.0485436893,0.21212123
271229421,shelleyshell4,10,3414,79,294,1,23,41.6677233727,40-49,565,5,4,5,9,9,4,5,10,3.688338074,6.8692856582,0.0363791879,0.1111111111,0.55,0,135,7.940825973788773E-5,1.2582731E-4,1.2909889E-4,99,0.33918127,11,2,201,2,0.0099502488,0.21081873
1001077782,freechimchim,10,3884,182,2001,1,0,33.2250080867,30-39,640,6,1,4,5,5,1,4,10,4.0138155221,1.3205045954,6.404349169710305E-4,0.25,0.6666667,0,135,4.8877597188101595E-5,5.0330927E-5,5.1639556E-5,71,0.46666667,88,0,201,0,0,0.20000003
115491361,patriciapresti,10,4147,348,833,17,105,41.1601996141,40-49,604,6,4,4,8,8,4,4,11,4.8407151564,746.1569365299,0.0020866825,0.1071428571,0.5,0,135,1.0576167137317363E-4,1.2582731E-4,1.2909889E-4,267,0.30357143,3,0,200,0,0,0.19642857
16616320,miraoreck,10,505,348,532,7,0,33.8547597742,30-39,568,4,3,4,7,7,3,4,11,4.0832994718,24.8086364417,0.0094168702,0.0952380952,0.5833333,0,135,2.3318741770187316E-4,1.00661855E-4,1.0327911E-4,71,0.408867,0,0,199,0,0,0.1744663
17768745,janeschmidt,10,5991,398,301,23,189,50.668543469,50-59,708,6,7,8,15,15,7,8,11,4.7631044291,1357.5965028033,0.0046251771,0.0904761905,0.44444445,0,135,1.6735691669324607E-4,2.0132371E-4,2.0655822E-4,267,0.27083334,79,1,200,1,0.005,0.17361111
627598217,IainTRankin,10,99,104,217,0,0,33.4507534806,30-39,405,3,4,7,11,11,4,7,11,4.1698496546,120.1032081702,0.0076073119,0.1454545455,0.61904764,0,135,7.047855460542234E-5,1.2582731E-4,1.2909889E-4,343,0.44545454,4,1,100,1,0.01,0.1735931
587673918,GardinerGavin,10,151,164,193,2,5,40.6391362998,40-49,521,3,13,13,26,26,13,13,11,3.7793579846,138.9033551753,0.0409234118,0.1430769231,0.54044116,0,135,1.003494308201178E-4,3.5231648E-4,3.6147688E-4,257,0.3723077,3,0,158,0,0,0.16813346
510831727,nolansnolan,10,113,16,184,0,16,12.6209713021,10-19,115,4,2,1,3,3,2,1,11,4.0284437221,0,0.0483661603,0.1666666667,1,0,135,5.417645440906808E-5,7.549639E-5,7.7459335E-5,353,0.8333333,0,0,147,0,0,0.1666667
805784827,mark_luimes,10,316,44,52,0,35,29.9639385075,20-29,523,4,0,3,3,3,0,3,12,5.0389926889,0,0,0.3333333333,0.6666667,0,656,5.034065667458013E-5,0,2.5819778E-5,353,0.5,5,0,199,0,0,0.1666667
529784722,Bacon604,10,543,31,112,1,5,16.9417068801,10-19,421,4,0,2,2,2,0,2,10,3.7022745735,0,0,0.5,1,0,776,4.719077607448976E-5,0,2.5819778E-5,99,0.8333333,1,0,192,0,0,0.1666667
618163102,Bobby_B44,10,276,59,113,0,0,27.806687422,20-29,528,4,2,2,4,4,2,2,11,4.6269809021,2460,0.0020627644,0.0833333333,0.5,0,135,1.1686021338716388E-4,7.549639E-5,7.7459335E-5,353,0.33333334,8,0,200,0,0,0.16666666
69002150,StealthFlyBy,10,1035,36,8,1,1,42.0909084703,40-49,608,5,2,1,3,3,2,1,11,4.7078423405,0,0.0085353799,0.1666666667,0.5,0,135,6.61751925386398E-5,7.549639E-5,7.7459335E-5,257,0.33333334,8,0,200,0,0,0.16666666
563759499,stanczykowski,10,2970,368,564,22,16,51.9449419308,50-59,630,6,3,4,7,7,3,4,10,4.1080861438,129.4018991348,0.0084221883,0.1428571429,0.6,0,135,5.936850104859263E-5,1.00661855E-4,1.0327911E-4,267,0.43636364,4,0,200,0,0,0.16363636
83491633,hsvirk,10,458,34,37,5,2,26.6808797692,20-29,362,4,2,3,5,5,2,3,10,3.9142624949,4.3796691759,0.0030625745,0.1,0.5,0,135,5.72839684876865E-5,7.549639E-5,7.7459335E-5,505,0.3392857,1,0,200,0,0,0.1607143
29253678,kellyelliottmcm,10,4271,209,230,5,83,47.5556430367,40-49,669,6,5,4,9,9,5,4,11,4.0020316944,40.6707018984,0.0101276858,0.1805555556,0.6333333,0,135,6.849572644336519E-5,1.5099278E-4,1.5491867E-4,257,0.47272727,1,0,200,0,0,0.16060603
300290452,carbonexplorer,10,1332,252,522,13,29,47.0270462286,40-49,602,5,1,3,4,4,1,3,10,3.8321820398,0,0.0044776094,0.1666666667,0.6666667,0,135,6.064823386545359E-5,5.0330927E-5,5.1639556E-5,283,0.5138889,2,0,200,0,0,0.1527778
398380924,DouglasDolores,10,38,7,50,0,0,12.0125759127,10-19,17,2,1,3,4,4,1,3,11,4.2767167818,0.8868617241,0.0052766058,0.4166666667,0.75,0,135,4.8860267099825625E-5,5.0330927E-5,5.1639556E-5,257,0.6,0,0,39,0,0,0.15
1009127808,MonicaBALLUCB,10,692,34,76,0,20,35.9452747351,30-39,348,5,2,1,3,3,2,1,10,3.8642828119,0,0.0084648743,0.1666666667,0.5,0,135,5.360572524539934E-5,7.549639E-5,7.7459335E-5,99,0.35555556,3,3,201,3,0.0149253731,0.14444444
877623170,kitchen_ryan,10,827,36,168,0,0,34.3451868379,30-39,631,5,1,3,4,4,1,3,11,4.0711093052,8.1392476769,0.0013944332,0.0833333333,0.33333334,0,135,5.440302572270092E-5,5.0330927E-5,5.1639556E-5,257,0.1904762,1,0,200,0,0,0.14285714
874887668,ninnygoat,10,331,63,230,0,69,32.5955688332,30-39,479,4,0,5,5,5,0,5,11,4.1035743298,0,0,0.35,0.5,0,230,4.952210990120778E-5,0,2.5819778E-5,257,0.35714287,1,2,196,2,0.0102040816,0.14285713
244816624,pau1234la,10,3883,245,503,3,402,42.8478660992,40-49,682,6,11,13,24,24,11,13,10,3.5969118245,220.517259599,0.0389998096,0.1105072464,0.5824176,0,135,8.930597223655317E-5,3.0198556E-4,3.0983734E-4,257,0.4402174,24,0,200,0,0,0.1422002
388024089,felixhythlo,10,982,108,99,0,77,40.3619505937,40-49,594,5,6,4,10,10,6,4,10,3.7622917513,144.8621856462,0.0231360312,0.0777777778,0.4,0,135,8.106746815184422E-5,1.7615824E-4,1.8073844E-4,505,0.25833333,6,0,201,0,0,0.14166667
561028136,Staarky,10,222,17,28,0,7,22.4234821074,20-29,421,4,1,2,3,3,1,2,11,4.7074360016,0,0.0033533194,0.1666666667,0.5,0,135,6.114333838801465E-5,5.0330927E-5,5.1639556E-5,257,0.3611111,4,0,199,0,0,0.1388889
591150170,COPEthunderbay,10,119,31,66,0,0,17.3445602746,10-19,152,4,3,3,6,6,3,3,11,3.9479886225,25.5155713094,0.0039342171,0.0666666667,0.6666667,0,135,5.790806592544397E-5,1.00661855E-4,1.0327911E-4,257,0.53333336,0,0,160,0,0,0.13333334
37515185,RobertAHammer,10,157,54,126,1,0,32.2912834843,30-39,522,4,3,5,8,8,3,5,11,3.9878098334,3.4843542416,0.006437654,0.1607142857,0.75,0,135,5.866446134563014E-5,1.00661855E-4,1.0327911E-4,343,0.6212121,13,0,200,0,0,0.1287879
225811778,Netghost88,10,1650,95,17,0,12,22.5211378319,20-29,689,6,13,3,16,16,13,3,10,3.8000812678,8.7260549016,0.160110064,0.275,0.6318681,0,135,1.0895127368611395E-4,3.5231648E-4,3.6147688E-4,353,0.5036765,4,0,200,0,0,0.1281916
384357977,NWVoyageur,10,2856,111,153,2,24,31.16472171,30-39,586,6,17,20,37,37,17,20,10,3.3275091426,75.1899012306,0.2590986942,0.1403903904,0.77272725,0,135,1.1694584129403932E-4,4.5297833E-4,4.64756E-4,353,0.6453202,10,0,199,0,0,0.12740705
209609597,PeebsY0,10,1862,79,370,0,97,27.5949842372,20-29,552,6,1,2,3,3,1,2,10,3.8911011784,0,0.0044164531,0.1666666667,0.5,0,135,4.6591070128343536E-5,5.0330927E-5,5.1639556E-5,257,0.375,2,0,199,0,0,0.125
184931005,natgdulz,10,5549,136,193,0,815,41.5953633057,40-49,613,3,6,8,14,14,6,8,11,4.068264933,86.4026791809,0.0163369415,0.1538461538,0.6527778,0,135,7.529397448048785E-5,1.7615824E-4,1.8073844E-4,353,0.53333336,20,1,200,1,0.005,0.11944444
284757897,ckane616,10,2744,1454,1955,25,147,52.5942086456,50-59,649,7,8,0,8,8,8,0,0,0,0,0.010585483,0.2321428571,0.4642857,0,22,1.328166268143072E-4,2.2648917E-4,0,303,0.34583333,3,0,202,0,0,0.11845237
17735910,Hankers,10,13633,192,232,6,4,50.3878706857,50-59,714,7,11,11,22,22,11,11,10,3.4973587972,27.2263483635,0.1611749815,0.1731601732,0.6904762,0,135,9.948417320383482E-5,3.0198556E-4,3.0983734E-4,353,0.5731225,29,0,199,0,0,0.1173537
24497152,Eddie_Gravity,10,12422,274,443,2,18,46.6109544164,40-49,737,7,3,3,6,6,3,3,11,4.0552620886,38.6749411661,0.0158731083,0.1666666667,0.5833333,0,135,5.382952073708526E-5,1.00661855E-4,1.0327911E-4,505,0.46666667,15,0,200,0,0,0.11666663
262476027,spiderrico38,10,1740,46,49,0,25,32.0591002198,30-39,562,6,16,13,29,29,16,13,10,3.5432750914,63.2548707426,0.2235833873,0.1588669951,0.61315787,0,135,1.2259083482616043E-4,4.2781286E-4,4.3893623E-4,353,0.49867725,5,3,197,3,0.0152284264,0.11448062
246426922,voxgroove,10,11793,879,692,21,1223,54.2667787761,50-59,728,7,3,4,7,7,3,4,11,3.9731816335,42.7733587328,0.0122920697,0.119047619,0.45,0,135,6.595426033406831E-5,1.00661855E-4,1.0327911E-4,353,0.3392857,12,0,200,0,0,0.1107143
302659496,nucks99,10,1635,97,221,3,9,40.4416572366,40-49,616,6,9,12,21,21,9,12,10,3.39780577,339.8515246623,0.1429555613,0.1,0.5984849,0,135,8.414677931157608E-5,2.5165462E-4,2.5819778E-4,353,0.4904762,1,0,192,0,0,0.1080087
42985494,fawking_riot,10,11475,603,229,11,332,51.8049395696,50-59,743,7,5,3,8,8,5,3,10,3.6302316132,2.4823746698,0.0216156315,0.1428571429,0.75,0,135,7.146789757271887E-5,1.5099278E-4,1.5491867E-4,99,0.6454545,6,0,201,0,0,0.1045455
16603504,bryw,10,3294,204,289,5,1313,45.241760287,40-49,626,6,6,9,15,15,6,9,11,3.9097927672,151.0584347001,0.0077686565,0.080952381,0.3888889,0,135,1.3192974135100874E-4,1.7615824E-4,1.8073844E-4,257,0.28666666,5,0,200,0,0,0.10222224
275295586,wwwwwayne,10,135,6,22,0,2,11.8833382982,10-19,66,2,2,1,3,3,2,1,11,4.0776107273,3.4168617784,0.0077431589,0.1666666667,0.5,0,135,5.1709464610847275E-5,7.549639E-5,7.7459335E-5,257,0.4,1,0,139,0,0,0.1
1228713486,FranceMarion2,10,171,35,282,0,0,23.4764636169,20-29,337,4,0,2,2,2,0,2,10,4.7583265638,0,0,0.5,0.5,0,393,4.8767668038289396E-5,0,2.5819778E-5,267,0.4,1,0,200,0,0,0.1
90996160,Stroppy_Girl,10,29435,254,249,7,6866,38.8663923856,30-39,784,8,4,5,9,9,4,5,10,3.5704997968,343.0288894965,0.0103629061,0.0416666667,0.3,0,135,6.208026226128624E-5,1.2582731E-4,1.2909889E-4,71,0.2,4,0,201,0,0,0.1
6351532,redgirl13,10,10817,654,645,53,525,,,727,7,6,8,14,14,6,8,11,4.6899634295,1307.8414947223,0.0037928598,0.0879120879,0.44642857,0,135,1.5428951632540577E-4,1.7615824E-4,1.8073844E-4,267,0.3472222,57,0,200,0,0,0.09920637
468128433,Packer_man,10,8644,708,1951,8,295,42.6045954001,40-49,737,8,13,20,33,33,13,20,10,3.2775294596,4334.6979199728,0.1722678663,0.0606060606,0.3131579,0,135,1.181189018645248E-4,3.5231648E-4,3.6147688E-4,353,0.2139785,17,0,201,0,0,0.0991794
69233373,SuzakiTheAmazon,10,1266,190,394,1,30,40.7003182665,40-49,586,5,16,23,39,39,16,23,10,3.2620885819,551.7859904335,0.2137296447,0.0978407557,0.45471016,0,135,1.0192867065833268E-4,4.2781286E-4,4.3893623E-4,353,0.3563492,0,1,200,1,0.005,0.09836096
249264319,ErikJohnline,10,559,77,144,3,0,43.9252429774,40-49,577,5,14,12,26,26,14,12,10,3.7220642015,5126.4910154977,0.0340804806,0.0923076923,0.5095238,0,135,1.754058466871111E-4,3.7748195E-4,3.8729666E-4,283,0.4117647,38,1,200,1,0.005,0.0977591
1015951808,tomgrinnellzw,10,243,29,63,0,0,34.8792796979,30-39,518,4,2,4,6,6,2,4,10,3.8138967899,35.8037389793,0.0087740866,0.1,0.5,0,135,8.282971247315404E-5,7.549639E-5,7.7459335E-5,257,0.4027778,23,2,199,1,0.0050251256,0.0972222
604842373,A_Wall2,10,826,59,179,1,65,41.269495477,40-49,516,5,10,15,25,25,10,15,10,3.5672490857,392.7248300809,0.024720027,0.1066666667,0.52380955,0,135,1.3590160861002824E-4,2.768201E-4,2.8401756E-4,283,0.42857143,33,0,200,0,0,0.09523812
176306039,WOComoxValley,10,463,26,88,0,1,21.1081886256,20-29,457,4,2,0,2,2,2,0,0,0,0,0.0046755489,0.5,0.5,0,88,5.334115557421492E-5,7.549639E-5,0,353,0.4047619,2,0,199,0,0,0.0952381
91846036,Bait_and_Switch,10,937,122,634,3,0,38.5055397108,30-39,539,5,8,8,16,16,8,8,10,3.702559935,234.5140965352,0.0206955942,0.1041666667,0.6388889,0,135,8.2165963740436E-5,2.2648917E-4,2.32378E-4,283,0.54545456,17,2,200,2,0.01,0.09343434
207864860,ButterBrained,10,614,73,165,3,2,31.5130305395,30-39,536,5,12,17,29,29,12,17,10,3.4144656644,92.6957581886,0.1850454274,0.118226601,0.54901963,0,135,9.310859558253036E-5,3.27151E-4,3.3565713E-4,353,0.45726496,8,18,200,18,0.09,0.09175467
633839714,luresaregood,10,927,81,134,0,5,25.8477509641,20-29,590,5,11,15,26,26,11,15,10,3.5071109305,334.6495550481,0.14645535,0.0769230769,0.42380953,0,135,9.523770200756586E-5,3.0198556E-4,3.0983734E-4,353,0.33475783,5,3,200,3,0.015,0.0890517
44777956,heatherkel,10,82,48,71,7,4,24.1252369731,20-29,203,2,4,3,7,7,4,3,11,4.0402275498,7.2812104824,0.0098380844,0.1904761905,0.6,0,135,6.160237381881175E-5,1.2582731E-4,1.2909889E-4,257,0.510989,6,0,110,0,0,0.089011
107794362,RunnertheFirst,10,19386,828,467,23,2,48.1379640052,40-49,755,8,38,51,89,89,38,51,10,3.1227143438,7335.2402679925,0.4375282224,0.0795454545,0.36936027,0,135,4.089068123913106E-4,9.814531E-4,0.0010069713,353,0.28079194,137,0,204,0,0,0.08856833
108909795,LM_Campbell,10,2463,390,378,36,20,49.3558280243,40-49,672,6,15,13,28,28,15,13,10,3.5444941081,825.0587115147,0.0402905753,0.0952380952,0.5904762,0,135,1.615643440336059E-4,4.0264742E-4,4.1311645E-4,283,0.50292397,37,0,199,0,0,0.08755223
485164245,cook_erika,10,302,142,316,1,0,33.2648751357,30-39,511,4,11,20,31,31,11,20,10,3.265339293,275.5898285584,0.1666709406,0.1548387097,0.6261905,0,135,1.1586809529983754E-4,3.0198556E-4,3.0983734E-4,353,0.5392157,17,2,200,2,0.01,0.0869748
53720659,cansciencetwit,10,528,178,264,20,7,31.6227783209,30-39,470,4,5,3,8,8,5,3,11,4.1966680211,26.4962058703,0.0150143538,0.1071428571,0.55,0,135,9.04699257297369E-5,1.5099278E-4,1.5491867E-4,283,0.4642857,1,0,200,0,0,0.0857143
292624934,AB_CutRock,10,12949,922,1990,12,80,32.6989626776,30-39,681,7,27,34,61,61,27,34,10,3.1889475823,7821.5994095233,0.3659529859,0.0928961749,0.5409982,0,135,1.4532707884000804E-4,7.0463296E-4,7.2295376E-4,353,0.4566365,4,0,199,0,0,0.0843617
273479738,wcgirl2,10,28666,2505,1821,104,0,44.0581658879,40-49,803,9,11,12,23,23,11,12,10,3.684681024,888.8878592514,0.0155266828,0.0533596838,0.3409091,0,135,1.5250302234612838E-4,3.0198556E-4,3.0983734E-4,303,0.25714287,49,0,202,0,0,0.08376623
736130144,jlynnz7,10,291,34,112,0,0,19.8026559485,10-19,338,4,0,2,2,2,0,2,11,4.5028432169,0,0,0.5,0.5,0,737,5.03848497503507E-5,0,2.5819778E-5,353,0.41666666,0,0,200,0,0,0.08333334
194222922,TheLeftCall,10,4263,1068,1999,29,5,45.0317042418,40-49,714,6,2,3,5,5,2,3,11,4.3506704592,1.938955338,0.0018208887,0.15,0.8333333,0,135,6.892800422079857E-5,7.549639E-5,7.7459335E-5,303,0.75,79,1,200,1,0.005,0.0833333
32485442,jensaisrien,10,172,52,67,2,0,33.8652364446,30-39,496,3,5,2,7,7,5,2,11,4.3892726534,0,0.0052608828,0.1904761905,0.75,0,135,8.881007204952608E-5,1.5099278E-4,1.5491867E-4,283,0.6666667,12,0,190,0,0,0.0833333
447436221,jessi_jaja,10,571,188,396,0,36,22.8613874762,20-29,515,5,10,11,21,21,10,11,10,3.3811458757,3048.3888990597,0.0322154192,0.069047619,0.37878788,0,135,1.0968735500109812E-4,2.768201E-4,2.8401756E-4,283,0.3,1,0,200,0,0,0.07878788
49018161,Gottahrdt,10,67932,1760,2001,48,32,43.4783738639,40-49,783,9,6,9,15,15,6,9,10,3.3770824868,261.9379273439,0.0998940858,0.0952380952,0.43333334,0,135,1.3254057670009873E-4,1.7615824E-4,1.8073844E-4,353,0.3547619,6,0,200,0,0,0.07857144
818707315,sean_theguard,10,164,118,148,1,2,30.4970057597,30-39,441,3,5,2,7,7,5,2,10,4.035757822,47.3378861237,0.0092172232,0.1904761905,0.6,0,135,6.370409668070063E-5,1.5099278E-4,1.5491867E-4,257,0.5222222,3,1,181,1,0.0055248619,0.0777778
443448249,hanline_,10,691,44,144,1,2,36.0839071387,30-39,525,5,3,3,6,6,3,3,11,3.906948395,62.9581465609,0.0083559236,0.2,0.3,0,135,5.1426946959664815E-5,1.00661855E-4,1.0327911E-4,257,0.22222222,14,2,200,2,0.01,0.07777778
374735534,honkey_blueye,10,255,8,36,0,5,32.6099289204,30-39,474,4,2,3,5,5,2,3,10,3.8370581065,819.8651531291,0.0185596601,0.05,0.33333334,0,135,6.244273051361753E-5,7.549639E-5,7.7459335E-5,353,0.25757575,18,7,200,7,0.035,0.07575759
277145358,johnrbolton1,10,2649,395,488,6,0,45.8926032095,40-49,672,6,25,23,48,48,25,23,10,3.2673709874,6408.1185737661,0.3154582435,0.0944148936,0.47906405,0,135,1.8258546752896422E-4,6.54302E-4,6.7131425E-4,353,0.40386474,23,0,199,0,0,0.07519931
1004484314,dcbarrett_,10,772,65,227,0,86,38.2128872269,30-39,589,5,4,8,12,12,4,8,10,3.6314506298,749.9454941447,0.0112291476,0.0909090909,0.375,0,135,6.045702796571224E-5,1.2582731E-4,1.2909889E-4,283,0.3,8,0,200,0,0,0.075
69479599,CNTtabulating,10,812,229,360,3,2,33.9749349864,30-39,557,5,6,9,15,15,6,9,10,3.6208858188,117.7223336846,0.0501050812,0.1380952381,0.46666667,0,135,7.21679718319933E-5,1.7615824E-4,1.8073844E-4,99,0.39166668,3,2,200,2,0.01,0.07499999
1231844737,Jack__Wagon,10,118,23,349,0,1,32.9474406492,30-39,276,4,1,9,10,10,1,9,11,3.6367330354,9.6753128302,0.0163321031,0.2777777778,0.625,0,135,5.202746662459446E-5,5.0330927E-5,5.1639556E-5,353,0.5514184,3,2,149,1,0.0067114094,0.0735816
317061843,Thinkey1013,10,10254,277,258,8,146,52.1886941927,50-59,706,8,4,4,8,8,4,4,9,3.7862657456,19.9140869406,0.0083173476,0.1428571429,0.55,0,135,5.957452896471531E-5,1.2582731E-4,1.2909889E-4,343,0.47777778,12,0,200,0,0,0.07222222
47845089,paulbthompson,10,249,93,263,3,3,41.8978333763,40-49,527,4,6,14,20,20,6,14,10,3.5851279967,344.9758191284,0.0155528167,0.2078947368,0.39215687,0,135,7.586497261765162E-5,1.7615824E-4,1.8073844E-4,257,0.31996435,16,1,199,1,0.0050251256,0.07219252
238248595,CanadianCBR,10,1688,479,253,25,2,42.0047912377,40-49,697,6,22,7,29,29,22,7,11,4.6074766355,2312.3829350354,0.0432288449,0.0935960591,0.27489176,0,135,2.049412571919608E-4,5.7880563E-4,5.680351E-4,353,0.2046371,60,0,200,0,0,0.07025466
446524341,StraitShooter0,10,717,76,40,1,0,16.575934507,10-19,599,5,9,3,12,12,9,3,11,4.6233238521,42.6617826489,0.0575285184,0.1742424242,0.4861111,0,135,1.1424311494019987E-4,2.5165462E-4,2.5819778E-4,353,0.41666666,1,3,200,3,0.015,0.06944444
293313896,RobertRoss4,10,13312,564,2001,6,0,48.7254027004,40-49,741,6,24,25,49,49,24,25,10,3.2994717594,1770.0815000301,0.2942936109,0.1020408163,0.44254032,0,135,1.298840387108727E-4,6.291366E-4,6.4549444E-4,353,0.37554428,193,8,202,8,0.0396039604,0.06699604
38442445,Jord_EST,10,8274,1117,1351,1,350,56.9636106197,50-59,736,7,3,4,7,7,3,4,10,3.6769605851,33.0564063375,0.0138030706,0.0952380952,0.6666667,0,135,5.360782222686846E-5,1.00661855E-4,1.0327911E-4,99,0.6,1,0,201,0,0,0.0666667
272398543,davidhyde2,10,3643,477,455,13,2,49.2544215627,40-49,684,6,1,3,4,4,1,3,11,4.4412840309,21.6976719532,0.0026427571,0.0833333333,0.16666667,0,135,4.7042335631851746E-5,5.0330927E-5,5.1639556E-5,257,0.1,4,0,200,0,0,0.06666667
15156469,techberry,10,8342,429,409,35,26,46.8636607079,40-49,684,6,3,3,6,6,3,3,10,4.1584721658,298.5917917962,0.0143946304,0.0333333333,0.16666667,0,135,6.227689053834909E-5,1.00661855E-4,1.0327911E-4,505,0.1,0,0,200,0,0,0.06666667
138585158,Bill5250,10,25348,959,1031,46,439,47.9843824689,40-49,785,9,4,3,7,7,4,3,11,4.494514425,79.1375370001,0.0022750968,0.0238095238,0.16666667,0,135,6.029327137003068E-5,1.2582731E-4,1.2909889E-4,257,0.1,26,0,201,0,0,0.06666667
17691510,Jennoit,10,2275,240,93,14,0,43.033441025,40-49,678,6,4,3,7,7,4,3,11,4.4721657863,1320.9739498941,0.0078720708,0.0714285714,0.41666666,0,135,9.603284109842125E-5,1.2582731E-4,1.2909889E-4,267,0.35,6,0,200,0,0,0.06666666
385789390,Fergyisms,10,438,162,152,2,1,33.1049467778,30-39,570,4,1,2,3,3,1,2,10,4.3230394149,0,0.0019632056,0.1666666667,0.5,0,135,4.629480618748087E-5,5.0330927E-5,5.1639556E-5,353,0.43333334,7,0,200,0,0,0.06666666
85094715,kplasterer,10,1238,84,370,1,20,26.6701313996,20-29,543,5,2,5,7,7,2,5,9,3.7054043072,160.4329345465,0.004496836,0.0476190476,0.2,0,135,5.852280859427298E-5,7.549639E-5,7.7459335E-5,99,0.13333334,0,0,198,0,0,0.06666666
262540645,Usual5uspect,10,1927,454,492,6,63,45.9354010143,40-49,628,6,28,41,69,69,28,41,10,3.3002844372,2332.5862440703,0.3681884732,0.0927109974,0.40803382,0,135,1.4505742237961512E-4,7.297984E-4,7.487736E-4,353,0.34164536,22,0,199,0,0,0.06638846
844495087,uOStudents4Life,10,166,100,136,0,12,36.4683570539,30-39,485,3,11,14,25,25,11,14,11,3.8338073954,2705.6334167822,0.0358774147,0.08,0.42857143,0,135,1.0420398606237699E-4,3.0198556E-4,3.0983734E-4,353,0.3627451,2,2,177,2,0.011299435,0.06582633
366654973,Conser_Hippy,10,707,98,123,1,1,40.2362011056,40-49,600,5,7,4,11,11,7,4,10,3.817147501,15.1378717577,0.0971028639,0.1090909091,0.52380955,0,135,7.447146965543509E-5,2.0132371E-4,2.0655822E-4,353,0.45833334,2,0,200,0,0,0.06547621
894588307,MeyFung_,10,130,30,47,0,5,30.920356203,30-39,452,3,6,9,15,15,6,9,11,3.9983746445,23.8125534262,0.0149302747,0.1428571429,0.5555556,0,135,6.953339820714255E-5,1.7615824E-4,1.8073844E-4,353,0.4909091,20,3,141,3,0.0212765957,0.0646465
379869808,leelsask,10,921,103,289,1,0,33.0300641677,30-39,554,5,7,7,14,14,7,7,10,3.7127184072,816.802111379,0.0259140707,0.0549450549,0.3392857,0,135,7.739094521663562E-5,2.0132371E-4,1.8073844E-4,257,0.27564102,1,0,199,0,0,0.06364468
134993381,rob_beiko,10,1896,296,325,18,19,42.4886950189,40-49,639,5,4,6,10,10,4,6,10,3.8874441284,732.2734427684,0.0057532713,0.1111111111,0.45238096,0,135,1.2111719371669611E-4,1.2582731E-4,1.2909889E-4,283,0.3888889,10,0,200,0,0,0.06349206
1049199278,rufus_lingo,10,44,155,690,1,71,45.4806333053,40-49,630,6,2,10,12,12,2,10,9,3.637952052,58.5371000555,0.0080971457,0.1363636364,0.24545455,0,135,5.2012334338297156E-5,7.549639E-5,7.7459335E-5,99,0.18571429,3,0,201,0,0,0.05974026
14244309,balleyne,10,4455,1114,644,72,359,44.6925230836,40-49,637,5,13,9,22,22,13,9,10,4.0524177164,4569.0851744174,0.0340627084,0.0865800866,0.43589744,0,135,3.0233822254835407E-4,3.5231648E-4,3.6147688E-4,353,0.3763158,8,0,200,0,0,0.05958164
63631693,CanMNews,10,13533,1200,350,38,74,47.0379675261,40-49,682,7,4,0,4,4,4,0,0,0,0,0.0288457529,0.0833333333,0.16666667,0,44,1.613548256113426E-4,1.2582731E-4,0,353,0.10714286,3,0,200,0,0,0.05952381
1022666976,MWRiop,10,477,39,67,0,7,34.1937574312,30-39,592,5,7,4,11,11,7,4,10,3.5570906136,69.3848405658,0.0870759066,0.1,0.47619048,0,135,7.054134513545802E-5,2.0132371E-4,2.0655822E-4,353,0.4181818,24,1,200,1,0.005,0.05800868
251256864,CPCANADIANS,10,2063,624,580,17,1,49.7600821048,40-49,729,6,12,12,24,24,12,12,11,4.1239333604,39920.3461429181,0.0117857346,0.0543478261,0.3939394,0,135,5.443087680884565E-4,3.27151E-4,3.3565713E-4,37,0.33974358,356,0,206,0,0,0.05419582
282900362,kelly_t_mac,10,3611,233,420,7,639,42.440299539,40-49,653,6,42,57,99,99,42,57,10,3.1328728159,1790.8318631093,0.5402875609,0.0828695114,0.40028247,0,135,1.9948126707994653E-4,0.0010821149,0.0011102505,353,0.34808794,6,0,200,0,0,0.05219453
356303383,Maryann_Chichak,10,1245,402,527,12,12,41.2902353504,40-49,604,5,21,28,49,49,21,28,10,3.3075985372,418.1254261549,0.2769282831,0.1058673469,0.5270936,0,135,2.2520926606959767E-4,5.536402E-4,5.680351E-4,353,0.4767347,8,1,200,1,0.005,0.0503589
72987186,MitchCaseSSM,10,200,24,40,0,0,26.479399812,20-29,306,4,4,2,6,6,4,2,11,4.2978464039,0.6955471572,0.023059112,0.1666666667,0.75,0,135,7.86121056638761E-5,1.2582731E-4,1.2909889E-4,99,0.7,9,0,200,0,0,0.05
522620461,lisagrandetang,10,662,43,116,0,40,27.3431726878,20-29,527,5,2,4,6,6,2,4,10,3.7395367737,40.0017649637,0.0046664666,0.0666666667,0.25,0,135,4.766265961963238E-5,7.549639E-5,7.7459335E-5,343,0.2,0,0,199,0,0,0.05
14049092,erlking,10,6858,456,469,35,196,59.3972383264,50-59,705,7,4,2,6,6,4,2,9,4.0987403495,29.7056430011,0.0070809037,0.1,0.41666666,0,135,6.152580017945455E-5,1.2582731E-4,1.2909889E-4,343,0.36666667,4,1,201,1,0.0049751244,0.04999999
19077807,IEWMrMatthew,10,413,56,99,1,12,43.8330669456,40-49,601,5,5,8,13,13,5,8,10,3.7269402682,179.3377503292,0.0063454298,0.1153846154,0.4027778,0,135,7.804548800634283E-5,1.5099278E-4,1.5491867E-4,257,0.35555556,59,0,200,0,0,0.04722224
1149032365,RwkXdc,10,2132,202,450,0,35,45.467262558,40-49,612,6,1,12,13,13,1,12,10,3.5886409736,10.614328202,2.6808524730492474E-4,0.1217948718,0.22727273,0,328,4.58919816623078E-5,5.0330927E-5,5.1639556E-5,99,0.18014705,6,0,202,0,0,0.04712568
542169141,altaMike,10,501,76,147,0,22,44.0168845782,40-49,569,5,4,5,9,9,4,5,10,3.5168630638,103.2169307265,0.032889297,0.0833333333,0.33333334,0,135,5.645365053036296E-5,1.2582731E-4,1.2909889E-4,353,0.28846154,18,0,202,0,0,0.0448718
252824869,JackFonsec,10,90,61,105,3,1,40.5727609415,40-49,461,2,6,8,14,14,6,8,11,4.175538399,4581.3422646416,0.0106021454,0.1263736264,0.43333334,0,135,1.1478750017229275E-4,1.7615824E-4,1.5491867E-4,353,0.3904762,27,1,103,1,0.0097087379,0.04285714
227169236,LandrevilleRRP,10,4309,765,862,15,8,46.0376282356,40-49,696,6,46,48,94,94,46,48,10,3.1722876879,3812.6757937162,0.5712834093,0.0689773507,0.42705882,0,135,2.4356338369466903E-4,0.0011827768,0.0012135296,353,0.38530466,25,0,199,0,0,0.04175416
250364353,tomcintosh,10,3328,205,75,5,14,47.446078123,40-49,720,6,18,3,21,21,18,3,11,4.3100365705,96.3770417147,0.0547490724,0.1761904762,0.31578946,0,135,1.4730444471988587E-4,4.781438E-4,4.905758E-4,257,0.2753846,86,0,200,0,0,0.04040486
51156456,scbritton,10,27002,427,291,11,55,37.2869037597,30-39,783,9,36,24,60,60,36,24,10,3.3197887038,2867.2008556795,0.3993417326,0.1008474576,0.373403,0,135,2.372851290638821E-4,9.311221E-4,9.553318E-4,353,0.3331169,31,0,200,0,0,0.0402861
23534420,tararobertson,10,20859,1311,458,135,250,,,759,8,5,4,9,9,5,4,11,4.3250711093,3407.1822524509,0.0057571234,0.0833333333,0.26190478,0,135,9.176843158322455E-5,1.5099278E-4,1.5491867E-4,267,0.22222222,6,0,200,0,0,0.03968256
1202110940,IamRedBrown,10,295,30,88,1,16,36.0012439003,30-39,388,4,9,10,19,19,9,10,10,3.362047948,509.5844010376,0.0601684786,0.0760233918,0.36363637,0,135,7.550724117746996E-5,2.5165462E-4,2.5819778E-4,99,0.32916668,6,0,198,0,0,0.03446969
1102468592,mogrant61,10,425,77,185,2,1,42.5001641189,40-49,514,5,24,40,64,64,24,40,10,3.272247054,692.478975122,0.3583618558,0.1061507937,0.4846154,0,135,1.4000211907870254E-4,6.291366E-4,6.4549444E-4,353,0.4502551,7,2,200,2,0.01,0.0343603
575858975,RyanChatterjee,10,1252,140,262,2,21,36.7617115225,30-39,572,5,11,13,24,24,11,13,11,3.8789110118,192.8227434988,0.0349430732,0.0923913043,0.4,0,135,9.254773400828993E-5,3.0198556E-4,3.0983734E-4,353,0.36615384,7,0,199,0,0,0.03384616
19134335,sddavis63,10,4165,118,76,11,4,35.038343329,30-39,623,4,3,3,6,6,3,3,11,4.6627387241,150.990390986,0.0019074353,0.0333333333,0.16666667,0,135,9.938359068574483E-5,1.00661855E-4,1.0327911E-4,99,0.13333334,1,0,200,0,0,0.03333333
836517360,TheManda27,10,74,24,59,0,0,20.8277929394,20-29,156,3,2,4,6,6,2,4,10,3.7988622511,120.6235852342,0.0042917099,0.1666666667,0.5833333,0,135,5.56483342313255E-5,7.549639E-5,7.7459335E-5,257,0.55,4,0,105,0,0,0.0333333
374658826,voter1vote,10,16228,1253,1445,48,2607,59.3241421367,50-59,744,8,11,14,25,25,11,14,10,3.5721251524,4805.3007808432,0.0244665491,0.0433333333,0.24175824,0,135,1.4064382108248851E-4,3.0198556E-4,3.0983734E-4,303,0.20952381,11,0,201,0,0,0.03223443
209693045,Clapperdudgeon,10,5025,1498,1943,7,35,45.7740013799,40-49,691,7,21,29,50,50,21,29,9,3.0138155221,15397.1653860071,0.2656803688,0.0506122449,0.28448275,0,135,1.395058157275535E-4,5.536402E-4,5.680351E-4,353,0.2529221,32,3,207,3,0.0144927536,0.03156065
309326261,LindaMae4,10,986,109,196,2,5,35.2654119846,30-39,582,5,12,15,27,27,12,15,10,3.6793986184,968.0411412311,0.0346014095,0.1168091168,0.4852941,0,135,1.0919739138915248E-4,3.27151E-4,3.0983734E-4,257,0.45384616,5,0,200,0,0,0.03144794
297483708,albertasoapbox,10,2484,341,384,12,4,45.4673863345,40-49,669,6,38,43,81,81,38,43,10,3.0755790329,3148.8090757184,0.5128267593,0.0844135802,0.50959593,0,135,2.1984935916552695E-4,9.814531E-4,0.0010069713,353,0.47960785,139,2,199,2,0.0100502513,0.02998808
267881942,JeanBPe,10,409,107,329,3,2,26.4217324907,20-29,509,4,2,2,4,4,2,2,11,4.5965054856,0,0.0105606994,0.25,0.5,0,135,1.5138267841251137E-4,7.549639E-5,7.7459335E-5,353,0.47076023,0,0,200,0,0,0.02923977
883423585,Anon0psCanada,10,1000,125,21,3,16,45.1488154668,40-49,592,5,9,1,10,10,9,1,10,3.781389679,0,0.0147817932,0.1333333333,0.25,0,135,8.626206561358264E-5,2.5165462E-4,2.5819778E-4,99,0.22222222,18,0,198,0,0,0.02777778
323400565,BCLA_InfoPolicy,10,172,82,41,1,1,41.3164563999,40-49,507,3,7,1,8,8,7,1,12,5.5188947582,175.3047167957,0.0051352504,0.1071428571,0.23809524,0,135,1.3440295488740986E-4,2.0132371E-4,2.0655822E-4,267,0.21111111,16,0,200,0,0,0.02698413
374643582,kyallskNDP,10,1284,261,225,11,9,45.8088404864,40-49,628,5,23,15,38,38,23,15,10,3.4778545307,4954.2496497085,0.0910819505,0.0960170697,0.27492878,0,135,1.4693024194008153E-4,6.0397113E-4,5.938549E-4,257,0.24831308,40,5,199,5,0.0251256281,0.0266157
263691341,bluecanadaca,10,2269,518,524,15,7,50.0114586131,50-59,715,6,42,33,75,75,42,33,10,3.2405526209,6836.7202595681,0.4569855538,0.0659459459,0.36157253,0,135,3.8158060860824113E-4,0.0010821149,0.0010844307,353,0.33527234,99,14,200,14,0.07,0.02630019
84207565,DESicnarF,10,1747,386,418,8,334,45.6344514806,40-49,667,6,36,50,86,86,36,50,10,3.179195449,2697.0006231339,0.4374288537,0.0783857729,0.41183674,0,135,1.891238280304813E-4,9.311221E-4,9.553318E-4,353,0.38557693,31,3,201,3,0.0149253731,0.02625981
37970352,JoeyViezner,10,4812,247,510,1,20,59.8461863431,50-59,644,6,11,18,29,29,11,18,10,3.3413246648,895.7838970681,0.1499893516,0.1206896552,0.37619048,0,135,8.989218951059398E-5,3.0198556E-4,3.0983734E-4,353,0.35027224,28,3,202,3,0.0148514851,0.02591824
341813644,clintupham,10,12323,606,379,18,1052,41.4049834748,40-49,767,8,48,54,102,102,48,54,10,3.1483136936,2650.7167544501,0.5753754489,0.0827023879,0.41857922,0,135,2.182787498619767E-4,0.0012331076,0.0012651691,353,0.39296067,177,1,202,1,0.004950495,0.02561855
466963666,cunningtonmatt,10,950,118,128,3,0,37.1971841076,30-39,580,5,6,3,9,9,6,3,10,4.19707436,11.9964348609,0.0185863149,0.2083333333,0.5952381,0,135,6.809525599966694E-5,1.7615824E-4,1.8073844E-4,505,0.57051283,27,2,200,2,0.01,0.02472527
354973054,alinsenharbc,10,2021,120,161,3,8,28.6411832622,20-29,545,6,4,7,11,11,4,7,10,3.5891913856,345.2279448299,0.0126259733,0.0545454545,0.26190478,0,135,7.109895296226161E-5,1.2582731E-4,1.2909889E-4,71,0.2375,0,2,199,2,0.0100502513,0.02440478
116476946,JamesatLFPress,10,6340,1532,241,76,19,49.3800088743,40-49,706,7,4,1,5,5,4,1,11,4.659488013,31.4876110552,0.0140275569,0.15,0.5,0,135,1.0952355637538767E-4,1.2582731E-4,1.2909889E-4,257,0.47619048,6,1,200,1,0.005,0.02380952
283301194,Haggisman57,10,7034,1594,2001,22,13,48.5756439288,40-49,705,7,58,67,125,125,58,67,10,3.1527834214,14370.0567784398,0.6148933305,0.0584516129,0.27596492,0,135,3.6087660707537206E-4,0.0014847623,0.0015233669,353,0.25333333,29,1,200,1,0.005,0.02263159
279142381,stoughtonfreak,10,1464,158,184,2,100,41.7051408975,40-49,631,5,14,16,30,30,14,16,10,3.4063388866,5378.1698459026,0.0376734878,0.0643678161,0.35416666,0,135,1.157493115296889E-4,3.7748195E-4,3.8729666E-4,257,0.33157894,9,3,200,3,0.015,0.02258772
197650075,NothingworksDan,10,367,48,196,0,21,15.1642347214,10-19,422,4,4,6,10,10,4,6,10,3.6997155628,273.6734449904,0.0623138336,0.1111111111,0.4047619,0,135,6.626106924262083E-5,1.2582731E-4,1.2909889E-4,353,0.38235295,2,0,199,0,0,0.02240895
872059213,EC_Kosters,10,628,67,145,2,3,42.9657706808,40-49,510,5,10,5,15,15,10,5,11,3.9703372613,89.4030524512,0.0191216968,0.1380952381,0.44545454,0,135,1.1635676620924108E-4,2.768201E-4,2.8401756E-4,283,0.42307693,22,1,201,1,0.0049751244,0.02237761
213296469,msamaroden,10,304,93,55,8,1,32.6780234793,30-39,506,4,6,2,8,8,6,2,11,4.0463226331,4.2577109251,0.0233790595,0.2142857143,0.7,0,135,8.196721386883055E-5,1.7615824E-4,1.8073844E-4,257,0.67777777,9,1,198,1,0.0050505051,0.02222223
19613023,BoGoWo,10,439,77,186,3,1,25.5438385832,20-29,412,4,0,2,2,2,0,2,10,4.2286758733,0,0,0.5,0.5,0,683,7.684784164179283E-5,0,2.5819778E-5,257,0.47777778,1,0,200,0,0,0.02222222
132021619,djsteverapson,10,335,113,346,3,14,36.182151148,30-39,534,4,2,5,7,7,2,5,10,3.4303128809,909.9681968448,0.0246520986,0.0952380952,0.4,0,135,5.812548216460455E-5,7.549639E-5,7.7459335E-5,353,0.37777779,14,1,200,1,0.005,0.02222221
347213984,flu9,10,1203,560,706,4,301,43.838933323,40-49,566,5,8,11,19,19,8,11,10,3.4323445754,3968.5446347582,0.0619274622,0.0438596491,0.23636363,0,135,9.352768750149017E-5,2.2648917E-4,2.32378E-4,353,0.21428572,16,10,230,10,0.0434782609,0.02207791
1156300052,XAVIERFISHER03,10,679,170,834,0,25,31.0495611415,30-39,419,5,10,15,25,25,10,15,10,3.2202356766,672.3597338403,0.0931334811,0.0816666667,0.34761906,0,135,9.138525999659192E-5,2.768201E-4,2.8401756E-4,99,0.32560974,1,1,196,1,0.0051020408,0.02200932
364330022,BrettParnell,10,1889,218,278,3,114,41.495097696,40-49,626,6,22,21,43,43,22,21,10,3.5164567249,5123.6465864249,0.0755906446,0.0686600221,0.3123077,0,135,1.4211401388653387E-4,5.7880563E-4,5.680351E-4,353,0.29032257,6,0,200,0,0,0.02198513
430570888,torngatmha,10,85,194,319,1,3,41.2931535827,40-49,516,3,10,11,21,21,10,11,9,3.5981308411,1198.7435488693,0.0276035402,0.069047619,0.30769232,0,135,8.626278555428266E-5,2.768201E-4,2.8401756E-4,343,0.2857143,9,1,103,1,0.0097087379,0.02197802
37399340,takuarm,10,2114,129,490,0,318,39.4261160263,30-39,561,6,9,20,29,29,9,20,9,3.2913449817,2289.6440967331,0.0611990103,0.1071428571,0.3030303,0,135,7.415997397075757E-5,2.5165462E-4,2.5819778E-4,99,0.28125,2,0,198,0,0,0.0217803
915477338,Banks_Todd,10,636,32,79,0,16,35.6940640244,30-39,571,5,6,14,20,20,6,14,10,3.5136123527,490.2516854302,0.0692271819,0.1184210526,0.35714287,0,135,6.701222977345561E-5,1.7615824E-4,1.8073844E-4,353,0.33571428,34,8,208,8,0.0384615385,0.02142859
53913259,gastongourde,10,5953,394,525,22,10,46.0222453197,40-49,643,7,4,4,8,8,4,4,9,4.0402275498,86.9384757364,0.005997061,0.0892857143,0.45,0,135,6.823282508862142E-5,1.2582731E-4,1.2909889E-4,267,0.42857143,3,0,200,0,0,0.02142857
252237345,IndependentNL,10,682,3294,1192,84,0,47.2972561985,40-49,663,4,26,15,41,41,26,15,8,3.4213734254,8415.0321032249,0.0597544022,0.0713414634,0.26353276,0,135,1.5938743455141616E-4,6.794675E-4,6.97134E-4,343,0.24420677,20,0,200,0,0,0.01932599
22868993,lawrence_thomas,10,2033,974,1881,21,8,43.5014701705,40-49,617,6,3,6,9,9,3,6,10,3.612759041,439.7047306813,0.0108572348,0.0555555556,0.26666668,0,135,6.110676555541325E-5,1.00661855E-4,1.0327911E-4,505,0.24761905,2,0,200,0,0,0.01904763
373581418,reason911,10,8354,223,306,3,21,32.2497048834,30-39,742,8,14,17,31,31,14,17,9,3.4116212922,3161.981760616,0.1308810764,0.076344086,0.20471014,0,135,1.0215054743950286E-4,3.7748195E-4,3.8729666E-4,353,0.18583043,70,0,200,0,0,0.01887971
844825399,Can_Limnology,10,1585,446,716,18,40,52.0113427247,50-59,673,6,24,26,50,50,24,26,10,3.5400243803,8928.1765940344,0.0441595714,0.0497959184,0.23448277,0,135,2.3364972614983427E-4,6.291366E-4,6.196747E-4,283,0.21596639,151,1,202,1,0.004950495,0.01851638
293223633,1967canadian,10,14119,507,607,13,301,41.0820211313,40-49,754,8,47,53,100,100,47,53,10,3.2190166599,3692.3072338901,0.5571204693,0.0685858586,0.42767295,0,135,2.2059128727555698E-4,0.0012079423,0.0012393494,353,0.4093702,67,0,201,0,0,0.01830275
119769483,aka_Pooch,10,392,167,351,7,21,40.3009863664,40-49,630,6,31,28,59,59,31,28,10,3.3275091426,2834.7420545883,0.3362351589,0.0844535359,0.34547907,0,135,1.9900205172584083E-4,8.0529484E-4,8.262329E-4,353,0.32759562,7,0,200,0,0,0.01788345
292074881,Sharpestick,10,8750,312,99,8,194,52.5218758148,50-59,706,7,21,9,30,30,21,9,10,3.6854937017,51.0291233889,0.2831833584,0.175862069,0.6017316,0,135,1.5331069849092112E-4,5.536402E-4,5.680351E-4,353,0.58465606,20,0,199,0,0,0.01707554
18253198,mensaghic,10,3604,184,284,1,7,40.2322936605,40-49,659,6,9,12,21,21,9,12,10,3.3933360423,259.4499963376,0.1377719462,0.130952381,0.43809524,0,135,1.1298120761163586E-4,2.5165462E-4,2.5819778E-4,353,0.42137095,8,1,200,1,0.005,0.01672429
36073085,pt_tory,10,54,404,1,18,0,37.4785362592,30-39,474,2,4,0,4,4,4,0,0,0,0,0.0090373307,0.0833333333,0.16666667,0,50,6.07446373394025E-5,1.2582731E-4,0,353,0.15,3,0,55,0,0,0.01666667
334976289,Dolfan_13,10,1203,90,218,0,15,36.4011068601,30-39,518,5,3,5,8,8,3,5,10,3.9045103616,408.1039176071,0.0107488731,0.0535714286,0.25,0,135,7.245691144015738E-5,1.00661855E-4,1.0327911E-4,353,0.23333333,5,0,200,0,0,0.01666667
1194989221,EoinWC,10,59,37,64,2,0,41.6728597014,40-49,487,3,5,2,7,7,5,2,10,4.1064607883,8.20806412,0.0114844919,0.0952380952,0.35,0,135,1.1258163275769024E-4,1.5099278E-4,1.5491867E-4,71,0.33333334,18,0,68,0,0,0.01666666
1260608046,thinktanker_,10,59,24,126,0,20,24.2383397295,20-29,267,3,4,12,16,16,4,12,10,3.3913043478,107.675865745,0.0214295511,0.1208333333,0.33333334,0,135,6.333076039096569E-5,1.2582731E-4,1.2909889E-4,99,0.31699347,4,0,90,0,0,0.01633987
271670918,vwriding,10,88,99,56,10,7,28.0121794975,20-29,545,3,7,6,13,13,7,6,11,3.7927671678,137.7823675208,0.0755451698,0.1025641026,0.3611111,0,135,7.590686262950654E-5,2.0132371E-4,2.0655822E-4,353,0.34545454,1,2,88,2,0.0227272727,0.01565656
114595836,LuckyJaxson,10,153,55,91,1,2,21.0202724751,20-29,307,3,6,3,9,9,6,3,10,4.0166598944,11.7144212153,0.0188851608,0.2361111111,0.5535714,0,135,6.245087378797679E-5,1.7615824E-4,1.8073844E-4,343,0.53809524,1,1,164,1,0.006097561,0.01547616
218285658,john_delgrande,10,2803,392,147,19,1,44.7432783884,40-49,685,5,11,4,15,15,11,4,11,4.2889069484,812.2731497189,0.0341965094,0.0476190476,0.12727273,0,135,1.1957085890453972E-4,3.0198556E-4,3.0983734E-4,353,0.1125,5,0,200,0,0,0.01477273
1074278209,BilboBagman,10,4739,2694,2941,58,3,55.3054330375,50-59,667,7,14,18,32,32,14,18,10,3.874441284,1050.5811390699,0.0171096652,0.0665322581,0.375817,0,135,1.7981126733298766E-4,3.7748195E-4,3.8729666E-4,303,0.36147186,14,0,201,0,0,0.01434514
354740222,jeffcliff1,10,7979,242,489,9,1585,43.3242763107,40-49,671,7,3,4,7,7,3,4,10,3.6603006908,178.6081168635,0.0106183637,0.0952380952,0.4,0,135,8.368385776122729E-5,1.00661855E-4,1.0327911E-4,257,0.3857143,6,1,200,1,0.005,0.0142857
20508681,robbutz,10,1065,387,446,21,70,35.3900130657,30-39,573,5,9,11,20,20,9,11,10,3.5201137749,563.0446812121,0.0470614441,0.0789473684,0.38636363,0,135,9.170444904791577E-5,2.5165462E-4,2.5819778E-4,257,0.37229437,2,0,201,0,0,0.01406926
860099179,FremontJuan,10,452,17,44,0,7,26.2170842455,20-29,528,5,3,7,10,10,3,7,11,3.7273466071,7.8247922186,0.0321583925,0.1555555556,0.5,0,135,5.296902962079738E-5,1.00661855E-4,1.0327911E-4,353,0.4861111,8,7,200,7,0.035,0.0138889
902773724,smebulok,10,2925,1248,1763,30,1742,51.9184262505,50-59,719,7,10,14,24,24,10,14,9,3.6095083299,1528.6042621696,0.0126895345,0.0652173913,0.32967034,0,135,1.3678307453360297E-4,2.768201E-4,2.8401756E-4,303,0.31617647,2,0,201,0,0,0.01349387
339722887,SnowHydro,10,6089,784,995,46,414,57.6278483931,50-59,727,7,23,22,45,45,23,22,10,3.5176757416,6730.0238200281,0.0435126573,0.053030303,0.20114942,0,135,2.3946143136829807E-4,6.0397113E-4,6.196747E-4,283,0.1876877,170,0,208,0,0,0.01346172
169657063,RebeccaFaustina,10,196,207,422,10,0,41.4428393352,40-49,478,4,14,18,32,32,14,18,11,3.8447785453,3211.6658155611,0.0300656345,0.0816532258,0.36549708,0,135,1.3995946569923923E-4,3.7748195E-4,3.8729666E-4,353,0.35282257,28,1,200,1,0.005,0.01267451
603053240,shouldbesaidcan,10,6664,333,530,7,8,36.562493145,30-39,709,7,60,66,126,126,60,66,10,3.0642015441,11390.0491429467,0.6098222734,0.0584761905,0.26107225,0,135,2.852119289594701E-4,0.0015350933,0.0015750064,353,0.24848485,41,0,199,0,0,0.0125874
358291440,kingcambie,10,6899,64,103,1,2,48.6244836633,40-49,708,7,2,1,3,3,2,1,11,4.838683462,0.0801806889,0.0301503706,0.3333333333,0.5,0,135,9.23685998348348E-5,7.549639E-5,7.7459335E-5,353,0.4875,13,0,202,0,0,0.0125
432957230,TFraser2,10,611,111,442,1,20,54.3387892098,50-59,493,5,0,4,4,4,0,4,11,4.2343623071,0,0,0.25,0.25,0,554,4.794597780917101E-5,0,2.5819778E-5,343,0.23809524,0,0,199,0,0,0.01190476
1043296272,anoncdn,10,2151,217,325,0,94,50.8192549519,50-59,668,7,9,8,17,17,9,8,10,3.5977245022,7332.0550425384,0.0110973324,0.0551470588,0.14393939,0,135,1.3795332133394422E-4,2.5165462E-4,2.5819778E-4,99,0.13235295,76,0,204,0,0,0.01158644
355105989,MommaYomma,10,33267,1647,1496,47,1373,56.0874511306,50-59,802,9,41,44,85,85,41,44,9,2.9565217391,18814.4743405637,0.4097202994,0.043977591,0.24601063,0,135,2.259949113778029E-4,0.0010569495,0.0010844307,353,0.23487103,158,0,201,0,0,0.0111396
18445844,ocean_raven,10,21387,2017,2083,40,41,45.0583748596,40-49,693,7,7,9,16,16,7,9,9,3.1946363267,1608.8227847488,0.0526086921,0.0416666667,0.2361111,0,135,7.820716800587586E-5,2.0132371E-4,2.0655822E-4,99,0.225,1,0,199,0,0,0.0111111
158937744,deantiquate,10,4908,444,362,26,242,48.4339806807,40-49,695,7,13,7,20,20,13,7,11,4.2702153596,4900.3078566568,0.0152159282,0.0421052632,0.17948718,0,135,2.1687229140637603E-4,3.5231648E-4,3.6147688E-4,267,0.16842106,39,0,201,0,0,0.01106612
635598734,AlleyHen,10,939,139,497,0,1259,35.0642760401,30-39,425,5,9,14,23,23,9,14,9,3.3059731816,536.5059757957,0.0808564082,0.0968379447,0.35416666,0,135,8.434852295780555E-5,2.5165462E-4,2.5819778E-4,99,0.34352773,0,0,199,0,0,0.01063893
993020562,GaryCar69543942,10,3985,1850,1934,54,793,55.2196400604,50-59,687,6,12,13,25,25,12,13,10,3.9650548557,344.9724667894,0.0130283211,0.075,0.41208792,0,135,1.6149078476920725E-4,3.27151E-4,3.3565713E-4,303,0.4019608,1,0,201,0,0,0.01012712
260566096,Bibliocracy,10,2527,406,205,17,393,51.2389596437,50-59,704,6,18,10,28,28,18,10,11,4.5193010971,17029.3511873737,0.0193263046,0.041005291,0.16013072,0,135,3.0699328922400426E-4,4.781438E-4,4.64756E-4,267,0.15036231,125,0,200,0,0,0.00976841
976734595,PolitJunkieM,10,1128,957,1078,19,74,45.5040286844,40-49,553,6,6,6,12,12,6,6,11,4.1084924827,13.1183481487,0.0084659115,0.0984848485,0.8666667,0,135,1.0187586217472178E-4,1.7615824E-4,1.8073844E-4,303,0.85714287,0,0,199,0,0,0.00952383
367333161,Dkrupski,10,12238,1786,1988,51,484,41.5515479354,40-49,753,8,43,40,83,83,43,40,10,3.19707436,10440.8228761699,0.495818226,0.0800764032,0.39183673,0,135,2.0741728377473784E-4,0.0011072804,0.0011360702,353,0.38251367,65,0,200,0,0,0.00932306
272525580,wtfrwe,10,389,22,81,0,6,22.1691318508,20-29,152,3,5,9,14,14,5,9,10,3.5546525803,218.1028331426,0.0315852236,0.0769230769,0.3472222,0,135,6.492059567267232E-5,1.5099278E-4,1.5491867E-4,99,0.33809525,6,0,199,0,0,0.00912695
16874564,FloydusMaxximus,10,6428,525,544,20,277,46.0964857799,40-49,659,7,15,15,30,30,15,15,9,3.2954083706,762.4113522056,0.1024322035,0.0747126437,0.30701753,0,135,9.971330541539442E-5,4.0264742E-4,4.1311645E-4,99,0.29833335,5,0,203,0,0,0.00868418
261751772,CarolHusband,10,8621,947,1122,14,401,49.9036999637,40-49,744,7,50,71,121,121,50,71,10,3.0060950833,10487.9814835917,0.5638060678,0.0628099174,0.28162163,0,135,2.4569453848455677E-4,0.0012834386,0.0013168086,353,0.27353913,38,0,200,0,0,0.0080825
255487471,K7K2tog,10,8607,390,573,7,819,47.4561013834,40-49,737,7,12,10,22,22,12,10,9,3.5916294189,2865.3287982764,0.0310676671,0.0562770563,0.20952381,0,135,9.533298840167869E-5,3.27151E-4,3.3565713E-4,343,0.20238096,6,1,201,1,0.0049751244,0.00714285
409740980,_LCarlson,10,354,284,119,7,1,40.2141389974,40-49,610,4,23,10,33,33,23,10,10,3.5343356359,197.5936856611,0.2477808679,0.1439393939,0.5217391,0,135,2.4256060627167434E-4,6.0397113E-4,6.196747E-4,353,0.514936,3,1,200,1,0.005,0.0068031
325994896,Freedomzone_,10,4723,1737,1698,39,8,48.8689194384,40-49,728,7,34,53,87,87,34,53,10,3.0410402275,8640.7739444078,0.3972292992,0.0613472334,0.2431942,0,135,1.9403593160955969E-4,8.807912E-4,9.036922E-4,353,0.23659673,53,0,200,0,0,0.00659747
15675351,pdamerica,10,8319,2798,1769,168,22,57.865958336,50-59,770,6,14,5,19,19,14,5,10,4.0182852499,5115.4525735143,0.0121586473,0.0204678363,0.04945055,0,135,3.0928396338146964E-4,3.7748195E-4,3.6147688E-4,303,0.042857144,50,0,201,0,0,0.006593406
378615823,HenrikSandbergJ,10,4802,10220,10999,121,64,59.6013916228,50-59,774,6,8,9,17,17,8,9,9,4.5595286469,65622.0125545141,0.0033930083,0.0036764706,0.027777778,0,135,3.9065621306185757E-4,2.2648917E-4,2.32378E-4,148,0.022222223,1387,0,202,0,0,0.005555555
376499821,langleyteacher,10,1437,308,183,20,10,47.3144877012,40-49,675,6,6,4,10,10,6,4,10,3.756196668,152.8409371944,0.0147217628,0.0666666667,0.26190478,0,135,7.22271572862253E-5,1.7615824E-4,1.8073844E-4,71,0.25641027,9,0,200,0,0,0.00549451
16405982,mooseandskwerl,10,31371,5200,4954,114,391,57.8237499901,50-59,776,8,74,70,144,144,74,70,10,3.078829744,22258.6686792072,0.7043875461,0.0476398601,0.25756174,0,135,4.63536408302431E-4,0.0018874097,0.0019106636,353,0.25247252,101,1,202,1,0.004950495,0.00508922
431971226,WhiteCoco80,10,3142,178,111,1,10,48.8017002206,40-49,702,7,12,7,19,19,12,7,10,3.8240552621,1144.5707127342,0.0210423996,0.0701754386,0.1923077,0,135,9.95428644921527E-5,3.27151E-4,3.3565713E-4,257,0.1875,43,0,201,0,0,0.0048077
19581788,brianlinca,10,5397,367,550,16,150,55.1247709577,50-59,673,6,3,5,8,8,3,5,10,3.4546932141,365.4209449105,0.0195719343,0.0178571429,0.1,0,135,6.148196481636623E-5,1.00661855E-4,1.0327911E-4,71,0.0952381,7,0,200,0,0,0.0047619
756085640,twilasinger,10,1195,265,600,1,65,39.4561301605,30-39,591,5,26,31,57,57,26,31,9,3.1373425437,2892.5994384071,0.194561742,0.0642230576,0.36989248,0,135,1.7865732240563873E-4,6.794675E-4,6.97134E-4,99,0.36651585,15,0,198,0,0,0.00337663
485425161,SparksLiam,10,229,67,257,0,3,14.0694883297,10-19,433,3,3,10,13,13,3,10,10,3.3892726534,138.873834292,0.0283924751,0.1217948718,0.3,0,135,5.478951651318825E-5,1.00661855E-4,1.0327911E-4,353,0.29692307,6,0,200,0,0,0.00307693
305894011,Deb_Libby,10,17384,707,817,25,742,44.5579910447,40-49,774,8,6,8,14,14,6,8,9,3.688338074,957.7952044228,0.0060661032,0.010989011,0.071428575,0,135,6.983501926826667E-5,1.7615824E-4,1.8073844E-4,303,0.06944445,6,0,200,0,0,0.001984125
187997748,Jamloops,10,6454,1106,713,39,18,48.2346493561,40-49,739,7,10,2,12,12,10,2,10,4.0808614384,55.9338823348,0.0537290982,0.1818181818,0.37777779,0,135,1.262352281389274E-4,2.768201E-4,2.8401756E-4,71,0.37666667,6,0,200,0,0,0.00111112
592461813,CatholicMouse,10,3024,311,317,8,1,33.5175250931,30-39,639,6,11,18,29,29,11,18,11,3.8882568062,4447.2192021226,0.0210560526,0.078817734,0.32456142,0,135,1.22664324800977E-4,3.0198556E-4,3.0983734E-4,353,0.32368422,27,3,200,3,0.015,0.0008772
569445382,CCA_Chair,10,455,199,250,9,43,41.4403802548,40-49,588,4,10,11,21,21,10,11,10,4.0511986997,12545.424219756,0.0073168588,0.0333333333,0.18181819,0,135,1.981503756041026E-4,2.768201E-4,2.8401756E-4,267,0.18131869,15,0,200,0,0,0.0004995
400144770,thedrachms,10,31,6,13,1,0,14.1059510478,10-19,17,0,1,1,2,2,1,1,1,1,0,3.103424351647038E-4,0,0.5,0,0,7.917821274201192E-5,5.0330927E-5,5.1639556E-5,257,0.5,0,0,33,0,0,0
127551326,packermanno,10,13,5,109,0,0,16.2021988767,10-19,25,1,0,0,0,0,0,0,0,0,0,0,0,0,1,1,4.4780486537007367E-5,0,0,0,0,0,0,15,0,0,0
856928725,CpcBallycastle,10,49,187,13,0,0,41.3331300318,40-49,518,2,11,0,11,11,11,0,0,0,0,0.0038377868,0.2454545455,0.36363637,2,2,3.861754640442089E-4,3.0198556E-4,0,95,0.36363637,45,0,69,0,0,0
887461274,ArthurPPrice,10,19,2,18,0,0,16.0632857838,10-19,2,1,0,0,0,0,0,0,0,0,0,0,0,0,3,3,4.4780486537007367E-5,0,0,1,0,0,0,19,0,0,0
1272977286,BoonevilleCPC,10,3,2,12,0,0,11.0632857838,10-19,6,1,1,1,2,2,1,1,1,1,0,2.6808524730492474E-4,0,0,4,136,2.9852402567743944E-4,5.0330927E-5,5.1639556E-5,104,0,0,0,30,0,0,0
937513957,adamdasilva3,10,4,0,2,0,0,10,10-19,0,0,0,0,0,0,0,0,0,0,0,0,0,0,5,138,4.4780486537007367E-5,0,0,2,0,1,0,5,0,0,0
1249794612,NDPInduNPD,10,6,12,5,0,0,22.7196314499,20-29,86,1,1,0,1,1,1,0,0,0,0,0.005274272,0,0.56666666,0,5,1.0747430690300085E-4,5.0330927E-5,0,267,0.56666666,1,1,9,1,0.1111111111,0
818131350,ROVCCalgary,10,48,16,11,0,0,19.4457468082,10-19,168,1,1,1,2,2,1,1,14,7.0726755989,0,2.6808524730492474E-4,0,0,0,139,7.569917912644684E-5,5.0330927E-5,5.1639556E-5,353,0,7,0,52,0,0,0
1072032300,ikwew_III,10,18355,828,1259,9,12721,55.4912653621,50-59,755,8,0,0,0,0,0,0,0,0,0,0,0,0,6,140,4.4780486537007367E-5,0,0,3,0,87,0,7,0,0,0
900693096,Airstream001,10,12,5,20,0,1,11.7341444214,10-19,85,1,0,0,0,0,0,0,0,0,0,0,0,0.5,7,141,4.4780486537007367E-5,0,0,4,0.5,1,0,15,0,0,0
18834072,HinkleGroup,10,12,19,32,0,0,17.5864448717,10-19,139,1,0,0,0,0,0,0,0,0,0,0,0,0,8,142,4.4780486537007367E-5,0,0,5,0,0,0,30,0,0,0
1072851218,codprocommunity,10,0,1,0,0,0,10,10-19,2,0,0,0,0,0,0,0,0,0,0,0,0,0,9,143,4.4780486537007367E-5,0,0,6,0,0,0,4,0,0,0
619105419,CindyTurner12,10,15,5,19,0,0,16.6202243016,10-19,6,1,0,0,0,0,0,0,0,0,0,0,0,0,10,144,4.4780486537007367E-5,0,0,7,0,0,0,19,0,0,0
998331242,abuaysha007,10,13,9,52,0,2,13.2677859755,10-19,59,1,0,0,0,0,0,0,0,0,0,0,0,1,11,145,4.4780486537007367E-5,0,0,8,1,1,0,13,0,0,0
611297227,GamerDad42,10,8,42,23,1,4,26.8763341249,20-29,594,5,2,2,4,4,2,2,11,4.0008126778,6.8400281556,0.0028182657,0.1666666667,0.5,0,135,5.02064244352889E-5,7.549639E-5,7.7459335E-5,257,0.5,0,0,21,0,0,0
307963985,RayMartin2,10,1,4,0,0,0,,,4,0,0,0,0,0,0,0,0,0,0,0,0,0,12,146,4.4780486537007367E-5,0,0,9,0,0,0,2,0,0,0
729134036,christendfsanto,10,104,28,492,0,0,16.9852522565,10-19,29,2,0,0,0,0,0,0,0,0,0,0,0,0,13,147,4.4780486537007367E-5,0,0,10,0,0,0,1,0,0,0
494327659,wheinzie,10,10,6,13,0,2,12.6327888949,10-19,67,2,2,0,2,2,2,0,0,0,0,0.0066153653,0.5,0.5,0,6,5.142456581429312E-5,7.549639E-5,0,99,0.5,0,0,15,0,0,0
743129088,FrankDrouin1,10,3,4,46,0,0,12.5850434429,10-19,4,0,0,0,0,0,0,0,0,0,0,0,0,1,14,148,4.4780486537007367E-5,0,0,11,1,0,0,3,0,0,0
1264764085,Loopfanaatnl,10,4,2,11,0,0,11.0632857838,10-19,27,0,0,0,0,0,0,0,0,0,0,0,0,0,15,149,4.4780486537007367E-5,0,0,12,0,0,0,7,0,0,0
501954782,Laforest35,10,7,65,35,1,2,30.9981594967,30-39,450,1,5,4,9,9,5,4,12,5.1223080049,0.1666666667,0.0028158637,0.125,0.85,0,135,2.3213598175901622E-4,1.5099278E-4,1.5491867E-4,37,0.85,2,0,9,0,0,0
857278716,SkepticCritic,10,20,2,7,0,0,12.3543574036,10-19,12,1,0,0,0,0,0,0,0,0,0,0,0,1,16,150,4.4780486537007367E-5,0,0,13,1,0,0,26,0,0,0
1190178762,futurecpleaders,10,8,26,225,0,0,16.5723021556,10-19,79,2,1,0,1,1,1,0,0,0,0,0.0029392723,0,0.6944444,0,11,4.8201210683774905E-5,5.0330927E-5,0,353,0.6944444,0,6,29,6,0.2068965517,0
290294378,DamnLapin,10,2,21,109,0,0,12.9916482201,10-19,21,1,0,0,0,0,0,0,0,0,0,0,0,0,17,151,4.947954594634506E-5,0,0,14,0,0,0,2,0,0,0
1079162658,DriverTraining7,10,22,58,247,0,0,17.2831686011,10-19,197,1,1,0,1,1,1,0,0,0,0,2.4460721920661915E-4,0,0,18,152,8.284390166388585E-5,5.0330927E-5,0,136,0,2,0,24,0,0,0
1020248611,MGreywolfV,10,9,3,10,0,0,11.3417172752,10-19,23,0,0,1,1,1,0,1,12,5.6214459789,0,0,0,0.5,0,153,4.4780486537007367E-5,0,2.5819778E-5,353,0.5,0,0,10,0,0,0
14678965,frederikkau,10,11,5,10,0,3,11.5576855183,10-19,14,1,0,0,0,0,0,0,0,0,0,0,0,0,19,154,4.4780486537007367E-5,0,0,15,0,0,0,13,0,0,0
59767832,kgallag1,10,7,6,48,0,1,16.5262378324,10-19,15,0,0,0,0,0,0,0,0,0,0,0,0,0,20,155,4.4780486537007367E-5,0,0,16,0,0,0,8,0,0,0
562628806,MrSharpe24,10,40,14,15,0,0,12.2285441559,10-19,124,0,0,0,0,0,0,0,0,0,0,0,0,0,21,156,4.4780486537007367E-5,0,0,17,0,0,0,40,0,0,0
9697172,stevebrister,10,21,36,34,0,1,,,46,0,0,0,0,0,0,0,0,0,0,0,0,0,22,157,4.4780486537007367E-5,0,0,18,0,0,0,22,0,0,0
824473112,MrMysteries_,10,4157,807,190,13,944,47.3489088048,40-49,728,7,10,6,16,16,10,6,9,3.6623323852,230.041751225,0.0330257686,0.1208333333,0.34848484,0,135,9.047569674973457E-5,2.768201E-4,2.8401756E-4,99,0.34848484,2,0,1,0,0,0
989666251,peterrgibbs,10,9,2,12,0,0,16.0632857838,10-19,37,1,0,0,0,0,0,0,0,0,0,0,0,0.6666667,23,159,4.553966086114525E-5,0,0,19,0.6666667,0,0,10,0,0,0
63674633,DelisNACKandRUN,10,46456,849,529,5,103,44.466867973,40-49,799,9,0,0,0,0,0,0,0,0,0,0,0,0,24,160,4.4780486537007367E-5,0,0,20,0,1,0,1,0,0,0
747000386,Star_temps,10,14,11,67,0,0,17.9273937892,10-19,29,1,0,0,0,0,0,0,0,0,0,0,0,0,25,161,4.4780486537007367E-5,0,0,21,0,0,0,23,0,0,0
985409348,TOrumlu,10,0,1,7,0,0,,,1,0,0,0,0,0,0,0,0,0,0,0,0,0,26,162,4.4780486537007367E-5,0,0,22,0,0,0,1,0,0,0
1268953286,barry8ronald,10,0,0,14,0,0,,,0,0,0,0,0,0,0,0,0,0,0,0,0,0,27,163,4.4780486537007367E-5,0,0,23,0,0,0,1,0,0,0
1255891004,nettietraas,10,1,3,21,0,0,11.3417172752,10-19,3,0,0,0,0,0,0,0,0,0,0,0,0,0,28,164,4.4780486537007367E-5,0,0,24,0,0,0,1,0,0,0
1251825284,femke_storm,10,5,3,9,0,0,11.3417172752,10-19,3,0,1,3,4,4,1,3,1,1,2,3.1619846010267586E-4,0.1666666667,0.5,29,165,2.550363331221934E-4,5.0330927E-5,5.1639556E-5,243,0.5,0,0,5,0,0,0
273283728,djvanbc,10,12,79,678,0,3,29.7246350936,20-29,462,5,0,0,0,0,0,0,0,0,0,0,0,1,30,166,5.179837177470212E-5,0,0,25,1,0,0,1,0,0,0
1298696424,3f127riejuzji91,10,0,0,0,0,2,10,10-19,0,0,0,0,0,0,0,0,0,0,0,0,0,0,31,167,4.4780486537007367E-5,0,0,26,0,0,0,1,0,0,0
1298749087,oleg_dm_8857434,10,1,0,0,0,1,10,10-19,0,0,0,0,0,0,0,0,0,0,0,0,0,0,32,168,4.4780486537007367E-5,0,0,27,0,0,0,1,0,0,0
1298733192,dasha_sa_471341,10,2,0,0,0,1,10,10-19,10,0,0,0,0,0,0,0,0,0,0,0,0,0,33,169,4.4780486537007367E-5,0,0,28,0,0,0,2,0,0,0
350305569,AScar27,10,496,210,96,0,204,31.0552469777,30-39,586,5,8,6,14,14,8,6,3,1.6153846154,3.3333333333,0.0036718707,0.1153846154,0.71428573,34,170,3.8511649765785315E-4,2.2648917E-4,2.32378E-4,113,0.71428573,17,0,180,0,0,0
302418309,VAC_CF_News,10,11436,19,5,0,0,15.2297162328,10-19,211,4,1,0,1,1,1,0,0,0,0,0.0023058186,0,0,0,65,4.610632938191189E-5,5.0330927E-5,0,71,0,0,0,267,0,0,0
241355995,Schmungle,10,42031,217,419,7,5,47.4223668968,40-49,684,5,0,0,0,0,0,0,0,0,0,0,0,0,35,171,4.4780486537007367E-5,0,0,29,0,2,0,202,0,0,0
143255693,ohmyhog,10,142,7,26,0,0,25.7709321099,20-29,283,3,1,1,2,2,1,1,11,4.7496952458,0,0.0179727621,0,0,0,135,1.2404656393735715E-4,5.0330927E-5,5.1639556E-5,99,0,1,0,191,0,0,0
319538480,WorkingChepe,10,1621,117,138,0,2,38.4106803891,30-39,682,6,0,0,0,0,0,0,0,0,0,0,0,0,36,173,4.4780486537007367E-5,0,0,30,0,1,0,200,0,0,0
245400098,HaydenRooney,10,2060,167,249,0,76,31.4120655207,30-39,668,6,0,0,0,0,0,0,0,0,0,0,0,0,37,174,4.4780486537007367E-5,0,0,31,0,0,0,200,0,0,0
1260599725,AnaisArmede,10,49,12,18,0,0,40.6773610568,40-49,582,4,2,2,4,4,2,2,8,3.9393939394,0,6.132773496799374E-4,0.0833333333,1,38,176,1.420195880440812E-4,7.549639E-5,7.7459335E-5,88,1,36,0,195,0,0,0
102119892,jamesaaronsnow,10,17122,388,510,14,0,45.9463637823,40-49,712,7,0,0,0,0,0,0,0,0,0,0,0,0,39,177,4.4780486537007367E-5,0,0,32,0,2,0,203,0,0,0
50882624,gqtrilogy,10,47349,839,647,11,91,34.3793591378,30-39,788,9,0,0,0,0,0,0,0,0,0,0,0,0,40,179,4.4780486537007367E-5,0,0,33,0,0,0,209,0,0,0
1191396000,Mxelle_Axelle,10,228,39,62,0,1,40.1766520351,40-49,555,4,2,4,6,6,2,4,7,3.0606060606,63.9,6.132773496799374E-4,0.0666666667,0.33333334,38,176,1.6690965191385452E-4,7.549639E-5,7.7459335E-5,88,0.33333334,19,0,199,0,0,0
22853441,katinedmonton,10,361,23,77,1,11,28.0260605451,20-29,476,4,0,0,0,0,0,0,0,0,0,0,0,0,41,180,4.4780486537007367E-5,0,0,34,0,2,0,199,0,0,0
29864721,oneritual,10,5590,158,161,1,458,35.0347619097,30-39,584,6,0,0,0,0,0,0,0,0,0,0,0,0,42,181,4.4780486537007367E-5,0,0,35,0,0,0,200,0,0,0
70184896,jessisninja,10,4171,136,292,0,115,32.8830788405,30-39,637,6,3,5,8,8,3,5,1,1,1,0.0010260215,0.1428571429,0.65,0,92,2.45417510099266E-4,1.00661855E-4,1.0327911E-4,408,0.65,26,0,200,0,0,0
490519631,PeterSymaniw,10,101,8,61,0,3,29.5294554173,20-29,413,5,0,1,1,1,0,1,2,1.5,0,0,0,0.5,0,182,4.4780486537007367E-5,0,2.5819778E-5,71,0.5,16,0,204,0,0,0
322356264,GeraGuerraa,10,12638,211,194,2,2,30.5238997304,30-39,725,6,1,1,2,2,1,1,1,1,0,2.6808524730492474E-4,0,0,43,183,2.9852402567743944E-4,5.0330927E-5,5.1639556E-5,53,0,1,0,199,0,0,0
71446721,meganclendining,10,1336,94,83,0,77,29.6391636501,20-29,547,4,3,4,7,7,3,4,2,1.2,0,0.0010260215,0.1428571429,0.8333333,0,92,2.3681532511563334E-4,1.00661855E-4,1.0327911E-4,408,0.8333333,13,0,200,0,0,0
1049348168,SqueakyCleanDV,10,343,19,49,2,5,19.8568075747,10-19,241,2,0,0,0,0,0,0,0,0,0,0,0,0,44,184,4.4780486537007367E-5,0,0,36,0,0,0,199,0,0,0
703965512,DinoRancho,10,221,11,12,0,0,25.4261326272,20-29,329,3,1,1,2,2,1,1,11,4.0406338887,0,0.0033408422,0,0,0,135,5.1208119790535E-5,5.0330927E-5,5.1639556E-5,257,0,5,2,200,2,0.01,0
175121830,laurablanke,10,2426,134,118,0,313,37.0552080119,30-39,632,5,3,4,7,7,3,4,2,1.2,0,0.0010260215,0.1428571429,0.8333333,0,92,2.3681532511563334E-4,1.00661855E-4,1.0327911E-4,408,0.8333333,0,0,198,0,0,0
17300745,ckayaker,10,570,52,78,2,2,36.1699161416,30-39,489,5,1,0,1,1,1,0,0,0,0,0.0013482027,0,0.4551282,0,59,6.439874905593154E-5,5.0330927E-5,0,99,0.4551282,8,2,200,2,0.01,0
369757190,ErbiFullyLoaded,10,2639,316,439,1,1070,42.220006805,40-49,663,6,8,8,16,16,8,8,12,5.1198699716,8.4166666667,0.0041434527,0.0875,0.6785714,0,135,3.9347848772024863E-4,2.2648917E-4,2.32378E-4,37,0.6785714,24,0,200,0,0,0
1098099410,Devin_Campbell7,10,90,120,119,1,36,30.0112870311,30-39,461,3,7,9,16,16,7,9,11,4.1251523771,16961.7305463044,0.00992143,0.1,0.6111111,0,135,3.0505215348968965E-4,2.0132371E-4,2.0655822E-4,37,0.6111111,19,0,113,0,0,0
948163202,genbydayr,10,135,49,22,0,0,24.8403702993,20-29,213,3,0,0,0,0,0,0,0,0,0,0,0,0,45,185,4.4780486537007367E-5,0,0,38,0,0,0,200,0,0,0
200037786,ygwebdesign,10,23298,9628,10590,95,2,46.1231972823,40-49,716,6,4,3,7,7,4,3,8,4.7972368956,20416.0617355138,0.0033187055,0,0,0,135,1.3101984556750944E-4,1.2582731E-4,1.2909889E-4,148,0,0,0,251,0,0,0
861645158,drovenny,10,15597,203,3,0,0,22.5717333372,20-29,266,3,1,0,1,1,1,0,0,0,0,2.6808524730492474E-4,0,0,46,186,5.9686805425790906E-5,5.0330927E-5,0,116,0,4,0,572,0,0,0
606653450,Infospress,10,14171,4,10,0,0,11.5576855183,10-19,352,4,1,2,3,3,1,2,2,1.5,0,2.6808524730492474E-4,0.1666666667,0.5,46,189,5.9686805425790906E-5,5.0330927E-5,5.1639556E-5,116,0.5,0,0,293,0,0,0
227464980,NEweatherHQ,10,26854,1722,946,97,278,49.376774529,40-49,766,8,4,0,4,4,4,0,0,0,0,9.784288768264766E-4,0,0,47,190,1.9703414704452132E-4,1.2582731E-4,0,39,0,30,0,200,0,0,0
403007460,ZDuhaimeDMJ,10,7779,447,258,2,481,47.2333524769,40-49,698,7,0,1,1,1,0,1,1,1,0,0,0,0,47,191,4.4780486537007367E-5,0,2.5819778E-5,39,0,2,0,201,0,0,0
348195475,stormchaserjs,10,31420,142,57,5,53,36.7841298647,30-39,643,7,0,1,1,1,0,1,1,1,0,0,0,0,47,192,4.4780486537007367E-5,0,2.5819778E-5,39,0,2,0,201,0,0,0
731817787,stormtrackersb,10,3910,27,212,0,281,27.9711744292,20-29,530,6,0,1,1,1,0,1,1,1,0,0,0,0,47,193,4.4780486537007367E-5,0,2.5819778E-5,39,0,0,0,201,0,0,0
64946383,BenjaminMangold,10,215,68,74,0,0,50.0241420153,50-59,532,4,0,0,0,0,0,0,0,0,0,0,0,0,48,194,4.4780486537007367E-5,0,0,40,0,1,0,200,0,0,0
228232989,ianwrighting,10,8885,112,131,9,0,30.0283773553,30-39,616,7,1,1,2,2,1,1,10,4.2377082487,0,7.819730931111888E-4,0,0.6666667,0,135,5.373821004258761E-5,5.0330927E-5,5.1639556E-5,257,0.6666667,0,0,200,0,0,0
367960701,kellysummers96,10,569,363,197,1,96,43.3173289299,40-49,656,4,9,7,16,16,9,7,12,5.1202763104,5.7833333333,0.0045209304,0.1125,0.6666667,0,135,4.131342710978313E-4,2.5165462E-4,2.5819778E-4,37,0.6666667,29,0,199,0,0,0
245477839,trandell88,10,3620,205,180,2,1,40.4434562992,40-49,676,7,5,7,12,12,5,7,12,5.1206826493,27.3639750448,0.0025907279,0.1287878788,0.5535714,0,135,2.307106946330971E-4,1.5099278E-4,1.5491867E-4,37,0.5535714,46,0,200,0,0,0
1214680596,PLHSFlanny,10,126,75,82,0,67,57.4347593739,50-59,473,3,1,1,2,2,1,1,1,1,0,2.6808524730492474E-4,0,0,49,195,2.9852402567743944E-4,5.0330927E-5,5.1639556E-5,278,0,2,0,179,0,0,0
594525433,Maestria_OMG,10,462,179,205,1,20,40.1595673077,40-49,550,4,0,0,0,0,0,0,0,0,0,0,0,0,50,196,4.4780486537007367E-5,0,0,41,0,45,0,200,0,0,0
137508424,DeesNutz83,10,2757,277,188,0,1154,42.0902668789,40-49,686,6,0,0,0,0,0,0,0,0,0,0,0,0,51,197,4.4780486537007367E-5,0,0,42,0,8,0,200,0,0,0
363490877,dugdangerfly,10,124,3,27,0,47,16.3417172752,10-19,23,2,0,1,1,1,0,1,1,1,0,0,0,0,47,198,4.4780486537007367E-5,0,2.5819778E-5,39,0,0,0,144,0,0,0
224922810,successfor2011,10,161,19,56,0,1,17.1610429148,10-19,327,3,0,0,0,0,0,0,0,0,0,0,0,0,52,199,4.4780486537007367E-5,0,0,43,0,1,0,162,0,0,0
468732172,VanStreetDog,10,868,44,161,0,1,13.7467203342,10-19,349,5,0,0,0,0,0,0,0,0,0,0,0,0,53,200,4.4780486537007367E-5,0,0,44,0,0,0,199,0,0,0
79746968,GroovyGrapesTWT,10,1018,726,339,46,1,43.698892173,40-49,602,5,2,2,4,4,2,2,10,3.8951645672,321.6096852177,0.0067483761,0,0,0,135,5.337915539511025E-5,7.549639E-5,7.7459335E-5,267,0,10,0,200,0,0,0
1250157301,quebec_rt,10,3868,56,0,0,0,38.6576306853,30-39,503,8,1,0,1,1,1,0,0,0,0,0.0046989067,0,0,0,129,4.724175670871345E-5,5.0330927E-5,0,267,0,0,1,202,1,0.004950495,0
195978878,Lucianaazevedo7,10,851,112,284,1,0,25.9090785793,20-29,451,4,0,0,0,0,0,0,0,0,0,0,0,0,54,201,4.4780486537007367E-5,0,0,45,0,0,0,201,0,0,0
953027875,law_knowledge,10,11045,932,1035,6,0,43.7437033864,40-49,579,9,1,1,2,2,1,1,9,4.6221048354,0,8.096601273418801E-4,0,0,0,135,7.54503506542261E-5,5.0330927E-5,5.1639556E-5,148,0,0,0,201,0,0,0
820890391,ChavoDeIOcho,10,128062,2250,479,10,756,24.2877227485,20-29,760,11,1,0,1,1,1,0,0,0,0,3.23895479080217E-4,0,0,0,30,5.8924708258098824E-5,5.0330927E-5,0,148,0,0,0,201,0,0,0
56164159,RandallSHolmes,10,18813,1208,1988,58,21,49.0108132758,40-49,749,8,8,7,15,15,8,7,11,4.1409995937,1161.7473886147,0.0087201498,0.0523809524,0.21111111,0,135,1.6029963991981823E-4,2.2648917E-4,2.32378E-4,303,0.21111111,1,0,201,0,0,0
596734648,PDAAZ,10,3531,250,508,8,0,38.0929691542,30-39,653,6,6,4,10,10,6,4,11,4.3372612759,176.2583887703,0.0059093496,0.0555555556,0.26666668,0,135,1.6193320913786833E-4,1.7615824E-4,1.8073844E-4,303,0.26666668,20,0,201,0,0,0
399714083,GLV213,10,2522,31,38,0,5,40.4752935455,40-49,656,6,2,2,4,4,2,2,7,3.8484848485,65,6.002681193657241E-4,0,0,38,176,2.3749429115861408E-4,7.549639E-5,7.7459335E-5,88,0,43,0,203,0,0,0
24697131,krakout,10,1142,112,104,2,6,36.4642755472,30-39,578,5,2,1,3,3,2,1,1,1,2,5.361704946098499E-4,0,0,55,203,5.522675648178714E-4,7.549639E-5,7.7459335E-5,91,0,4,0,199,0,0,0
14360480,manuelsagra,10,9424,922,35,70,105,50.7600089978,50-59,730,6,1,1,2,2,1,1,2,1.5,2,2.4460721920661915E-4,0,0,55,204,8.284390166388585E-5,5.0330927E-5,2.5819778E-5,91,0,8,0,200,0,0,0
128514866,erubio0,10,5172,201,90,18,3,45.4088400805,40-49,713,7,0,1,1,1,0,1,3,2,0,0,0,0,55,205,4.4780486537007367E-5,0,2.5819778E-5,91,0,5,0,200,0,0,0
222178281,GeorgeOz4,10,4985,246,561,0,290,42.5522363191,40-49,727,6,6,7,13,13,6,7,1,1,0,0.0025357202,0.1346153846,0.85714287,56,207,1.6498109788469208E-4,1.7615824E-4,1.8073844E-4,48,0.85714287,38,0,202,0,0,0
431886597,jacob_chalkley,10,1384,156,145,0,22,41.9958749948,40-49,651,5,6,7,13,13,6,7,1,1,0,0.0025357202,0.1346153846,0.85714287,56,207,1.6498109788469208E-4,1.7615824E-4,1.8073844E-4,48,0.85714287,16,0,196,0,0,0
297944158,cpcholding,10,1338,996,1994,0,2,26.6014114939,20-29,545,4,0,0,0,0,0,0,0,0,0,0,0,0,57,208,4.4780486537007367E-5,0,0,46,0,4,0,200,0,0,0
262689657,DriverHireDton,10,128,78,300,0,1,38.9790983396,30-39,449,3,1,1,2,2,1,1,1,1,0,2.6808524730492474E-4,0,0,58,209,2.9852402567743944E-4,5.0330927E-5,5.1639556E-5,47,0,12,0,200,0,0,0
559888611,Bendods1,10,673,121,125,0,99,37.1605694631,30-39,614,4,6,7,13,13,6,7,1,1,0,0.0025357202,0.1346153846,0.85714287,56,207,1.6498109788469208E-4,1.7615824E-4,1.8073844E-4,48,0.85714287,17,0,200,0,0,0
50656896,amaurass,10,6295,424,521,4,1,48.5955811822,40-49,689,6,0,0,0,0,0,0,0,0,0,0,0,0,59,210,4.4780486537007367E-5,0,0,49,0,8,0,198,0,0,0
247571455,savagestate,10,4437,122,92,5,1748,44.7915752116,40-49,659,7,3,3,6,6,3,3,11,4.075172694,0,0.0048699114,0.1,1,0,135,6.913275583692257E-5,1.00661855E-4,1.0327911E-4,303,1,2,0,199,0,0,0
259226302,webgra,10,1148,173,124,1,0,34.6167078325,30-39,461,3,1,0,1,1,1,0,0,0,0,2.4460721920661915E-4,0,0,60,211,8.284390166388585E-5,5.0330927E-5,0,50,0,1,0,200,0,0,0
139880319,RyanMason95,10,6843,183,140,0,780,42.3859576018,40-49,732,7,6,7,13,13,6,7,1,1,0,0.0025357202,0.1346153846,0.85714287,56,207,1.6498109788469208E-4,1.7615824E-4,1.8073844E-4,48,0.85714287,24,0,199,0,0,0
95268418,SocialDows,10,19789,357,416,0,503,44.633177411,40-49,772,8,6,7,13,13,6,7,1,1,0,0.0025357202,0.1346153846,0.85714287,56,207,1.6498109788469208E-4,1.7615824E-4,1.8073844E-4,48,0.85714287,163,0,209,0,0,0
609037714,tnbertelsen,10,547,143,309,3,1,30.8325514022,30-39,433,4,0,1,1,1,0,1,2,1.5,0,0,0,0,0,212,4.4780486537007367E-5,0,2.5819778E-5,94,0,0,0,201,0,0,0
526913370,AMoses4,10,1280,31,30,0,0,41.4841198394,40-49,540,2,1,1,2,2,1,1,10,4.1275904104,0,0.0015705,0,0.43333334,0,135,6.137434445823673E-5,5.0330927E-5,5.1639556E-5,99,0.43333334,27,0,203,0,0,0
40448657,grahamgreer,10,1566,443,193,16,72,43.8528411111,40-49,657,5,1,3,4,4,1,3,10,4.4542868753,42.6367192232,7.867966172241881E-4,0,0,0,135,4.921887343688777E-5,5.0330927E-5,5.1639556E-5,148,0,0,0,200,0,0,0
279237257,wakeupjohnston,10,1549,44,83,0,14,38.0126228516,30-39,548,5,1,0,1,1,1,0,0,0,0,0.0094873869,0,0.35,0,124,5.62794426030705E-5,5.0330927E-5,0,99,0.35,6,0,200,0,0,0
251564109,JimvanderDeijl,10,1262,573,64,9,2,45.2600623828,40-49,679,5,1,1,2,2,1,1,2,1.5,0,2.9162299782298695E-4,0,0,61,213,2.29874507414389E-4,5.0330927E-5,5.1639556E-5,51,0,8,0,200,0,0,0
41156065,hoenscheid,10,1275,355,244,22,10,39.8768348135,30-39,550,5,0,1,1,1,0,1,1,1,0,0,0,0,60,214,4.4780486537007367E-5,0,2.5819778E-5,50,0,0,0,200,0,0,0
130571649,IvanVizcaino,10,5637,287,335,7,2321,44.972028134,40-49,724,7,6,7,13,13,6,7,1,1,22.5,0.0018817589,0.0448717949,0.30952382,62,216,5.455534883039043E-4,1.7615824E-4,1.8073844E-4,101,0.30952382,110,0,202,0,0,0
336221845,VanEastMan,10,93,11,43,0,0,14.6018026945,10-19,111,3,1,2,3,3,1,2,11,3.9731816335,0,4.3832536936642974E-4,0.1666666667,1,0,135,5.0037485202879985E-5,5.0330927E-5,5.1639556E-5,257,1,0,0,105,0,0,0
16025963,jah08,10,65921,1427,1301,76,259,43.5875199746,40-49,770,9,6,5,11,11,6,5,10,4.1312474604,1867.974861159,0.0079210792,0.0454545455,0.33333334,0,135,1.0944947610565627E-4,1.7615824E-4,1.8073844E-4,303,0.33333334,0,0,202,0,0,0
48350044,MennoTamming,10,8298,1314,699,29,1,46.0158973922,40-49,724,7,2,2,4,4,2,2,1,1,2,5.382408138703652E-4,0,0,61,213,4.3582306220354E-4,7.549639E-5,7.7459335E-5,51,0,21,0,200,0,0,0
426905638,lexyyluv,10,7805,487,709,2,1816,36.4951125221,30-39,714,6,3,3,6,6,3,3,1,1,2,9.092611511070317E-4,0.1,0.6666667,63,217,4.3033909587467686E-4,1.00661855E-4,1.0327911E-4,58,0.6666667,23,0,201,0,0,0
622198555,MRBeavis,10,843,43,185,0,11,20.0250087065,20-29,486,4,0,0,0,0,0,0,0,0,0,0,0,0.5882353,64,218,5.4548463274752463E-5,0,0,52,0.5882353,0,0,200,0,0,0
87152213,MediaclickSMM,10,2163,1875,953,179,1,51.8221918814,50-59,692,5,4,2,6,6,4,2,9,5.7338480293,132.6242595464,0.0013107434,0,0,0,135,2.2844050929918215E-4,1.2582731E-4,1.0327911E-4,148,0,8,0,200,0,0,0
201747020,ArjanSmilde,10,3031,230,280,4,2,41.0101550639,40-49,664,6,1,1,2,2,1,1,2,1.5,0,2.9162299782298695E-4,0,0,61,213,2.29874507414389E-4,5.0330927E-5,5.1639556E-5,51,0,7,0,200,0,0,0
312568240,Fundacion_ERLAC,10,715,440,536,6,94,40.6762392357,40-49,612,4,5,4,9,9,5,4,3,1.5714285714,4.5,0.0017053025,0.0833333333,0.55,62,216,4.4514408342411486E-4,1.5099278E-4,1.5491867E-4,101,0.55,60,0,200,0,0,0
347321914,oscarcamilo3,10,98,22,114,0,0,18.2720158964,10-19,395,3,1,1,2,2,1,1,1,1,0,2.6808524730492474E-4,0,0,43,183,2.9852402567743944E-4,5.0330927E-5,5.1639556E-5,53,0,0,0,111,0,0,0
1239757610,CanConstitution,10,10,11,1,0,0,24.8040094374,20-29,293,0,1,0,1,1,1,0,0,0,0,4.2762467474007803E-4,0,0.5,0,15,1.6662230202262653E-4,5.0330927E-5,0,99,0.5,5,0,51,0,0,0
25869252,SunnyDeeLighted,10,10084,513,460,0,96,43.7469217191,40-49,744,7,1,1,2,2,1,1,1,1,0,2.6808524730492474E-4,0,0,65,219,2.9852402567743944E-4,5.0330927E-5,5.1639556E-5,222,0,37,0,196,0,0,0
414199653,j_leckii,10,7042,248,554,0,597,42.7534460536,40-49,702,6,0,0,0,0,0,0,0,0,0,0,0,0,66,220,4.4780486537007367E-5,0,0,54,0,6,0,201,0,0,0
368839993,Driver_Skills,10,848,307,434,5,5,24.7263730731,20-29,581,5,0,0,0,0,0,0,0,0,0,0,0,0,67,221,4.4780486537007367E-5,0,0,55,0,0,0,198,0,0,0
131589912,alnbrookes,10,9425,2007,243,87,8,54.0296886548,50-59,741,7,1,0,1,1,1,0,0,0,0,0.0052675125,0,0.5,0,49,4.983106171350255E-5,5.0330927E-5,0,257,0.5,15,0,200,0,0,0
6034422,Winooski,10,11106,811,406,54,2303,53.6319384951,50-59,742,8,0,0,0,0,0,0,0,0,0,0,0,0,68,222,4.4780486537007367E-5,0,0,56,0,16,0,201,0,0,0
85118235,qubit_i,10,367,11,13,1,1,19.5123110538,10-19,289,3,0,0,0,0,0,0,0,0,0,0,0,1,69,223,4.4780486537007367E-5,0,0,57,1,1,0,200,0,0,0
404385781,Larry_Smithh,10,5848,335,371,1,1207,35.7726814074,30-39,729,7,8,6,14,14,8,6,12,5.1206826493,4911.8666666667,0.0040423459,0.1043956044,0.625,0,135,4.1535431548845084E-4,2.2648917E-4,2.32378E-4,37,0.625,60,0,202,0,0,0
707512603,Smoker420Kush,10,241,116,324,1,12,34.5991087877,30-39,424,4,1,2,3,3,1,2,10,3.7736692401,0,0.0078290605,0.1666666667,1,0,135,4.8517769716958163E-5,5.0330927E-5,5.1639556E-5,99,1,3,0,196,0,0,0
820865316,mIzEsTeLlA,10,4331,769,1614,0,28,43.5893719907,40-49,606,6,1,1,2,2,1,1,12,5.5960991467,0,4.8351167221443424E-4,0,0,0,135,1.0883891314946082E-4,5.0330927E-5,5.1639556E-5,99,0,2,0,201,0,0,0
342867480,t_stewart9,10,627,207,112,1,105,41.1580134668,40-49,531,4,7,7,14,14,7,7,12,5.1202763104,4912.9166666667,0.0036637557,0.1043956044,0.625,0,135,3.89078650851176E-4,2.0132371E-4,2.0655822E-4,37,0.625,37,0,200,0,0,0
537867910,Getchell_a,10,2584,336,378,1,656,32.8376912449,30-39,656,6,2,3,5,5,2,3,1,1,0,6.143761184276883E-4,0.15,0.8333333,63,217,2.3261649057882062E-4,7.549639E-5,7.7459335E-5,58,0.8333333,53,0,198,0,0,0
254749458,ezpe98_,10,7885,58,160,0,1,30.4733237673,30-39,659,6,0,1,1,1,0,1,11,5.0779853777,0,0,0,0.6666667,0,224,4.939757183859327E-5,0,2.5819778E-5,106,0.6666667,3,4,201,4,0.0199004975,0
772708915,Dan_Man_10,10,723,169,129,0,815,41.5980042996,40-49,643,5,7,6,13,13,7,6,3,1.6923076923,6.373015873,0.0032166567,0.0961538462,0.6666667,34,170,3.5380400967090334E-4,2.0132371E-4,2.0655822E-4,113,0.6666667,44,0,198,0,0,0
385760695,RyanMerrill07,10,3148,364,283,0,758,46.8130414052,40-49,686,6,3,3,6,6,3,3,3,1.8461538462,1.0888888889,0.0014247782,0.0666666667,0.5,34,170,1.7426130928695005E-4,1.00661855E-4,1.0327911E-4,113,0.5,13,0,199,0,0,0
350961252,hannycarson,10,8640,420,304,0,2011,45.6266316211,40-49,732,6,8,9,17,17,8,9,2,1.3076923077,16.9841269841,0.0036387973,0.0882352941,0.5972222,34,170,4.574228057190301E-4,2.2648917E-4,2.32378E-4,113,0.5972222,40,0,200,0,0,0
86203783,happydaze11,10,9946,1074,168,4,1488,53.9061370752,50-59,751,7,5,2,7,7,5,2,3,2,1.2166666667,0.002219319,0.1428571429,0.55,34,170,2.486126067467458E-4,1.5099278E-4,1.5491867E-4,113,0.55,17,0,201,0,0,0
278789553,JeffreyBenton,10,9374,337,188,1,4626,46.6853738585,40-49,744,7,8,8,16,16,8,8,2,1.3846153846,18.5579365079,0.0035158174,0.0625,0.48214287,34,170,4.5131538111607174E-4,2.2648917E-4,2.32378E-4,113,0.48214287,26,0,200,0,0,0
302873036,Jose_Quilon,10,731,145,286,1,7,41.6623326352,40-49,465,5,0,2,2,2,0,2,10,5.7632006499,0,0,0,0,0,225,4.4780486537007367E-5,0,2.5819778E-5,148,0,0,0,200,0,0,0
376889920,fuckbrogan,10,8891,495,217,0,2046,46.8422660147,40-49,761,7,3,4,7,7,3,4,3,1.8461538462,2.0333333333,0.0012652864,0.0952380952,0.5833333,34,170,1.7205787389522467E-4,1.00661855E-4,1.0327911E-4,113,0.5833333,17,0,201,0,0,0
618286828,CritikMystique,10,92,9,52,0,3,25.226104314,20-29,283,4,0,0,0,0,0,0,0,0,0,0,0,0,70,226,4.4780486537007367E-5,0,0,59,0,0,0,184,0,0,0
444788886,joeyspeigel,10,2992,365,254,0,631,33.8180451008,30-39,684,6,8,8,16,16,8,8,2,1.3846153846,13.9055555556,0.0036426884,0.0791666667,0.625,34,170,4.098447164967848E-4,2.2648917E-4,2.32378E-4,113,0.625,0,0,198,0,0,0
758049516,PPT_Search,10,205340,5,0,0,0,14.3847822671,10-19,115,4,0,0,0,0,0,0,0,0,0,0,0,0,71,227,4.4780486537007367E-5,0,0,60,0,0,1,201,1,0.0049751244,0
208706267,jairogalvan,10,1539,83,97,1,289,35.1135900474,30-39,628,5,1,1,2,2,1,1,4,2.4,0,3.1845395219724196E-4,0,0,72,228,1.652932312661057E-4,5.0330927E-5,5.1639556E-5,62,0,8,0,198,0,0,0
313465906,LaPryce,10,66,18,49,0,40,18.1766056551,10-19,438,3,0,0,0,0,0,0,0,0,0,0,0,0,73,229,4.4780486537007367E-5,0,0,61,0,8,0,68,0,0,0
239478762,barrick36,10,2752,644,188,13,527,47.9230114912,40-49,702,6,4,3,7,7,4,3,12,5.1227143438,557.5533394687,0.0020489407,0.0714285714,0.5,0,135,1.5339927233024548E-4,1.2582731E-4,1.2909889E-4,37,0.5,19,0,200,0,0,0
716197484,G_Baby67,10,2974,287,251,0,1991,43.3252881373,40-49,687,6,2,2,4,4,2,2,3,2,0,8.094656675608639E-4,0.0833333333,1,34,170,1.1274967873956999E-4,7.549639E-5,7.7459335E-5,113,1,8,0,189,0,0,0
113690283,LaBergman_,10,53920,1621,703,45,5528,46.1376015781,40-49,810,9,3,3,6,6,3,3,2,1.4,12,9.081616559672022E-4,0.0333333333,0.33333334,72,228,4.205976348642071E-4,1.00661855E-4,1.0327911E-4,62,0.33333334,32,0,201,0,0,0
945691729,TruthVanguard87,10,861,71,153,0,44,40.1086821897,40-49,558,5,1,1,2,2,1,1,10,4.5388053637,0,0.001002435,0,0,0,135,5.61740161837842E-5,5.0330927E-5,5.1639556E-5,99,0,0,0,201,0,0,0
53400950,IguanoSinuano,10,6002,286,61,7,15,36.1238513463,30-39,733,7,3,3,6,6,3,3,3,1.6,8,8.856291615048906E-4,0.0333333333,0.33333334,72,228,4.253425714390234E-4,1.00661855E-4,1.0327911E-4,62,0.33333334,5,0,198,0,0,0
36175685,JJVergaraD,10,30949,1465,677,33,114,52.5673663208,50-59,785,8,2,2,4,4,2,2,3,1.8,0,6.3791383589164E-4,0.0833333333,1,72,228,2.8446170349844565E-4,7.549639E-5,7.7459335E-5,62,1,5,0,201,0,0,0
348863339,H_Jutz,10,1549,255,185,0,111,37.5085043437,30-39,658,5,6,6,12,12,6,6,3,1.6923076923,3.953968254,0.0027707779,0.1060606061,0.64285713,34,170,3.156049060756155E-4,1.7615824E-4,1.8073844E-4,113,0.64285713,16,0,197,0,0,0
412997002,DallasGarth,10,568,89,343,1,176,24.6661304622,20-29,457,4,0,0,0,0,0,0,0,0,0,0,0,0,74,231,4.4780486537007367E-5,0,0,63,0,0,0,200,0,0,0
79187514,hrhsar,10,113819,1398,1663,93,29530,45.9668798452,40-49,780,9,2,1,3,3,2,1,11,4.3795205201,43.1577051883,0.0047874045,0.1666666667,0.33333334,0,135,4.876509097327154E-5,7.549639E-5,7.7459335E-5,303,0.33333334,3,0,201,0,0,0
166398809,Clarkie1977,10,1334,186,233,5,0,40.003983711,40-49,623,6,4,6,10,10,4,6,12,5.1214953271,17.4878225524,0.0020352448,0.1111111111,0.6333333,0,135,1.966218888355149E-4,1.2582731E-4,1.2909889E-4,37,0.6333333,35,0,199,0,0,0
381069997,_STiiNooO,10,3730,100,55,0,6,43.3899192538,40-49,669,6,2,2,4,4,2,2,1,1,0,5.875113113304263E-4,0.0833333333,1,75,232,2.985240256774393E-4,7.549639E-5,7.7459335E-5,87,1,6,0,201,0,0,0
545311971,HeyIamDavey,10,5486,344,292,0,2,47.5451611978,40-49,713,6,2,2,4,4,2,2,1,1,0,5.875113113304263E-4,0.0833333333,1,75,232,2.985240256774393E-4,7.549639E-5,7.7459335E-5,87,1,28,0,201,0,0,0
900604650,Cajun_Fury,10,4136,1144,1121,14,17,51.7970678068,50-59,717,6,7,7,14,14,7,7,11,3.7297846404,2067.9224450867,0.0491083214,0.0274725275,0.23809524,0,135,1.1479807191568629E-4,2.0132371E-4,2.0655822E-4,353,0.23809524,5,0,201,0,0,0
282252740,Electoral_BS,10,59,4,77,0,0,18.0031050061,10-19,226,2,0,1,1,1,0,1,11,4.5349309504,0,0,0,0.625,0,233,4.4780486537007367E-5,0,2.5819778E-5,257,0.625,6,1,72,1,0.0138888889,0
547888856,cupplacoppers,10,367,33,40,1,1,28.5290152044,20-29,519,4,1,0,1,1,1,0,0,0,0,3.1747799811478715E-4,0,0,0,119,5.378108641614841E-5,5.0330927E-5,0,505,0,4,1,200,1,0.005,0
281582497,C_paws,10,446,22,65,0,24,20.1282449678,20-29,433,4,0,1,1,1,0,1,1,1,0,0,0,0.45614034,76,235,5.379950976293402E-5,0,2.5819778E-5,64,0.45614034,4,1,199,1,0.0050251256,0
196737461,CatBar63,10,516,29,71,0,40,28.93304913,20-29,478,5,1,1,2,2,1,1,12,5.1235270215,0,7.557201596899865E-4,0,0,0,135,8.333600227631969E-5,5.0330927E-5,5.1639556E-5,37,0,8,0,200,0,0,0
398028301,Joncalon,10,1309,46,94,0,33,31.7972030723,30-39,623,6,1,1,2,2,1,1,11,4.2068264933,0,0.0013653589,0,0,0,135,4.8369062644149766E-5,5.0330927E-5,5.1639556E-5,99,0,3,0,200,0,0,0
501192516,6Bronwyn,10,653,89,78,0,25,26.3179300509,20-29,544,4,0,0,0,0,0,0,0,0,0,0,0,0,77,236,4.4780486537007367E-5,0,0,65,0,9,0,199,0,0,0
338465827,USRadioNews,10,275103,476,54,6,1,45.1529103005,40-49,782,10,0,0,0,0,0,0,0,0,0,0,0,0,78,237,4.4780486537007367E-5,0,0,66,0,1,0,205,0,0,0
387707281,dlewis189,10,4114,98,123,3,168,44.3041847859,40-49,574,7,2,2,4,4,2,2,11,4.2909386428,0,0.0025453661,0.0833333333,1,0,135,7.022491510904732E-5,7.549639E-5,7.7459335E-5,303,1,2,0,201,0,0,0
1090036602,ProLifeGuy,10,353,519,536,7,0,43.8638623954,40-49,523,4,2,2,4,4,2,2,11,4.2677773263,0,0.0065210781,0.0833333333,1,0,135,6.387814258470701E-5,7.549639E-5,7.7459335E-5,353,1,14,0,200,0,0,0
47501529,hunterccarter,10,2564,332,815,4,2,44.0994325872,40-49,653,6,0,0,0,0,0,0,0,0,0,0,0,0,79,238,4.4780486537007367E-5,0,0,67,0,14,0,200,0,0,0
1250116735,ottawa_rt,10,6043,110,0,3,0,41.3578237281,40-49,532,9,2,0,2,2,2,0,0,0,0,0.0100278321,0.5,1,0,81,4.7393183933105995E-5,7.549639E-5,0,257,1,2,0,210,0,0,0
258463599,Hctraf,10,5676,183,153,0,304,44.6166079494,40-49,719,7,0,0,0,0,0,0,0,0,0,0,0,0,80,239,4.4780486537007367E-5,0,0,68,0,2,0,201,0,0,0
1140070970,DougTbay,10,58,11,40,0,8,29.3199278513,20-29,397,3,0,0,0,0,0,0,0,0,0,0,0,0.5,81,240,4.4780486537007367E-5,0,0,69,0.5,4,0,78,0,0,0
275529865,gordmcfee,10,13445,211,437,2,117,39.7518371087,30-39,686,8,1,1,2,2,1,1,10,4.0219422999,0,0.0047481281,0,0.5204301,0,135,1.1226516777940747E-4,5.0330927E-5,5.1639556E-5,257,0.5204301,14,0,201,0,0,0
465200547,RangaMorlin,10,25,48,65,0,0,24.9697946373,20-29,327,3,0,1,1,1,0,1,11,4.7770105605,0,0,0,0,0,241,4.4780486537007367E-5,0,2.5819778E-5,303,0,0,0,58,0,0,0
603227316,wallin_r,10,6077,255,486,3,1269,44.4102272208,40-49,718,7,2,2,4,4,2,2,11,4.1930109711,30.253954886,0.0094355869,0,0,0,135,7.954543926474572E-5,7.549639E-5,7.7459335E-5,353,0,16,0,201,0,0,0
30959934,feaxie,10,3214,127,55,1,2,37.8170668768,30-39,655,6,0,0,0,0,0,0,0,0,0,0,0,0,82,242,4.4780486537007367E-5,0,0,70,0,5,0,198,0,0,0
809099172,MittenBuster,10,36,15,207,0,6,15.1091396809,10-19,62,2,0,0,0,0,0,0,0,0,0,0,0,0.76,83,243,4.4780486537007367E-5,0,0,72,0.76,0,0,47,0,0,0
21421397,bruce_in,10,2063,106,108,4,4,40.2047678196,40-49,626,6,0,0,0,0,0,0,0,0,0,0,0,0,84,244,4.4780486537007367E-5,0,0,73,0,2,0,200,0,0,0
792044107,mcnoble_11,10,1952,84,68,0,10,36.7366190612,30-39,643,4,0,0,0,0,0,0,0,0,0,0,0,0,85,245,4.4780486537007367E-5,0,0,74,0,3,0,200,0,0,0
19246319,Redroadie,10,67,55,129,0,6,15.0371286187,10-19,342,2,0,0,0,0,0,0,0,0,0,0,0,0.8888889,86,246,4.4780486537007367E-5,0,0,75,0.8888889,0,0,69,0,0,0
18309340,topher_batty,10,1000,153,243,7,2,39.8285053134,30-39,526,5,1,0,1,1,1,0,0,0,0,0.0054477326,0,0.16666667,0,132,5.602811429769493E-5,5.0330927E-5,0,71,0.16666667,1,0,199,0,0,0
422937826,BobsInExile,10,1010,27,105,1,8,18.5257774064,10-19,375,5,0,0,0,0,0,0,0,0,0,0,0,0.42647058,87,247,5.627516904312703E-5,0,0,76,0.42647058,0,2,200,2,0.01,0
140129979,alinnyprado,10,4787,843,1047,27,4,31.696387206,30-39,717,6,0,0,0,0,0,0,0,0,0,0,0,0,88,248,4.4780486537007367E-5,0,0,77,0,1,0,200,0,0,0
887333558,Thewhizzzzzzzz,10,16,46,50,0,8,30.3634391638,30-39,491,3,0,0,0,0,0,0,0,0,0,0,0,0,89,249,4.4780486537007367E-5,0,0,78,0,1,0,104,0,0,0
230404096,pulistbook,10,477330,3560,0,105,0,49.4031909553,40-49,750,4,0,0,0,0,0,0,0,0,0,0,0,0,90,250,4.4780486537007367E-5,0,0,79,0,0,0,201,0,0,0
416699333,Lateralfade,10,429,6,42,0,106,16.3649968361,10-19,147,4,0,0,0,0,0,0,0,0,0,0,0,0.55,91,251,4.4780486537007367E-5,0,0,80,0.55,0,0,200,0,0,0
16028749,swoolf001,10,530,64,398,3,23,34.6309437455,30-39,519,4,0,0,0,0,0,0,0,0,0,0,0,0,92,252,4.4780486537007367E-5,0,0,81,0,2,0,200,0,0,0
129812924,camilorestrepoh,10,723,40,64,1,10,32.713761224,30-39,521,4,0,0,0,0,0,0,0,0,0,0,0,0,93,253,4.4780486537007367E-5,0,0,82,0,0,0,200,0,0,0
203600449,rpilgrimdesigns,10,740,164,420,2,195,33.8769612965,30-39,478,4,0,0,0,0,0,0,0,0,0,0,0,0,94,254,4.4780486537007367E-5,0,0,83,0,2,0,200,0,0,0
82907020,anandpkrishnan,10,7306,204,431,4,11,39.7584491294,30-39,595,7,1,1,2,2,1,1,1,1,0,3.3779151387007924E-4,0,0,0,116,4.599496116192142E-4,5.0330927E-5,5.1639556E-5,94,0,0,0,205,0,0,0
129389158,cloud_stream,10,44403,527,216,7,962,33.8531979914,30-39,703,9,0,0,0,0,0,0,0,0,0,0,0,0,95,255,4.4780486537007367E-5,0,0,84,0,1,0,202,0,0,0
79229494,Abu4arsenal,10,1363,109,343,2,8,40.5285725728,40-49,582,5,0,0,0,0,0,0,0,0,0,0,0,0,96,256,4.4780486537007367E-5,0,0,85,0,7,0,198,0,0,0
943203804,Ari_Prayoga2,10,313,158,188,0,2,28.7151801696,20-29,460,4,0,0,0,0,0,0,0,0,0,0,0,0,97,257,4.4780486537007367E-5,0,0,86,0,12,0,198,0,0,0
370736598,MR_MiiLKYWAY,10,26953,377,303,1,92,35.123957795,30-39,779,8,2,2,4,4,2,2,1,1,0,5.875113113304263E-4,0.0833333333,1,75,232,2.985240256774393E-4,7.549639E-5,7.7459335E-5,87,1,16,0,198,0,0,0
385486802,DDUOrden,10,555,75,444,1,8,40.4250955383,40-49,672,5,3,3,6,6,3,3,2,1.5714285714,0.5,0.0011011322,0.1,0.8333333,62,216,2.8690815099642256E-4,1.00661855E-4,1.0327911E-4,101,0.8333333,193,0,200,0,0,0
218789119,Lucasdiaz_1,10,4380,195,456,6,27,43.5255800884,40-49,702,7,3,3,6,6,3,3,2,1.5714285714,0.5,0.0011011322,0.1,0.8333333,62,216,2.8690815099642256E-4,1.00661855E-4,1.0327911E-4,101,0.8333333,136,0,201,0,0,0
619815732,Bii_Boune,10,5451,287,264,1,102,49.3749419732,40-49,719,7,3,4,7,7,3,4,6,2.7878787879,308.5333333333,0.0011411424,0,0,38,176,2.618946774521599E-4,1.00661855E-4,1.0327911E-4,88,0,20,0,201,0,0,0
421714996,Joecass14,10,1285,421,279,0,41,40.5492408971,40-49,655,6,7,2,9,9,7,2,1,1,0.25,0.0025579459,0.3194444444,0.5535714,2,258,2.0633166934554148E-4,2.0132371E-4,2.0655822E-4,95,0.5535714,11,0,197,0,0,0
256773530,WFTitanBaseball,10,1189,211,29,1,5,42.6949907924,40-49,621,3,3,1,4,4,3,1,3,2,0,9.350284715159881E-4,0.25,1,98,259,3.1919263514044495E-4,1.00661855E-4,1.0327911E-4,90,1,59,0,199,0,0,0
92854317,marianneWvK,10,9039,588,1133,7,36,42.9181650495,40-49,715,7,0,0,0,0,0,0,0,0,0,0,0,0,99,260,4.4780486537007367E-5,0,0,89,0,26,0,198,0,0,0
243730839,CoachB_WFtitans,10,612,144,112,1,8,31.1361339217,30-39,565,4,3,3,6,6,3,3,2,1.25,3,9.350284715159881E-4,0.1,0.6666667,98,259,4.601340226831424E-4,1.00661855E-4,1.0327911E-4,90,0.6666667,4,0,199,0,0,0
381666934,JacquelineHine1,10,16845,798,593,17,1486,41.1034902529,40-49,744,8,8,7,15,15,8,7,10,3.9853718001,375.4680621837,0.0103095917,0.0714285714,0.41666666,0,135,1.4564200266515155E-4,2.2648917E-4,2.32378E-4,303,0.41666666,3,0,202,0,0,0
389648206,BinhoaAyesta,10,166607,5997,4809,50,3,52.890272277,50-59,736,10,4,2,6,6,4,2,11,4.5965054856,5132.2196459165,0.0077100359,0.0333333333,0.083333336,0,135,1.507256962817647E-4,1.2582731E-4,1.2909889E-4,99,0.083333336,2,0,204,0,0,0
361496918,DPFINGST_17,10,10622,503,652,1,655,41.4137914813,40-49,736,7,2,3,5,5,2,3,2,1.25,0,6.390757681936024E-4,0.15,0.8333333,98,259,2.487219413690962E-4,7.549639E-5,7.7459335E-5,90,0.8333333,7,0,201,0,0,0
16903221,Octoate,10,9708,349,242,17,20,44.1963360962,40-49,685,6,1,1,2,2,1,1,1,1,0,2.9156327540323033E-4,0,0,55,203,5.142041496909928E-4,5.0330927E-5,5.1639556E-5,91,0,7,0,200,0,0,0
1200627678,EganzgkKimberle,10,5,4,63,0,0,,,6,0,0,0,0,0,0,0,0,0,0,0,0,0,100,261,4.4780486537007367E-5,0,0,92,0,0,0,10,0,0,0
5130001,DataBrokers,10,7713,291,276,19,15,41.6521474189,40-49,587,7,1,1,2,2,1,1,11,3.924827306,0,0.0078137227,0,0,0,135,4.918548551045996E-5,5.0330927E-5,5.1639556E-5,99,0,0,0,202,0,0,0
487803136,Mii_Words_Speak,10,9475,770,751,1,7,37.3749718227,30-39,732,7,0,0,0,0,0,0,0,0,0,0,0,0,101,262,4.4780486537007367E-5,0,0,93,0,13,0,203,0,0,0
50910154,BeijingReview,10,3445,1654,940,115,0,49.9966623784,40-49,677,4,4,1,5,5,4,1,1,1,2454,0.001083611,0,0,0,116,4.888519341250382E-4,1.2582731E-4,7.7459335E-5,94,0,5,0,201,0,0,0
538458120,ConnorNorcott,10,913,152,283,0,20,40.2571317381,40-49,584,5,3,6,9,9,3,6,2,1.4,0.8333333333,0.001159228,0.1805555556,0.56666666,2,263,8.775901043010341E-5,1.00661855E-4,1.0327911E-4,95,0.56666666,13,0,198,0,0,0
182055360,sfullofbs,10,1055,41,88,0,1194,28.7132900028,20-29,597,5,0,0,0,0,0,0,0,0,0,0,0,0,102,264,4.4780486537007367E-5,0,0,96,0,4,0,200,0,0,0
1060875288,GEJ_4MoreYears,10,946,126,542,0,46,49.0190683089,40-49,643,6,1,3,4,4,1,3,2,1.25,3,2.6808524730492474E-4,0,0,0,267,1.0912479197109002E-4,5.0330927E-5,5.1639556E-5,205,0,14,0,204,0,0,0
277351885,Mr_Soch,10,814,119,39,2,32,41.9011146184,40-49,556,5,1,1,2,2,1,1,11,4.7216578627,0,0.0014535357,0,0,0,135,5.624933352247571E-5,5.0330927E-5,5.1639556E-5,283,0,38,0,200,0,0,0
390696780,MFL1956,10,42881,847,789,23,6232,40.9081223653,40-49,741,9,4,6,10,10,4,6,10,3.8951645672,278.1511222612,0.0068382764,0.0888888889,0.35714287,0,135,7.858040826031464E-5,1.2582731E-4,1.2909889E-4,303,0.35714287,5,0,202,0,0,0
284242666,adriandpetry,10,4760,225,181,9,831,42.5010537637,40-49,681,6,1,1,2,2,1,1,11,4.5497765136,0,0.0016488059,0,0.6,0,135,8.510235236935262E-5,5.0330927E-5,5.1639556E-5,257,0.6,5,0,200,0,0,0
279146802,Hemporium17th,10,624,55,65,2,1,26.2251057018,20-29,532,4,1,1,2,2,1,1,10,3.6757415685,0,0.008504538,0,0.42857143,0,135,5.7850377223210584E-5,5.0330927E-5,5.1639556E-5,99,0.42857143,1,0,196,0,0,0
929557369,Carli_maLpar,10,169,125,325,1,1,35.6646888943,30-39,498,3,0,0,0,0,0,0,0,0,0,0,0,0,103,268,4.4780486537007367E-5,0,0,97,0,0,0,182,0,0,0
1243510502,environnement_1,10,1407,37,1,4,0,47.2445374632,40-49,579,6,0,0,0,0,0,0,0,0,0,0,0,0,104,269,4.4780486537007367E-5,0,0,98,0,4,1,201,1,0.0049751244,0
254777166,Nik_koy,10,7869,224,266,1,21,30.8043930722,30-39,690,6,0,0,0,0,0,0,0,0,0,0,0,0,105,270,4.4780486537007367E-5,0,0,100,0,1,0,200,0,0,0
442860890,LuciaSanchezF,10,11870,589,534,2,388,39.3948917219,30-39,747,7,2,2,4,4,2,2,2,1.7142857143,0,7.228570486523941E-4,0.0833333333,1,62,216,1.7007939231578067E-4,7.549639E-5,7.7459335E-5,101,1,39,0,202,0,0,0
29217969,AheadAhead9ja,10,2875,468,1048,1,83,45.08430979,40-49,682,6,1,1,2,2,1,1,3,2,0,2.6808524730492474E-4,0,0,0,267,7.569917912644684E-5,5.0330927E-5,5.1639556E-5,205,0,1,0,201,0,0,0
33607722,DaveGreen93,10,5330,131,69,0,820,40.7774761379,40-49,733,7,0,0,0,0,0,0,0,0,0,0,0,0,106,271,4.4780486537007367E-5,0,0,103,0,2,0,201,0,0,0
35975222,alancomic,10,208,229,111,6,1,41.7205045903,40-49,588,3,4,0,4,4,4,0,0,0,0,0.0031687968,0,0,0,45,1.1181771310892493E-4,1.2582731E-4,0,283,0,8,0,200,0,0,0
951841164,andrewjackpei,10,133,15,82,0,5,36.0396722884,30-39,456,3,0,2,2,2,0,2,1,1,0,0,0,0,0,272,4.4780486537007367E-5,0,2.5819778E-5,283,0,2,0,198,0,0,0
316696841,CPYAMC,10,31,48,18,4,0,26.4616324078,20-29,179,0,1,1,2,2,1,1,1,1,0,2.6808524730492474E-4,0,0,4,136,2.9852402567743944E-4,5.0330927E-5,5.1639556E-5,104,0,4,0,33,0,0,0
308632273,BounTyBornToDie,10,6037,74,133,2,34,41.2114993845,40-49,692,7,0,0,0,0,0,0,0,0,0,0,0,0,107,274,4.4780486537007367E-5,0,0,105,0,10,0,201,0,0,0
544713449,RockinRobin2012,10,593,10,13,0,12,21.3060917858,20-29,340,5,1,0,1,1,1,0,0,0,0,0.001705941,0,0,0,37,4.563965479756169E-5,5.0330927E-5,0,99,0,0,0,200,0,0,0
207745397,ProgressivePort,10,16895,149,259,3,11,28.2081978137,20-29,491,8,0,2,2,2,0,2,11,4.3468724614,0,0,0,0,0,275,4.4780486537007367E-5,0,2.5819778E-5,303,0,0,0,202,0,0,0
28186031,atl058,10,519,38,157,1,15,22.9126413442,20-29,226,4,0,0,0,0,0,0,0,0,0,0,0,0,108,276,4.4780486537007367E-5,0,0,107,0,1,0,198,0,0,0
469538872,DBC68,10,53,4,111,0,9,22.3614395686,20-29,113,3,0,1,1,1,0,1,1,1,0,0,0,0,0,277,4.4780486537007367E-5,0,2.5819778E-5,283,0,0,0,70,0,0,0
919156579,Bruce_LePage,10,162,29,67,0,1,21.7035237489,20-29,305,3,2,3,5,5,2,3,10,3.8268996343,0,0.0036064237,0.15,0.6666667,0,135,5.141614730061203E-5,7.549639E-5,7.7459335E-5,257,0.6666667,1,0,187,0,0,0
250931446,SSexpress10,10,14749,258,258,0,869,42.9809239008,40-49,721,7,8,8,16,16,8,8,2,1.3846153846,10.7674603175,0.0036718707,0.0875,0.6785714,34,170,3.9744593976229973E-4,2.2648917E-4,2.32378E-4,113,0.6785714,60,0,199,0,0,0
347227889,D_Shepherd54,10,1477,244,242,0,21,37.3519227893,30-39,620,5,3,4,7,7,3,4,3,2,0.1666666667,0.0014160665,0.1428571429,0.9166667,34,170,1.7491981564444727E-4,1.00661855E-4,1.0327911E-4,113,0.9166667,8,0,200,0,0,0
426673015,CCS24h,10,435066,6871,40,103,0,40.2565440219,40-49,769,12,0,0,0,0,0,0,0,0,0,0,0,0,109,278,4.4780486537007367E-5,0,0,108,0,0,0,202,0,0,0
341310432,_RollingSt0ne,10,1742,165,250,0,56,22.2485589148,20-29,570,5,0,0,0,0,0,0,0,0,0,0,0,0,110,279,4.4780486537007367E-5,0,0,109,0,0,0,200,0,0,0
252167009,marcel_campelo,10,34001,1349,1348,22,27,65.6239913645,60-69,799,9,0,0,0,0,0,0,0,0,0,0,0,0,111,280,4.4780486537007367E-5,0,0,110,0,17,0,200,0,0,0
215987838,Nedifeora,10,8117,156,111,1,17,33.8719295976,30-39,669,7,0,0,0,0,0,0,0,0,0,0,0,0,112,281,4.4780486537007367E-5,0,0,111,0,0,0,202,0,0,0
231211484,OrtizLeiris,10,8074,328,1430,3,12,41.4884137428,40-49,660,6,0,0,0,0,0,0,0,0,0,0,0,0,113,282,4.4780486537007367E-5,0,0,112,0,9,0,200,0,0,0
19231224,LABcrab,10,2051,148,121,3,18,42.5814063529,40-49,689,7,3,0,3,3,3,0,0,0,0,0.0247641578,0.1666666667,0.33333334,0,41,5.600262376795542E-5,1.00661855E-4,0,353,0.33333334,23,0,200,0,0,0
499366511,WillenborgEmily,10,5055,386,436,0,2313,42.6055909036,40-49,715,6,8,11,19,19,8,11,2,1.1538461538,41.619047619,0.0032480737,0.0643274854,0.3909091,34,170,4.064475805543674E-4,2.2648917E-4,2.32378E-4,113,0.3909091,6,0,201,0,0,0
348226471,Nick_Sully24,10,3296,351,247,1,1461,44.5416283327,40-49,694,6,2,2,4,4,2,2,3,1.9230769231,0,9.677509472920216E-4,0.0833333333,1,34,170,1.1973323811828786E-4,7.549639E-5,7.7459335E-5,113,1,7,0,200,0,0,0
263850473,madisonduan,10,944,127,115,0,411,34.3198236759,30-39,586,5,0,0,0,0,0,0,0,0,0,0,0,0,114,284,4.4780486537007367E-5,0,0,114,0,12,0,200,0,0,0
200140108,aliceedunn,10,10961,1053,725,1,17,46.4300366664,40-49,764,7,7,0,7,7,7,0,0,0,0,0.0029583403,0.5,1,56,206,1.8501453310930619E-4,2.0132371E-4,0,48,1,5,0,201,0,0,0
403689317,PatRonayne7,10,1552,165,174,0,113,41.3977159033,40-49,679,6,6,7,13,13,6,7,1,1,0,0.0025357202,0.1346153846,0.85714287,56,207,1.6498109788469208E-4,1.7615824E-4,1.8073844E-4,48,0.85714287,28,0,197,0,0,0
552080063,paulapeps,10,2727,286,254,1,184,42.4731262792,40-49,685,6,0,0,0,0,0,0,0,0,0,0,0,0,115,286,4.4780486537007367E-5,0,0,115,0,23,0,199,0,0,0
596527769,Sasquacht,10,32812,234,15,0,0,40.4521496179,40-49,588,5,1,4,5,5,1,4,1,1,2,2.6808524730492474E-4,0.05,0.083333336,46,189,7.014737994708823E-5,5.0330927E-5,5.1639556E-5,116,0.083333336,0,0,202,0,0,0
1169215122,webmasterx13,10,24332,160,50,4,0,44.0634207901,40-49,590,9,0,0,0,0,0,0,0,0,0,0,0,0,116,288,4.4780486537007367E-5,0,0,117,0,5,0,201,0,0,0
1268694740,tw88follow,10,1738,11,1,1,0,39.5236969392,30-39,464,8,0,0,0,0,0,0,0,0,0,0,0,0,117,289,4.4780486537007367E-5,0,0,118,0,0,0,201,0,0,0
21357830,mrdanielha,10,350,128,235,2,5,34.1162404003,30-39,515,4,0,0,0,0,0,0,0,0,0,0,0,0,118,290,4.4780486537007367E-5,0,0,119,0,10,0,201,0,0,0
19598120,MattKreutz,10,1702,210,212,7,25,27.9059299214,20-29,586,5,0,0,0,0,0,0,0,0,0,0,0,0,119,291,4.4780486537007367E-5,0,0,120,0,3,0,200,0,0,0
133170079,mash_nica,10,7764,382,533,1,1133,45.8544425039,40-49,739,7,0,1,1,1,0,1,2,1.5,0,0,0,0,0,292,4.4780486537007367E-5,0,2.5819778E-5,99,0,0,0,201,0,0,0
420665931,DeeDubbia,10,671,42,78,1,0,21.7431735868,20-29,456,5,1,0,1,1,1,0,0,0,0,0.0145656992,0,0.54761904,0,42,5.4983066193524124E-5,5.0330927E-5,0,353,0.54761904,0,0,200,0,0,0
1152981883,votecarefully,10,24,2,7,0,25,21.3630434841,20-29,126,3,1,1,2,2,1,1,10,4.2629012597,0,0.0012262346,0,0.6,0,135,4.650175098890308E-5,5.0330927E-5,5.1639556E-5,99,0.6,1,0,77,0,0,0
774519661,andrewkidd83s,10,169,18,36,0,0,26.4382135272,20-29,299,1,0,0,0,0,0,0,0,0,0,0,0,0,120,293,4.4780486537007367E-5,0,0,121,0,0,0,200,0,0,0
374096811,ibroayo,10,10620,294,222,0,165,50.4055867615,50-59,744,7,0,0,0,0,0,0,0,0,0,0,0,0,121,294,4.4780486537007367E-5,0,0,122,0,8,0,201,0,0,0
19365951,Jen_PaquetPhoto,10,1393,96,222,0,10,22.0270317405,20-29,541,5,1,1,2,2,1,1,11,4.279561154,0,0.0019847882,0,0,0,135,4.8505140895042504E-5,5.0330927E-5,5.1639556E-5,257,0,0,0,198,0,0,0
334996907,atwLIVE,10,914,71,147,0,6,26.3404460603,20-29,545,4,0,0,0,0,0,0,0,0,0,0,0,0,122,295,4.4780486537007367E-5,0,0,123,0,3,0,200,0,0,0
23695888,iamtedking,10,6684,17399,413,1147,271,71.7070800402,70-79,803,7,6,0,6,6,6,0,0,0,0,0.0046194238,0,0,0,52,2.224331593169507E-4,1.7615824E-4,0,283,0,26,0,200,0,0,0
94760350,DonABassey,10,1441,116,396,0,2,26.1113061928,20-29,516,5,0,0,0,0,0,0,0,0,0,0,0,0,123,296,4.4780486537007367E-5,0,0,124,0,7,0,200,0,0,0
1323671,BLOGBloke,10,41619,7033,6094,150,2088,53.3576045388,50-59,783,8,0,0,0,0,0,0,0,0,0,0,0,0.5,124,297,4.689617954764729E-5,0,0,125,0.5,11,0,201,0,0,0
11609972,cwindley,10,58506,4430,4869,167,10443,66.6771041906,60-69,862,10,0,1,1,1,0,1,1,1,0,0,0,0,0,298,4.4780486537007367E-5,0,2.5819778E-5,148,0,31,0,201,0,0,0
43047440,kirvine1,10,1946,142,146,5,24,40.0800964432,40-49,636,6,1,1,2,2,1,1,1,1,102.050803351,0.0023666705,0,0,0,53,5.1437291395228235E-5,5.0330927E-5,5.1639556E-5,283,0,6,0,200,0,0,0
1108718324,whoisGeorgeD,10,39,4,106,0,1,12.1265715677,10-19,18,3,0,1,1,1,0,1,1,1,0,0,0,0,0,299,4.4780486537007367E-5,0,2.5819778E-5,283,0,0,0,93,0,0,0
285717387,LucasChnd,10,17105,198,105,0,263,34.784271113,30-39,746,7,0,0,0,0,0,0,0,0,0,0,0,0,125,300,4.4780486537007367E-5,0,0,126,0,4,0,201,0,0,0
617241899,SteveReynolds_,10,733,156,235,0,36,40.0431349716,40-49,619,5,6,7,13,13,6,7,1,1,0,0.0025357202,0.1346153846,0.85714287,56,207,1.6498109788469208E-4,1.7615824E-4,1.8073844E-4,48,0.85714287,12,0,197,0,0,0
43364540,CarlosPaulC,10,8809,630,1084,5,8,48.5964999655,40-49,759,8,0,0,0,0,0,0,0,0,0,0,0,0,126,301,4.4780486537007367E-5,0,0,127,0,79,0,200,0,0,0
247125962,ChelseyRaeS,10,731,171,887,10,0,29.0880549171,20-29,480,5,1,1,2,2,1,1,11,4.379926859,0,0.0026278461,0,0,0,135,5.8129038212847856E-5,5.0330927E-5,5.1639556E-5,303,0,0,0,199,0,0,0
146792452,Rashiid9,10,40770,681,669,2,291,45.0986178334,40-49,778,9,0,0,0,0,0,0,0,0,0,0,0,0,127,302,4.4780486537007367E-5,0,0,128,0,12,0,201,0,0,0
851744330,StrghtBlk,10,442,26,151,4,11,29.3119934701,20-29,537,5,0,1,1,1,0,1,1,1,0,0,0,0,0,303,4.4780486537007367E-5,0,2.5819778E-5,283,0,1,0,200,0,0,0
78317432,mbo108,10,255,35,136,1,5,20.2435715129,20-29,429,4,0,1,1,1,0,1,1,1,0,0,0,0,0,304,4.4780486537007367E-5,0,2.5819778E-5,283,0,0,0,198,0,0,0
547611286,Jah_Nyce,10,3543,106,109,0,17,41.0348949556,40-49,679,6,2,2,4,4,2,2,8,4.1515151515,101.1666666667,6.135539977403334E-4,0,0,38,176,1.821334296097246E-4,7.549639E-5,7.7459335E-5,88,0,49,0,201,0,0,0
61472094,Curlyisrunning,10,7402,451,398,21,0,44.7297731512,40-49,729,7,0,0,0,0,0,0,0,0,0,0,0,0,128,305,4.4780486537007367E-5,0,0,129,0,5,0,200,0,0,0
398326897,meredth_seymour,10,1119,145,203,0,1561,34.5469686655,30-39,574,5,2,2,4,4,2,2,1,1,1,5.618090794925434E-4,0.0833333333,0.5,129,306,3.8755706676916064E-4,7.549639E-5,7.7459335E-5,130,0.5,7,0,199,0,0,0
397543166,jragland96,10,14,48,70,0,0,21.346206605,20-29,320,1,2,1,3,3,2,1,2,1.5,0,5.618090794925434E-4,0.1666666667,1,129,306,2.985240256774394E-4,7.549639E-5,7.7459335E-5,130,1,6,0,18,0,0,0
1187398310,emariegriffin,10,14,27,56,0,8,26.5969314997,20-29,222,2,1,2,3,3,1,2,1,1,0,2.926588007250267E-4,0.1666666667,1,129,306,2.094909845857181E-4,5.0330927E-5,5.1639556E-5,130,1,9,0,28,0,0,0
564920924,tsuOECTA,10,265,101,6,1,0,24.4876100198,20-29,473,3,4,1,5,5,4,1,11,4.0739536774,50.3399483476,0.0070982872,0.1,0.16666667,0,135,7.113266888486271E-5,1.2582731E-4,1.0327911E-4,257,0.16666667,29,0,197,0,0,0
1265329136,FP_TopEnergy,10,19,9,29,0,7,24.3686086301,20-29,96,2,1,2,3,3,1,2,11,3.8033319789,0,0.0241051796,0.1666666667,0.5,0,135,4.9481557891212485E-5,5.0330927E-5,5.1639556E-5,353,0.5,0,0,28,0,0,0
342772599,BrilliantDeeCee,10,5406,553,825,1,143,46.0854419558,40-49,656,6,0,0,0,0,0,0,0,0,0,0,0,0,130,307,4.4780486537007367E-5,0,0,131,0,9,0,202,0,0,0
310970714,cgvandenb,10,1093,39,62,0,49,31.0405612181,30-39,555,4,0,0,0,0,0,0,0,0,0,0,0,0,131,308,4.4780486537007367E-5,0,0,132,0,1,0,200,0,0,0
391400343,Sultan_H_Z,10,5223,149,234,0,48,41.5947495621,40-49,686,7,1,1,2,2,1,1,1,1,0,2.6808524730492474E-4,0,0,132,309,2.9852402567743944E-4,5.0330927E-5,5.1639556E-5,133,0,16,0,197,0,0,0
465446391,MohammedMAlanaz,10,134,16,62,0,0,22.9809264955,20-29,378,3,1,1,2,2,1,1,1,1,0,2.6808524730492474E-4,0,0,132,309,2.9852402567743944E-4,5.0330927E-5,5.1639556E-5,133,0,2,0,133,0,0,0
128490244,krisMCFC,10,3868,728,516,12,26,46.997304526,40-49,698,7,1,1,2,2,1,1,1,1,0,2.6808524730492474E-4,0,0,133,310,2.9852402567743944E-4,5.0330927E-5,5.1639556E-5,134,0,6,0,200,0,0,0
279550566,rociolf12,10,3400,174,240,0,1097,41.3260393324,40-49,713,6,3,2,5,5,3,2,2,1.7142857143,0.5,0.0010999695,0.15,0.8333333,62,216,2.6467175579011144E-4,1.00661855E-4,1.0327911E-4,101,0.8333333,4,0,200,0,0,0
1204117964,PensionMatters,10,15228,407,58,10,0,50.9948939829,50-59,646,8,2,0,2,2,2,0,0,0,0,0.0022347917,0,0,0,83,5.004884455150075E-5,7.549639E-5,0,257,0,1,0,201,0,0,0
570611285,BanditShooter,10,265,25,194,0,0,37.7225610901,30-39,500,4,0,0,0,0,0,0,0,0,0,0,0,1,134,311,4.4780486537007367E-5,0,0,135,1,0,0,200,0,0,0
1114250790,MomberTraining,10,61,73,236,1,0,31.6802954552,30-39,338,2,0,1,1,1,0,1,1,1,0,0,0,0,18,312,4.4780486537007367E-5,0,2.5819778E-5,136,0,1,0,84,0,0,0
732493945,jeanettezbcisol,10,128,31,495,0,0,13.0758616966,10-19,30,2,0,0,0,0,0,0,0,0,0,0,0,0,135,313,4.4780486537007367E-5,0,0,137,0,0,0,199,0,0,0
271516426,Alcala1818,10,253,160,198,0,3,35.5183374615,30-39,567,4,1,1,2,2,1,1,1,1,0,2.6808524730492474E-4,0,0,136,314,2.9852402567743944E-4,5.0330927E-5,5.1639556E-5,138,0,48,0,200,0,0,0
149543873,alcaleitor1988,10,422,95,227,0,2,24.3016482329,20-29,552,4,1,1,2,2,1,1,1,1,0,2.6808524730492474E-4,0,0,136,314,2.9852402567743944E-4,5.0330927E-5,5.1639556E-5,138,0,3,0,196,0,0,0
1151108563,igarashiorico,10,12260,644,696,1,0,45.6016247434,40-49,588,7,1,1,2,2,1,1,9,4.6221048354,0,8.096601273418801E-4,0,0,0,135,7.54503506542261E-5,5.0330927E-5,5.1639556E-5,148,0,0,0,202,0,0,0
242205201,DrJudyBarrett,10,1879,317,758,1,55,32.0615479429,30-39,571,5,0,0,0,0,0,0,0,0,0,0,0,0,137,315,4.4780486537007367E-5,0,0,139,0,2,0,200,0,0,0
139732486,PersianWanderer,10,1722,112,79,9,2,40.7354364454,40-49,628,5,0,0,0,0,0,0,0,0,0,0,0,0,138,316,4.4780486537007367E-5,0,0,140,0,3,0,199,0,0,0
498940924,BrianEdey,10,441,6,26,0,31,17.767894248,10-19,454,4,1,0,1,1,1,0,0,0,0,0.0022570128,0,0.53333336,0,68,4.5677515201501E-5,5.0330927E-5,0,257,0.53333336,0,0,200,0,0,0
36293581,ishienriquez,10,6742,140,252,0,1583,41.2110076966,40-49,658,6,0,0,0,0,0,0,0,0,0,0,0,0,139,317,4.4780486537007367E-5,0,0,141,0,3,0,200,0,0,0
581863095,manuelelejog46,10,734,209,329,0,58,39.9993897263,30-39,608,5,1,1,2,2,1,1,1,1,0,2.6808524730492474E-4,0,0,140,318,2.9852402567743944E-4,5.0330927E-5,5.1639556E-5,144,0,46,0,200,0,0,0
856448304,CuartAnfiteatro,10,3829,466,699,1,7,45.0333902796,40-49,688,6,2,1,3,3,2,1,1,1,2,5.372050215923944E-4,0,0,141,319,4.971463702468208E-4,7.549639E-5,7.7459335E-5,142,0,15,0,201,0,0,0
599188522,jaimegs89,10,1926,148,292,0,14,39.9568988369,30-39,636,6,1,2,3,3,1,2,2,1.3333333333,2,2.6808524730492474E-4,0,0,141,320,1.2969692065828504E-4,5.0330927E-5,5.1639556E-5,142,0,3,0,199,0,0,0
387348325,TommyManzano,10,4955,259,229,0,391,40.9859331231,40-49,693,7,1,1,2,2,1,1,1,1,0,2.9159312613363325E-4,0,0,141,319,4.673511306965937E-4,5.0330927E-5,5.1639556E-5,142,0,4,0,200,0,0,0
102927420,ZachDeRitis,10,6192,274,475,1,74,37.2814026847,30-39,650,6,0,0,0,0,0,0,0,0,0,0,0,0,142,321,4.4780486537007367E-5,0,0,143,0,6,0,199,0,0,0
584380180,Ricardo_shire,10,2961,452,123,0,1,33.4012943736,30-39,658,5,1,1,2,2,1,1,1,1,0,2.6808524730492474E-4,0,0,143,322,2.9852402567743944E-4,5.0330927E-5,5.1639556E-5,146,0,29,0,200,0,0,0
464824122,kimberlygil97,10,1929,174,306,0,45,40.4499580084,40-49,654,6,1,1,2,2,1,1,1,1,0,2.6808524730492474E-4,0,0,140,318,2.9852402567743944E-4,5.0330927E-5,5.1639556E-5,144,0,117,0,198,0,0,0
1194130064,GFYSuckMonkeys,10,80,12,63,0,0,16.4666797829,10-19,104,2,0,0,0,0,0,0,0,0,0,0,0,0,144,323,4.4780486537007367E-5,0,0,145,0,0,0,131,0,0,0
83689327,tawanlima,10,5460,1244,155,1,15,47.3552618025,40-49,713,6,1,1,2,2,1,1,1,1,0,2.6808524730492474E-4,0,0,143,322,2.9852402567743944E-4,5.0330927E-5,5.1639556E-5,146,0,26,0,201,0,0,0
37106938,hesa2,10,1891,3197,3520,65,2,40.2304730948,40-49,653,6,5,5,10,10,5,5,8,3.813490451,233465.872378304,0.0047789423,0.0111111111,0.1,0,135,2.1241655650718576E-4,1.5099278E-4,1.5491867E-4,148,0.1,0,0,199,0,0,0
395446247,HenrikSandberg2,10,1861,10174,9901,69,0,42.229248097,40-49,695,6,3,3,6,6,3,3,9,5.5042665583,643.0954201141,0.0014398351,0,0,0,135,1.7852637359809444E-4,1.00661855E-4,1.0327911E-4,148,0,0,0,200,0,0,0
396099486,HenrikSandberg3,10,1838,3683,4025,38,0,40.5343647636,40-49,642,6,2,2,4,4,2,2,9,5.5371800081,26.4884123805,9.638333877737092E-4,0,0,0,135,1.2653078673569365E-4,7.549639E-5,7.7459335E-5,148,0,0,0,200,0,0,0
404402803,SeoCustomer,10,1191,5626,5841,54,0,41.6572291234,40-49,670,6,4,4,8,8,4,4,9,5.5038602194,1006.5148774734,0.0017444003,0.0178571429,0.16666667,0,135,2.3985127980863705E-4,1.2582731E-4,1.2909889E-4,148,0.16666667,0,0,199,0,0,0
1267285542,seo899seo,10,3272,114,55,0,0,46.1399207733,40-49,576,7,0,0,0,0,0,0,0,0,0,0,0,0,145,324,4.4780486537007367E-5,0,0,147,0,0,0,201,0,0,0
404420419,IMPAdvertising,10,7504,1009,842,14,410,38.8002931663,30-39,741,8,3,4,7,7,3,4,8,4.7354733848,1296.6839615971,0.0013694309,0.0238095238,0.16666667,0,135,1.485912273975616E-4,1.00661855E-4,1.0327911E-4,148,0.16666667,81,0,201,0,0,0
362310283,Gmoore18,10,95,187,154,0,1,40.0412082485,40-49,589,4,7,6,13,13,7,6,12,5.1206826493,2,0.003757353,0.1153846154,0.78571427,0,135,3.380638602310351E-4,2.0132371E-4,2.0655822E-4,37,0.78571427,24,0,70,0,0,0
356883125,MaryanDiazC,10,18155,383,239,0,365,35.7878437442,30-39,736,7,0,0,0,0,0,0,0,0,0,0,0,0,146,325,4.4780486537007367E-5,0,0,149,0,11,0,200,0,0,0
1109187241,RHFLA,10,12,12,45,0,0,20.421019073,20-29,71,1,1,0,1,1,1,0,0,0,0,0.001581971,0,0.62637365,0,128,5.010510701803951E-5,5.0330927E-5,0,99,0.62637365,3,0,21,0,0,0
880810860,Coco68274Cp,10,1091,121,135,1,4,40.9722087099,40-49,582,5,0,0,0,0,0,0,0,0,0,0,0,0,147,326,4.4780486537007367E-5,0,0,150,0,3,0,200,0,0,0
596080947,KimKimy3,10,25050,415,179,0,540,38.1016257911,30-39,762,8,11,8,19,19,11,8,6,2.7878787879,88.8765873016,0.0050512997,0.0730994152,0.4090909,38,176,5.445462530741334E-4,3.0198556E-4,3.0983734E-4,88,0.4090909,20,0,202,0,0,0
144598107,_miguel_cabrera,10,6389,427,407,0,133,31.0481722369,30-39,685,7,0,0,0,0,0,0,0,0,0,0,0,0,148,329,4.4780486537007367E-5,0,0,151,0,4,0,197,0,0,0
21790920,brianlogan,10,7233,208,103,2,119,41.623816278,40-49,698,6,1,0,1,1,1,0,0,0,0,2.6808524730492474E-4,0,0,0,327,4.58919816623078E-5,5.0330927E-5,0,99,0,3,0,201,0,0,0
400019874,vraicroyant,10,6136,213,572,4,2294,31.7274643388,30-39,614,7,0,0,0,0,0,0,0,0,0,0,0,0,149,330,4.4780486537007367E-5,0,0,152,0,2,0,198,0,0,0
44126988,gwplex,10,15,7,14,0,0,16.6056782525,10-19,17,0,0,0,0,0,0,0,0,0,0,0,0,0,150,331,4.4780486537007367E-5,0,0,153,0,1,0,16,0,0,0
188916172,4squareviews,10,4532,529,866,8,1,44.836197539,40-49,651,6,1,1,2,2,1,1,11,4.2068264933,0,0.0013653589,0,0,0,135,4.8369062644149766E-5,5.0330927E-5,5.1639556E-5,99,0,1,0,200,0,0,0
286504250,AnonimaPapaya,10,25896,1200,979,5,5786,46.7188630319,40-49,788,8,1,0,1,1,1,0,0,0,0,2.4460721920661915E-4,0,0,151,332,8.284390166388585E-5,5.0330927E-5,0,154,0,38,0,202,0,0,0
153668307,keykey_13,10,1765,65,127,0,31,34.7047191985,30-39,654,5,0,1,1,1,0,1,1,1,0,0,0,0,151,333,4.4780486537007367E-5,0,2.5819778E-5,154,0,1,0,200,0,0,0
182865739,Eviann_J,10,8522,177,261,0,382,47.5986377612,40-49,715,7,0,0,0,0,0,0,0,0,0,0,0,0,152,334,4.4780486537007367E-5,0,0,155,0,3,0,201,0,0,0
86392520,seotweetz,10,279248,4414,1,419,0,56.244837431,50-59,794,12,6,0,6,6,6,0,0,0,0,0.0056651109,0,0,0,27,2.3965233577394795E-4,1.7615824E-4,0,148,0,15,0,202,0,0,0
64611995,SaarahAndSons,10,3023,594,319,2,3522,47.8282070785,40-49,759,7,0,1,1,1,0,1,11,4.1835905768,0,0,0,0.5,0,335,4.4780486537007367E-5,0,2.5819778E-5,99,0.5,14,0,200,0,0,0
54636481,ladymonton,10,11899,124,237,2,1900,40.5493540879,40-49,723,6,0,0,0,0,0,0,0,0,0,0,0,0,153,336,4.4780486537007367E-5,0,0,156,0,2,0,200,0,0,0
110587321,NMSUWSP,10,11553,413,544,18,403,46.4105927857,40-49,587,8,0,0,0,0,0,0,0,0,0,0,0,1,154,337,4.884407411694686E-5,0,0,157,1,0,0,201,0,0,0
995002429,intandjockey,10,521,156,73,0,1,45.849150565,40-49,646,5,1,1,2,2,1,1,1,1,0,2.6808524730492474E-4,0,0,155,339,2.9852402567743944E-4,5.0330927E-5,5.1639556E-5,158,0,7,0,201,0,0,0
496075854,anandaandika3,10,7614,131,242,0,64,46.670516676,40-49,696,7,1,1,2,2,1,1,1,1,0,2.6808524730492474E-4,0,0,155,339,2.9852402567743944E-4,5.0330927E-5,5.1639556E-5,158,0,20,0,201,0,0,0
740994812,sgrdirect,10,21,0,0,0,0,13.3936304817,10-19,20,0,0,0,0,0,0,0,0,0,0,0,0,0,156,340,4.4780486537007367E-5,0,0,159,0,26,0,176,0,0,0
426739723,wampidsilva,10,1910,75,160,1,70,16.5504634468,10-19,643,6,1,0,1,1,1,0,0,0,0,0.001742578,0,0.5,0,110,5.0269977913473726E-5,5.0330927E-5,0,99,0.5,0,0,200,0,0,0
389550963,NRoualec,10,440,132,109,3,0,44.1789747193,40-49,583,5,0,0,0,0,0,0,0,0,0,0,0,0,157,341,4.4780486537007367E-5,0,0,160,0,0,0,200,0,0,0
55901461,swissguy5,10,1827,85,168,4,1,40.7293352569,40-49,581,5,1,0,1,1,1,0,0,0,0,8.612250412190542E-4,0,0.33571428,0,109,8.305000576294658E-5,5.0330927E-5,0,283,0.33571428,4,1,200,1,0.005,0
8795262,renaudjoly,10,8666,4023,520,423,540,64.648167687,60-69,759,7,10,7,17,17,10,7,2,1.125,19623.9,0.0036396855,0.0588235294,0.21818182,0,32,8.743283348264202E-4,2.768201E-4,2.5819778E-4,148,0.21818182,58,0,200,0,0,0
15315875,diije,10,11561,1049,324,84,1,58.4149883382,50-59,749,8,4,3,7,7,4,3,2,1.625,0,0.001815303,0.1428571429,0.9166667,0,32,4.931171092423478E-4,1.2582731E-4,1.2909889E-4,148,0.9166667,1,0,201,0,0,0
20036361,danielbroche,10,10502,3638,759,245,584,64.6363196049,60-69,777,7,7,5,12,12,7,5,2,1.375,40.05,0.0025798803,0.0909090909,0.30357143,0,32,7.419313879699045E-4,2.0132371E-4,1.8073844E-4,148,0.30357143,7,0,201,0,0,0
22094253,Omega_,10,2891,135,159,15,4,44.982753182,40-49,653,6,1,0,1,1,1,0,0,0,0,0.0026551261,0,0.45,0,131,1.0658218935157425E-4,5.0330927E-5,0,257,0.45,4,0,200,0,0,0
18115619,glemarchand,10,5217,1518,622,110,15,49.6796326673,40-49,691,7,6,6,12,12,6,6,2,1.25,10.5333333333,0.0022336383,0.1212121212,0.3611111,0,32,4.752427742128663E-4,1.7615824E-4,1.5491867E-4,148,0.3611111,3,0,200,0,0,0
126408925,Infiniclick,10,8555,1047,154,57,87,57.379565223,50-59,771,7,5,3,8,8,5,3,2,1.625,1.45,0.0022240325,0.1607142857,0.85,0,32,5.913982947396527E-4,1.5099278E-4,1.5491867E-4,148,0.85,13,0,200,0,0,0
66268665,LucilleRoss,10,440,10,13,0,5,33.2239565625,30-39,435,4,0,0,0,0,0,0,0,0,0,0,0,0,158,342,4.4780486537007367E-5,0,0,161,0,7,0,200,0,0,0
55762792,mitchdeg,10,8021,4204,89,249,33,58.1118283135,50-59,768,7,5,1,6,6,5,1,3,2.25,16,0.0018566486,0.1,0.3,0,32,3.951518364160162E-4,1.5099278E-4,1.0327911E-4,148,0.3,14,0,200,0,0,0
726718814,MPSCHM,10,9587,941,1976,9,2831,51.7343099017,50-59,718,8,0,2,2,2,0,2,11,4.3850528026,0,0,0,0,0,343,4.4780486537007367E-5,0,2.5819778E-5,148,0,19,0,201,0,0,0
74387981,axenetwit,10,8092,5316,745,557,0,63.1356073652,60-69,792,7,9,6,15,15,9,6,2,1.25,2479.2,0.0031929003,0.0714285714,0.30555555,0,32,7.572970809269562E-4,2.5165462E-4,2.32378E-4,148,0.30555555,26,0,200,0,0,0
66387685,bistoule,10,775,897,239,68,5,41.3485289645,40-49,547,4,1,1,2,2,1,1,3,2,0,5.181703985159008E-4,0,0,0,32,1.5094792967029218E-4,5.0330927E-5,5.1639556E-5,148,0,5,0,200,0,0,0
45113194,Jc_gay,10,1438,78,222,4,28,43.0126742727,40-49,532,5,0,1,1,1,0,1,4,3,0,0,0,0,0,345,4.4780486537007367E-5,0,2.5819778E-5,148,0,0,0,200,0,0,0
222039393,ad6media,10,1025,857,1486,22,11,42.2857926155,40-49,593,5,0,2,2,2,0,2,9,4.4902518278,0,0,0,0,0,346,4.4780486537007367E-5,0,2.5819778E-5,148,0,2,0,200,0,0,0
112119151,jlhumblet,10,6365,255,308,17,12,47.7202348102,40-49,622,7,0,2,2,2,0,2,3,2,0,0,0.5,1,0,347,4.4780486537007367E-5,0,2.5819778E-5,148,1,1,0,200,0,0,0
308347303,LaurentMichaut,10,609,284,350,8,0,41.3415090376,40-49,601,4,1,3,4,4,1,3,10,6.5054811206,0,2.6808524730492474E-4,0.25,0.6666667,0,349,5.200742033902463E-5,5.0330927E-5,5.1639556E-5,148,0.6666667,10,0,200,0,0,0
1128592190,Web2Roi,10,36,189,1045,0,0,32.8192097617,30-39,371,3,1,7,8,8,1,7,9,5.508729192,2453.6666666667,2.6808524730492474E-4,0.1428571429,0.33333334,0,349,5.9515922919722364E-5,5.0330927E-5,5.1639556E-5,148,0.33333334,11,0,40,0,0,0
451541694,Web_Analytix,10,23,26,50,0,0,17.2834874196,10-19,36,1,0,1,1,1,0,1,3,2,0,0,0,0,0,350,4.4780486537007367E-5,0,2.5819778E-5,148,0,0,0,28,0,0,0
1237156772,moneyerenda,10,5,4,5,0,0,14.7192575349,10-19,25,1,0,0,0,0,0,0,0,0,0,0,0,0,159,351,4.4780486537007367E-5,0,0,162,0,0,0,30,0,0,0
606564909,Ottawa_Andrew,10,129,35,192,1,5,33.4406210347,30-39,329,3,0,0,0,0,0,0,0,0,0,0,0,0.74444443,160,352,4.4780486537007367E-5,0,0,163,0.74444443,4,13,180,10,0.0555555556,0
29046868,London_UK,10,2000,2097,193,60,0,45.7902253844,40-49,688,5,3,0,3,3,3,0,0,0,0,0.0022637604,0,0,0,103,9.270004964483057E-5,1.00661855E-4,0,303,0,31,0,200,0,0,0
854562582,SKSMediaLondres,10,96980,496,1174,40,0,44.3657362181,40-49,601,10,0,1,1,1,0,1,1,1,0,0,0,0,0,353,4.4780486537007367E-5,0,2.5819778E-5,303,0,0,0,201,0,0,0
285744807,mathias_berlin,10,10,10,18,0,5,12.3207895825,10-19,30,1,0,0,0,0,0,0,0,0,0,0,0,0,161,354,4.4780486537007367E-5,0,0,164,0,0,0,11,0,0,0
974785080,VisionGRAMintl,10,130,19,63,0,8,41.0434443063,40-49,521,6,1,1,2,2,1,1,11,4.759853718,0,4.030084020443562E-4,0,0.16666667,0,135,4.657606218139627E-5,5.0330927E-5,5.1639556E-5,353,0.16666667,29,0,201,0,0,0
23926358,web20_freenet,10,105989,278,18,8,0,39.2177691034,30-39,674,4,0,0,0,0,0,0,0,0,0,0,0,0,162,355,4.4780486537007367E-5,0,0,165,0,0,0,201,0,0,0
963460488,janiebeenyc,10,260,8,59,0,16,17.8488717925,10-19,94,4,1,1,2,2,1,1,11,4.379926859,0,0.0026278461,0,0,0,135,5.8129038212847856E-5,5.0330927E-5,5.1639556E-5,303,0,0,0,200,0,0,0
92674567,rrhondarat,10,462,30,131,0,12,25.602456193,20-29,457,4,0,0,0,0,0,0,0,0,0,0,0,0.16666667,163,357,4.4780486537007367E-5,0,0,166,0.16666667,1,0,200,0,0,0
843842581,NSAOhio,10,996,360,362,2,0,41.3843921895,40-49,507,4,1,1,2,2,1,1,10,3.641609102,0,0.0143493568,0,0,0,135,4.828105566339335E-5,5.0330927E-5,5.1639556E-5,353,0,0,0,200,0,0,0
268622701,InManibusDei,10,51039,1682,1647,65,132,56.607102171,50-59,853,10,2,3,5,5,2,3,11,4.2466477042,0.4398233885,0.0065210781,0.1,0.6666667,0,135,6.387814258470701E-5,7.549639E-5,7.7459335E-5,353,0.6666667,40,0,200,0,0,0
935377976,Lachelagrappe,10,2869,72,80,0,16,41.7187698214,40-49,656,6,2,2,4,4,2,2,6,3.1818181818,0,0.001136931,0.0833333333,1,38,176,1.520200398329523E-4,7.549639E-5,7.7459335E-5,88,1,10,0,200,0,0,0
24384002,lebatailleur,10,23799,535,464,19,47,44.3236452005,40-49,748,9,3,2,5,5,3,2,10,3.6802112962,174.9906124934,0.0057488189,0.05,0.16666667,0,135,6.0445403596684415E-5,1.00661855E-4,1.0327911E-4,303,0.16666667,6,0,202,0,0,0
1106614572,bulkdiscount,10,51253,460,10,3,0,44.7362312444,40-49,615,9,0,0,0,0,0,0,0,0,0,0,0,0,164,358,4.4780486537007367E-5,0,0,167,0,0,0,195,0,0,0
24121325,O2L,10,2341,256,243,4,11,42.6083299878,40-49,627,6,0,0,0,0,0,0,0,0,0,0,0,0,165,359,4.4780486537007367E-5,0,0,168,0,0,0,199,0,0,0
319742258,RanaldH,10,121,1,6,0,0,11.0632857838,10-19,21,3,0,0,0,0,0,0,0,0,0,0,0,0,166,360,4.4780486537007367E-5,0,0,169,0,0,0,122,0,0,0
446445291,CandlishClown,10,984,52,106,0,5,25.8299215452,20-29,569,4,0,0,0,0,0,0,0,0,0,0,0,0,167,361,4.4780486537007367E-5,0,0,170,0,1,0,199,0,0,0
56399458,1947grandpa,10,1227,27,71,0,5,30.6515532745,30-39,585,5,0,0,0,0,0,0,0,0,0,0,0,0.5,168,362,4.4780486537007367E-5,0,0,171,0.5,4,0,200,0,0,0
28885750,NewYork_Events,10,2708,1488,495,67,0,43.6579912669,40-49,620,5,2,0,2,2,2,0,0,0,0,0.0025293873,0,0,0,122,5.561744717538547E-5,7.549639E-5,0,303,0,7,0,200,0,0,0
912448819,TrishVx,10,77,18,48,0,1,20.4744131217,20-29,248,2,0,1,1,1,0,1,10,3.9346060114,0,0,0,0.6666667,0,363,4.4780486537007367E-5,0,2.5819778E-5,283,0.6666667,0,0,84,0,0,0
438922660,CeibaGroup,10,79,65,151,0,0,18.4448838664,10-19,124,3,0,0,0,0,0,0,0,0,0,0,0,0,169,364,4.4780486537007367E-5,0,0,172,0,1,0,107,0,0,0
177303552,KendallMade,10,562,71,23,2,7,29.0385761834,20-29,477,4,1,0,1,1,1,0,0,0,0,2.4460721920661915E-4,0,0.083333336,0,365,5.1124389058153783E-5,5.0330927E-5,0,283,0.083333336,1,0,200,0,0,0
20636473,djsaiyan,10,9160,459,803,9,7,36.5523304446,30-39,679,6,0,0,0,0,0,0,0,0,0,0,0,0,170,367,4.4780486537007367E-5,0,0,173,0,1,0,200,0,0,0
263891856,Cleon255,10,45574,1560,1321,2,39,43.714075409,40-49,789,9,1,1,2,2,1,1,1,1,0,2.6808524730492474E-4,0,0,171,368,2.9852402567743944E-4,5.0330927E-5,5.1639556E-5,174,0,22,0,202,0,0,0
17964900,ADAction,10,2280,700,574,62,6,46.6911063845,40-49,651,5,3,3,6,6,3,3,11,4.6607070297,22.4798172173,0.0016890182,0.0666666667,0.33333334,0,135,1.058897663225307E-4,1.00661855E-4,1.0327911E-4,303,0.33333334,1,0,200,0,0,0
1112892476,jeffreyawhiteca,10,15,8,14,0,0,12.1265715677,10-19,8,1,0,0,0,0,0,0,0,0,0,0,0,0.33333334,172,370,4.4780486537007367E-5,0,0,175,0.33333334,0,0,20,0,0,0
18592513,Ivan_Avery_Frey,10,83,13,19,0,0,12.3207895825,10-19,53,2,0,0,0,0,0,0,0,0,0,0,0,0,173,371,4.4780486537007367E-5,0,0,176,0,0,0,86,0,0,0
41112530,catmommy23,10,243,5,17,0,0,11.7341444214,10-19,15,4,0,0,0,0,0,0,0,0,0,0,0,0,174,372,4.4780486537007367E-5,0,0,177,0,0,0,200,0,0,0
466603103,Zircorn,10,1297,172,441,1,70,32.3820615268,30-39,400,5,0,0,0,0,0,0,0,0,0,0,0,0,175,373,4.4780486537007367E-5,0,0,178,0,2,0,200,0,0,0
25164154,bradleymw,10,2221,374,115,13,2,42.485949614,40-49,509,5,0,1,1,1,0,1,10,4.3229082047,0,0,0,0.46666667,0,374,5.244376196361784E-5,0,2.5819778E-5,257,0.46666667,13,2,201,2,0.0099502488,0
822198745,moombashley,10,1065,167,581,0,1077,41.5293989339,40-49,570,6,0,0,0,0,0,0,0,0,0,0,0,0.5,176,375,4.4780486537007367E-5,0,0,179,0.5,7,0,200,0,0,0
435094631,Justmax360,10,185,4,26,0,0,11.5576855183,10-19,45,3,0,0,0,0,0,0,0,0,0,0,0,0,177,376,4.4780486537007367E-5,0,0,180,0,0,0,194,0,0,0
181176786,cyberrat46,10,81,5,37,0,1,11.7341444214,10-19,4,3,0,0,0,0,0,0,0,0,0,0,0,0,178,377,4.4780486537007367E-5,0,0,181,0,0,0,112,0,0,0
69505975,ctjn,10,48,47,95,0,0,16.3608738954,10-19,232,2,0,0,0,0,0,0,0,0,0,0,0,0,179,378,4.4780486537007367E-5,0,0,182,0,2,0,51,0,0,0
220518078,johnndp,10,213,7,30,0,3,17.7974754862,10-19,317,3,0,0,0,0,0,0,0,0,0,0,0,0.6666667,180,379,4.4780486537007367E-5,0,0,183,0.6666667,0,0,200,0,0,0
469911910,CodyFields82,10,440,77,238,0,3,40.3553009797,40-49,560,4,0,0,0,0,0,0,0,0,0,0,0,0,181,380,4.4780486537007367E-5,0,0,184,0,0,0,200,0,0,0
1192013226,loo2404,10,47,5,19,0,0,12.3207895825,10-19,71,4,0,1,1,1,0,1,11,4.2814784728,0,0,0,0,0,381,4.4780486537007367E-5,0,2.5819778E-5,257,0,1,0,143,0,0,0
1197136231,KinchhutLatrish,10,15,7,81,0,0,14.4389478168,10-19,37,1,0,0,0,0,0,0,0,0,0,0,0,0,182,382,4.4780486537007367E-5,0,0,185,0,1,0,18,0,0,0
581131583,douglaslaforme,10,315,3,39,0,2,13.2962348455,10-19,352,4,0,0,0,0,0,0,0,0,0,0,0,0,183,383,4.4780486537007367E-5,0,0,186,0,1,0,200,0,0,0
23009685,Sweetthang30,10,1061,91,679,1,0,21.1617114208,20-29,368,4,0,1,1,1,0,1,11,4.4910641755,0,0,0,0.16666667,0,384,4.4780486537007367E-5,0,2.5819778E-5,99,0.16666667,0,0,200,0,0,0
377574684,NYCGreenHouse,10,677,281,146,9,0,39.1305753969,30-39,556,4,1,1,2,2,1,1,1,1,0,2.6808524730492474E-4,0,0,184,385,2.9852402567743944E-4,5.0330927E-5,5.1639556E-5,187,0,15,0,200,0,0,0
33650839,communityp,10,2767,684,637,23,2,42.4795381466,40-49,633,6,1,1,2,2,1,1,1,1,0,2.6808524730492474E-4,0,0,184,385,2.9852402567743944E-4,5.0330927E-5,5.1639556E-5,187,0,70,0,200,0,0,0
595562971,RyanMuddy1,10,170,17,111,0,9,24.5370068431,20-29,379,4,1,0,1,1,1,0,0,0,0,0.0173333675,0,0.5,0,127,4.731630191670526E-5,5.0330927E-5,0,353,0.5,1,0,182,0,0,0
256005257,liordegani,10,1788,460,849,6,219,61.1867104665,60-69,607,6,0,0,0,0,0,0,0,0,0,0,0,0,185,386,4.4780486537007367E-5,0,0,188,0,1,0,200,0,0,0
16744001,shafto3,10,108,31,147,0,1,15.3271531957,10-19,71,1,0,0,0,0,0,0,0,0,0,0,0,0.5,186,387,5.235188313114724E-5,0,0,189,0.5,1,0,109,0,0,0
310425304,bernie8859,10,799,9,40,0,3,23.5544698802,20-29,333,4,1,0,1,1,1,0,0,0,0,0.0062146905,0,0.8333333,0,125,5.251614908581462E-5,5.0330927E-5,0,257,0.8333333,3,0,200,0,0,0
247776029,adrianasn11,10,11623,229,286,0,1012,45.3065869954,40-49,745,7,0,0,0,0,0,0,0,0,0,0,0,0,187,388,4.4780486537007367E-5,0,0,190,0,26,0,201,0,0,0
148821315,cstocovaz,10,312,11,38,0,0,41.2339975169,40-49,281,4,0,0,0,0,0,0,0,0,0,0,0,0.8333333,188,389,4.4780486537007367E-5,0,0,191,0.8333333,0,0,200,0,0,0
42691701,lucyfukushima,10,493,37,243,0,2,22.3547546888,20-29,195,4,0,0,0,0,0,0,0,0,0,0,0,0.4,189,390,4.553966086114525E-5,0,0,192,0.4,0,0,200,0,0,0
751791666,Adigence,10,1328,644,605,8,1,44.1294840335,40-49,593,6,0,0,0,0,0,0,0,0,0,0,0,0,190,391,4.4780486537007367E-5,0,0,193,0,1,0,200,0,0,0
1038618348,nathandueck,10,73,9,19,0,0,22.4985591915,20-29,229,3,0,0,0,0,0,0,0,0,0,0,0,0,191,392,4.4780486537007367E-5,0,0,194,0,3,0,90,0,0,0
117247943,jafroese,10,58,9,25,0,2,16.7576971628,10-19,100,2,0,0,0,0,0,0,0,0,0,0,0,0,192,394,4.4780486537007367E-5,0,0,195,0,5,0,61,0,0,0
43568344,loreleemarin,10,325,70,145,0,9,21.219721316,20-29,480,4,1,1,2,2,1,1,11,4.0837058106,0,0.0163321031,0,0.7619048,0,135,6.042858578572334E-5,5.0330927E-5,5.1639556E-5,353,0.7619048,3,1,200,1,0.005,0
879136458,Mamie_Careyn,10,140,52,158,0,0,25.9755965193,20-29,264,2,0,0,0,0,0,0,0,0,0,0,0,0,193,396,4.4780486537007367E-5,0,0,196,0,0,0,194,0,0,0
138121045,JP3Magalhaes,10,3031,113,245,2,158,35.2710248784,30-39,663,6,0,0,0,0,0,0,0,0,0,0,0,0,194,397,4.4780486537007367E-5,0,0,197,0,11,0,199,0,0,0
342136282,SLEnergy,10,1899,335,1334,7,6,42.116328405,40-49,500,5,0,3,3,3,0,3,12,4.7258326564,0,0,0.1666666667,0.16666667,0,398,4.4780486537007367E-5,0,2.5819778E-5,353,0.16666667,0,0,200,0,0,0
123035624,WaffleWolfer,10,1446,22,23,2,31,24.7533441756,20-29,584,5,0,0,0,0,0,0,0,0,0,0,0,0,195,399,4.4780486537007367E-5,0,0,198,0,0,0,199,0,0,0
13230662,DianneKnight,10,394,1268,1948,2,6,29.6361403349,20-29,536,4,0,1,1,1,0,1,10,4.3574329813,0,0,0,0.39285713,0,400,6.053091611183764E-5,0,2.5819778E-5,267,0.39285713,0,0,200,0,0,0
189004642,kristruelsen,10,58,37,40,0,3,17.2096651077,10-19,227,3,0,0,0,0,0,0,0,0,0,0,0,0,196,401,4.4780486537007367E-5,0,0,199,0,0,0,58,0,0,0
15636921,LloydHLawrence,10,213,9,6,0,1,14.7471614865,10-19,230,4,1,1,2,2,1,1,11,4.8976026006,0,8.095362124183002E-4,0,0,0,135,5.1872112453307355E-5,5.0330927E-5,5.1639556E-5,257,0,1,1,185,1,0.0054054054,0
484065654,KuShMaNz,10,315,219,644,1,13,33.4538752896,30-39,530,4,4,7,11,11,4,7,9,3.913856156,34.9110869458,0.0110420978,0.1181818182,0.5952381,0,135,6.70683382178823E-5,1.2582731E-4,1.2909889E-4,99,0.5952381,1,0,200,0,0,0
43005927,imHannanymous,10,14390,312,277,0,1955,48.8665017319,40-49,750,7,0,0,0,0,0,0,0,0,0,0,0,0,197,402,4.4780486537007367E-5,0,0,200,0,10,0,201,0,0,0
203949424,adrianteoyc,10,182,87,349,1,1,41.1372218726,40-49,352,3,0,0,0,0,0,0,0,0,0,0,0,0,198,403,4.4780486537007367E-5,0,0,201,0,1,0,188,0,0,0
919815234,youngdejan,10,80,77,122,0,55,39.4069160094,30-39,448,3,1,1,2,2,1,1,1,1,0,2.6808524730492474E-4,0,0,199,404,2.9852402567743944E-4,5.0330927E-5,5.1639556E-5,208,0,15,0,131,0,0,0
35494350,celuss,10,2540,206,401,4,0,37.7252638877,30-39,653,6,0,0,0,0,0,0,0,0,0,0,0,0,200,405,4.4780486537007367E-5,0,0,202,0,1,0,200,0,0,0
496253544,KcwhyteC,10,1101,34,67,0,80,24.1670129837,20-29,395,6,0,0,0,0,0,0,0,0,0,0,0,0.75,201,406,4.5771838259536714E-5,0,0,203,0.75,0,2,201,2,0.0099502488,0
374184788,NicholasBrake,10,213,59,122,0,3,20.1950660534,20-29,355,4,1,1,2,2,1,1,11,3.8090207233,0,0.0241051796,0,0,0,135,4.9481557891212485E-5,5.0330927E-5,5.1639556E-5,353,0,1,0,194,0,0,0
1267627562,DoctorT_D,10,79,26,70,0,0,40.3333448005,40-49,442,3,0,0,0,0,0,0,0,0,0,0,0,0,202,407,4.4780486537007367E-5,0,0,204,0,2,0,111,0,0,0
248827135,chamberlainusoh,10,4902,6721,175,41,8,60.8636863668,60-69,787,6,3,1,4,4,3,1,2,1.5,5,8.298924180872802E-4,0,0,0,266,1.8362925590659695E-4,1.00661855E-4,1.0327911E-4,205,0,8,0,200,0,0,0
463569382,KeratanChiefo,10,2470,167,464,0,72,42.8537721532,40-49,622,6,1,2,3,3,1,2,1,1,1,3.1613679724031344E-4,0,0,0,266,2.0086536655335947E-4,5.0330927E-5,5.1639556E-5,205,0,33,0,199,0,0,0
732658308,latrinazgziegle,10,102,25,482,0,0,,,49,2,0,0,0,0,0,0,0,0,0,0,0,0,203,408,4.4780486537007367E-5,0,0,206,0,0,0,106,0,0,0
707226692,HMCBV,10,64,27,33,0,0,19.7087516881,10-19,217,2,0,0,0,0,0,0,0,0,0,0,0,0,204,409,4.4780486537007367E-5,0,0,207,0,7,0,79,0,0,0
398307307,FrahmBahmb,10,1435,121,129,0,101,39.0190830795,30-39,625,5,1,1,2,2,1,1,1,1,0,2.6808524730492474E-4,0,0,199,404,2.9852402567743944E-4,5.0330927E-5,5.1639556E-5,208,0,18,0,200,0,0,0
741659616,stefanodimeran,10,184,19,49,0,0,26.9362496537,20-29,208,3,0,0,0,0,0,0,0,0,0,0,0,0,205,410,4.4780486537007367E-5,0,0,209,0,0,0,200,0,0,0
340188238,onanongruengjan,10,69,12,54,0,2,12.4824719478,10-19,262,2,0,0,0,0,0,0,0,0,0,0,0,0,206,412,4.4780486537007367E-5,0,0,210,0,3,0,72,0,0,0
20565770,joelduggan,10,13384,1147,476,97,43,59.2630223065,50-59,756,8,2,2,4,4,2,2,11,4.8886631451,4449.0501321096,0.0029398321,0,0,0,135,1.1475081413112345E-4,7.549639E-5,7.7459335E-5,343,0,23,0,200,0,0,0
86378138,JuliaKinsman,10,2279,156,403,8,677,41.3844809787,40-49,601,5,2,2,4,4,2,2,12,5.863876473,46.6946485046,6.680513913937163E-4,0,0,0,135,1.3005179785308656E-4,7.549639E-5,7.7459335E-5,343,0,4,0,200,0,0,0
66066925,ritgup,10,1758,152,46,5,1,45.940149925,40-49,564,5,0,0,0,0,0,0,0,0,0,0,0,0,207,413,4.4780486537007367E-5,0,0,211,0,1,0,200,0,0,0
361428694,leticiaacutrim,10,1190,159,164,0,92,43.4398232228,40-49,626,5,1,1,2,2,1,1,1,1,0,2.6808524730492474E-4,0,0,208,414,2.9852402567743944E-4,5.0330927E-5,5.1639556E-5,229,0,27,0,201,0,0,0
514642261,Reyitaas,10,3035,176,162,0,6,40.54988497,40-49,684,6,5,5,10,10,5,5,1,1,0.75,0.0018317203,0.1,0.85,209,415,3.29751550043913E-4,1.5099278E-4,1.5491867E-4,416,0.85,46,0,200,0,0,0
267462180,Aaron_Stamper9,10,7174,4700,442,1,770,52.0856174916,50-59,734,7,3,4,7,7,3,4,1,1,6,8.867917590647982E-4,0.0714285714,0.41666666,98,259,3.462198478431495E-4,1.00661855E-4,1.0327911E-4,90,0.41666666,15,0,196,0,0,0
103950335,officialtellem_,10,11638,498,475,1,177,55.3457853135,50-59,726,8,2,2,4,4,2,2,2,1.3333333333,0,6.391069814618759E-4,0.0833333333,1,210,416,2.4453587828285984E-4,7.549639E-5,7.7459335E-5,212,1,30,0,203,0,0,0
18975909,hervella,10,8227,3289,2538,337,22,57.9554727858,50-59,776,8,2,2,4,4,2,2,10,5.7647297846,120.5,8.241804164120513E-4,0,0,0,135,1.9386352469239444E-4,7.549639E-5,7.7459335E-5,148,0,0,0,200,0,0,0
293196522,JakeC_SBG,10,8140,575,567,1,500,35.7873137957,30-39,736,7,1,1,2,2,1,1,2,1.75,0,3.18486474568927E-4,0,0,98,259,1.1835168135136378E-4,5.0330927E-5,5.1639556E-5,90,0,11,0,199,0,0,0
205834289,emeka_efidi,10,15029,1002,946,1,6,60.0762141272,60-69,763,8,3,3,6,6,3,3,1,1,1,9.114602066337551E-4,0.0666666667,0.6666667,210,416,3.525121730720189E-4,1.00661855E-4,1.0327911E-4,212,0.6666667,84,0,201,0,0,0
170041767,FraIsgaRcoN,10,33278,948,917,1,61,48.7480120255,40-49,790,8,3,3,6,6,3,3,1,1,1,9.114602066337551E-4,0.0666666667,0.6666667,210,416,3.525121730720189E-4,1.00661855E-4,1.0327911E-4,212,0.6666667,107,0,201,0,0,0
610589750,md_laolu,10,16327,335,260,1,15,46.5481207758,40-49,772,8,2,2,4,4,2,2,2,1.3333333333,0,6.391069814618759E-4,0.0833333333,1,210,416,2.4453587828285984E-4,7.549639E-5,7.7459335E-5,212,1,46,0,201,0,0,0
37827784,intelicode,10,1902,793,1704,11,44,36.9163644443,30-39,579,5,3,2,5,5,3,2,2,1.5,0,9.631556311462233E-4,0.15,1,211,417,3.0742779325956316E-4,1.00661855E-4,1.0327911E-4,261,1,11,0,200,0,0,0
322802999,AddShoppers,10,1348,883,1335,23,1,43.8825427589,40-49,635,6,1,1,2,2,1,1,3,2.2222222222,7.8,2.4460721920661915E-4,0,0,0,418,6.38121941004466E-5,5.0330927E-5,2.5819778E-5,148,0,8,0,200,0,0,0
60500762,peterbtriassi,10,320,78,298,1,25,26.7176481197,20-29,455,3,1,0,1,1,1,0,0,0,0,0.0046989067,0,0,0,130,4.724175670871345E-5,5.0330927E-5,0,267,0,1,0,200,0,0,0
1116102128,Dexplorar,10,428,121,89,1,41,40.2433694231,40-49,441,3,0,0,0,0,0,0,0,0,0,0,0,0,212,419,4.4780486537007367E-5,0,0,213,0,0,0,200,0,0,0
250164587,as_LSL,10,173,32,71,0,25,13.4410238165,10-19,84,3,0,0,0,0,0,0,0,0,0,0,0,0.5,213,420,9.152841714394098E-5,0,0,214,0.5,0,0,177,0,0,0
22329923,fwhite46,10,176,10,25,0,2,16.9166760892,10-19,220,3,0,0,0,0,0,0,0,0,0,0,0,0,214,421,4.4780486537007367E-5,0,0,215,0,1,0,180,0,0,0
46396082,chowamis,10,199,1100,1401,10,0,47.3690169264,40-49,491,3,0,0,0,0,0,0,0,0,0,0,0,0,215,422,4.4780486537007367E-5,0,0,216,0,1,0,200,0,0,0
111120328,pautefacil,10,345,614,477,10,3,37.3822406806,30-39,585,3,0,0,0,0,0,0,0,0,0,0,0,0,216,423,4.4780486537007367E-5,0,0,217,0,4,0,200,0,0,0
560765411,36Emmet,10,155,5,9,0,1,17.4414173747,10-19,383,3,1,1,2,2,1,1,10,4.1288094271,0,0.0016367396,0,0,0,135,4.6998751278856705E-5,5.0330927E-5,5.1639556E-5,99,0,0,0,155,0,0,0
1153290691,kogisdgsdfg,10,1977,0,1,0,0,,,25,0,0,0,0,0,0,0,0,0,0,0,0,0,217,424,4.4780486537007367E-5,0,0,218,0,0,0,201,0,0,0
1218767424,erierixxchu,10,1109,323,339,0,0,39.9507881449,30-39,493,6,0,1,1,1,0,1,9,4.621039805,0,0,0,0,0,425,4.4780486537007367E-5,0,2.5819778E-5,148,0,0,0,201,0,0,0
852052230,richellebenoit,10,317,67,282,0,20,33.7402581819,30-39,485,4,0,1,1,1,0,1,10,4.3229082047,0,0,0,0.21428572,0,426,5.384359899980077E-5,0,2.5819778E-5,257,0.21428572,17,0,201,0,0,0
878546018,wjgreen_,10,4121,1180,1612,16,173,53.5059893386,50-59,703,7,1,3,4,4,1,3,11,3.8411214953,0,0.0180937383,0.25,1,0,135,4.900707065209591E-5,5.0330927E-5,5.1639556E-5,353,1,1,1,201,1,0.0049751244,0
365088087,steph_haldane,10,1072,158,363,0,205,35.7702966387,30-39,557,5,0,0,0,0,0,0,0,0,0,0,0,0,218,427,4.4780486537007367E-5,0,0,219,0,1,0,200,0,0,0
37513164,financialdude1,10,7708,80,25,0,0,42.3909593416,40-49,552,9,0,0,0,0,0,0,0,0,0,0,0,0,219,428,4.4780486537007367E-5,0,0,220,0,1,1,201,1,0.0049751244,0
206255781,jleclair_Btfd,10,3241,308,268,8,69,46.3243881947,40-49,663,6,0,1,1,1,0,1,11,5.1007311129,0,0,0,0,0,429,5.2088774069150574E-5,0,2.5819778E-5,99,0,2,2,201,2,0.0099502488,0
318577966,RichardPatey,10,1096,863,1999,18,5,55.1147217567,50-59,649,6,0,0,0,0,0,0,0,0,0,0,0,0,220,431,4.4780486537007367E-5,0,0,221,0,6,0,200,0,0,0
480897676,shortstuff521,10,577,11,154,0,376,29.7198114896,20-29,495,5,0,1,1,1,0,1,11,4.3614947197,0,0,0,0.41111112,0,432,4.4780486537007367E-5,0,2.5819778E-5,71,0.41111112,1,3,201,3,0.0149253731,0
86216486,RSN_Godot,10,12413,2091,241,134,0,52.4680944997,50-59,748,3,7,1,8,8,7,1,11,5.0170662332,212.7173780647,0.0142708459,0.0714285714,0.08928572,0,135,7.127811861386601E-5,2.0132371E-4,2.0655822E-4,71,0.08928572,0,0,200,0,0,0
54251346,arlookingbill,10,6033,165,164,0,635,43.0387586087,40-49,668,6,1,1,2,2,1,1,1,1,0,2.6808524730492474E-4,0,0,65,219,2.9852402567743944E-4,5.0330927E-5,5.1639556E-5,222,0,18,0,201,0,0,0
46420869,librariantechie,10,554,356,837,9,157,47.0006366989,40-49,535,5,3,4,7,7,3,4,11,3.7594473791,709.0235951828,0.0066976831,0.0952380952,0.41666666,0,135,6.760814706039866E-5,1.00661855E-4,1.0327911E-4,303,0.41666666,0,0,201,0,0,0
296482531,Tigergal62,10,11234,712,977,25,574,38.1637470261,30-39,686,8,2,3,5,5,2,3,11,4.1901665989,153.6370471306,0.0039050899,0.05,0.16666667,0,135,6.379014922957469E-5,7.549639E-5,7.7459335E-5,303,0.16666667,5,0,198,0,0,0
322367885,hedgeit_tcronin,10,8986,2509,515,76,128,54.7710821348,50-59,748,7,0,0,0,0,0,0,0,0,0,0,0,0,221,433,4.4780486537007367E-5,0,0,223,0,0,0,43,0,0,0
17178342,drmaggiesa,10,4227,258,1047,10,649,43.3269072343,40-49,617,7,1,2,3,3,1,2,11,4.2397399431,13.1598239219,0.0026278461,0,0,0,135,5.8129038212847856E-5,5.0330927E-5,5.1639556E-5,303,0,0,0,199,0,0,0
18703833,kerrie12345,10,106,17,49,0,7,17.5152534531,10-19,239,3,1,1,2,2,1,1,11,4.3315725315,0,0.0053691105,0,0.75,0,135,4.909407424415506E-5,5.0330927E-5,5.1639556E-5,257,0.75,0,1,116,1,0.0086206897,0
244622688,HomeRobert,10,764,21,74,0,1,18.249115778,10-19,235,4,0,0,0,0,0,0,0,0,0,0,0,0.52380955,222,434,9.104040384044588E-5,0,0,224,0.52380955,12,0,200,0,0,0
586185825,Greg__V,10,34312,398,142,1,1,38.5209166949,30-39,785,8,11,7,18,18,11,7,6,2.8181818182,76.4150793651,0.0053570944,0.1045751634,0.5272727,38,176,5.99313163458045E-4,3.0198556E-4,3.0983734E-4,88,0.5272727,44,0,203,0,0,0
721201848,Morganovitch_,10,34453,695,139,4,323,41.962825981,40-49,787,8,7,3,10,10,7,3,7,3.6363636364,0.65,0.0034217327,0.1666666667,0.64285713,38,176,3.565397147892313E-4,2.0132371E-4,2.0655822E-4,88,0.64285713,20,0,201,0,0,0
41362246,calfoss,10,3480,123,292,0,0,33.3024146171,30-39,402,5,0,0,0,0,0,0,0,0,0,0,0,0,223,435,4.4780486537007367E-5,0,0,225,0,0,0,201,0,0,0
72506180,royhunter2009,10,5498,80,367,2,74,30.8988073502,30-39,587,6,0,0,0,0,0,0,0,0,0,0,0,0,224,436,4.4780486537007367E-5,0,0,226,0,1,0,200,0,0,0
1272650227,ScareDeeCat2000,10,20,5,18,0,0,24.2228062601,20-29,276,3,0,0,0,0,0,0,0,0,0,0,0,0.5,225,437,4.4780486537007367E-5,0,0,227,0.5,1,1,82,1,0.012195122,0
521738852,ChrisMadih,10,11076,96,79,0,18,32.3812402806,30-39,733,7,0,0,0,0,0,0,0,0,0,0,0,0,226,438,4.4780486537007367E-5,0,0,228,0,4,0,200,0,0,0
98162037,sweetmonst3r,10,17360,643,1237,8,256,43.3418119252,40-49,729,8,1,1,2,2,1,1,1,1,0,2.6808524730492474E-4,0,0,208,414,2.9852402567743944E-4,5.0330927E-5,5.1639556E-5,229,0,10,0,200,0,0,0
324489515,DanCas2,10,95282,1199,1992,26,420,45.9351011315,40-49,761,10,7,3,10,10,7,3,11,4.3145062983,265.0127757902,0.0066053817,0.1111111111,0.22222222,0,135,1.4364123766382863E-4,2.0132371E-4,2.0655822E-4,303,0.22222222,0,0,201,0,0,0
241630348,joe1scott1,10,486,10,8,1,7,19.5453400169,10-19,379,4,2,2,4,4,2,2,11,4.3677366924,65.4226865407,0.004903064,0,0,0,135,5.1683332907338564E-5,7.549639E-5,7.7459335E-5,257,0,4,0,197,0,0,0
246901576,dakTdek,10,74,49,46,0,1,35.4545034262,30-39,439,3,7,7,14,14,7,7,10,3.7720438846,3125.1090089135,0.0188312432,0.1263736264,0.5694444,0,135,1.403782651902971E-4,2.0132371E-4,2.0655822E-4,283,0.5694444,16,1,93,1,0.0107526882,0
398897629,awanderingsky,10,2270,83,336,2,0,30.4299759843,30-39,599,6,0,0,0,0,0,0,0,0,0,0,0,0.33333334,227,440,4.4780486537007367E-5,0,0,230,0.33333334,0,0,200,0,0,0
704055756,OrlandoMisfit,10,6379,42,194,2,12,38.6087220119,30-39,485,7,2,1,3,3,2,1,11,4.379926859,0,0.004042495,0.1666666667,1,0,135,6.185020090348513E-5,7.549639E-5,7.7459335E-5,303,1,0,0,201,0,0,0
22253014,JuanPittau,10,34334,9894,8333,326,10,59.5979097751,50-59,779,8,9,8,17,17,9,8,9,4.7724502235,197686.02501844,0.0029704472,0,0,0,135,4.893688019295989E-4,2.5165462E-4,2.32378E-4,148,0,12,0,201,0,0,0
146532434,Julio_JDR,10,3881,186,652,0,32,54.0947521194,50-59,551,6,1,1,2,2,1,1,10,5.7720438846,0,4.760016851921617E-4,0,0,0,135,9.677607339940816E-5,5.0330927E-5,5.1639556E-5,148,0,1,0,201,0,0,0
132378897,realyst2k,10,2285,43,90,0,49,31.3264580929,30-39,552,6,0,0,0,0,0,0,0,0,0,0,0,0.5,228,441,4.6617225370003676E-5,0,0,231,0.5,2,2,200,2,0.01,0
14862531,DerfVader,10,1287,135,579,1,135,22.0937866908,20-29,469,5,0,1,1,1,0,1,11,4.9423233144,0,0,0,0.61538464,0,442,7.373707279410766E-5,0,2.5819778E-5,99,0.61538464,0,0,200,0,0,0
171236379,LW709,10,2490,149,181,0,1964,33.3251716379,30-39,571,6,2,2,4,4,2,2,10,4.6911824462,0,0.0037311471,0.0833333333,1,0,135,6.925294332108141E-5,7.549639E-5,7.7459335E-5,343,1,15,0,199,0,0,0
508785291,_BlaackDiamond,10,23270,616,358,2,396,39.4549198108,30-39,775,8,4,4,8,8,4,4,7,3.1515151515,143.9238095238,0.0015902412,0.0178571429,0.16666667,38,176,2.255048039329575E-4,1.2582731E-4,1.2909889E-4,88,0.16666667,24,0,201,0,0,0
177671430,MissFIoyd,10,1959,281,260,16,22,37.4505868575,30-39,652,5,1,1,2,2,1,1,10,5.7720438846,0,4.760016851921617E-4,0,0,0,135,9.677607339940816E-5,5.0330927E-5,5.1639556E-5,148,0,2,0,200,0,0,0
423070189,Sammyvandrunen,10,1068,155,121,0,17,40.561168203,40-49,609,4,1,1,2,2,1,1,1,1,0,2.6808524730492474E-4,0,0,229,443,2.9852402567743944E-4,5.0330927E-5,5.1639556E-5,235,0,7,0,199,0,0,0
353995991,skapindo,10,8395,119,235,0,1,41.0454010833,40-49,625,7,0,0,0,0,0,0,0,0,0,0,0,0,230,444,4.7706985717987906E-5,0,0,232,0,0,0,201,0,0,0
98314052,MakeEmSay_Oww,10,37037,536,378,1,49,33.5787166801,30-39,774,8,2,2,4,4,2,2,1,1,0,5.875113113304263E-4,0.0833333333,1,231,445,2.985240256774393E-4,7.549639E-5,7.7459335E-5,233,1,4,0,200,0,0,0
66895826,Bcoox,10,909,108,156,4,37,30.2003080366,30-39,549,5,0,0,0,0,0,0,0,0,0,0,0,0,232,446,4.4780486537007367E-5,0,0,234,0,1,0,199,0,0,0
242477265,_brigitteee,10,10409,247,196,0,929,35.0692115294,30-39,716,7,1,1,2,2,1,1,1,1,0,2.6808524730492474E-4,0,0,229,443,2.9852402567743944E-4,5.0330927E-5,5.1639556E-5,235,0,13,0,200,0,0,0
552830823,Eh_riick,10,6704,85,67,0,64,43.050931167,40-49,705,7,1,1,2,2,1,1,9,4.9696969697,0,2.952535992387853E-4,0,0,38,176,9.35838373612677E-5,5.0330927E-5,5.1639556E-5,88,0,10,0,201,0,0,0
559146347,Manzell_mata,10,7572,237,246,0,57,47.2766958538,40-49,714,7,2,3,5,5,2,3,8,4,68.2666666667,6.281563927359252E-4,0,0,38,176,1.7224671998761069E-4,7.549639E-5,7.7459335E-5,88,0,38,0,201,0,0,0
1262402966,cantbeeserious,10,39,3,18,0,0,22.905235186,20-29,186,3,1,0,1,1,1,0,0,0,0,0.0015505512,0,0.23333333,0,69,5.018247648201187E-5,5.0330927E-5,0,257,0.23333333,1,1,91,1,0.010989011,0
995325540,githahardictan3,10,10,37,158,0,10,19.941758684,10-19,117,2,0,0,0,0,0,0,0,0,0,0,0,0,233,447,4.4780486537007367E-5,0,0,236,0,0,0,12,0,0,0
513824018,MeetCaseyB,10,4185,5575,6120,24,9,47.736882462,40-49,686,5,2,2,4,4,2,2,9,5.3640796424,0,9.148850823728034E-4,0.0833333333,1,0,135,1.2781885145429095E-4,7.549639E-5,7.7459335E-5,148,1,0,0,204,0,0,0
801743592,v_diz,10,3473,124,235,5,2390,45.2188042443,40-49,633,6,1,1,2,2,1,1,11,4.7257212515,0,4.232352472383554E-4,0,0.33333334,0,135,4.760373178111833E-5,5.0330927E-5,5.1639556E-5,99,0.33333334,2,0,200,0,0,0
528006485,TrentDryad,10,341,10,16,0,0,12.3207895825,10-19,443,3,1,0,1,1,1,0,0,0,0,0.0049830681,0,0.47619048,0,70,4.714170574410645E-5,5.0330927E-5,0,257,0.47619048,2,1,200,1,0.005,0
272214370,ClaysonBra,10,1101,452,696,0,68,30.1834551259,30-39,509,5,0,0,0,0,0,0,0,0,0,0,0,0,234,448,4.4780486537007367E-5,0,0,237,0,6,0,200,0,0,0
497213370,HeadlineNewsBC,10,8577,327,327,0,0,40.4944616942,40-49,615,4,3,3,6,6,3,3,10,3.5794392523,67.9069093053,0.0165613438,0.0666666667,0.6666667,0,135,5.077473061525102E-5,1.00661855E-4,1.0327911E-4,71,0.6666667,2,0,201,0,0,0
494329128,ShaneMiersch,10,29,18,50,0,1,22.9921796915,20-29,169,3,0,0,0,0,0,0,0,0,0,0,0,0,235,449,4.4780486537007367E-5,0,0,238,0,0,1,31,1,0.0322580645,0
17411801,niclariviere,10,720,143,225,2,14,48.6236758848,40-49,557,5,1,2,3,3,1,2,9,4.3831775701,0,0.0017567223,0.1666666667,1,0,135,5.69906247607208E-5,5.0330927E-5,5.1639556E-5,267,1,0,0,201,0,0,0
147190097,aminumuky,10,4381,123,115,1,108,29.5034044423,20-29,543,6,0,0,0,0,0,0,0,0,0,0,0,0,236,450,4.4780486537007367E-5,0,0,239,0,0,0,200,0,0,0
459561197,Nells18,10,5178,205,355,1,1,43.7012857733,40-49,660,6,0,0,0,0,0,0,0,0,0,0,0,0,237,451,4.4780486537007367E-5,0,0,240,0,21,0,200,0,0,0
1238445726,hikarinspace,10,1593,434,463,0,0,40.3646786837,40-49,521,6,0,0,0,0,0,0,0,0,0,0,0,0,238,452,4.790338355077782E-5,0,0,241,0,0,0,201,0,0,0
263580149,55FiftyFive55,10,674,580,91,24,0,42.9612783517,40-49,592,4,4,1,5,5,4,1,1,1,2454,0.0011785778,0,0,0,111,6.681792381853696E-4,1.2582731E-4,1.0327911E-4,148,0,15,0,200,0,0,0
7638772,D_V,10,420,112,91,4,0,29.7955957126,20-29,553,3,1,1,2,2,1,1,1,1,0,3.429937690887501E-4,0,0,0,111,6.127222374028747E-4,5.0330927E-5,5.1639556E-5,148,0,2,0,200,0,0,0
192814611,lynneheal,10,5992,161,2002,2,5973,41.0902734014,40-49,556,6,1,1,2,2,1,1,1,1,0,3.130319509972524E-4,0,0.5,0,178,8.972493312360835E-5,5.0330927E-5,5.1639556E-5,71,0.5,17,0,201,0,0,0
16646460,David_Rentzsch,10,2370,88,277,1,5,38.0825374099,30-39,585,5,0,0,0,0,0,0,0,0,0,0,0,0,239,453,4.4780486537007367E-5,0,0,242,0,2,0,199,0,0,0
149120710,GeekMasque,10,560,116,355,0,1,26.4629712234,20-29,455,4,0,1,1,1,0,1,2,1.5,0,0,0,0,0,454,4.4780486537007367E-5,0,2.5819778E-5,148,0,1,0,200,0,0,0
38158508,jeroenu,10,3230,375,279,11,3,38.470726029,30-39,568,5,3,2,5,5,3,2,2,1.3333333333,4,8.320549263577297E-4,0.1,0.33333334,29,165,4.947234369086922E-4,1.00661855E-4,1.0327911E-4,243,0.33333334,2,0,199,0,0,0
90445427,loostende,10,319,171,152,7,2,48.9618632104,40-49,478,4,2,1,3,3,2,1,3,2,0,5.86383930085144E-4,0.1666666667,1,29,165,3.2729608963202894E-4,7.549639E-5,7.7459335E-5,243,1,0,0,200,0,0,0
17482189,ejvanvuuren,10,388,102,102,4,5,43.0790964135,40-49,479,3,1,1,2,2,1,1,2,1.6666666667,0,2.701854699824681E-4,0.5,1,29,165,1.1704024304684287E-4,5.0330927E-5,5.1639556E-5,243,1,1,0,200,0,0,0
221250086,reidrraymond,10,544,49,86,0,11,26.2657801497,20-29,476,4,0,0,0,0,0,0,0,0,0,0,0,0.9027778,240,455,4.4780486537007367E-5,0,0,244,0.9027778,1,0,200,0,0,0
111624312,hill_chris,10,1456,169,467,1,5,49.0680221491,40-49,594,5,1,1,2,2,1,1,10,4.1072734661,0,0.0034765439,0,0.5694444,0,135,4.760600506570529E-5,5.0330927E-5,5.1639556E-5,343,0.5694444,0,0,200,0,0,0
22313084,JamesRADunn,10,92,16,71,0,41,23.8016531743,20-29,258,2,0,0,0,0,0,0,0,0,0,0,0,0.8333333,241,456,4.4780486537007367E-5,0,0,245,0.8333333,4,0,102,0,0,0
63805938,DFinanciero,10,50301,42464,139,939,7,69.7948431764,60-69,897,6,21,0,21,21,21,0,0,0,0,0.0067888632,0.0428571429,0.06428572,0,28,5.275711142305934E-4,5.536402E-4,0,148,0.06428572,67,0,208,0,0,0
167132271,Estrategiacl,10,41303,20589,8642,505,8,55.7277089819,50-59,882,6,15,5,20,20,15,5,13,8.7098740349,12279.3,0.0050600815,0.0368421053,0.0952381,0,135,3.9664615074059856E-4,4.0264742E-4,3.6147688E-4,148,0.0952381,19,0,203,0,0,0
146087611,Emol,10,51010,401026,161655,3556,96,73.9669536832,70-79,986,8,24,22,46,46,24,22,11,6.7171881349,146601.100000002,0.0076906637,0.0381642512,0.09677419,0,135,5.995906336035045E-4,6.291366E-4,5.4221536E-4,148,0.09677419,19,0,201,0,0,0
155944229,javiervegac,10,5764,131,510,3,42,34.3899965974,30-39,485,7,1,4,5,5,1,4,12,7.7143437627,1839.35,6.368043784275767E-4,0.15,0.25,0,135,1.122103523552837E-4,5.0330927E-5,5.1639556E-5,148,0.25,0,0,201,0,0,0
256508013,CER_Chile,10,267,1501,49,45,1,48.5401135115,40-49,648,3,2,4,6,6,2,4,12,7.7139374238,5,0.0016128466,0.1,0.33333334,0,135,1.8630248228475728E-4,7.549639E-5,7.7459335E-5,148,0.33333334,7,0,200,0,0,0
183076776,Prespssp,10,102,28,18,1,0,34.4028037001,30-39,434,3,2,0,2,2,2,0,0,0,0,0.0024906885,0.5,1,0,67,5.2589004262889535E-5,7.549639E-5,0,257,1,2,0,120,0,0,0
615702478,angelovallejosf,10,1934,295,816,0,0,20.8514194501,20-29,536,6,0,4,4,4,0,4,12,7.7116165719,0,0,0.25,0.33333334,0,457,4.4780486537007367E-5,0,2.5819778E-5,148,0.33333334,1,0,199,0,0,0
90227660,24HorasTVN,10,90371,883441,183,5631,15,78.2272691363,70-79,990,8,25,0,25,25,25,0,0,0,0,0.0080798286,0.0416666667,0.065,0,29,5.474016130327693E-4,6.54302E-4,0,148,0.065,142,0,201,0,0,0
123164736,huyoa,10,101895,2546,2581,83,1371,52.7261417599,50-59,842,9,3,5,8,8,3,5,12,7.713124746,2450.8833333333,0.0015483313,0.0892857143,0.4,0,135,1.0539543819392093E-4,1.00661855E-4,1.0327911E-4,148,0.4,1,0,201,0,0,0
456776119,jorgedd_91,10,690,47,117,1,1,38.5819919118,30-39,594,5,0,1,1,1,0,1,1,1,0,0,0,0,0,458,4.4780486537007367E-5,0,2.5819778E-5,148,0,1,0,201,0,0,0
387381118,GuyLafond,10,99,12,48,0,0,14.9088438518,10-19,92,2,0,1,1,1,0,1,12,5.487002437,0,0,0,0.16666667,0,459,4.4780486537007367E-5,0,2.5819778E-5,267,0.16666667,1,0,111,0,0,0
1063688797,Synonomous1,10,18,6,58,0,0,20.6486347106,20-29,102,2,4,6,10,10,4,6,9,3.6623323852,102.0800811385,0.0181207966,0.1777777778,0.5952381,0,135,6.916161610462765E-5,1.2582731E-4,1.2909889E-4,99,0.5952381,2,0,18,0,0,0
503754930,oldschooldookie,10,4667,1289,1893,1,216,40.7873580982,40-49,589,7,2,2,4,4,2,2,12,7.7159691182,1626.9666666667,0.0013042789,0.0833333333,0.5,0,135,1.1648178928206347E-4,7.549639E-5,7.7459335E-5,148,0.5,0,0,200,0,0,0
279758619,gonzalo_barra94,10,69753,1113,1536,4,31,37.5675272228,30-39,704,8,1,3,4,4,1,3,12,7.7155627794,0,8.550376980862657E-4,0.1666666667,0.5,0,135,6.79464955354548E-5,5.0330927E-5,5.1639556E-5,148,0.5,0,0,201,0,0,0
842788621,Fedefruta,10,102,300,27,4,0,42.9402305354,40-49,512,1,1,0,1,1,1,0,0,0,0,2.4460721920661915E-4,0,0,0,460,5.239316956238307E-5,5.0330927E-5,0,148,0,2,0,108,0,0,0
327807599,Carlos_Caimann,10,9302,675,1457,7,26,36.1620595467,30-39,744,7,0,5,5,5,0,5,12,7.7101096224,0,0,0.15,0.2,0,461,4.4780486537007367E-5,0,2.5819778E-5,148,0.2,3,0,200,0,0,0
85606463,teacherace,10,2740,87,324,3,142,34.335487177,30-39,606,6,0,0,0,0,0,0,0,0,0,0,0,0.6789474,242,462,7.860789615630293E-5,0,0,246,0.6789474,6,0,200,0,0,0
1265924923,Zsoom99,10,16,2,21,0,0,15.6708586376,10-19,1,2,0,0,0,0,0,0,0,0,0,0,0,0,243,463,4.4780486537007367E-5,0,0,247,0,0,0,24,0,0,0
451666832,NuckPup,10,4878,512,184,13,23,43.8699818234,40-49,750,7,0,0,0,0,0,0,0,0,0,0,0,0,244,464,4.4780486537007367E-5,0,0,248,0,2,1,200,1,0.005,0
180377030,dorineeee_,10,4140,132,136,0,0,40.838875276,40-49,715,5,0,0,0,0,0,0,0,0,0,0,0,0,245,465,4.4780486537007367E-5,0,0,249,0,2,0,200,0,0,0
1270694791,Tache_Alex,10,34,15,85,0,0,24.1019768134,20-29,94,2,0,0,0,0,0,0,0,0,0,0,0,0.26785713,246,466,4.790338355077782E-5,0,0,250,0.26785713,0,0,50,0,0,0
87769317,La_Segunda,10,32330,209884,2493,2265,3,68.4461381654,60-69,951,6,20,3,23,23,20,3,12,7.7155627794,8589.1,0.0065018981,0.0395256917,0.07380953,0,135,4.1772689945595383E-4,5.2847475E-4,4.1311645E-4,148,0.07380953,22,0,201,0,0,0
636188420,benjalunaguti,10,1987,866,327,0,4,36.8214124538,30-39,507,5,1,2,3,3,1,2,13,8.7139374238,0,8.550376980862657E-4,0.3333333333,0.5,0,135,6.79464955354548E-5,5.0330927E-5,5.1639556E-5,148,0.5,0,0,201,0,0,0
20054216,andrewsutton,10,7171,237,426,10,570,57.4661414757,50-59,690,7,0,1,1,1,0,1,1,1,0,0,0,0.16666667,0,467,4.4780486537007367E-5,0,2.5819778E-5,257,0.16666667,3,0,200,0,0,0
289629680,soychilecl,10,60610,28441,6150,204,0,63.8817473648,60-69,882,6,7,4,11,11,7,4,13,8.706216985,12979.8333333334,0.002872888,0.0454545455,0.23809524,0,135,2.284012929351859E-4,2.0132371E-4,2.0655822E-4,148,0.23809524,7,0,201,0,0,0
735752629,Leyton_ttomas,10,1053,632,637,1,267,27.95430574,20-29,486,5,0,0,0,0,0,0,0,0,0,0,0,0,247,468,4.4780486537007367E-5,0,0,251,0,4,0,200,0,0,0
80063918,Al_Goodhall,10,1804,349,304,14,6,42.1823231528,40-49,615,5,0,1,1,1,0,1,10,4.2656376929,0,0,0,0.6727273,0,469,5.180732819647899E-5,0,2.5819778E-5,71,0.6727273,4,0,200,0,0,0
991559018,Portal_Elite,10,5334,9987,620,7,1,49.1131986918,40-49,669,4,0,3,3,3,0,3,12,7.7132412673,0,0,0.3333333333,0.5,0,470,4.4780486537007367E-5,0,2.5819778E-5,148,0.5,0,0,202,0,0,0
299228664,jermo_8,10,1404,182,145,0,85,37.428132149,30-39,636,6,1,1,2,2,1,1,13,6.1198699716,0,4.728374697072317E-4,0,0,0,135,9.202613453265988E-5,5.0330927E-5,5.1639556E-5,37,0,16,0,198,0,0,0
334800870,thefirstrobg,10,46,13,140,0,0,18.3140902219,10-19,63,2,1,1,2,2,1,1,10,4.211296221,0,0.0019670648,0,0.61904764,0,135,4.842532685708261E-5,5.0330927E-5,5.1639556E-5,343,0.61904764,0,0,48,0,0,0
284495320,musafonia,10,8126,330,282,3,7,46.2482734001,40-49,720,7,2,3,5,5,2,3,14,9.7078423405,0.6,0.0014918421,0.15,0.25,0,135,1.3537636135373113E-4,7.549639E-5,7.7459335E-5,148,0.25,6,0,201,0,0,0
34296179,priosleal,10,17867,227,141,2,114,43.4244054534,40-49,739,8,0,0,0,0,0,0,0,0,0,0,0,0,248,472,4.4780486537007367E-5,0,0,252,0,2,0,201,0,0,0
365574202,kevinjs1977,10,613,83,177,0,31,32.2873924794,30-39,487,5,0,1,1,1,0,1,12,5.1738424045,0,0,0,0.5,0,473,4.4780486537007367E-5,0,2.5819778E-5,353,0.5,2,0,200,0,0,0
591378710,HChandia,10,112,13,94,0,176,12.405003059,10-19,11,4,0,1,1,1,0,1,13,8.7124289196,0,0,0,0,0,474,4.4780486537007367E-5,0,2.5819778E-5,148,0,0,0,201,0,0,0
90606540,naomiduguid,10,6627,1315,175,70,564,55.0231806768,50-59,733,7,1,0,1,1,1,0,0,0,0,2.4460721920661915E-4,0,0,249,475,4.71873769653818E-5,5.0330927E-5,0,253,0,6,0,200,0,0,0
983481974,AngAngieAngela,10,4578,423,681,13,209,54.6204204296,50-59,676,7,2,2,4,4,2,2,11,4.261682243,1173.3306468701,0.0024471209,0,0,0,135,9.372583724690415E-5,7.549639E-5,7.7459335E-5,303,0,4,0,209,0,0,0
411940861,jd_nudo,10,932,38,122,0,8,26.6644277275,20-29,595,5,0,0,0,0,0,0,0,0,0,0,0,0.8333333,250,476,4.4780486537007367E-5,0,0,254,0.8333333,0,0,200,0,0,0
915413804,AIMInternetMktg,10,59,36,122,0,0,18.2883285546,10-19,84,2,0,0,0,0,0,0,0,0,0,0,0,0,251,477,4.4780486537007367E-5,0,0,255,0,0,0,65,0,0,0
40674652,DivoGiulio,10,1807,126,109,2,7,41.1618894203,40-49,639,6,2,1,3,3,2,1,12,5.6265745632,0,0.0020627644,0.1666666667,1,0,135,7.659081318217085E-5,7.549639E-5,7.7459335E-5,353,1,38,0,200,0,0,0
300669060,chewislewis,10,1296,165,158,1,161,40.1167771413,40-49,623,6,0,0,0,0,0,0,0,0,0,0,0,0,252,478,4.4780486537007367E-5,0,0,256,0,7,0,200,0,0,0
360988971,hailthegreatpan,10,694,43,84,1,0,40.3845984512,40-49,739,7,1,2,3,3,1,2,10,4.1852905323,0.5420426149,0.0041609595,0.3333333333,0.5,0,135,4.5659487327114946E-5,5.0330927E-5,5.1639556E-5,99,0.5,0,0,200,0,0,0
281639257,nmthomsen,10,608,432,831,8,32,58.3220966197,50-59,583,5,1,1,2,2,1,1,1,1,0,2.6808524730492474E-4,0,0,253,479,2.9852402567743944E-4,5.0330927E-5,5.1639556E-5,270,0,6,0,199,0,0,0
413381411,nicole_xnicole,10,2010,144,363,0,68,26.7886335241,20-29,548,5,0,0,0,0,0,0,0,0,0,0,0,0,254,480,4.4780486537007367E-5,0,0,258,0,1,0,199,0,0,0
44280511,yardiblack,10,1795,167,482,1,3,40.3416128473,40-49,500,5,0,0,0,0,0,0,0,0,0,0,0,0,255,481,4.4780486537007367E-5,0,0,259,0,1,0,201,0,0,0
18584466,MoniqueAC,10,195,52,452,0,0,18.4660438635,10-19,170,4,0,0,0,0,0,0,0,0,0,0,0,0.5138889,256,482,4.4780486537007367E-5,0,0,260,0.5138889,0,3,199,2,0.0100502513,0
66766337,culberthealth,10,498,404,1147,17,2,40.9855992517,40-49,536,4,2,3,5,5,2,3,2,1.25,0,6.66070843723057E-4,0.15,1,211,417,2.3955451062393376E-4,7.549639E-5,7.7459335E-5,261,1,1,0,200,0,0,0
416083105,AkifaKhan17,10,672,191,252,3,80,25.7984391856,20-29,570,5,0,0,0,0,0,0,0,0,0,0,0,0,257,483,4.4780486537007367E-5,0,0,262,0,2,0,197,0,0,0
17929477,pepprspraypatti,10,3033,52,203,5,379,43.3825544823,40-49,615,5,0,1,1,1,0,1,11,4.2189277011,0,0,0,0.5,0,484,4.4780486537007367E-5,0,2.5819778E-5,283,0.5,1,0,201,0,0,0
327394273,skirri,10,761,27,87,0,6,23.886565494,20-29,490,5,0,1,1,1,0,1,10,3.953696182,0,0,0,0.5095238,0,485,5.3977718244164354E-5,0,2.5819778E-5,99,0.5095238,2,2,200,2,0.01,0
198405522,Jesse_DeTienne,10,7448,684,1313,10,421,47.4109206334,40-49,724,7,1,1,2,2,1,1,2,1.5,0,2.9162299782298695E-4,0,0,258,486,2.29874507414389E-4,5.0330927E-5,5.1639556E-5,271,0,16,0,200,0,0,0
166642906,gjgijsbert,10,2720,319,323,4,25,45.2999047042,40-49,633,5,0,0,0,0,0,0,0,0,0,0,0,0,259,487,4.4780486537007367E-5,0,0,263,0,8,0,200,0,0,0
252401073,RoyalShipyard,10,22923,150,52,4,0,43.5584777351,40-49,596,6,0,0,0,0,0,0,0,0,0,0,0,0.5,260,488,5.0494860569512354E-5,0,0,264,0.5,3,0,201,0,0,0
103735808,curtismarta,10,758,108,529,0,35,25.7523898908,20-29,523,4,1,1,2,2,1,1,10,3.935392117,0,0.0068719943,0,0.44761905,0,135,5.0401915707389886E-5,5.0330927E-5,5.1639556E-5,283,0.44761905,4,1,199,1,0.0050251256,0
1102098822,ErinDaleMariner,10,210,65,144,2,20,32.561547789,30-39,400,3,0,0,0,0,0,0,0,0,0,0,0,0,261,489,4.4780486537007367E-5,0,0,265,0,5,0,200,0,0,0
583022820,Truck_daBea5t,10,9091,284,268,0,11,34.1989201543,30-39,691,6,1,1,2,2,1,1,1,1,0,2.6808524730492474E-4,0,0,262,490,2.9852402567743944E-4,5.0330927E-5,5.1639556E-5,266,0,9,0,201,0,0,0
27576784,adnanraja08,10,1328,72,267,0,108,30.3933079877,30-39,504,5,0,3,3,3,0,3,11,4.2120227457,0,0,0.1666666667,0.33333334,0,491,4.4780486537007367E-5,0,2.5819778E-5,353,0.33333334,6,0,199,0,0,0
324666915,YourDream_Charm,10,1305,124,102,0,2,39.1620078003,30-39,595,5,1,1,2,2,1,1,1,1,0,2.6808524730492474E-4,0,0,262,490,2.9852402567743944E-4,5.0330927E-5,5.1639556E-5,266,0,20,0,201,0,0,0
839357312,cdn_genWhy,10,579,6,59,0,2,13.7975231035,10-19,86,5,1,1,2,2,1,1,10,4.247460382,0,0.0018759017,0,0.530303,0,135,4.7108683956464697E-5,5.0330927E-5,5.1639556E-5,257,0.530303,0,4,200,3,0.015,0
1256231707,hal5464,10,17,1,14,0,4,16.6047033747,10-19,51,0,0,0,0,0,0,0,0,0,0,0,0,0,263,492,4.4780486537007367E-5,0,0,268,0,0,0,33,0,0,0
49772096,Larhanya,10,1018,78,144,6,14,25.5113266064,20-29,431,5,0,0,0,0,0,0,0,0,0,0,0,0,264,493,4.4780486537007367E-5,0,0,269,0,0,0,199,0,0,0
15728569,2Uinc,10,638,1656,312,97,4,53.1590994376,50-59,736,5,1,1,2,2,1,1,1,1,0,2.6808524730492474E-4,0,0,253,479,2.9852402567743944E-4,5.0330927E-5,5.1639556E-5,270,0,63,0,200,0,0,0
1179642390,GeosciencesEd,10,670,346,1114,9,3,47.1672570537,40-49,527,6,1,4,5,5,1,4,11,4.1194636327,66.9199272624,0.0039143912,0.15,0.5,0,135,4.92897591374447E-5,5.0330927E-5,5.1639556E-5,283,0.5,0,0,201,0,0,0
942627236,JennGreenTea,10,278,132,491,0,159,36.4917714566,30-39,537,4,2,2,4,4,2,2,1,1,2,5.382408138703652E-4,0,0,258,486,4.3582306220354E-4,7.549639E-5,7.7459335E-5,271,0,35,0,199,0,0,0
35342112,nklas,10,3388,104,333,1,423,44.4120822076,40-49,649,6,2,3,5,5,2,3,11,4.2247054043,217.3451953473,0.0039675624,0.05,0.16666667,0,135,6.115536515939523E-5,7.549639E-5,7.7459335E-5,106,0.16666667,12,0,201,0,0,0
17881636,chriskissoff,10,246,67,83,2,11,24.3682432204,20-29,417,3,0,0,0,0,0,0,0,0,0,0,0,1,265,494,4.4780486537007367E-5,0,0,272,1,1,0,200,0,0,0
234910661,spencersi,10,777,33,27,1,1,28.496994591,20-29,491,5,3,0,3,3,3,0,0,0,0,0.0146938668,0,0,0,66,5.793308537418196E-5,1.00661855E-4,0,99,0,0,0,199,0,0,0
16546939,The_Jedinator,10,920,88,204,1,65,41.229222845,40-49,580,5,1,0,1,1,1,0,0,0,0,0.0080697697,0,0.5,0,120,7.752144940072851E-5,5.0330927E-5,0,99,0.5,2,0,200,0,0,0
16654103,BramptonNewf,10,504,14,34,0,1,17.5411198243,10-19,273,2,0,0,0,0,0,0,0,0,0,0,0,0,266,495,4.4780486537007367E-5,0,0,273,0,1,0,200,0,0,0
57771926,depHugoLeal,10,4341,30988,713,188,1,51.4140104091,50-59,754,5,1,0,1,1,1,0,0,0,0,3.6114136732715924E-4,0,0,267,496,1.0340065745167209E-4,5.0330927E-5,0,355,0,2,0,201,0,0,0
255823181,lefthungry,10,1899,40,164,3,38,27.2282852928,20-29,572,5,0,0,0,0,0,0,0,0,0,0,0,0.8333333,268,497,4.4780486537007367E-5,0,0,274,0.8333333,1,0,200,0,0,0
71703535,Sincerely_Hubbs,10,10227,613,711,0,64,43.9411240992,40-49,704,6,0,0,0,0,0,0,0,0,0,0,0,0,269,499,4.4780486537007367E-5,0,0,275,0,3,0,202,0,0,0
20692578,watkwen,10,258,41,102,1,8,22.1812356183,20-29,480,3,0,1,1,1,0,1,11,4.8838342811,0,0,0,0.6142857,0,500,5.12021012990578E-5,0,2.5819778E-5,267,0.6142857,3,3,200,3,0.015,0
397393302,rawaonca,10,168,6,67,0,38,20.7279208449,20-29,391,3,0,0,0,0,0,0,0,0,0,0,0,0.45555556,270,501,4.4780486537007367E-5,0,0,276,0.45555556,0,0,172,0,0,0
361448967,tulipgrrrl,10,1525,100,167,0,1033,32.2687640275,30-39,598,5,0,1,1,1,0,1,11,5.0779853777,0,0,0,0,0,502,4.4780486537007367E-5,0,2.5819778E-5,106,0,4,0,199,0,0,0
430896247,Tii_Polow972,10,3199,378,323,0,44,47.0377929367,40-49,683,6,3,0,3,3,3,0,0,0,0,9.85327885047324E-4,0,0,38,175,1.9430393103457837E-4,1.00661855E-4,0,88,0,6,0,200,0,0,0
26442278,ritchieage,10,5326,94,87,1,226,40.947744218,40-49,719,7,0,1,1,1,0,1,11,5.0779853777,0,0,0,0,0,503,4.4780486537007367E-5,0,2.5819778E-5,106,0,0,0,200,0,0,0
160339209,MorgAn_maRiE003,10,14192,315,619,1,568,40.4918172145,40-49,740,7,0,0,0,0,0,0,0,0,0,0,0,0,271,504,4.4780486537007367E-5,0,0,277,0,6,0,200,0,0,0
427822638,dalesy17,10,209,31,121,0,20,25.5255224833,20-29,441,4,2,3,5,5,2,3,11,4.0670459163,1870.7680573482,0.0090622313,0.05,0.33333334,0,135,5.009379781038065E-5,7.549639E-5,7.7459335E-5,257,0.33333334,7,0,200,0,0,0
265733538,akplourdee,10,944,176,412,0,334,32.9772350398,30-39,579,4,1,1,2,2,1,1,1,1,0,2.6808524730492474E-4,0,0,49,195,2.9852402567743944E-4,5.0330927E-5,5.1639556E-5,278,0,5,0,198,0,0,0
124236594,SNoutreach,10,125,176,50,12,0,34.8541698834,30-39,433,2,0,0,0,0,0,0,0,0,0,0,0,0,272,505,6.077903169553801E-5,0,0,279,0,1,0,135,0,0,0
325333226,Jennyfromdabl,10,3646,247,232,0,369,33.7818557424,30-39,683,6,0,0,0,0,0,0,0,0,0,0,0,0,273,506,4.4780486537007367E-5,0,0,280,0,0,0,200,0,0,0
190251799,D_a_r_i_y_a,10,126,9,98,0,1,20.4574105692,20-29,366,3,0,1,1,1,0,1,11,4.4455727051,0,0,0,0,0,507,4.4780486537007367E-5,0,2.5819778E-5,283,0,1,0,166,0,0,0
303321116,A_ShotOfTequila,10,12098,280,275,1,17,33.6438576803,30-39,703,6,0,0,0,0,0,0,0,0,0,0,0,0,274,508,4.4780486537007367E-5,0,0,281,0,7,0,199,0,0,0
853288416,Oenema666,10,257,20,154,0,3,17.8547541134,10-19,108,4,0,0,0,0,0,0,0,0,0,0,0,0.53333336,275,509,4.4780486537007367E-5,0,0,282,0.53333336,0,0,199,0,0,0
8150292,jjackunrau,10,3703,247,309,17,55,,,665,5,4,7,11,11,4,7,12,4.9979683056,2887.560880176,0.0022737171,0.1090909091,0.45238096,0,135,1.0731040853801889E-4,1.2582731E-4,1.2909889E-4,267,0.45238096,11,0,200,0,0,0
395300100,SalomeAlexx,10,168,15,67,0,1,29.344984788,20-29,328,3,1,1,2,2,1,1,11,4.501828525,0,0.0012387115,0,0.41666666,0,135,5.0218172863394E-5,5.0330927E-5,5.1639556E-5,257,0.41666666,1,1,176,1,0.0056818182,0
523849647,huckabee972,10,5695,120,121,0,161,44.3536959705,40-49,721,7,0,0,0,0,0,0,0,0,0,0,0,0,276,511,4.4780486537007367E-5,0,0,284,0,3,0,201,0,0,0
1208959315,QuietOakFarm,10,30,17,87,0,0,23.4152386492,20-29,68,3,1,2,3,3,1,2,12,5.1250507511,5.1237065608,2.6808524730492474E-4,0,0,0,512,6.533581315393133E-5,5.0330927E-5,5.1639556E-5,353,0,1,0,65,0,0,0
256664075,RexdaleCLC,10,757,110,82,5,0,30.2117547154,30-39,506,5,1,0,1,1,1,0,0,0,0,7.27922906893465E-4,0,0,0,19,9.776042757753394E-5,5.0330927E-5,0,257,0,5,1,200,1,0.005,0
1273148768,WarrenIDunlop,10,14,18,69,1,0,38.5445815374,30-39,401,3,4,7,11,11,4,7,10,3.7712312068,363.0571933111,0.0119396316,0.1636363636,0.7380952,0,135,7.371079031601867E-5,1.2582731E-4,1.2909889E-4,283,0.7380952,9,0,65,0,0,0
1141224883,InterculturalSK,10,84,10,24,1,0,18.3779454967,10-19,49,3,0,0,0,0,0,0,0,0,0,0,0,1,277,513,4.4780486537007367E-5,0,0,285,1,0,0,111,0,0,0
14954158,Aprila,10,2352,53,102,0,11,44.4364416407,40-49,664,5,0,0,0,0,0,0,0,0,0,0,0,1,278,514,4.4780486537007367E-5,0,0,286,1,1,0,200,0,0,0
328029510,alisonnn_taylor,10,4703,247,235,1,227,42.5238409194,40-49,695,6,5,5,10,10,5,5,1,1,1.75,0.0018007566,0.1,0.8,279,515,3.648004638058968E-4,1.5099278E-4,1.5491867E-4,300,0.8,37,0,201,0,0,0
390127676,shannonmkelleyy,10,1696,110,272,0,117,25.5228096173,20-29,533,5,0,0,0,0,0,0,0,0,0,0,0,0,280,516,4.4780486537007367E-5,0,0,287,0,3,0,194,0,0,0
360639045,2sej_hre,10,1303,18,167,0,321,14.708184835,10-19,499,6,0,1,1,1,0,1,1,1,0,0,0,0.5,0,517,4.6442216882367446E-5,0,2.5819778E-5,257,0.5,0,0,199,0,0,0
449920911,IamHollySutton,10,13745,383,394,1,2854,21.1836553644,20-29,720,8,0,0,0,0,0,0,0,0,0,0,0,0,281,518,4.4780486537007367E-5,0,0,288,0,3,0,200,0,0,0
1202055853,chrisdarimont,10,10,49,39,0,0,39.5289954612,30-39,416,2,2,2,4,4,2,2,10,4.0662332385,0,0.0046992611,0.0833333333,1,0,135,6.098567990188838E-5,7.549639E-5,7.7459335E-5,71,1,5,0,21,0,0,0
331776617,SamSolar1,10,3059,3005,2964,4,0,43.97357971,40-49,654,5,1,1,2,2,1,1,10,4.0239739943,0,0.0013482027,0,0.45,0,135,5.887812281799419E-5,5.0330927E-5,5.1639556E-5,99,0.45,18,0,200,0,0,0
587725384,LaIraPopular,10,1377,131,99,1,18,29.8820588626,20-29,541,5,0,0,0,0,0,0,0,0,0,0,0,0,282,519,4.4780486537007367E-5,0,0,289,0,6,0,202,0,0,0
125282905,RobDChambers,10,1521,289,266,17,4,43.5510552128,40-49,591,5,0,0,0,0,0,0,0,0,0,0,0,0,283,520,4.4780486537007367E-5,0,0,290,0,0,0,200,0,0,0
20207497,MohammadAliZ,10,6861,626,514,10,390,45.0263626942,40-49,692,6,0,0,0,0,0,0,0,0,0,0,0,0.36666667,284,521,5.8481066523831634E-5,0,0,291,0.36666667,1,0,201,0,0,0
19328001,epptendo,10,28721,1044,644,35,44,42.8855748935,40-49,772,8,6,6,12,12,6,6,2,1.25,1,0.0025944922,0.0984848485,0.8666667,285,522,3.162001656099139E-4,1.7615824E-4,1.8073844E-4,385,0.8666667,30,0,200,0,0,0
1084878776,PhatSra,10,317,19,81,0,10,35.7551991806,30-39,498,4,0,0,0,0,0,0,0,0,0,0,0,0.55,286,523,6.600586911204107E-5,0,0,292,0.55,4,0,200,0,0,0
456209002,RSMacPherson,10,1242,60,158,5,10,30.5760801736,30-39,480,5,1,1,2,2,1,1,11,5.0507923608,0,6.175948929630688E-4,0,0.33333334,0,135,6.270558587581596E-5,5.0330927E-5,5.1639556E-5,267,0.33333334,4,0,200,0,0,0
25362154,jennrpeters,10,855,187,109,7,16,43.1022612853,40-49,605,5,4,2,6,6,4,2,11,4.8480292564,0.5,0.0017693472,0.1666666667,0.8333333,0,135,9.15078208574759E-5,1.2582731E-4,1.2909889E-4,267,0.8333333,7,0,200,0,0,0
213064124,DKoppin,10,308,58,116,1,33,19.3692871952,10-19,342,4,0,0,0,0,0,0,0,0,0,0,0,0.16666667,287,524,4.9780041976527344E-5,0,0,293,0.16666667,0,0,200,0,0,0
360341311,miguelgaraym,10,19137,1275,1995,5,8,56.2154174978,50-59,779,7,4,6,10,10,4,6,13,8.7074360016,2464.6666666667,0.0012927217,0.0666666667,0.23809524,0,135,1.378708966480061E-4,1.2582731E-4,1.2909889E-4,148,0.23809524,43,0,208,0,0,0
45418457,Pablitski,10,50852,2609,2517,68,209,52.404884945,50-59,783,9,3,5,8,8,3,5,12,7.7135310849,3682.6500000002,0.0015483313,0.0892857143,0.35,0,135,1.0539543819392093E-4,1.00661855E-4,1.0327911E-4,148,0.35,1,0,201,0,0,0
612019451,nicoldesign2012,10,1734,29,74,0,5,36.464265152,30-39,538,6,0,0,0,0,0,0,0,0,0,0,0,0.6,288,525,5.156536677218207E-5,0,0,294,0.6,14,0,202,0,0,0
214164173,DrJaneChi,10,6872,1222,554,25,231,63.3363438391,60-69,765,7,5,2,7,7,5,2,11,4.4969524584,2516.5779067186,0.003276289,0.0238095238,0.1,0,135,1.0485689443648995E-4,1.5099278E-4,1.2909889E-4,257,0.1,26,0,202,0,0,0
50715881,Gabizinha19,10,2782,22,28,2,0,20.9579187635,20-29,649,6,0,0,0,0,0,0,0,0,0,0,0,0,289,526,4.4780486537007367E-5,0,0,295,0,0,0,200,0,0,0
30967575,fvankalmthout,10,1075,102,204,5,0,40.7233970547,40-49,446,5,3,2,5,5,3,2,11,5.0491670053,80.665186077,0.0019866053,0.05,0.33333334,0,135,7.725395626920747E-5,1.00661855E-4,1.0327911E-4,267,0.33333334,5,0,200,0,0,0
543844268,Johnvanbergeijk,10,460,189,187,9,11,40.7994508365,40-49,508,5,1,3,4,4,1,3,12,5.1416971173,2.4896825397,2.6808524730492474E-4,0.0833333333,0.16666667,0,512,7.25482083614257E-5,5.0330927E-5,5.1639556E-5,353,0.16666667,8,0,200,0,0,0
94229756,Terence_Johnson,10,549,307,118,3,4,38.0321482938,30-39,467,4,0,0,0,0,0,0,0,0,0,0,0,0.5,290,527,4.7596287865126745E-5,0,0,296,0.5,0,0,199,0,0,0
360384010,LJBriar,10,273,9,83,0,3,20.4161753084,20-29,452,4,1,2,3,3,1,2,11,4.505485575,110.1202499466,3.0999072219658905E-4,0,0,0,135,5.9437713684008654E-5,5.0330927E-5,5.1639556E-5,505,0,1,0,200,0,0,0
991803612,tammie_kelly,10,48,29,50,0,0,25.0616140066,20-29,437,2,0,0,0,0,0,0,0,0,0,0,0,0,291,528,4.4780486537007367E-5,0,0,297,0,0,0,59,0,0,0
172487387,agdconstruccion,10,3557,1685,1540,29,1,44.7425118069,40-49,650,4,2,5,7,7,2,5,12,7.7135310849,1842.35,0.0014918421,0.0952380952,0.25,0,135,1.3537636135373113E-4,7.549639E-5,7.7459335E-5,148,0.25,1,0,200,0,0,0
354709978,KevinPatrickNL,10,44,4,25,0,0,12.8753588292,10-19,125,2,0,0,0,0,0,0,0,0,0,0,0,0,292,529,4.4780486537007367E-5,0,0,298,0,2,1,48,1,0.0208333333,0
18709858,LAWZSPOKEN,10,30044,800,526,18,796,44.8531627309,40-49,767,8,8,8,16,16,8,8,1,1,8.6666666667,0.003221592,0.0708333333,0.60714287,285,522,4.2075200114485736E-4,2.2648917E-4,2.32378E-4,385,0.60714287,62,0,204,0,0,0
270534541,brtalbot,10,147,4,25,0,1,16.4815821791,10-19,64,3,0,0,0,0,0,0,0,0,0,0,0,0,293,530,5.0959439341855286E-5,0,0,299,0,0,0,150,0,0,0
380376309,sjGoring,10,1921,323,291,18,46,,,670,6,3,1,4,4,3,1,11,4.7716375457,0.5,0.0031432935,0.0833333333,0.16666667,0,135,7.87070238763635E-5,1.00661855E-4,1.0327911E-4,283,0.16666667,2,0,200,0,0,0
61583209,couturerm,10,14,3,15,0,0,15.6708586376,10-19,3,1,2,4,6,6,2,4,11,4.1243396993,1.6964693394,0.0057791133,0.1666666667,0.8333333,0,135,5.5696286266009436E-5,7.549639E-5,7.7459335E-5,283,0.8333333,0,0,14,0,0,0
189622949,coplancreative,10,1935,252,198,1,0,41.2343563986,40-49,561,3,1,2,3,3,1,2,9,5.5103616416,64.3573987671,4.2725702284040736E-4,0,0,0,135,7.927442740923612E-5,5.0330927E-5,5.1639556E-5,148,0,0,0,200,0,0,0
1041906002,OrganicSocial,10,2295,509,465,11,530,55.8160319846,50-59,663,6,1,1,2,2,1,1,9,5.5278342137,0,4.2725702284040736E-4,0,0,0,135,7.927442740923612E-5,5.0330927E-5,5.1639556E-5,148,0,2,0,201,0,0,0
383826803,AGO_RM,10,190,82,860,0,6,20.5678818226,20-29,473,5,0,3,3,3,0,3,2,1.4,0,0,0.3333333333,0.5,267,533,4.4780486537007367E-5,0,2.5819778E-5,355,0.5,0,0,192,0,0,0
287974083,BlondeRachellll,10,1646,287,234,0,222,41.394315171,40-49,635,5,4,2,6,6,4,2,2,1.6,0,0.0014717293,0.2,1,279,515,2.6065177531832076E-4,1.2582731E-4,1.2909889E-4,300,1,22,0,198,0,0,0
25562342,pauloteixeira13,10,13984,14832,4890,484,17,62.1233211074,60-69,900,7,5,3,8,8,5,3,2,1.25,12,0.0013230994,0.0357142857,0.06666667,267,532,2.0689471024981583E-4,1.5099278E-4,7.7459335E-5,355,0.06666667,16,0,201,0,0,0
371070418,CorrynSojourner,10,1025,108,182,0,249,34.4149919218,30-39,596,5,4,5,9,9,4,5,1,1,0.25,0.0014717293,0.125,0.85,279,515,2.701198379081004E-4,1.2582731E-4,1.2909889E-4,300,0.85,33,0,200,0,0,0
146972021,KellyMacFarlane,10,1460,139,282,11,1,41.3445250662,40-49,583,5,2,4,6,6,2,4,11,3.9768386835,23.2615084103,0.0050867372,0.0666666667,0.25,0,135,6.280611075274792E-5,7.549639E-5,7.7459335E-5,353,0.25,7,0,200,0,0,0
218748524,magnamoreira_,10,35056,728,673,4,1183,46.4959841483,40-49,776,9,1,2,3,3,1,2,2,1.5,1,3.6114136732715924E-4,0,0,267,532,1.0340065745167209E-4,5.0330927E-5,5.1639556E-5,355,0,1,0,201,0,0,0
814665444,haileybretee,10,3108,143,173,0,869,43.1548313052,40-49,644,6,4,5,9,9,4,5,1,1,0.25,0.0014717293,0.125,0.85,279,515,2.701198379081004E-4,1.2582731E-4,1.2909889E-4,300,0.85,45,0,200,0,0,0
82261964,sergiobc1300,10,8220,2482,355,60,10,48.4423368553,40-49,754,7,3,2,5,5,3,2,2,1.5,1,8.503558057403968E-4,0.2,0.33333334,267,532,1.2877626753625776E-4,1.00661855E-4,5.1639556E-5,355,0.33333334,18,0,198,0,0,0
361405809,davidinkansas,10,58,38,20,0,1,24.5481429862,20-29,343,2,2,2,4,4,2,2,1,1,0,5.875113113304263E-4,0.0833333333,1,294,534,2.985240256774393E-4,7.549639E-5,7.7459335E-5,301,1,11,0,64,0,0,0
404973272,VanNewsWatcher,10,175,11,59,0,12,12.405003059,10-19,368,2,0,1,1,1,0,1,11,4.4224207961,0,0,0,0.48214287,0,535,4.553966086114525E-5,0,2.5819778E-5,71,0.48214287,0,0,174,0,0,0
362170813,CrossPointsKC,10,210,39,28,0,0,23.567566506,20-29,400,2,2,2,4,4,2,2,1,1,0,5.875113113304263E-4,0.0833333333,1,294,534,2.985240256774393E-4,7.549639E-5,7.7459335E-5,301,1,7,0,200,0,0,0
253180312,Shhlie,10,1426,133,164,1,330,39.2117400588,30-39,620,5,4,4,8,8,4,4,2,1.2,0,0.0014717293,0.1071428571,1,279,515,2.6065177531832076E-4,1.2582731E-4,1.2909889E-4,300,1,22,0,200,0,0,0
256124395,Westcoastmaven,10,1161,31,72,2,6,25.1682105011,20-29,524,3,1,0,1,1,1,0,0,0,0,0.0017298296,0,0.7380952,0,113,6.555850129704277E-5,5.0330927E-5,0,99,0.7380952,3,0,200,0,0,0
463015551,Magov25,10,773,138,608,0,6,28.2007999775,20-29,376,5,1,3,4,4,1,3,13,8.7090613572,2.6666666667,3.69242484970673E-4,0.25,0.6666667,0,135,7.391436124808641E-5,5.0330927E-5,5.1639556E-5,148,0.6666667,0,0,200,0,0,0
61619217,muribepmontt,10,8219,1065,2001,7,138,45.7511333481,40-49,724,7,4,6,10,10,4,6,12,7.7127184072,11440.2166666667,0.0017965029,0.0666666667,0.16666667,0,135,2.056508393604276E-4,1.2582731E-4,1.2909889E-4,148,0.16666667,2,0,196,0,0,0
227291265,PROGREWAYNA,10,1891,323,531,6,7,41.6695834247,40-49,637,6,3,1,4,4,3,1,13,8.7123120683,0,9.882583307304503E-4,0.25,0.6666667,0,135,1.1438848076226887E-4,1.00661855E-4,1.0327911E-4,148,0.6666667,0,0,200,0,0,0
800913169,LeaMacKenzie1,10,12,15,28,0,0,18.7919337076,10-19,124,1,0,1,1,1,0,1,11,4.3720552396,0,0,0,0,0,538,4.4780486537007367E-5,0,2.5819778E-5,99,0,0,0,13,0,0,0
19282352,nadlanu,10,13992,4313,774,51,680,57.7534162815,50-59,744,7,0,0,0,0,0,0,0,0,0,0,0,0,295,539,4.4780486537007367E-5,0,0,302,0,5,0,201,0,0,0
473169001,jimmyyadig,10,36939,510,1040,2,67,41.6503565301,40-49,778,8,0,1,1,1,0,1,10,4.2656376929,0,0,0,0.45833334,0,540,4.7552819304927756E-5,0,2.5819778E-5,71,0.45833334,8,0,201,0,0,0
272059064,marilynrbush,10,663,41,140,0,710,44.2866416591,40-49,581,6,2,2,4,4,2,2,11,5.0735473385,1,0.0010170882,0,0,0,135,9.645704293253715E-5,7.549639E-5,7.7459335E-5,303,0,0,0,200,0,0,0
18958712,KatyMackay,10,649,117,206,7,1,32.6112800403,30-39,467,4,2,3,5,5,2,3,11,4.0349451443,0.7341824108,0.0050867372,0.1,0.5,0,135,6.45555880045126E-5,7.549639E-5,7.7459335E-5,353,0.5,1,1,200,1,0.005,0
438398549,PJWillemsen,10,771,126,227,3,5,29.2534466998,20-29,471,5,1,1,2,2,1,1,1,1,0,2.6808524730492474E-4,0,0,296,541,2.9852402567743944E-4,5.0330927E-5,5.1639556E-5,318,0,5,0,200,0,0,0
946498220,OTICProforma,10,730,278,645,0,2,39.3411473734,30-39,552,3,0,5,5,5,0,5,12,7.7112103981,0,0,0.2,0.25,0,542,4.4780486537007367E-5,0,2.5819778E-5,148,0.25,2,0,200,0,0,0
221577386,parhamfarmgirl,10,2694,75,280,0,16,23.8684134116,20-29,602,6,0,0,0,0,0,0,0,0,0,0,0,0,297,543,4.4780486537007367E-5,0,0,304,0,0,1,200,1,0.005,0
241222972,Kluvsja,10,14999,433,703,12,219,43.6146721052,40-49,786,8,0,1,1,1,0,1,12,5.4756295695,0,0,0,0.65,0,544,4.4780486537007367E-5,0,2.5819778E-5,505,0.65,0,1,201,1,0.0049751244,0
57750980,WuDisciple36,10,3141,222,473,1,412,38.4026151633,30-39,650,5,1,1,2,2,1,1,10,3.781389679,0,0.0078290605,0,0,0,135,4.8517769716958163E-5,5.0330927E-5,5.1639556E-5,99,0,13,0,198,0,0,0
1210051994,Mwadden_cheer,10,137,33,74,0,27,18.2212069328,10-19,279,2,0,0,0,0,0,0,0,0,0,0,0,0,298,545,4.4780486537007367E-5,0,0,305,0,4,0,161,0,0,0
135823693,HVerduM,10,962,290,698,10,17,45.4627804119,40-49,567,5,0,0,0,0,0,0,0,0,0,0,0,0,299,546,4.4780486537007367E-5,0,0,306,0,2,0,200,0,0,0
86553574,ashleypiscuc,10,456,70,55,1,111,32.3059555865,30-39,545,4,0,0,0,0,0,0,0,0,0,0,0,0,300,547,4.4780486537007367E-5,0,0,307,0,3,0,199,0,0,0
851843886,DSharpComms,10,70,17,70,0,0,17.146559443,10-19,96,2,1,1,2,2,1,1,11,4.6688338074,0,0.0017052293,0,0.6964286,0,135,8.150761879052249E-5,5.0330927E-5,5.1639556E-5,505,0.6964286,0,0,77,0,0,0
1212389454,DorothyCStaley,10,1875,125,375,1,75,44.3313585773,40-49,581,7,2,6,8,8,2,6,9,3.9207639171,98.9760695059,0.0027141174,0.0357142857,0.1,0,135,5.6028545136902605E-5,7.549639E-5,7.7459335E-5,303,0.1,7,0,201,0,0,0
973670803,MilneJudi,10,136,60,247,1,3,24.972355909,20-29,283,3,0,0,0,0,0,0,0,0,0,0,0,0.70454544,301,548,5.2616918548074475E-5,0,0,308,0.70454544,0,3,154,3,0.0194805195,0
48066044,MikeMcGill77,10,109,2,74,0,0,18.0788399951,10-19,142,3,0,0,0,0,0,0,0,0,0,0,0,1,302,549,4.4780486537007367E-5,0,0,309,1,3,1,132,1,0.0075757576,0
252605568,Chris_Grimshaw,10,1265,92,243,4,4,38.2330221113,30-39,514,5,1,1,2,2,1,1,11,4.6688338074,0,0.0017052293,0,0.5,0,135,5.2658610429339275E-5,5.0330927E-5,5.1639556E-5,505,0.5,0,0,200,0,0,0
1027658838,mloewen6,10,215,24,57,0,8,34.1972986062,30-39,417,4,0,0,0,0,0,0,0,0,0,0,0,0,303,550,4.4780486537007367E-5,0,0,310,0,1,0,200,0,0,0
780844903,LizHexham,10,577,36,102,0,2,13.4948067874,10-19,333,5,1,1,2,2,1,1,11,4.9362047948,0,0.0012142169,0,0.6666667,0,135,5.477277479227954E-5,5.0330927E-5,5.1639556E-5,267,0.6666667,0,1,200,1,0.005,0
20508361,gwander,10,1348,94,102,2,4,,,494,4,0,0,0,0,0,0,0,0,0,0,0,0,304,551,4.4780486537007367E-5,0,0,311,0,0,0,199,0,0,0
38278645,chelsea_cameron,10,637,147,173,11,48,47.9357150636,40-49,541,4,0,0,0,0,0,0,0,0,0,0,0,0.6666667,305,552,5.346355368835059E-5,0,0,312,0.6666667,4,1,200,1,0.005,0
492873598,arswy,10,39,7,45,0,4,27.0140526012,20-29,272,3,0,0,0,0,0,0,0,0,0,0,0,0.6,306,553,4.4780486537007367E-5,0,0,313,0.6,0,0,79,0,0,0
311567625,TheYazata,10,1918,210,298,4,232,44.0083221748,40-49,645,6,0,1,1,1,0,1,11,4.6921202275,0,0,0,0.47619048,0,555,4.770024243342563E-5,0,2.5819778E-5,257,0.47619048,1,0,200,0,0,0
1226601480,NovaLyceum,10,285,5,12,1,0,34.2320998246,30-39,504,5,0,0,0,0,0,0,0,0,0,0,0,0,307,556,4.4780486537007367E-5,0,0,314,0,5,0,201,0,0,0
199457885,MALTEAZERCARM,10,1103,30,78,0,11,19.9709156332,10-19,453,5,0,0,0,0,0,0,0,0,0,0,0,0,308,557,4.4780486537007367E-5,0,0,315,0,6,1,200,1,0.005,0
585434206,JillianLeBlanc4,10,116,46,121,0,53,19.3553062833,10-19,446,3,0,0,0,0,0,0,0,0,0,0,0,0.6666667,309,558,4.4780486537007367E-5,0,0,316,0.6666667,0,0,126,0,0,0
906560450,RaffaHacks,10,78,32,253,0,0,19.6961663343,10-19,135,3,0,1,1,1,0,1,1,1,0,0,0,0,0,559,4.4780486537007367E-5,0,2.5819778E-5,99,0,1,0,85,0,0,0
17543769,verbz,10,9262,1537,1625,24,209,43.9062705506,40-49,717,6,8,8,16,16,8,8,1,1,8.6666666667,0.003221592,0.0708333333,0.60714287,285,522,4.2075200114485736E-4,2.2648917E-4,2.32378E-4,385,0.60714287,8,0,200,0,0,0
25619895,JAYRON_SSE,10,1885,210,363,2,29,43.0681372887,40-49,630,6,4,4,8,8,4,4,2,1.5,0,0.0018268328,0.1071428571,1,285,522,2.2320849686773938E-4,1.2582731E-4,1.2909889E-4,385,1,8,0,200,0,0,0
713308196,reesespeaksblog,10,111,4,14,0,0,20.1395213733,20-29,167,2,1,2,3,3,1,2,11,4.1999187322,0,4.6372454995167626E-4,0.1666666667,1,0,135,5.754211563577795E-5,5.0330927E-5,5.1639556E-5,99,1,2,0,163,0,0,0
86124232,Joseph_Kouvelas,10,1728,169,363,2,0,22.9674646624,20-29,518,5,0,1,1,1,0,1,12,5.0028432169,0,0,0,0.59150326,0,560,6.161209660612117E-5,0,2.5819778E-5,257,0.59150326,0,0,199,0,0,0
492633469,CMDoze,10,160,8,49,0,30,20.7246452613,20-29,227,3,0,0,0,0,0,0,0,0,0,0,0,0.5,310,561,4.4780486537007367E-5,0,0,317,0.5,0,1,191,1,0.0052356021,0
154240814,GertHoogendoorn,10,62,20,52,0,1,14.6882160989,10-19,210,1,1,1,2,2,1,1,1,1,0,2.6808524730492474E-4,0,0,296,541,2.9852402567743944E-4,5.0330927E-5,5.1639556E-5,318,0,3,0,67,0,0,0
887025247,miguelful2,10,5916,1307,1568,4,93,47.7528615296,40-49,721,7,4,6,10,10,4,6,9,5.2840308818,9808.6068487785,0.00184431,0,0,0,135,2.156487316970673E-4,1.2582731E-4,1.2909889E-4,148,0,9,0,201,0,0,0
448278822,deepstaples,10,344,2,67,0,0,14.0610612502,10-19,325,4,1,1,2,2,1,1,10,4.0365704998,0,0.008081525,0,0,0,135,5.558289898184132E-5,5.0330927E-5,5.1639556E-5,505,0,0,0,191,0,0,0
181043440,mdelow,10,54,25,29,1,0,38.0549015583,30-39,377,3,2,6,8,8,2,6,10,3.8289313287,38.5240175088,0.0028305702,0.1785714286,0.6,0,135,6.279690178321874E-5,7.549639E-5,7.7459335E-5,283,0.6,16,2,93,2,0.0215053763,0
392401248,AlfonsoToronto,10,4842,104,89,5,1,28.5754083739,20-29,508,7,0,0,0,0,0,0,0,0,0,0,0,0,311,562,4.833448709276406E-5,0,0,319,0,0,0,200,0,0,0
421246147,munky18t,10,112,31,134,0,0,17.7973244891,10-19,230,2,0,1,1,1,0,1,11,4.7717303006,0,0,0,0.33333334,0,563,5.034065667458013E-5,0,2.5819778E-5,343,0.33333334,0,0,114,0,0,0
273625397,RedLabelRyan,10,274,12,32,0,14,18.6493146519,10-19,142,3,0,0,0,0,0,0,0,0,0,0,0,0,312,564,4.4780486537007367E-5,0,0,320,0,1,0,199,0,0,0
282698826,OranKearney,10,1558,2160,183,3,46,46.6459578465,40-49,735,4,6,2,8,8,6,2,1,1,0,0.0022529698,0.3392857143,0.5952381,2,258,1.9760708903596182E-4,1.7615824E-4,1.8073844E-4,95,0.5952381,25,0,197,0,0,0
1155341306,McAfeeConor49,10,169,148,222,0,23,30.2148331019,30-39,509,4,2,6,8,8,2,6,2,1.4,0.5833333333,7.299743333229089E-4,0.2321428571,0.53333336,2,263,7.132968692329396E-5,7.549639E-5,7.7459335E-5,95,0.53333336,7,0,200,0,0,0
445580884,TUSKS71,10,1332,57,77,0,10,25.8978888829,20-29,582,5,0,0,0,0,0,0,0,0,0,0,0,0.5,313,565,4.4780486537007367E-5,0,0,321,0.5,3,1,200,1,0.005,0
70761385,a_elgueta,10,1785,202,542,0,7,32.21331575,30-39,559,6,1,5,6,6,1,5,12,7.7135310849,1842.35,6.368043784275767E-4,0.1333333333,0.25,0,135,1.122103523552837E-4,5.0330927E-5,5.1639556E-5,148,0.25,0,0,201,0,0,0
593940488,SmallToffee,10,16745,391,298,1,975,36.8678016122,30-39,743,7,3,7,10,10,3,7,7,3.1515151515,16.0285714286,0.0015618255,0.1666666667,0.6904762,38,176,1.897265784102486E-4,1.00661855E-4,1.0327911E-4,88,0.6904762,43,0,200,0,0,0
354691591,DouglasMusk,10,120,10,116,0,0,20.3725785081,20-29,308,3,0,1,1,1,0,1,10,4.0353371243,0,0,0,0.58928573,0,566,4.4780486537007367E-5,0,2.5819778E-5,353,0.58928573,4,0,136,0,0,0
16407144,IvanOresnik,10,687,135,127,9,4,41.9113320121,40-49,555,5,5,6,11,11,5,6,10,3.8874441284,4731.0188343204,0.0104887475,0.0818181818,0.5,0,135,1.462521116782171E-4,1.5099278E-4,1.5491867E-4,283,0.5,39,0,200,0,0,0
15152494,cheriak,10,1160,272,537,6,26,42.1567935276,40-49,558,5,1,1,2,2,1,1,11,4.2198293377,0,0.0034014508,0,0.525,0,135,7.510849402671351E-5,5.0330927E-5,5.1639556E-5,283,0.525,2,0,200,0,0,0
500297431,mccxv,10,3320,83,212,3,1,33.0402177464,30-39,451,6,1,1,2,2,1,1,10,3.8687525396,0,0.0035168619,0,0.5277778,0,135,5.7193999123869704E-5,5.0330927E-5,5.1639556E-5,505,0.5277778,0,0,197,0,0,0
252274047,Roberto59xx,10,296,94,821,0,2,14.4175789717,10-19,299,4,1,1,2,2,1,1,10,4.0800487607,0,0.0084273789,0,0.4,0,135,4.7417036255471055E-5,5.0330927E-5,5.1639556E-5,99,0.4,0,0,200,0,0,0
299738128,ArnaldoBeni,10,37,6,40,0,0,13.8378558686,10-19,115,2,0,0,0,0,0,0,0,0,0,0,0,0,314,568,4.4780486537007367E-5,0,0,322,0,1,0,45,0,0,0
33326848,CarolinaMartelo,10,1119,104,135,1,43,34.274192971,30-39,574,5,0,0,0,0,0,0,0,0,0,0,0,0.5222222,315,569,6.44096245741372E-5,0,0,323,0.5222222,12,0,200,0,0,0
26949351,MeganDoesNOLA,10,22057,1931,2108,64,1548,69.7434136146,60-69,766,8,0,0,0,0,0,0,0,0,0,0,0,0,316,570,4.4780486537007367E-5,0,0,324,0,3,0,200,0,0,0
561387460,melissaburke85,10,155,37,91,2,16,29.2760203205,20-29,426,3,0,0,0,0,0,0,0,0,0,0,0,0.5,317,571,4.4780486537007367E-5,0,0,325,0.5,0,0,187,0,0,0
15285969,JCookie6201,10,1679,61,118,0,121,20.8876007147,20-29,543,3,2,2,4,4,2,2,1,1,0,5.875113113304263E-4,0.0833333333,1,294,534,2.985240256774393E-4,7.549639E-5,7.7459335E-5,301,1,1,0,200,0,0,0
501910165,DenisSalter,10,340,119,543,3,2,22.3899236917,20-29,378,4,1,1,2,2,1,1,11,4.6647704185,0,0.0011545487,0,0.45454547,0,135,5.111343450918407E-5,5.0330927E-5,5.1639556E-5,257,0.45454547,1,0,199,0,0,0
167990608,superbugfighter,10,159,64,41,2,1,41.0508644318,40-49,444,3,2,1,3,3,2,1,11,4.8870377895,0,0.0011100128,0.1666666667,1,0,135,7.836824587099387E-5,7.549639E-5,7.7459335E-5,283,1,1,0,180,0,0,0
793079546,AllanTiSirai,10,252,134,178,0,2,30.7039508684,30-39,443,2,2,2,4,4,2,2,9,5.3636363636,65,5.629473307648944E-4,0,0,38,176,3.0093038622527044E-4,7.549639E-5,7.7459335E-5,88,0,3,0,200,0,0,0
1195737266,LucasFacelina,10,1050,85,72,0,1,41.5695438043,40-49,629,4,1,1,2,2,1,1,10,6.3333333333,0,2.9269077831384145E-4,0,0,38,176,1.7267363141546682E-4,5.0330927E-5,5.1639556E-5,88,0,3,0,201,0,0,0
84600728,Dagy_92,10,22991,206,217,2,82,44.2537291788,40-49,731,8,0,0,0,0,0,0,0,0,0,0,0,0,318,572,4.4780486537007367E-5,0,0,326,0,1,0,201,0,0,0
242571362,fowlerkp,10,884,48,279,0,10,20.5307614406,20-29,513,5,0,0,0,0,0,0,0,0,0,0,0,0.5769231,319,573,6.124636716836655E-5,0,0,327,0.5769231,6,0,199,0,0,0
860135372,AntotoBlue,10,1476,532,370,0,16,41.8807072433,40-49,615,5,2,2,4,4,2,2,8,4.4545454545,126,5.890797480786052E-4,0,0,38,176,2.573415194161958E-4,7.549639E-5,7.7459335E-5,88,0,13,0,199,0,0,0
727353728,Loriane972,10,9173,251,148,1,336,43.2306068556,40-49,683,6,2,2,4,4,2,2,7,3.6060606061,183,6.553178743961138E-4,0,0,38,176,1.9922096627174774E-4,7.549639E-5,7.7459335E-5,88,0,9,0,200,0,0,0
1209622626,EnviroExposed,10,30,25,63,0,0,21.6805310953,20-29,133,1,0,1,1,1,0,1,1,1,0,0,0,0.3,0,574,4.4780486537007367E-5,0,2.5819778E-5,99,0.3,1,0,33,0,0,0
101918538,ennovis,10,1404,161,302,1,0,40.2681767886,40-49,594,4,0,0,0,0,0,0,0,0,0,0,0,0,320,575,4.4780486537007367E-5,0,0,328,0,26,0,200,0,0,0
733527702,electionquebec,10,90,22,0,2,0,21.1983448627,20-29,404,3,1,0,1,1,1,0,0,0,0,0.0011856033,0,0,0,114,4.683012808773789E-5,5.0330927E-5,0,267,0,13,0,155,0,0,0
381289009,Ayo_Fermin,10,5211,130,121,0,17,38.6696058212,30-39,698,6,1,1,2,2,1,1,1,1,0,2.6808524730492474E-4,0,0,321,576,2.9852402567743944E-4,5.0330927E-5,5.1639556E-5,329,0,14,0,200,0,0,0
384833727,fabio_capucho,10,1032,123,200,0,1,25.5697137574,20-29,625,5,0,3,3,3,0,3,2,1.4,0,0,0.3333333333,0.5,267,577,4.4780486537007367E-5,0,2.5819778E-5,355,0.5,2,0,200,0,0,0
385830985,BigBossEmm,10,9033,295,289,1,952,35.4304374728,30-39,725,7,1,1,2,2,1,1,1,1,0,2.6808524730492474E-4,0,0,321,576,2.9852402567743944E-4,5.0330927E-5,5.1639556E-5,329,0,10,0,200,0,0,0
1076711600,MexicoCompanies,10,64665,0,0,0,0,14.8992979188,10-19,30,3,0,0,0,0,0,0,0,0,0,0,0,0,322,578,4.4780486537007367E-5,0,0,330,0,0,0,201,0,0,0
262520354,msmely,10,6175,56,97,1,77,36.5278288174,30-39,664,7,0,1,1,1,0,1,11,4.5349309504,0,0,0,0.33333334,0,579,4.807166088595508E-5,0,2.5819778E-5,505,0.33333334,1,0,200,0,0,0
59831613,jimotayek,10,180,47,76,0,48,36.8766989287,30-39,568,4,1,2,3,3,1,2,1,1,1,2.6808524730492474E-4,0,0,323,581,1.2969692065828504E-4,5.0330927E-5,5.1639556E-5,339,0,25,0,192,0,0,0
138745077,ZenaHaddad,10,2504,255,198,4,42,43.4892036506,40-49,652,7,1,1,2,2,1,1,2,1.5,0,2.6808524730492474E-4,0,0,323,581,9.990168110805797E-5,5.0330927E-5,5.1639556E-5,339,0,26,0,200,0,0,0
247862756,Hunterlo44,10,7128,77,348,0,110,35.0887999289,30-39,675,6,1,2,3,3,1,2,11,3.7752945957,9.3225978707,0.007020327,0,0,0,135,5.33708879741348E-5,5.0330927E-5,5.1639556E-5,99,0,8,0,198,0,0,0
115663035,uwemspeaks,10,24735,565,339,4,14,57.3437679116,50-59,753,8,0,0,0,0,0,0,0,0,0,0,0,0,324,582,4.4780486537007367E-5,0,0,331,0,13,0,201,0,0,0
388443126,AislinnElliott,10,474,333,320,0,33,41.5205497616,40-49,587,4,3,6,9,9,3,6,2,1.4,0.25,0.0011853161,0.2083333333,0.6,2,263,8.742576660530252E-5,1.00661855E-4,1.0327911E-4,95,0.6,16,0,198,0,0,0
99116591,WindsorFellow,10,5203,2959,258,8,399,45.6503401656,40-49,704,7,0,0,0,0,0,0,0,0,0,0,0,0,325,583,4.4780486537007367E-5,0,0,332,0,2,0,200,0,0,0
948394051,KenGuilford2,10,22,1,12,0,0,15.6708586376,10-19,11,1,0,0,0,0,0,0,0,0,0,0,0,0,326,584,4.4780486537007367E-5,0,0,333,0,3,0,27,0,0,0
266793860,Abeer_Raafat,10,4457,151,273,0,459,36.2247102145,30-39,677,6,0,0,0,0,0,0,0,0,0,0,0,0,327,585,4.4780486537007367E-5,0,0,334,0,0,0,200,0,0,0
477043749,AnnTByrne,10,154,1,5,0,0,10.6708586376,10-19,21,3,0,0,0,0,0,0,0,0,0,0,0,0,328,586,4.4780486537007367E-5,0,0,335,0,0,0,156,0,0,0
255480780,KLAFFS103,10,273,55,110,0,1,16.6067878497,10-19,391,3,0,0,0,0,0,0,0,0,0,0,0,0,329,587,4.4780486537007367E-5,0,0,336,0,7,0,199,0,0,0
452957426,Ofarellpol,10,844,198,218,1,204,40.8528806338,40-49,598,5,0,0,0,0,0,0,0,0,0,0,0,0,330,588,4.4780486537007367E-5,0,0,337,0,18,0,200,0,0,0
459245980,JaniceLutz,10,57,21,45,0,1,22.878102694,20-29,183,2,0,1,1,1,0,1,11,4.8895207149,0,0,0,0.5,0,589,5.370319470653586E-5,0,2.5819778E-5,343,0.5,3,0,80,0,0,0
620453067,NokitaOh,10,27232,279,1682,0,0,40.9257422492,40-49,630,6,1,0,1,1,1,0,0,0,0,2.6808524730492474E-4,0,0,46,187,5.9686805425790906E-5,5.0330927E-5,0,116,0,0,0,202,0,0,0
245693197,Voiceof9jathugs,10,213728,2954,1316,44,310,47.8953916891,40-49,781,7,1,0,1,1,1,0,0,0,0,2.9162299782298695E-4,0,0,0,590,6.734277591528606E-5,5.0330927E-5,0,205,0,0,0,201,0,0,0
299360167,janicetwlee,10,2621,32,34,2,6,40.1289957527,40-49,624,5,1,2,3,3,1,2,11,4.3892726534,0,0.0013760902,0.1666666667,1,0,135,5.632733933819057E-5,5.0330927E-5,5.1639556E-5,283,1,1,0,200,0,0,0
731941633,eviehanna,10,4339,2114,1967,1,1209,46.8948365184,40-49,698,6,0,0,0,0,0,0,0,0,0,0,0,0,331,591,4.4780486537007367E-5,0,0,338,0,5,0,201,0,0,0
46714028,EhsanBegloo,10,7636,461,477,20,17,30.7232334576,30-39,708,7,2,2,4,4,2,2,10,3.9565217391,106.5049935537,0.0063824229,0,0,0,135,5.439191684546428E-5,7.549639E-5,7.7459335E-5,505,0,0,0,200,0,0,0
24757830,Tumitravel,10,4563,8057,1185,298,2122,71.3660488988,70-79,774,7,1,0,1,1,1,0,0,0,0,2.6808524730492474E-4,0,0,323,580,9.990168110805797E-5,5.0330927E-5,0,339,0,75,0,200,0,0,0
127901611,Rambojks,10,1741,64,160,0,16,31.933791127,30-39,626,6,1,1,2,2,1,1,10,4.3531084925,0,0.0013770534,0,1,0,135,5.1256865458305944E-5,5.0330927E-5,5.1639556E-5,99,1,6,0,199,0,0,0
238413434,SameerP93,10,67,39,56,0,5,28.5079401915,20-29,438,3,0,1,1,1,0,1,11,4.8090982941,0,0,0,0,0,592,4.4780486537007367E-5,0,2.5819778E-5,283,0,2,0,73,0,0,0
37485362,sjmc19,10,1358,168,111,2,36,36.8458813961,30-39,624,5,3,1,4,4,3,1,12,5.2897196262,2451.3735530064,0.0054605915,0,0,0,135,7.921719171680787E-5,1.00661855E-4,1.0327911E-4,257,0,23,0,200,0,0,0
70531121,omat_king14,10,1055,98,280,1,7,31.5663951614,30-39,504,5,0,0,0,0,0,0,0,0,0,0,0,0,332,593,4.4780486537007367E-5,0,0,340,0,2,0,200,0,0,0
81855161,mdavid6,10,149,9,51,0,0,13.4620039902,10-19,50,3,0,0,0,0,0,0,0,0,0,0,0,0,333,594,4.4780486537007367E-5,0,0,341,0,2,0,161,0,0,0
295364492,FunsizeKim31,10,3479,65,144,0,304,25.7529180384,20-29,635,6,0,0,0,0,0,0,0,0,0,0,0,0,334,595,4.4780486537007367E-5,0,0,342,0,2,0,200,0,0,0
14795481,alexbungle35,10,2094,64,201,4,5,38.7991299808,30-39,579,6,1,1,2,2,1,1,11,4.261682243,0,0.0011856033,0.5,0.5,0,135,4.683012808773789E-5,5.0330927E-5,5.1639556E-5,267,0.5,1,0,200,0,0,0
240778312,DaveYona,10,1341,192,470,3,210,53.2840115092,50-59,578,5,0,0,0,0,0,0,0,0,0,0,0,0,335,596,4.4780486537007367E-5,0,0,344,0,3,0,200,0,0,0
56065179,S_A_F,10,34293,1470,207,35,245,48.5758847409,40-49,758,7,0,0,0,0,0,0,0,0,0,0,0,0,336,597,4.4780486537007367E-5,0,0,345,0,1,0,201,0,0,0
16391511,garifuna,10,2909,417,299,37,1,43.7301405547,40-49,654,5,1,2,3,3,1,2,3,1.875,0,4.875180899263048E-4,0.1666666667,1,0,32,1.5206314911483688E-4,5.0330927E-5,5.1639556E-5,148,1,0,0,200,0,0,0
272124058,MyCatIsFat,10,42,6,55,0,0,16.5674566246,10-19,206,2,0,0,0,0,0,0,0,0,0,0,0,0.5882353,337,598,4.63462263885734E-5,0,0,346,0.5882353,0,0,43,0,0,0
37491208,CanadasPredsFan,10,1239,256,148,7,8,47.6940263464,40-49,711,7,0,0,0,0,0,0,0,0,0,0,0,1,338,599,5.5238768917226964E-5,0,0,347,1,6,0,201,0,0,0
71425364,Buster_86,10,1545,118,336,1,20,23.7467263128,20-29,616,5,0,0,0,0,0,0,0,0,0,0,0,0,339,600,4.4780486537007367E-5,0,0,348,0,2,0,200,0,0,0
211915045,ACTSAthlete,10,1284,275,224,4,7,44.6040080225,40-49,646,5,4,0,4,4,4,0,0,0,0,0.0015719963,0.3333333333,0.5,0,104,2.4226137248048603E-4,1.2582731E-4,0,343,0.5,15,0,200,0,0,0
302232667,amtanx,10,10211,244,169,1,1961,37.8640746939,30-39,716,6,1,1,2,2,1,1,13,6.1202763104,0,5.004478570705852E-4,0,0,0,135,1.0362282914105973E-4,5.0330927E-5,5.1639556E-5,37,0,11,0,200,0,0,0
1278893274,sforsapo,10,67,10,66,0,12,15.7541340606,10-19,271,4,1,2,3,3,1,2,14,9.7078423405,5,7.578089409356405E-4,0,0,0,135,1.6313647328630986E-4,5.0330927E-5,5.1639556E-5,148,0,0,0,168,0,0,0
105785852,Jnaveg,10,11359,231,322,1,14,41.8885306336,40-49,716,7,1,3,4,4,1,3,12,7.7159691182,0,8.550376980862657E-4,0.1666666667,0.33333334,0,135,6.79464955354548E-5,5.0330927E-5,5.1639556E-5,148,0.33333334,5,0,200,0,0,0
351847129,Julien_Leger,10,19,16,89,1,0,20.6493771953,20-29,65,1,0,1,1,1,0,1,10,3.9346060114,0,0,0,0.6090909,0,602,4.4780486537007367E-5,0,2.5819778E-5,283,0.6090909,1,1,22,1,0.0454545455,0
222901117,j_moreiraa,10,18021,734,1774,190,441,34.6159590384,30-39,680,7,0,0,0,0,0,0,0,0,0,0,0,0,340,603,4.4780486537007367E-5,0,0,349,0,3,0,200,0,0,0
90221203,fjmoranm,10,1463,83,130,2,10,26.9367826331,20-29,523,5,0,1,1,1,0,1,1,1,0,0,0,0,0,604,4.4780486537007367E-5,0,2.5819778E-5,148,0,2,0,200,0,0,0
380938969,larayav,10,5438,133,406,1,17,39.2112527143,30-39,623,7,1,3,4,4,1,3,12,7.7159691182,0,8.550376980862657E-4,0.1666666667,0.33333334,0,135,6.79464955354548E-5,5.0330927E-5,5.1639556E-5,148,0.33333334,1,0,199,0,0,0
47368707,Sr_Ramirez,10,9638,695,1266,1,2661,42.7697324016,40-49,665,7,2,5,7,7,2,5,12,7.7135310849,0,0.0011473421,0.2142857143,0.33333334,0,135,8.191306199890774E-5,7.549639E-5,7.7459335E-5,148,0.33333334,2,0,201,0,0,0
84853717,DavidSotoR,10,498,93,188,0,0,16.83973041,10-19,486,4,1,4,5,5,1,4,12,7.7143437627,1839.35,6.368043784275767E-4,0.15,0.25,0,135,1.122103523552837E-4,5.0330927E-5,5.1639556E-5,148,0.25,2,0,200,0,0,0
542162326,mparadis004,10,281,41,139,2,3,35.5553988678,30-39,449,4,1,1,2,2,1,1,11,4.4388459976,0,9.421775197262618E-4,0,0.4047619,0,135,4.683525430804407E-5,5.0330927E-5,5.1639556E-5,505,0.4047619,10,3,199,3,0.0150753769,0
201070049,ZeBaloo,10,11196,554,940,14,197,48.5793616744,40-49,741,7,1,1,2,2,1,1,10,4.6135717188,0,7.279493162744389E-4,0,0.6666667,0,135,6.022123260896187E-5,5.0330927E-5,5.1639556E-5,267,0.6666667,1,0,200,0,0,0
374864512,MichelVigneault,10,204,21,32,0,0,16.6374517062,10-19,359,3,0,0,0,0,0,0,0,0,0,0,0,0,341,605,4.4780486537007367E-5,0,0,350,0,0,0,199,0,0,0
22758206,PluckyDog,10,84,17,57,0,16,18.515042871,10-19,121,3,0,0,0,0,0,0,0,0,0,0,0,0,342,606,4.4780486537007367E-5,0,0,351,0,0,0,104,0,0,0
1198006309,SlusherksyCelia,10,11,4,77,0,0,,,14,0,0,0,0,0,0,0,0,0,0,0,0,0,343,607,4.4780486537007367E-5,0,0,352,0,0,0,12,0,0,0
543579866,biltongandgame,10,2353,144,298,2,99,25.766202068,20-29,576,6,0,0,0,0,0,0,0,0,0,0,0,0,344,608,4.4780486537007367E-5,0,0,354,0,1,0,200,0,0,0
160576237,CFOAB,10,5875,23178,60,321,0,59.8983607357,50-59,798,4,7,0,7,7,7,0,0,0,0,0.0018123139,0.0476190476,0.04761905,267,531,2.830215405035728E-4,2.0132371E-4,0,355,0.04761905,12,0,200,0,0,0
132646082,fpaisdigital,10,1790,2680,1371,105,13,51.2525973623,50-59,660,5,2,7,9,9,2,7,12,7.7114993905,4913,5.62236112677195E-4,0.1805555556,0.26785713,0,135,1.1501876722346492E-4,7.549639E-5,7.7459335E-5,148,0.26785713,55,0,201,0,0,0
331840766,adoresubtract,10,173,53,120,1,79,18.128616344,10-19,409,3,0,0,0,0,0,0,0,0,0,0,0,0,345,609,4.876272194723636E-5,0,0,356,0,0,0,181,0,0,0
538111610,mesarroc,10,422,232,472,1,5,33.0188472066,30-39,530,4,1,4,5,5,1,4,12,7.7139374238,0,2.9230441260810443E-4,0.25,0.5,0,135,5.8747053000460315E-5,5.0330927E-5,5.1639556E-5,148,0.5,9,0,200,0,0,0
221481261,infam0usap,10,9605,412,227,0,2450,42.8352952878,40-49,716,7,0,0,0,0,0,0,0,0,0,0,0,0,346,610,4.4780486537007367E-5,0,0,357,0,8,0,198,0,0,0
34023172,RICSON_MOREIRA,10,110,19,29,0,6,14.1904744132,10-19,149,3,0,1,1,1,0,1,1,1,0,0,0,0,267,611,4.4780486537007367E-5,0,2.5819778E-5,355,0,2,0,131,0,0,0
142271252,Samuel_Lum,10,1437,599,562,21,19,45.3267793393,40-49,632,5,0,0,0,0,0,0,0,0,0,0,0,0,347,612,4.4780486537007367E-5,0,0,358,0,5,0,200,0,0,0
1198862300,AnnieClaudeLaim,10,472,29,39,0,2,37.4084961019,30-39,542,4,0,0,0,0,0,0,0,0,0,0,0,0,348,613,4.4780486537007367E-5,0,0,359,0,9,0,201,0,0,0
325147095,op_enough,10,1275,147,0,5,0,22.9220728209,20-29,642,5,0,0,0,0,0,0,0,0,0,0,0,0,349,614,4.4780486537007367E-5,0,0,360,0,0,0,200,0,0,0
988707360,MichEdReform,10,2195,133,0,7,0,43.8739344467,40-49,586,6,0,0,0,0,0,0,0,0,0,0,0,0,350,615,4.4780486537007367E-5,0,0,361,0,0,0,201,0,0,0
297162974,Ruskin701,10,571,50,322,0,181,31.2683785644,30-39,402,5,1,0,1,1,1,0,0,0,0,0.0016500257,0,0.6461988,0,55,5.274729508834334E-5,5.0330927E-5,0,353,0.6461988,0,0,200,0,0,0
465539124,nickoszan,10,1684,142,443,0,0,41.0914442873,40-49,634,6,3,4,7,7,3,4,2,1.3333333333,0,8.82395667687167E-4,0.3571428571,0.6666667,351,617,7.486036425287252E-5,1.00661855E-4,1.0327911E-4,362,0.6666667,11,0,200,0,0,0
156210748,jerradtyson,10,2097,1533,131,25,55,53.1193395116,50-59,744,6,6,2,8,8,6,2,1,1,0,0.0020052466,0.2678571429,0.6333333,351,616,6.05091973227469E-4,1.7615824E-4,1.8073844E-4,362,0.6333333,115,0,198,0,0,0
1130448013,Interstate_WSW,10,164,139,110,1,34,40.6953757654,40-49,557,4,2,5,7,7,2,5,2,1.1666666667,0,5.886088422922964E-4,0.3571428571,0.6666667,351,617,6.398321690140619E-5,7.549639E-5,7.7459335E-5,362,0.6666667,27,0,174,0,0,0
43331611,Tjminniecon,10,1970,1478,211,24,5,50.7569501454,50-59,717,6,6,2,8,8,6,2,1,1,0,0.0020052466,0.2678571429,0.6333333,351,616,6.050919732274689E-4,1.7615824E-4,1.8073844E-4,362,0.6333333,57,0,199,0,0,0
1084556630,WanderingEel,10,2290,156,200,0,195,45.0887631409,40-49,719,7,3,6,9,9,3,6,1,1,3,8.82395667687167E-4,0.2083333333,0.6,351,617,7.950498557182188E-5,1.00661855E-4,1.0327911E-4,362,0.6,28,0,201,0,0,0
16438548,aelan,10,1004,16,61,0,134,20.1605079585,20-29,397,5,1,0,1,1,1,0,0,0,0,0.0018988383,0,0.56666666,0,108,4.7654556883821264E-5,5.0330927E-5,0,99,0.56666666,0,1,200,1,0.005,0
727776997,MrUptimeNinja,10,202490,658,10,9,0,41.0532060193,40-49,615,11,0,0,0,0,0,0,0,0,0,0,0,0,352,618,4.4780486537007367E-5,0,0,363,0,0,0,201,0,0,0
14070067,MosesIngram,10,530,2,56,0,0,15.6708586376,10-19,142,3,0,1,1,1,0,1,11,4.0430544273,0,0,0,0.59090906,0,619,4.4780486537007367E-5,0,2.5819778E-5,353,0.59090906,0,0,200,0,0,0
908380028,kayla_woodlock,10,4229,353,469,0,604,44.4469135747,40-49,665,6,0,0,0,0,0,0,0,0,0,0,0,0,353,620,4.4780486537007367E-5,0,0,364,0,1,0,201,0,0,0
1056665060,JeromePolenz6,10,138,1083,33,11,4,50.7075924036,50-59,689,3,6,2,8,8,6,2,1,1,0,0.0020052466,0.2678571429,0.6333333,351,616,6.050919732274689E-4,1.7615824E-4,1.8073844E-4,362,0.6333333,41,0,151,0,0,0
256807621,bel_ang,10,783,80,221,2,82,43.7899975153,40-49,604,5,1,6,7,7,1,6,1,1,0,3.1836169766958716E-4,0.3571428571,0.6666667,351,617,5.604369333356824E-5,5.0330927E-5,5.1639556E-5,362,0.6666667,8,0,201,0,0,0
1218420457,iamchaseabana,10,19,3,8,0,0,18.8620946581,10-19,63,2,0,0,0,0,0,0,0,0,0,0,0,0,354,621,4.4780486537007367E-5,0,0,365,0,1,0,24,0,0,0
1276931240,everythingyeg,10,1135,121,544,1,2,43.2473053779,40-49,501,7,0,1,1,1,0,1,11,4.4033306255,0,0,0,0.85,0,622,4.782055726777915E-5,0,2.5819778E-5,353,0.85,3,0,200,0,0,0
23121610,Starfishlb,10,2054,30,157,0,12,29.3479812939,20-29,610,6,1,0,1,1,1,0,0,0,0,0.0052308887,0,1,0,134,4.717867437035941E-5,5.0330927E-5,0,99,1,0,0,200,0,0,0
11627292,JerThis,10,1940,245,253,3,104,54.4477029786,50-59,578,5,0,0,0,0,0,0,0,0,0,0,0,0,355,623,4.4780486537007367E-5,0,0,366,0,12,0,198,0,0,0
19453805,Mike_Bull,10,4173,158,271,2,2,37.4417530031,30-39,714,7,1,1,2,2,1,1,1,1,0,2.6808524730492474E-4,0,0,356,624,2.9852402567743944E-4,5.0330927E-5,5.1639556E-5,369,0,53,0,200,0,0,0
8228752,arenosa,10,1707,319,688,8,111,40.1911964642,40-49,568,5,0,0,0,0,0,0,0,0,0,0,0,0,357,625,4.4780486537007367E-5,0,0,367,0,0,0,200,0,0,0
1050717998,jpcole70,10,8,4,8,0,0,17.4113347389,10-19,74,0,0,0,0,0,0,0,0,0,0,0,0,0,358,626,4.4780486537007367E-5,0,0,368,0,0,0,10,0,0,0
262885487,Botty11,10,7792,123,372,5,10,40.6097167637,40-49,733,7,1,1,2,2,1,1,1,1,0,2.6808524730492474E-4,0,0,356,624,2.9852402567743944E-4,5.0330927E-5,5.1639556E-5,369,0,65,0,200,0,0,0
194741356,Sam_fitts,10,134,44,122,0,1,21.8191360718,20-29,470,3,0,0,0,0,0,0,0,0,0,0,0,0,359,627,4.4780486537007367E-5,0,0,370,0,0,0,136,0,0,0
45129106,SIJAFNET,10,2199,270,481,11,79,38.0491433814,30-39,598,5,0,1,1,1,0,1,1,1,0,0,0,0,267,628,4.4780486537007367E-5,0,2.5819778E-5,355,0,0,0,200,0,0,0
229204006,craggy7,10,45,27,107,0,38,26.465407566,20-29,383,3,1,1,2,2,1,1,1,1,0,2.6808524730492474E-4,0,0,360,629,2.9852402567743944E-4,5.0330927E-5,5.1639556E-5,371,0,13,0,96,0,0,0
150631980,PaddMann10,10,897,178,151,0,102,32.7209741564,30-39,555,4,1,1,2,2,1,1,1,1,0,2.6808524730492474E-4,0,0,360,629,2.9852402567743944E-4,5.0330927E-5,5.1639556E-5,371,0,6,0,192,0,0,0
1214075808,Manunu972,10,159,19,27,0,2,32.3777789875,30-39,559,5,0,0,0,0,0,0,0,0,0,0,0,0,361,630,4.4780486537007367E-5,0,0,372,0,5,0,202,0,0,0
989309642,shaneezymybeezy,10,304,86,113,0,218,32.9636399172,30-39,554,4,2,3,5,5,2,3,1,1,0,6.143761184276883E-4,0.15,0.8333333,63,217,2.3261649057882062E-4,7.549639E-5,7.7459335E-5,58,0.8333333,62,0,199,0,0,0
616587294,ComanderSlander,10,394,161,134,0,211,29.8444148673,20-29,579,4,3,1,4,4,3,1,2,1.6666666667,0,9.092611511070317E-4,0.25,1,63,217,2.985240256774394E-4,1.00661855E-4,1.0327911E-4,58,1,13,0,198,0,0,0
559014346,pmccann83,10,639,96,230,0,278,24.6896491883,20-29,577,5,0,0,0,0,0,0,0,0,0,0,0,0,362,631,4.4780486537007367E-5,0,0,373,0,6,0,198,0,0,0
285097792,Stephen_Farr,10,168,31,119,0,5,30.9540614643,30-39,479,3,0,0,0,0,0,0,0,0,0,0,0,0,363,632,4.4780486537007367E-5,0,0,374,0,3,0,191,0,0,0
146643118,DonJonescu,10,4395,199,455,2,7,42.8592237031,40-49,665,6,0,0,0,0,0,0,0,0,0,0,0,0,364,633,4.4780486537007367E-5,0,0,375,0,0,0,200,0,0,0
277997330,alebarbosas,10,2619,285,120,2,375,39.1882830403,30-39,660,6,0,1,1,1,0,1,1,1,0,0,0,0,267,634,4.4780486537007367E-5,0,2.5819778E-5,355,0,13,0,200,0,0,0
790139850,asbinvancity,10,1900,49,49,0,108,43.5836946668,40-49,588,5,3,3,6,6,3,3,10,3.6623323852,35.4351929745,0.0142332558,0.0666666667,0.6666667,0,135,5.571548743515662E-5,1.00661855E-4,1.0327911E-4,99,0.6666667,3,0,200,0,0,0
42250627,SarahBestBailey,10,2453,235,219,1,120,30.7860489505,30-39,593,5,3,0,3,3,3,0,0,0,0,0.0010882138,0.5,1,365,635,1.4218311404253528E-4,1.00661855E-4,0,376,1,2,0,200,0,0,0
173496568,jenaleighb,10,1070,222,284,0,2,35.393430851,30-39,598,5,4,5,9,9,4,5,2,1.1666666667,0.6666666667,0.0014667722,0.1111111111,0.7,365,636,1.8798441438917248E-4,1.2582731E-4,1.2909889E-4,376,0.7,2,0,200,0,0,0
1260813001,publicidadxaweb,10,19,44,83,1,0,29.6924689836,20-29,281,2,1,1,2,2,1,1,1,1,0,2.6808524730492474E-4,0,0,366,637,2.9852402567743944E-4,5.0330927E-5,5.1639556E-5,377,0,12,0,38,0,0,0
714987132,AnaPleguezuelos,10,426,107,233,3,31,40.5783457199,40-49,546,4,1,1,2,2,1,1,1,1,0,2.6808524730492474E-4,0,0,366,637,2.9852402567743944E-4,5.0330927E-5,5.1639556E-5,377,0,23,0,200,0,0,0
379951860,advogadohenry,10,8277,563,2001,3,3,34.0583505456,30-39,639,7,0,1,1,1,0,1,3,2,0,0,0,0,267,638,4.4780486537007367E-5,0,2.5819778E-5,355,0,1,0,200,0,0,0
165514010,Twin_Sanity,10,5821,61,140,0,193,29.6425390007,20-29,662,7,0,0,0,0,0,0,0,0,0,0,0,0,367,639,4.4780486537007367E-5,0,0,378,0,1,0,200,0,0,0
204027188,Staytrue2theBLU,10,346,60,45,0,13,15.948941595,10-19,442,3,0,0,0,0,0,0,0,0,0,0,0,0,368,640,4.4780486537007367E-5,0,0,379,0,0,0,200,0,0,0
294078512,thompsonty,10,504,50,56,0,99,26.6686685597,20-29,536,4,2,2,4,4,2,2,2,1.6666666667,0,7.571166622036244E-4,0.0833333333,1,365,636,1.1748037124471323E-4,7.549639E-5,7.7459335E-5,376,1,4,0,200,0,0,0
1201207338,JaimesnutEliana,10,1,2,0,0,0,,,2,0,0,0,0,0,0,0,0,0,0,0,0,0,369,641,4.4780486537007367E-5,0,0,380,0,0,0,7,0,0,0
244650352,Chuckw12,10,1000,7,47,0,6,13.8612966293,10-19,217,5,0,0,0,0,0,0,0,0,0,0,0,0.8333333,370,642,4.4780486537007367E-5,0,0,381,0.8333333,1,0,200,0,0,0
1287167142,BrendanCalorie,10,24,7,43,0,0,16.7471707378,10-19,49,2,0,0,0,0,0,0,0,0,0,0,0,0,371,643,4.4780486537007367E-5,0,0,382,0,1,0,52,0,0,0
36009850,CalvinValentine,10,20057,1097,420,21,6,51.2852899313,50-59,782,8,7,7,14,14,7,7,2,1.125,2.6666666667,0.0029371436,0.0879120879,0.7619048,285,522,3.642021135260639E-4,2.0132371E-4,2.0655822E-4,385,0.7619048,65,0,200,0,0,0
16428261,djflipflop,10,8046,1376,318,49,5,43.8920518749,40-49,723,6,6,6,12,12,6,6,2,1.25,1,0.0025944922,0.0984848485,0.8666667,285,522,3.162001656099139E-4,1.7615824E-4,1.8073844E-4,385,0.8666667,31,0,200,0,0,0
1146007034,iziqpaul,10,335,33,77,0,6,38.8251723651,30-39,556,4,1,1,2,2,1,1,12,5.2435170178,0,2.9162299782298695E-4,0,0,0,644,6.734277591528606E-5,5.0330927E-5,5.1639556E-5,205,0,13,0,199,0,0,0
269899834,Ang_Amalfitano,10,224,27,37,1,0,25.3206287038,20-29,369,3,1,0,1,1,1,0,0,0,0,0.002982492,0,0,0,123,4.6289777447431015E-5,5.0330927E-5,0,99,0,3,0,199,0,0,0
1089520260,Kaitlyn_Abel,10,41,24,75,0,0,18.9211587405,10-19,102,2,0,1,1,1,0,1,10,4.0357432981,0,0,0,0,0,645,4.4780486537007367E-5,0,2.5819778E-5,505,0,0,0,61,0,0,0
185459722,rosielefaive,10,95,39,62,1,1,24.8004526536,20-29,342,2,0,0,0,0,0,0,0,0,0,0,0,0,372,646,4.4780486537007367E-5,0,0,383,0,0,0,98,0,0,0
625039826,heff_andrew,10,472,146,144,2,61,36.2867747626,30-39,515,4,0,1,1,1,0,1,10,4.0357432981,0,0,0,0.36666667,0,647,4.6114985185253634E-5,0,2.5819778E-5,505,0.36666667,3,0,200,0,0,0
64129314,_Aditya_,10,4033,136,140,0,1,12.2285441559,10-19,683,6,0,0,0,0,0,0,0,0,0,0,0,0,373,648,4.4780486537007367E-5,0,0,384,0,1,0,200,0,0,0
332455169,DJOzroc,10,2568,138,111,3,69,42.2947888167,40-49,645,6,4,4,8,8,4,4,2,1.5,0,0.0018268328,0.1071428571,1,285,522,2.2320849686773938E-4,1.2582731E-4,1.2909889E-4,385,1,32,0,200,0,0,0
521654689,RachelTaylor_3,10,1438,191,177,0,158,35.0638555335,30-39,621,5,4,5,9,9,4,5,2,1.1666666667,0.6666666667,0.0014667722,0.1111111111,0.7,365,636,1.8798441438917248E-4,1.2582731E-4,1.2909889E-4,376,0.7,20,0,200,0,0,0
15077420,TonyDaws,10,151,36,61,2,3,17.2540313491,10-19,312,2,0,0,0,0,0,0,0,0,0,0,0,0,374,649,4.4780486537007367E-5,0,0,386,0,0,0,152,0,0,0
406579529,ArezooC,10,643,23,89,0,556,18.198372495,10-19,456,4,1,1,2,2,1,1,10,4.0361641609,0,0.0044446574,0.5,1,0,135,4.640878291292658E-5,5.0330927E-5,5.1639556E-5,505,1,3,0,198,0,0,0
981418604,juju_tOo_court,10,1935,34,33,0,22,38.1119480171,30-39,640,5,1,1,2,2,1,1,8,4.8181818182,0,2.941033395756825E-4,0,0,38,176,1.4571567381377996E-4,5.0330927E-5,5.1639556E-5,88,0,20,0,200,0,0,0
118484087,Maxim_Brock_U,10,712,107,189,7,1,30.1963611331,30-39,437,4,0,0,0,0,0,0,0,0,0,0,0,0.8,375,651,4.923690682129442E-5,0,0,387,0.8,2,0,200,0,0,0
319746362,jenlovegreen,10,269,27,177,0,2,23.7358943565,20-29,340,4,1,1,2,2,1,1,10,4.0349451443,302.8097140397,6.474633814752539E-4,0,0,0,135,5.26860724908835E-5,5.0330927E-5,5.1639556E-5,257,0,0,0,200,0,0,0
1032840745,LOSO727,10,57,5,32,0,0,13.582865138,10-19,80,3,0,0,0,0,0,0,0,0,0,0,0,0,376,652,4.4780486537007367E-5,0,0,388,0,0,0,88,0,0,0
832466628,Alma_Academy,10,135,106,74,1,1,37.4842961154,30-39,494,2,4,6,10,10,4,6,2,1.1428571429,2458.8166666667,0.0014402283,0.1222222222,0.53333336,0,105,1.7967112446511116E-4,1.2582731E-4,1.2909889E-4,343,0.53333336,12,0,160,0,0,0
614523222,LindaLoth1,10,30,1,9,0,1,20.105064403,20-29,72,2,0,1,1,1,0,1,10,4.0767668562,0,0,0,0.35,0,654,4.4780486537007367E-5,0,2.5819778E-5,257,0.35,3,0,38,0,0,0
213861177,judebg,10,59,18,153,0,7,21.3703590807,20-29,187,3,0,3,3,3,0,3,10,4.0004061738,0,0,0.1666666667,0.33333334,0,655,4.4780486537007367E-5,0,2.5819778E-5,505,0.33333334,1,0,86,0,0,0
1140100759,greene1388,10,49928,562,8,9,0,52.1279182766,50-59,664,9,3,0,3,3,3,0,0,0,0,0.0439249961,0.1666666667,0.33333334,0,106,5.4148436880342027E-5,1.00661855E-4,0,353,0.33333334,0,0,201,0,0,0
1278708559,1713eh,10,15,2,19,0,1,14.6323791312,10-19,75,3,0,0,0,0,0,0,0,0,0,0,0,0.33333334,377,657,4.4780486537007367E-5,0,0,389,0.33333334,2,0,97,0,0,0
379443332,Madison_Dazey,10,9250,641,572,0,1403,35.9828461758,30-39,721,7,1,1,2,2,1,1,1,1,0,2.6808524730492474E-4,0,0,378,658,2.9852402567743944E-4,5.0330927E-5,5.1639556E-5,390,0,16,0,201,0,0,0
492378961,HeatherRenwick,10,57,7,27,0,1,16.3161565335,10-19,127,2,0,1,1,1,0,1,11,4.0991064175,0,0,0,0.55,0,659,4.4780486537007367E-5,0,2.5819778E-5,99,0.55,0,0,66,0,0,0
464983830,becca_joyyy,10,1283,218,340,1,919,40.8105381162,40-49,613,5,1,1,2,2,1,1,1,1,0,2.6808524730492474E-4,0,0,378,658,2.9852402567743944E-4,5.0330927E-5,5.1639556E-5,390,0,20,0,200,0,0,0
14997147,DavidGrant,10,47,34,79,0,1,22.5928156804,20-29,437,2,0,1,1,1,0,1,11,4.5264012998,0,0,0,0,0,661,4.4780486537007367E-5,0,2.5819778E-5,71,0,0,0,48,0,0,0
276179070,andreapercycdn,10,33,1,13,0,2,10.6708586376,10-19,31,2,0,1,1,1,0,1,10,4.0767668562,0,0,0,0.6666667,0,662,5.084480164059419E-5,0,2.5819778E-5,257,0.6666667,0,0,35,0,0,0
466540679,andrewadamu8,10,2876,83,130,0,26,44.3311515802,40-49,664,6,0,0,0,0,0,0,0,0,0,0,0,0,379,663,4.4780486537007367E-5,0,0,391,0,8,0,200,0,0,0
758299892,CloudEther,10,2324,59,73,1,183,36.4203731939,30-39,597,6,1,2,3,3,1,2,10,3.9110117838,2.2855232472,0.0027438232,0,0,0,135,4.9711911383749325E-5,5.0330927E-5,5.1639556E-5,99,0,2,0,199,0,0,0
196819240,oldmcdonaldbear,10,5576,106,364,0,27,26.9354347721,20-29,541,7,1,1,2,2,1,1,10,3.6757415685,0,0.008504538,0,0.3,0,135,4.7321570694625844E-5,5.0330927E-5,5.1639556E-5,99,0.3,1,0,200,0,0,0
524792313,Your__Dream__,10,9466,92,90,1,85,41.3731761199,40-49,688,6,3,3,6,6,3,3,7,3.1515151515,14.7448412698,0.0014476403,0.0666666667,0.6666667,38,176,1.6842343851373906E-4,1.00661855E-4,1.0327911E-4,88,0.6666667,2,0,201,0,0,0
186907090,Val_M_Diaz,10,2405,34,32,0,309,23.5767551679,20-29,475,5,0,0,0,0,0,0,0,0,0,0,0,0,380,664,4.4780486537007367E-5,0,0,392,0,0,0,200,0,0,0
945068773,DLeowinata,10,230,47,171,0,15,31.0342933093,30-39,453,3,1,1,2,2,1,1,11,4.1641609102,0,0.0034646387,0,1,0,135,4.9114587888461136E-5,5.0330927E-5,5.1639556E-5,283,1,4,0,200,0,0,0
775030206,cassidyaugust96,10,1628,250,180,0,831,40.6818270403,40-49,659,5,2,2,4,4,2,2,1,1,1,5.618090794925434E-4,0.0833333333,0.5,381,665,3.875570667691606E-4,7.549639E-5,7.7459335E-5,393,0.5,42,0,200,0,0,0
708214501,michellebear1,10,9,20,44,0,3,15.6581760777,10-19,354,1,1,2,3,3,1,2,1,1,0,2.926588007250267E-4,0.1666666667,1,381,665,2.0949098458571808E-4,5.0330927E-5,5.1639556E-5,393,1,1,0,7,0,0,0
376996977,kate_england,10,205,78,211,1,11,38.340733544,30-39,480,4,0,0,0,0,0,0,0,0,0,0,0,0.5,382,666,4.4780486537007367E-5,0,0,394,0.5,10,0,200,0,0,0
354963231,Batlacious,10,162,17,125,0,4,34.149910783,30-39,545,3,0,0,0,0,0,0,0,0,0,0,0,0,383,667,4.4780486537007367E-5,0,0,395,0,8,0,174,0,0,0
358506497,jot_au,10,118719,1851,2018,53,28911,55.0179665781,50-59,900,10,0,1,1,1,0,1,11,5.1007311129,0,0,0,0,0,668,4.4780486537007367E-5,0,2.5819778E-5,99,0,1,0,201,0,0,0
363637819,JTDerbs,10,2636,198,342,0,310,42.6575339535,40-49,695,6,0,0,0,0,0,0,0,0,0,0,0,0,384,669,4.4780486537007367E-5,0,0,396,0,12,0,200,0,0,0
322058839,Hnefi,10,207,43,115,0,8,21.0269549516,20-29,402,4,1,3,4,4,1,3,12,5.0438845998,0,0.0012194716,0.1666666667,0.6666667,0,135,5.516749454382095E-5,5.0330927E-5,5.1639556E-5,353,0.6666667,3,0,198,0,0,0
249181686,Holgadoo,10,1233,100,196,1,12,37.1893933906,30-39,586,5,1,1,2,2,1,1,3,2,0,2.6808524730492474E-4,0,0,141,320,9.990168110805797E-5,5.0330927E-5,5.1639556E-5,142,0,27,0,199,0,0,0
1181695452,YOUkniel,10,1922,82,133,0,9,29.2186615447,20-29,506,3,0,0,0,0,0,0,0,0,0,0,0,0,385,670,4.4780486537007367E-5,0,0,397,0,0,0,201,0,0,0
473116327,KeirsteadWin,10,1104,47,95,0,267,40.1299251321,40-49,639,6,1,1,2,2,1,1,10,4.2490857375,0,0.0015254566,0,0,0,135,5.386737515611327E-5,5.0330927E-5,5.1639556E-5,505,0,7,0,200,0,0,0
109749152,THShorn92,10,646,146,286,0,165,33.9859282695,30-39,565,4,0,0,0,0,0,0,0,0,0,0,0,0,386,671,4.4780486537007367E-5,0,0,398,0,0,0,199,0,0,0
287866585,SignGuyOttawa,10,1370,192,381,5,12,43.2182718378,40-49,610,5,2,2,4,4,2,2,2,1.6,0,7.017628329480223E-4,0.25,0.8333333,0,92,1.8649263792208323E-4,7.549639E-5,7.7459335E-5,408,0.8333333,7,0,200,0,0,0
1222486399,CP_Culture,10,28,11,30,0,1,19.4020539509,10-19,82,1,0,0,0,0,0,0,0,0,0,0,0,0,387,672,4.4780486537007367E-5,0,0,399,0,2,0,32,0,0,0
24004837,gillyadam,10,6860,432,364,4,68,42.8921111281,40-49,720,7,5,5,10,10,5,5,1,1,9820,0.0017244617,0.0888888889,0.55,0,92,5.881934283396008E-4,1.5099278E-4,1.5491867E-4,408,0.55,39,0,200,0,0,0
289720713,StephenVail,10,1952,478,586,0,13,33.7535434701,30-39,563,4,1,2,3,3,1,2,1,1,1,2.6808524730492474E-4,0,0,0,673,1.2969692065828504E-4,5.0330927E-5,5.1639556E-5,148,0,0,0,200,0,0,0
104811358,LorelMarketing,10,4919,2000,1751,43,0,44.9959969465,40-49,664,6,1,1,2,2,1,1,2,1.5,0,2.6808524730492474E-4,0,0,0,673,9.990168110805797E-5,5.0330927E-5,5.1639556E-5,148,0,7,0,200,0,0,0
365798739,eroland6,10,1834,262,225,0,217,40.2458323467,40-49,677,6,1,1,2,2,1,1,1,1,0,2.6808524730492474E-4,0,0,388,674,2.9852402567743944E-4,5.0330927E-5,5.1639556E-5,400,0,6,0,199,0,0,0
373631302,MattyG0202,10,3020,373,256,0,206,41.029896317,40-49,703,6,1,1,2,2,1,1,1,1,0,2.6808524730492474E-4,0,0,388,674,2.9852402567743944E-4,5.0330927E-5,5.1639556E-5,400,0,17,0,196,0,0,0
1019411000,LuettaFoster,10,31,4,182,0,0,,,14,1,0,0,0,0,0,0,0,0,0,0,0,0,389,675,4.4780486537007367E-5,0,0,401,0,0,0,35,0,0,0
397656856,alexalanegray,10,10285,397,450,0,1659,43.4052730684,40-49,715,7,4,4,8,8,4,4,2,1.3333333333,0,0.0014667722,0.1071428571,1,365,636,1.8139525519436552E-4,1.2582731E-4,1.2909889E-4,376,1,32,0,201,0,0,0
336398479,Robot_Anonymous,10,29956,567,0,18,6,35.3962059071,30-39,640,9,5,0,5,5,5,0,0,0,0,0.0190517336,0.2,0.35,0,80,9.308105197072567E-5,1.5099278E-4,0,99,0.35,0,0,205,0,0,0
1250141665,halifaxns_rt,10,9424,190,0,6,0,40.9552232924,40-49,520,8,2,0,2,2,2,0,0,0,0,0.0019266828,0,0,0,75,5.211736368691387E-5,7.549639E-5,0,343,0,2,0,202,0,0,0
224934239,JLggM,10,1856,269,362,18,117,43.3590453985,40-49,633,6,2,4,6,6,2,4,11,4.0056887444,28.6089423607,0.0046764623,0.1,0.41666666,0,135,6.38984152674799E-5,7.549639E-5,7.7459335E-5,283,0.41666666,33,0,200,0,0,0
323676011,CleptoEasy,10,50,85,195,0,5,22.7470090286,20-29,358,3,0,0,0,0,0,0,0,0,0,0,0,0,390,676,4.4780486537007367E-5,0,0,402,0,4,0,65,0,0,0
38186656,atayoko,10,2330,84,174,3,0,34.9577385657,30-39,561,5,0,0,0,0,0,0,0,0,0,0,0,0,391,677,4.4780486537007367E-5,0,0,403,0,0,2,200,2,0.01,0
1084243386,hogarty_ciara,10,19,13,73,0,3,12.7421097528,10-19,46,2,0,1,1,1,0,1,1,1,0,0,0,0,2,678,4.4780486537007367E-5,0,2.5819778E-5,95,0,0,0,21,0,0,0
85994989,fleurdefibre,10,428,42,116,3,5,52.7414081937,50-59,382,4,0,0,0,0,0,0,0,0,0,0,0,0.525641,392,679,5.6878449065646525E-5,0,0,404,0.525641,3,0,199,0,0,0
1266638515,amdptrainingltd,10,5,14,129,0,0,18.1372199078,10-19,118,2,1,1,2,2,1,1,1,1,0,2.6808524730492474E-4,0,0,393,680,2.9852402567743944E-4,5.0330927E-5,5.1639556E-5,407,0,2,0,20,0,0,0
472272419,JamieTFranklin,10,4411,254,678,4,3084,19.1202829618,10-19,580,7,0,0,0,0,0,0,0,0,0,0,0,0,394,681,4.4780486537007367E-5,0,0,405,0,0,0,200,0,0,0
57179067,ChicagoPhotoCtr,10,2060,1076,270,126,2,45.826818994,40-49,665,5,0,0,0,0,0,0,0,0,0,0,0,0,395,682,4.4780486537007367E-5,0,0,406,0,37,0,200,0,0,0
136735423,mistressmel,10,9644,287,565,8,82,36.9887630406,30-39,685,7,1,1,2,2,1,1,1,1,0,2.6808524730492474E-4,0,0,393,680,2.9852402567743944E-4,5.0330927E-5,5.1639556E-5,407,0,1,0,200,0,0,0
260980623,skmckenzie,10,11612,469,348,2,1875,38.5799504095,30-39,735,7,2,2,4,4,2,2,1,1,2,5.382408138703652E-4,0,0,396,684,4.3582306220354E-4,7.549639E-5,7.7459335E-5,461,0,31,0,200,0,0,0
250154970,As_In_Speech,10,1639,48,57,1,0,29.4639035671,20-29,568,6,1,1,2,2,1,1,2,1.5,0,2.9162299782298695E-4,0,0.56666666,397,685,7.549984949484228E-5,5.0330927E-5,5.1639556E-5,414,0.56666666,4,2,200,2,0.01,0
49731022,dydhillier,10,2721,859,157,24,92,47.9259279075,40-49,710,5,7,1,8,8,7,1,2,1.8,12265,0.0032712147,0.1428571429,0.35714287,0,92,3.7857911319820204E-4,2.0132371E-4,2.0655822E-4,408,0.35714287,25,0,201,0,0,0
1207063184,IggyPosh,10,126,64,206,0,89,40.8947907231,40-49,509,4,2,2,4,4,2,2,2,1.75,0,9.505062368276737E-4,0.0833333333,1,285,522,1.3418960891622365E-4,7.549639E-5,7.7459335E-5,385,1,13,0,199,0,0,0
49336963,dpbaril,10,212,40,61,0,3,33.221335582,30-39,407,3,0,0,0,0,0,0,0,0,0,0,0,0,398,686,4.4780486537007367E-5,0,0,409,0,9,0,200,0,0,0
1100601469,CannondaleBram,10,32,18,26,0,0,20.9919190395,20-29,109,1,0,0,0,0,0,0,0,0,0,0,0,0,399,687,4.4780486537007367E-5,0,0,410,0,1,0,36,0,0,0
416324285,HeritageFFA,10,275,85,21,0,0,31.4454957674,30-39,493,2,1,1,2,2,1,1,2,1.5,0,2.9162299782298695E-4,0,0,396,684,2.29874507414389E-4,5.0330927E-5,5.1639556E-5,461,0,6,0,200,0,0,0
20880992,Kalohamora,10,958,178,710,0,41,27.9320204368,20-29,510,5,0,1,1,1,0,1,1,1,0,0,0,0,2,688,4.4780486537007367E-5,0,2.5819778E-5,95,0,2,0,199,0,0,0
285343383,asham520,10,869,19,173,0,2,27.2023276647,20-29,488,5,0,0,0,0,0,0,0,0,0,0,0,0,400,689,4.4780486537007367E-5,0,0,411,0,0,0,200,0,0,0
20722511,EmmaJean_,10,12536,236,139,4,1944,43.0323920315,40-49,722,7,5,5,10,10,5,5,2,1.375,0,0.0022518408,0.1111111111,1,285,522,2.680031814096455E-4,1.5099278E-4,1.5491867E-4,385,1,1,0,200,0,0,0
192583618,Planetintel,10,205,139,230,2,0,22.8943865767,20-29,325,3,0,0,0,0,0,0,0,0,0,0,0,0,401,690,4.4780486537007367E-5,0,0,412,0,2,0,200,0,0,0
44207086,lynneakin,10,68,166,68,11,0,34.0593789734,30-39,388,2,0,0,0,0,0,0,0,0,0,0,0,1,402,691,6.071098789883314E-5,0,0,413,1,1,0,68,0,0,0
405207165,PaddyMcHenry_7,10,7931,485,588,0,119,42.1060747267,40-49,715,7,5,7,12,12,5,7,2,1.3,5.8333333333,0.001769459,0.1515151515,0.4642857,2,263,1.2923444806506432E-4,1.5099278E-4,1.5491867E-4,95,0.4642857,4,0,197,0,0,0
415064973,RyanMcC955,10,4036,397,601,0,563,42.3765813041,40-49,708,7,7,8,15,15,7,8,2,1.2,13.3333333333,0.0023730475,0.1333333333,0.42222223,2,263,1.5462891842825264E-4,2.0132371E-4,2.0655822E-4,95,0.42222223,11,0,200,0,0,0
423717475,Natalie_kelly_,10,2270,432,483,0,137,38.7810764352,30-39,672,6,4,5,9,9,4,5,2,1.5,2.5833333333,0.0014351503,0.125,0.6,2,263,9.427057794876205E-5,1.2582731E-4,1.2909889E-4,95,0.6,13,0,199,0,0,0
606430476,kierakerr12,10,171,95,115,0,22,24.2106288041,20-29,466,3,2,2,4,4,2,2,3,1.9,0,8.089080654861469E-4,0.0833333333,1,2,263,7.690256532503898E-5,7.549639E-5,7.7459335E-5,95,1,1,0,192,0,0,0
17193885,MatusStraznicky,10,2866,206,260,15,161,30.498802516,30-39,502,4,0,0,0,0,0,0,0,0,0,0,0,0,403,693,4.4780486537007367E-5,0,0,415,0,1,0,200,0,0,0
497122064,Silviaa_mg,10,5513,238,197,0,32,43.1350350985,40-49,715,6,5,4,9,9,5,4,2,1.2,0.5,0.0018317203,0.125,0.9,209,415,3.1819331780856254E-4,1.5099278E-4,1.5491867E-4,416,0.9,113,0,200,0,0,0
548472253,miriam_fdezgar,10,1677,197,179,0,1,41.8377174206,40-49,671,5,5,5,10,10,5,5,1,1,0.75,0.0018317203,0.1,0.85,209,415,3.29751550043913E-4,1.5099278E-4,1.5491867E-4,416,0.85,110,0,200,0,0,0
85647456,NotSoLogical,10,35148,79,135,2,666,34.2176598278,30-39,768,7,0,0,0,0,0,0,0,0,0,0,0,0,404,694,4.4780486537007367E-5,0,0,417,0,1,0,200,0,0,0
55149881,icelos,10,13016,138,115,8,110,41.5459033627,40-49,596,8,1,0,1,1,1,0,0,0,0,0.0042016057,0,0.6666667,0,126,6.361060529596562E-5,5.0330927E-5,0,99,0.6666667,4,0,201,0,0,0
116841782,1000daysoframen,10,24486,1563,1537,43,1143,57.4523262292,50-59,766,8,9,12,21,21,9,12,9,3.4510361642,3306.3697897735,0.0145202238,0.0357142857,0.1969697,0,135,1.084889248416545E-4,2.5165462E-4,2.5819778E-4,303,0.1969697,35,0,201,0,0,0
265049085,Sliik07,10,1706,52,51,0,11,33.0431272841,30-39,506,4,0,0,0,0,0,0,0,0,0,0,0,0,405,695,4.4780486537007367E-5,0,0,418,0,1,0,202,0,0,0
200187558,NorthPoleHoops,10,19350,4143,196,39,177,47.919214206,40-49,846,8,8,2,10,10,8,2,3,2.1428571429,17183.8666666667,0.0071536217,0.1,0.18055555,0,105,2.1053505689164125E-4,2.2648917E-4,2.0655822E-4,343,0.18055555,76,0,200,0,0,0
261024394,tylermcghie,10,103,90,275,5,12,34.95933624,30-39,436,3,1,3,4,4,1,3,4,2.5555555556,8,2.6808524730492474E-4,0.0833333333,0.16666667,0,696,1.0912479197109002E-4,5.0330927E-5,5.1639556E-5,343,0.16666667,6,0,101,0,0,0
287241249,FonsecaSFC,10,411,130,155,0,1,38.647134506,30-39,609,4,4,4,8,8,4,4,2,1.2,0.25,0.0015015189,0.1071428571,0.9166667,209,415,2.7074367365054316E-4,1.2582731E-4,1.2909889E-4,416,0.9166667,44,0,197,0,0,0
1066611444,oharaxx,10,25,65,167,0,0,20.1411079381,20-29,197,1,0,0,0,0,0,0,0,0,0,0,0,0,406,697,4.4780486537007367E-5,0,0,419,0,0,0,28,0,0,0
27674307,JillyKaren,10,2427,156,518,3,123,36.5941900686,30-39,616,6,0,1,1,1,0,1,10,4.3549959383,0,0,0,0.3,0,699,4.4780486537007367E-5,0,2.5819778E-5,99,0.3,1,0,200,0,0,0
234952524,RaiBecca,10,17403,308,188,2,106,47.440636062,40-49,739,7,4,5,9,9,4,5,6,2.8181818182,255.8666666667,0.0016561444,0.0277777778,0.2,38,176,2.650977820496736E-4,1.2582731E-4,1.2909889E-4,88,0.2,17,0,200,0,0,0
424265689,maevalebrusq,10,10389,552,379,3,150,37.2397544737,30-39,722,7,7,8,15,15,7,8,6,2.6363636364,102.8595238095,0.0033550308,0.0666666667,0.48214287,38,176,3.6280421670844404E-4,2.0132371E-4,2.0655822E-4,88,0.48214287,10,0,200,0,0,0
539865919,DonallPurvis,10,704,250,225,0,117,41.7928576176,40-49,615,5,0,0,0,0,0,0,0,0,0,0,0,0,407,700,4.4780486537007367E-5,0,0,420,0,13,0,199,0,0,0
951839304,Omarheaps,10,1090,72,124,2,919,38.7537689305,30-39,568,5,2,2,4,4,2,2,10,3.6895570906,0,0.0073361305,0.0833333333,1,0,135,4.778696976397694E-5,7.549639E-5,7.7459335E-5,99,1,4,0,188,0,0,0
559830210,lestebug10,10,10312,516,416,0,2465,35.2076311147,30-39,740,7,0,0,0,0,0,0,0,0,0,0,0,0,408,701,4.4780486537007367E-5,0,0,421,0,14,0,200,0,0,0
240679098,mclennonld,10,74,13,51,0,5,12.5541969358,10-19,123,2,0,1,1,1,0,1,10,4.2688870837,0,0,0,0.4,0,702,4.859532679030867E-5,0,2.5819778E-5,257,0.4,1,1,77,1,0.012987013,0
547119953,OlveraJulian,10,9003,301,315,1,4738,47.2816470799,40-49,735,7,0,0,0,0,0,0,0,0,0,0,0,0,409,703,4.4780486537007367E-5,0,0,422,0,6,0,202,0,0,0
34268681,Gemini717,10,2811,82,94,0,7,35.3045672239,30-39,651,6,2,2,4,4,2,2,1,1,0,5.875113113304263E-4,0.0833333333,1,231,445,2.985240256774393E-4,7.549639E-5,7.7459335E-5,233,1,9,0,200,0,0,0
298540272,AngryAccountant,10,1327,156,327,0,52,27.6321892287,20-29,594,5,0,1,1,1,0,1,12,5.0028432169,0,0,0,0,0,704,4.4780486537007367E-5,0,2.5819778E-5,257,0,3,0,200,0,0,0
272177720,peterjwray,10,168,21,66,1,0,22.2794009995,20-29,374,3,0,0,0,0,0,0,0,0,0,0,0,0.41666666,410,705,4.4780486537007367E-5,0,0,423,0.41666666,3,0,173,0,0,0
384610504,Its_LOLA_LoVe,10,1767,170,170,1,10,28.5715492276,20-29,622,5,2,2,4,4,2,2,1,1,0,5.875113113304263E-4,0.0833333333,1,231,445,2.985240256774393E-4,7.549639E-5,7.7459335E-5,233,1,9,0,199,0,0,0
381276559,Barack_McBush,10,20655,757,1376,12,60,43.7339744957,40-49,765,9,0,1,1,1,0,1,1,1,0,0,0,0.5,0,706,4.6114985185253634E-5,0,2.5819778E-5,99,0.5,0,0,201,0,0,0
23533926,AminahMS,10,8157,339,216,0,3077,42.2794639561,40-49,717,7,2,1,3,3,2,1,2,1.5,0,5.618090794925434E-4,0.1666666667,1,381,665,2.9852402567743933E-4,7.549639E-5,7.7459335E-5,393,1,34,0,197,0,0,0
334911180,stevenclark9,10,2155,170,177,0,31,34.8093188928,30-39,654,5,4,6,10,10,4,6,2,1.1428571429,4.35,0.0013571907,0.1111111111,0.56666666,0,105,1.73808727221371E-4,1.2582731E-4,1.2909889E-4,343,0.56666666,13,0,198,0,0,0
1159995445,booklifeislife,10,7220,686,738,1,0,42.6532011918,40-49,534,7,0,0,0,0,0,0,0,0,0,0,0,0,411,707,4.4780486537007367E-5,0,0,424,0,0,0,201,0,0,0
1218929485,kanako_day,10,2655,485,500,1,0,43.2507906627,40-49,520,6,1,1,2,2,1,1,9,4.6221048354,0,8.096601273418801E-4,0,0,0,135,7.857324766799657E-5,5.0330927E-5,5.1639556E-5,148,0,0,0,201,0,0,0
271972887,ChloeMilan101,10,6031,113,133,1,1564,53.7910422903,50-59,657,6,0,0,0,0,0,0,0,0,0,0,0,0,412,708,4.4780486537007367E-5,0,0,425,0,2,0,200,0,0,0
849729062,TonyMcEnery,10,514,202,164,14,85,44.9801460819,40-49,586,4,0,0,0,0,0,0,0,0,0,0,0,0,413,709,4.4780486537007367E-5,0,0,426,0,3,0,201,0,0,0
1019724050,RikkiWolfe3,10,17,2,164,0,0,11.0632857838,10-19,12,1,0,0,0,0,0,0,0,0,0,0,0,0,414,710,4.4780486537007367E-5,0,0,427,0,0,0,24,0,0,0
1298566278,inna_no_7492416,10,2,0,0,0,1,10,10-19,10,0,0,0,0,0,0,0,0,0,0,0,0,0,415,711,4.4780486537007367E-5,0,0,428,0,0,0,7,0,0,0
1298548159,eto771,10,2,0,6,0,0,10,10-19,0,0,0,0,0,0,0,0,0,0,0,0,0,0,416,712,4.4780486537007367E-5,0,0,429,0,0,0,2,0,0,0
1298555100,lera_af_4481100,10,2,0,0,0,2,10,10-19,0,0,0,0,0,0,0,0,0,0,0,0,0,0,417,713,4.4780486537007367E-5,0,0,430,0,0,0,2,0,0,0
1298577012,vadim_ro_075951,10,2,0,0,0,1,10,10-19,0,0,0,0,0,0,0,0,0,0,0,0,0,0,418,714,4.4780486537007367E-5,0,0,431,0,0,0,6,0,0,0
1298610535,nikita_ni_76352,10,2,0,0,0,0,10,10-19,0,0,0,0,0,0,0,0,0,0,0,0,0,0,419,715,4.4780486537007367E-5,0,0,432,0,0,0,6,0,0,0
1298580552,lena_la_5256382,10,3,0,0,0,1,10,10-19,10,0,0,0,0,0,0,0,0,0,0,0,0,0,420,716,4.4780486537007367E-5,0,0,433,0,0,0,2,0,0,0
1298692566,olga_go_7481477,10,2,0,0,0,2,10,10-19,0,0,0,0,0,0,0,0,0,0,0,0,0,0,421,717,4.4780486537007367E-5,0,0,434,0,0,0,3,0,0,0
1298711894,julija_is_22988,10,4,0,0,0,0,10,10-19,10,0,0,0,0,0,0,0,0,0,0,0,0,0,422,718,4.4780486537007367E-5,0,0,435,0,0,0,4,0,0,0
1298717598,663ftqstvle3mi1,10,2,0,0,0,1,10,10-19,0,0,0,0,0,0,0,0,0,0,0,0,0,0,423,719,4.4780486537007367E-5,0,0,436,0,0,0,6,0,0,0
1298759239,vlad_af_7231101,10,3,0,0,0,0,10,10-19,0,0,0,0,0,0,0,0,0,0,0,0,0,0,424,720,4.4780486537007367E-5,0,0,437,0,0,0,8,0,0,0
1298763265,nina_go_6542410,10,2,0,0,0,0,10,10-19,0,0,0,0,0,0,0,0,0,0,0,0,0,0,425,721,4.4780486537007367E-5,0,0,438,0,0,0,2,0,0,0
786944546,wadedossp,10,190,31,196,0,0,30.7852583113,30-39,345,2,0,0,0,0,0,0,0,0,0,0,0,0,426,722,4.4780486537007367E-5,0,0,439,0,0,0,200,0,0,0
174420405,MATOSCBA,10,16230,1002,645,12,353,46.2450453337,40-49,768,8,1,1,2,2,1,1,1,1,0,2.6808524730492474E-4,0,0,427,723,2.9852402567743944E-4,5.0330927E-5,5.1639556E-5,440,0,7,0,200,0,0,0
458053575,osamente,10,18690,1218,782,28,20452,42.5655539843,40-49,765,8,1,1,2,2,1,1,1,1,0,2.6808524730492474E-4,0,0,427,723,2.9852402567743944E-4,5.0330927E-5,5.1639556E-5,440,0,5,0,198,0,0,0
868966099,Shatta_Pat,10,1526,32,90,0,11,42.1467498144,40-49,672,6,0,2,2,2,0,2,8,3.9142857143,0,0,0.5,0.5,38,725,4.4780486537007367E-5,0,2.5819778E-5,88,0.5,20,0,201,0,0,0
580105810,LiiliieNutellah,10,906,54,84,0,3,41.2015518473,40-49,615,5,1,1,2,2,1,1,8,4,0,2.4460721920661915E-4,0.5,0.5,38,724,6.38121941004466E-5,5.0330927E-5,2.5819778E-5,88,0.5,23,0,200,0,0,0
344690602,ingrx,10,29043,354,2000,7,531,46.0125095376,40-49,699,9,5,4,9,9,5,4,10,3.8943518895,3047.5321097841,0.0100104933,0.0138888889,0.06666667,0,135,7.932301478690788E-5,1.5099278E-4,1.5491867E-4,99,0.06666667,10,0,201,0,0,0
494582291,KatherineRoosev,10,52,1,13,0,37,10.6708586376,10-19,21,2,0,0,0,0,0,0,0,0,0,0,0,0.6666667,428,726,4.4780486537007367E-5,0,0,441,0.6666667,1,0,65,0,0,0
347203262,PauLambispinhas,10,2576,276,245,3,330,43.6581015927,40-49,656,5,3,4,7,7,3,4,2,1.4285714286,2.5,0.0010730633,0.0952380952,0.5833333,62,216,2.779014133126098E-4,1.00661855E-4,1.0327911E-4,101,0.5833333,20,0,200,0,0,0
455081049,anaseoanec,10,2834,94,80,1,36,40.7723447867,40-49,641,6,1,1,2,2,1,1,2,1.8571428571,0,3.9652711738766305E-4,0,0,62,216,1.1102577028014864E-4,5.0330927E-5,5.1639556E-5,101,0,11,0,199,0,0,0
448621919,IrenePfister,10,946,82,144,0,541,27.6959541494,20-29,529,4,1,1,2,2,1,1,2,1.5,0,2.9162299782298695E-4,0,0,429,727,2.29874507414389E-4,5.0330927E-5,5.1639556E-5,453,0,1,0,200,0,0,0
71139897,yo_bell,10,42732,895,761,2,56,42.5528959947,40-49,779,8,1,1,2,2,1,1,1,1,0,2.6808524730492474E-4,0,0,171,368,2.9852402567743944E-4,5.0330927E-5,5.1639556E-5,174,0,26,0,201,0,0,0
131265901,cahschucman,10,19009,519,435,1,14,39.8010545189,30-39,761,7,3,4,7,7,3,4,2,1.2,1,0.0010208752,0.1428571429,0.8333333,430,728,2.8147502897192647E-4,1.00661855E-4,1.0327911E-4,442,0.8333333,17,0,198,0,0,0
465629292,DessaNeep_,10,1473,455,138,0,3,32.195795353,30-39,676,5,5,4,9,9,5,4,2,1.2,8.6666666667,0.0015949137,0.0833333333,0.5,430,728,4.613430376234753E-4,1.5099278E-4,1.5491867E-4,442,0.5,30,0,200,0,0,0
463794634,guigorresen,10,2675,302,250,0,3,32.7306296197,30-39,693,6,1,1,2,2,1,1,3,2,0,3.7251753658316115E-4,0,0,430,728,1.4281514119357714E-4,5.0330927E-5,5.1639556E-5,442,0,1,0,201,0,0,0
87287009,MarcosKachy,10,46784,294,215,21,191,40.8403394778,40-49,779,8,3,4,7,7,3,4,2,1.2,1,0.0010465588,0.1428571429,0.8333333,430,728,2.9932567423617847E-4,1.00661855E-4,1.0327911E-4,442,0.8333333,10,0,201,0,0,0
216054973,teteualvarado,10,27475,936,187,107,140,38.6996649426,30-39,785,8,4,3,7,7,4,3,2,1.4,1,0.0013449952,0.1428571429,0.8333333,430,728,3.4128802820314753E-4,1.2582731E-4,1.2909889E-4,442,0.8333333,15,0,200,0,0,0
252272072,vihhleiva,10,8318,224,187,0,0,26.8295260853,20-29,730,7,3,3,6,6,3,3,2,1.4,0.3333333333,9.992576120990391E-4,0.2,0.9166667,430,728,2.6489724383633106E-4,1.00661855E-4,1.0327911E-4,442,0.9166667,11,0,199,0,0,0
66349240,theCIOB,10,1312,8035,1713,151,105,53.3831101615,50-59,727,5,5,2,7,7,5,2,1,1,4912,0.0015602697,0.0238095238,0.1,0,61,6.284099721566414E-4,1.5099278E-4,1.0327911E-4,102,0.1,93,0,200,0,0,0
300474179,pegcitymadman,10,730,22,91,1,15,17.630140184,10-19,448,5,0,1,1,1,0,1,11,5.0779853777,0,0,0,0,0,729,4.4780486537007367E-5,0,2.5819778E-5,106,0,1,0,200,0,0,0
166161682,DiditSEM,10,1054,358,330,17,1,42.3837725722,40-49,580,4,0,0,0,0,0,0,0,0,0,0,0,0,431,730,4.4780486537007367E-5,0,0,443,0,17,0,200,0,0,0
155932739,amolpomane,10,9926,1959,1616,34,207,59.8818310999,50-59,696,6,9,9,18,18,9,9,8,4.7513206014,16229.0270154721,0.0032394348,0.0065359477,0.055555556,0,135,5.13998092168868E-4,2.5165462E-4,2.5819778E-4,148,0.055555556,1,0,200,0,0,0
497360864,FabioT_V1,10,1103,33,122,0,1,33.0129677206,30-39,544,5,1,1,2,2,1,1,10,4.0365704998,0,0.0023402487,0,0.5541667,0,135,6.1173681374175E-5,5.0330927E-5,5.1639556E-5,99,0.5541667,1,1,200,1,0.005,0
245019687,marciesharp,10,842,52,235,0,38,33.0883697323,30-39,519,5,1,1,2,2,1,1,11,4.415684681,0,0.0035999817,0,0.5,0,135,4.9714077548719635E-5,5.0330927E-5,5.1639556E-5,257,0.5,3,1,200,1,0.005,0
35559137,abiramyv,10,3321,236,186,7,134,45.7809374336,40-49,637,6,1,1,2,2,1,1,11,4.7545713125,0,0.001143312,0,0.5,0,135,5.224265670914629E-5,5.0330927E-5,5.1639556E-5,257,0.5,20,0,200,0,0,0
432940862,blanca_ure,10,1373,182,221,0,51,40.5755636497,40-49,687,6,4,4,8,8,4,4,1,1,0,0.0014099531,0.1071428571,1,432,732,2.985240256774394E-4,1.2582731E-4,1.2909889E-4,449,1,43,0,200,0,0,0
159923573,ilaminstrutt,10,415,135,341,4,35,48.8881314632,40-49,468,4,3,2,5,5,3,2,11,4.5782202357,5054.6178352512,0.0105529282,0,0,0,135,1.1883799808473999E-4,1.00661855E-4,1.0327911E-4,283,0,3,0,201,0,0,0
597939859,Baarbiiye_Gmb,10,12271,288,116,0,47,45.4734376731,40-49,723,7,3,3,6,6,3,3,8,3.7575757576,80.2333333333,8.845671965123164E-4,0.0333333333,0.33333334,38,176,2.180141531467771E-4,1.00661855E-4,1.0327911E-4,88,0.33333334,40,0,204,0,0,0
867034092,mizzstich,10,1033,83,138,0,239,30.1083379353,30-39,531,5,2,2,4,4,2,2,1,1,1,5.618090794925434E-4,0.0833333333,0.5,433,733,3.875570667691606E-4,7.549639E-5,7.7459335E-5,444,0.5,3,0,203,0,0,0
8833682,chellenator,10,18497,129,156,8,176,43.2429539851,40-49,756,7,1,1,2,2,1,1,10,4.3742381146,0,0.0023762623,0,0,0,135,4.857584331375936E-5,5.0330927E-5,5.1639556E-5,257,0,3,1,200,1,0.005,0
620365771,Madie_Verschoor,10,284,455,748,0,109,31.7211321804,30-39,498,4,1,2,3,3,1,2,1,1,0,2.926588007250267E-4,0.1666666667,1,433,733,2.0949098458571808E-4,5.0330927E-5,5.1639556E-5,444,1,8,0,200,0,0,0
40203927,laverty122,10,1519,292,724,0,7,29.1379739724,20-29,600,5,5,9,14,14,5,9,2,1.1,8.3333333333,0.001693681,0.1483516484,0.4861111,2,263,1.1142212515795368E-4,1.5099278E-4,1.5491867E-4,95,0.4861111,5,0,199,0,0,0
543906798,irenecasasg,10,3524,1236,1269,2,322,33.7749561888,30-39,699,6,4,4,8,8,4,4,1,1,0,0.0014099531,0.1071428571,1,432,732,2.985240256774394E-4,1.2582731E-4,1.2909889E-4,449,1,78,0,200,0,0,0
176801189,HowardSternBot,10,36807,3301,19,55,8,36.7154685563,30-39,733,9,0,0,0,0,0,0,0,0,0,0,0,0,434,734,4.4780486537007367E-5,0,0,445,0,13,3,203,3,0.0147783251,0
33763811,andyfalleur,10,2620,291,123,11,0,41.3684160162,40-49,621,5,4,2,6,6,4,2,12,5.0451036164,2451,0.0024916371,0.1,0.33333334,0,135,9.832542219935758E-5,1.2582731E-4,1.2909889E-4,353,0.33333334,13,0,198,0,0,0
411928135,CareyJacobs23,10,58,20,50,0,5,24.5011633034,20-29,290,2,2,1,3,3,2,1,2,1.5,0,5.618090794925434E-4,0.1666666667,1,433,733,2.9852402567743933E-4,7.549639E-5,7.7459335E-5,444,1,10,0,61,0,0,0
125476267,emilysnake3,10,1322,17,54,1,9,,,443,5,0,0,0,0,0,0,0,0,0,0,0,1,435,735,4.4780486537007367E-5,0,0,446,1,0,0,200,0,0,0
77251447,JoaoPauloLF_,10,3248,226,120,1,10,28.8455092933,20-29,661,6,0,0,0,0,0,0,0,0,0,0,0,0,436,736,4.4780486537007367E-5,0,0,447,0,3,0,200,0,0,0
541239060,alvarot98,10,238,107,150,0,0,41.2038941918,40-49,551,3,4,5,9,9,4,5,1,1,0.5,0.0014766214,0.125,0.9,209,415,2.719603888671609E-4,1.2582731E-4,1.2909889E-4,416,0.9,24,0,200,0,0,0
546030512,jschut_online,10,452,65,70,0,8,28.9782855273,20-29,489,4,0,0,0,0,0,0,0,0,0,0,0,0,437,738,4.833448709276406E-5,0,0,448,0,1,0,200,0,0,0
591973680,AngelaRomer01,10,2060,298,217,0,16,42.2039265722,40-49,627,4,4,4,8,8,4,4,2,1.2,0.25,0.0015015189,0.1071428571,0.9166667,209,415,2.7074367365054316E-4,1.2582731E-4,1.2909889E-4,416,0.9166667,41,0,200,0,0,0
435112555,iInfinite1D,10,5120,767,1120,3,4009,35.8197703933,30-39,704,7,4,4,8,8,4,4,1,1,0,0.0014099531,0.1071428571,1,432,732,2.985240256774394E-4,1.2582731E-4,1.2909889E-4,449,1,84,0,200,0,0,0
508063405,NoeliaHoran_,10,5823,659,1260,2,206,32.2193736631,30-39,711,7,4,4,8,8,4,4,1,1,0,0.0014099531,0.1071428571,1,432,732,2.985240256774394E-4,1.2582731E-4,1.2909889E-4,449,1,69,0,200,0,0,0
466654340,MariaEspejel,10,2328,437,237,2,199,43.6373300813,40-49,703,6,4,4,8,8,4,4,1,1,0,0.0014099531,0.1071428571,1,432,732,2.985240256774394E-4,1.2582731E-4,1.2909889E-4,449,1,78,0,200,0,0,0
1241637859,yyukiko17,10,1585,412,430,0,0,39.2763043791,30-39,493,6,0,0,0,0,0,0,0,0,0,0,0,0,438,739,4.4780486537007367E-5,0,0,450,0,0,0,201,0,0,0
166811593,davipaws,10,106,9,6,0,0,19.1597621605,10-19,269,2,1,0,1,1,1,0,0,0,0,2.4460721920661915E-4,0,0,76,234,4.747046245370493E-5,5.0330927E-5,0,64,0,2,0,110,0,0,0
1292431874,anythingbutlibs,10,4,0,3,0,0,10,10-19,30,1,0,0,0,0,0,0,0,0,0,0,0,0,439,740,4.4780486537007367E-5,0,0,451,0,0,0,3,0,0,0
130000271,ChristopherPam,10,1331,45,137,1,3,49.7464172301,40-49,577,5,0,0,0,0,0,0,0,0,0,0,0,0,440,741,4.4780486537007367E-5,0,0,452,0,0,0,200,0,0,0
150289143,acorduroystain,10,2259,188,145,1,16,32.5640502721,30-39,593,5,2,2,4,4,2,2,1,1,2,5.382408138703652E-4,0,0,429,727,4.3582306220354E-4,7.549639E-5,7.7459335E-5,453,0,3,0,200,0,0,0
44482290,pkyo,10,336,24,70,0,8,17.0376144503,10-19,453,3,0,0,0,0,0,0,0,0,0,0,0,1,441,742,4.4780486537007367E-5,0,0,454,1,0,0,200,0,0,0
755672683,RogerPalfree,10,138,11,38,1,3,29.0324371191,20-29,348,3,0,0,0,0,0,0,0,0,0,0,0,0.8333333,442,743,4.4780486537007367E-5,0,0,455,0.8333333,4,0,144,0,0,0
178540278,silviustd,10,2886,36,359,0,39,46.9516125166,40-49,437,5,0,1,1,1,0,1,11,4.2883834281,0,0,0,0.4722222,0,744,5.034065667458013E-5,0,2.5819778E-5,353,0.4722222,0,0,201,0,0,0
100078080,Daniivm,10,4042,142,199,1,22,31.3938335919,30-39,633,6,0,0,0,0,0,0,0,0,0,0,0,0.33333334,443,745,4.4780486537007367E-5,0,0,456,0.33333334,4,0,194,0,0,0
165245722,AleeFariii,10,10791,232,492,0,7,36.3105695788,30-39,587,5,2,2,4,4,2,2,1,1,0,5.875113113304263E-4,0.0833333333,1,444,746,2.985240256774393E-4,7.549639E-5,7.7459335E-5,459,1,13,0,202,0,0,0
46947111,ondasalmon,10,17557,396,401,1,46,44.3065257962,40-49,746,7,2,2,4,4,2,2,1,1,0,5.875113113304263E-4,0.0833333333,1,444,746,2.985240256774393E-4,7.549639E-5,7.7459335E-5,459,1,13,0,201,0,0,0
495680721,CoreyGordan,10,1080,45,124,0,48,25.4213616188,20-29,601,5,1,1,2,2,1,1,10,4.1036164161,0,0.0018633835,0,0.55,0,135,5.122959437710535E-5,5.0330927E-5,5.1639556E-5,99,0.55,18,0,199,0,0,0
1206181339,PetitPandaChou,10,28673,564,1,0,138,50.2592916648,50-59,672,9,1,0,1,1,1,0,0,0,0,0.005274272,0,0,0,133,4.737358737227889E-5,5.0330927E-5,0,267,0,15,0,202,0,0,0
517212252,midddlemiss,10,384,19,8,0,4,12.8994027935,10-19,559,3,0,0,0,0,0,0,0,0,0,0,0,0.45,445,747,5.216722293203918E-5,0,0,457,0.45,4,3,200,3,0.015,0
585885675,TotalPolicing,10,2462,186,299,2,638,45.6098119438,40-49,620,6,1,1,2,2,1,1,10,4.440877692,0,0.0021568065,0,0.5,0,135,5.0822371887202947E-5,5.0330927E-5,5.1639556E-5,99,0.5,4,0,200,0,0,0
271266410,kns223,10,710,192,194,0,233,36.5823195299,30-39,546,3,1,1,2,2,1,1,2,1.5,0,2.9162299782298695E-4,0,0,429,727,2.29874507414389E-4,5.0330927E-5,5.1639556E-5,453,0,1,0,200,0,0,0
310286381,DealSharks,10,16,136,813,0,0,17.5078479933,10-19,261,3,0,0,0,0,0,0,0,0,0,0,0,0,446,748,4.4780486537007367E-5,0,0,458,0,1,0,16,0,0,0
196349957,Carol_n_Gabe,10,549,33,167,2,81,21.5387522323,20-29,490,4,0,1,1,1,0,1,11,4.4366368806,0,0,0,0.6666667,0,749,4.4780486537007367E-5,0,2.5819778E-5,257,0.6666667,1,0,200,0,0,0
190057663,JaviBCordova,10,1939,147,174,0,82,39.0621108928,30-39,627,5,2,2,4,4,2,2,1,1,0,5.875113113304263E-4,0.0833333333,1,444,746,2.985240256774393E-4,7.549639E-5,7.7459335E-5,459,1,15,0,201,0,0,0
718369310,rivasoi,10,55,23,532,0,0,16.9973566537,10-19,43,2,0,0,0,0,0,0,0,0,0,0,0,0,447,750,4.4780486537007367E-5,0,0,460,0,0,2,201,2,0.0099502488,0
745799070,NCFFAProbz,10,3468,1894,123,2,1430,48.5123895672,40-49,747,6,1,1,2,2,1,1,2,1.5,0,2.9162299782298695E-4,0,0,396,684,2.29874507414389E-4,5.0330927E-5,5.1639556E-5,461,0,24,0,199,0,0,0
558030678,stitchxp626,10,25,7,10,0,0,15.7754814346,10-19,127,0,0,0,0,0,0,0,0,0,0,0,0,0,448,751,4.4780486537007367E-5,0,0,462,0,0,0,28,0,0,0
34509503,MomaLoves,10,212,11,109,0,44,23.9905291452,20-29,416,4,0,1,1,1,0,1,10,4.0767668562,0,0,0,0,0,752,4.4780486537007367E-5,0,2.5819778E-5,257,0,2,0,200,0,0,0
1240329889,Ms_Webshasha,10,18,42,107,0,0,17.3817105958,10-19,73,1,0,0,0,0,0,0,0,0,0,0,0,0,449,753,4.4780486537007367E-5,0,0,463,0,20,0,25,0,0,0
266435289,gentajiri,10,316,29,45,0,62,26.5948095752,20-29,379,4,0,0,0,0,0,0,0,0,0,0,0,0,450,754,4.4780486537007367E-5,0,0,464,0,0,0,201,0,0,0
581803888,kyrauvrml,10,38,12,349,0,0,,,14,2,0,0,0,0,0,0,0,0,0,0,0,0,451,755,4.4780486537007367E-5,0,0,465,0,0,0,201,0,0,0
67486555,NurseJayJay,10,1297,159,1980,0,3,16.8321937144,10-19,472,4,0,0,0,0,0,0,0,0,0,0,0,0,452,756,4.4780486537007367E-5,0,0,466,0,1,0,200,0,0,0
243655326,CSAFEUK,10,225,308,199,8,5,40.0804065443,40-49,540,4,0,1,1,1,0,1,2,1.6666666667,0,0,0,0,0,757,4.4780486537007367E-5,0,2.5819778E-5,102,0,9,0,200,0,0,0
76764120,stuartwilks,10,19290,566,688,16,132,56.7292808872,50-59,769,8,2,2,4,4,2,2,1,1,0,6.648564680308952E-4,0.0833333333,1,0,61,5.423447363973633E-4,7.549639E-5,7.7459335E-5,102,1,6,0,200,0,0,0
67949754,Hillintl,10,448,833,87,35,1,42.5891914779,40-49,607,3,2,2,4,4,2,2,1,1,0,6.648564680308952E-4,0.0833333333,1,0,61,5.423447363973633E-4,7.549639E-5,7.7459335E-5,102,1,36,0,200,0,0,0
92937067,healnigeria,10,2376,1031,384,10,5,52.5164512392,50-59,702,5,1,1,2,2,1,1,12,5.2435170178,0,2.9162299782298695E-4,0,0,0,644,6.734277591528606E-5,5.0330927E-5,5.1639556E-5,205,0,7,0,201,0,0,0
1202254177,LeiilyD,10,1932,46,48,0,8,41.8113666216,40-49,661,6,1,1,2,2,1,1,8,4.6666666667,0,2.940342679507864E-4,0,0,38,176,1.3693132358905425E-4,5.0330927E-5,5.1639556E-5,88,0,22,0,201,0,0,0
195886865,HAPNOC,10,1032,81,126,7,12,32.9831937027,30-39,523,5,1,0,1,1,1,0,0,0,0,0.0053314222,0,0.6217949,0,85,7.050683007128545E-5,5.0330927E-5,0,505,0.6217949,7,0,200,0,0,0
517065252,clubrelation,10,53852,35,0,0,0,12.1685557516,10-19,418,3,0,0,0,0,0,0,0,0,0,0,0,0,453,758,4.4780486537007367E-5,0,0,467,0,0,0,201,0,0,0
91090291,NTPServicesltd,10,962,237,531,1,0,33.6871449387,30-39,509,4,0,0,0,0,0,0,0,0,0,0,0,0,454,759,4.4780486537007367E-5,0,0,468,0,3,0,200,0,0,0
1130110310,C_heikkinen,10,137,141,160,1,87,39.8132373519,30-39,513,3,5,5,10,10,5,5,1,1,1.75,0.0018007566,0.1,0.8,279,515,3.6480046380589677E-4,1.5099278E-4,1.5491867E-4,300,0.8,21,0,150,0,0,0
599679507,CodingNotes,10,1041,360,460,7,71,45.7025877605,40-49,643,5,4,4,8,8,4,4,1,1,6.5,0.0012119406,0.0535714286,0.41666666,211,417,4.6143805912641166E-4,1.2582731E-4,1.2909889E-4,261,0.41666666,26,0,200,0,0,0
263863782,KamillaBerdin,10,2672,266,687,3,121,41.8277739118,40-49,559,5,0,0,0,0,0,0,0,0,0,0,0,1,455,760,4.4780486537007367E-5,0,0,469,1,1,0,200,0,0,0
370964111,smokeycrow,10,1318,248,214,14,38,48.9631462467,40-49,661,5,1,1,2,2,1,1,11,4.3128809427,0,0.0021624368,0,1,0,135,5.298732657835016E-5,5.0330927E-5,5.1639556E-5,257,1,5,0,201,0,0,0
378403945,Barsanti17,10,812,20,33,1,1,21.3501173106,20-29,446,4,1,1,2,2,1,1,10,3.6757415685,0,0.008504538,0,0.42857143,0,135,4.952851130524774E-5,5.0330927E-5,5.1639556E-5,99,0.42857143,4,1,199,1,0.0050251256,0
246436394,reverb256,10,26,41,183,0,3,43.126285367,40-49,338,3,1,1,2,2,1,1,10,4.211296221,0,0.0019670648,0,0.23214285,0,135,4.842532685708261E-5,5.0330927E-5,5.1639556E-5,343,0.23214285,0,0,17,0,0,0
1114582147,Easyconferences,10,19,25,70,0,0,25.4444116146,20-29,263,1,0,0,0,0,0,0,0,0,0,0,0,0,456,762,4.4780486537007367E-5,0,0,470,0,6,0,22,0,0,0
624961616,mrmichaelbrodie,10,371,20,106,0,44,18.325121574,10-19,330,4,0,0,0,0,0,0,0,0,0,0,0,0.58928573,457,763,4.5845875479401925E-5,0,0,471,0.58928573,0,2,199,2,0.0100502513,0
404689659,unitate_fortior,10,149,164,14,0,1,24.021687296,20-29,429,3,0,1,1,1,0,1,2,1.6666666667,0,0,0,0,0,764,4.4780486537007367E-5,0,2.5819778E-5,102,0,2,0,147,0,0,0
1284313915,RufusthaRed,10,17,4,30,0,0,14.480216282,10-19,46,1,0,0,0,0,0,0,0,0,0,0,0,0,458,765,4.4780486537007367E-5,0,0,472,0,0,0,29,0,0,0
191054889,marciemcphee,10,351,215,272,0,5,27.1269181026,20-29,562,4,5,5,10,10,5,5,2,1.1666666667,3,0.0017437982,0.0777777778,0.7,365,636,2.3065899025587807E-4,1.5099278E-4,1.5491867E-4,376,0.7,9,0,199,0,0,0
104531604,Jpudoba,10,1337,364,1993,1,137,25.7502441067,20-29,482,5,0,1,1,1,0,1,1,1,0,0,0,0,0,766,4.4780486537007367E-5,0,2.5819778E-5,205,0,3,0,200,0,0,0
1089369409,tenfourpr,10,111,73,252,0,10,32.8810002825,30-39,377,3,0,0,0,0,0,0,0,0,0,0,0,0,459,767,4.4780486537007367E-5,0,0,473,0,2,0,124,0,0,0
281891570,Dont_h8_Kate,10,90,53,351,1,1,23.3449308091,20-29,215,3,0,0,0,0,0,0,0,0,0,0,0,0.3392857,460,768,4.4780486537007367E-5,0,0,474,0.3392857,0,0,99,0,0,0
101309108,Vade_maaR,10,10108,644,323,33,85,47.5115558699,40-49,749,7,0,0,0,0,0,0,0,0,0,0,0,0,461,770,4.4780486537007367E-5,0,0,475,0,0,0,200,0,0,0
495386969,solelineros,10,3281,1442,1761,4,2200,48.9916303972,40-49,716,6,3,7,10,10,3,7,12,7.7119057294,6547.9333333333,0.0015753466,0.0555555556,0.14285715,0,135,1.7233237902918806E-4,1.00661855E-4,1.0327911E-4,148,0.14285715,14,0,200,0,0,0
275712545,JosebaAlfaro,10,5312,502,492,19,71,52.4092638104,50-59,659,6,0,0,0,0,0,0,0,0,0,0,0,0,462,771,4.4780486537007367E-5,0,0,476,0,0,0,200,0,0,0
274349407,zarpaoo,10,1591,165,380,1,10,30.0982566981,30-39,594,6,1,1,2,2,1,1,13,8.7114993905,0,3.4745231421876314E-4,0,0,0,135,6.570656681225841E-5,5.0330927E-5,5.1639556E-5,148,0,1,0,196,0,0,0
360605593,PrettyPatty89,10,4475,87,241,0,13,19.2105234616,10-19,627,6,0,0,0,0,0,0,0,0,0,0,0,0,463,773,4.4780486537007367E-5,0,0,477,0,8,0,199,0,0,0
559819013,Diidys_B,10,29491,197,117,0,148,48.1025003668,40-49,766,8,3,3,6,6,3,3,6,2.9393939394,157,0.0012050166,0,0,38,176,2.4301674083680646E-4,1.00661855E-4,1.0327911E-4,88,0,29,0,201,0,0,0
96502773,Zia68,10,24624,674,2001,7,39,45.5782251206,40-49,679,7,0,1,1,1,0,1,12,5.1506904955,0,0,0,0,0,775,4.4780486537007367E-5,0,2.5819778E-5,99,0,0,0,201,0,0,0
89553250,hakeem092,10,4636,542,1977,0,140,44.3260997973,40-49,638,7,2,6,8,8,2,6,11,4.2439222042,4934,5.382408138703652E-4,0,0,0,644,1.5926321123805478E-4,7.549639E-5,7.7459335E-5,205,0,8,0,200,0,0,0
26913913,Schoukeir,10,1887,64,245,1,71,37.3603422952,30-39,522,5,0,0,0,0,0,0,0,0,0,0,0,0.4047619,464,777,6.917416485974334E-5,0,0,478,0.4047619,1,0,200,0,0,0
25590464,Tsamblac,10,1626,58,307,0,80,35.325648722,30-39,594,5,1,1,2,2,1,1,10,3.9735879724,0,0.0042920007,0,0,0,135,4.686858941064033E-5,5.0330927E-5,5.1639556E-5,99,0,6,0,200,0,0,0
1299662108,ArizonaCompanie,10,1127,0,0,0,0,,,0,0,0,0,0,0,0,0,0,0,0,0,0,0,465,778,4.4780486537007367E-5,0,0,479,0,0,0,201,0,0,0
228846881,BRAFB,10,531,380,399,28,2,43.9881901009,40-49,569,4,1,0,1,1,1,0,0,0,0,2.4460721920661915E-4,0,0,466,779,8.284390166388585E-5,5.0330927E-5,0,494,0,23,0,200,0,0,0
926791760,juelzmai,10,278,57,158,0,16,32.4204478599,30-39,496,4,0,0,0,0,0,0,0,0,0,0,0,0.76363635,467,780,4.4780486537007367E-5,0,0,480,0.76363635,14,2,199,2,0.0100502513,0
61853352,phillip5150,10,1430,110,633,0,32,35.1602218636,30-39,596,5,0,0,0,0,0,0,0,0,0,0,0,0,468,781,4.4780486537007367E-5,0,0,481,0,1,0,199,0,0,0
594844518,chimera_mary,10,196,18,102,0,141,23.6743859829,20-29,298,4,0,0,0,0,0,0,0,0,0,0,0,0.65,469,782,4.4780486537007367E-5,0,0,482,0.65,0,0,200,0,0,0
1083627469,Ibrah_OvaarMarz,10,2829,111,120,0,84,43.5133648386,40-49,627,6,1,1,2,2,1,1,10,3.9398618448,0,0.0022570128,0,0.4,0,135,6.942536013097153E-5,5.0330927E-5,5.1639556E-5,257,0.4,10,0,201,0,0,0
1263333547,JacobNoseworthy,10,163,27,123,0,48,36.10286222,30-39,408,4,1,1,2,2,1,1,9,4.2214546932,0,0.001887146,0,0.16666667,0,135,4.6807489786043565E-5,5.0330927E-5,5.1639556E-5,343,0.16666667,5,0,200,0,0,0
92152246,sharongenest,10,776,49,175,1,35,32.7841169821,30-39,488,5,0,0,0,0,0,0,0,0,0,0,0,0,470,783,4.4780486537007367E-5,0,0,483,0,1,0,200,0,0,0
566058786,Dswagon,10,472,20,165,0,24,17.0305594176,10-19,312,4,0,1,1,1,0,1,11,4.647034931,0,0,0,0.6602564,0,784,4.4780486537007367E-5,0,2.5819778E-5,99,0.6602564,0,0,200,0,0,0
107120252,LinCee3,10,1705,136,211,1,14,40.5623498858,40-49,596,6,0,0,0,0,0,0,0,0,0,0,0,0.5,471,785,4.4780486537007367E-5,0,0,484,0.5,1,0,198,0,0,0
99879869,KelseyCMS,10,2795,116,189,4,12,36.7498561089,30-39,647,6,0,0,0,0,0,0,0,0,0,0,0,0.5,472,786,4.4780486537007367E-5,0,0,485,0.5,0,0,199,0,0,0
26788120,meanmeaghan,10,3260,127,595,3,379,26.6784585124,20-29,620,6,0,1,1,1,0,1,1,1,0,0,0,0.725,0,787,5.370319470653586E-5,0,2.5819778E-5,257,0.725,1,0,200,0,0,0
223368263,blairbateson,10,245,28,47,0,1,14.4330443475,10-19,289,3,0,0,0,0,0,0,0,0,0,0,0,0,473,788,4.4780486537007367E-5,0,0,486,0,0,0,200,0,0,0
223626848,kilnclown,10,51,12,95,0,0,17.0026185131,10-19,42,2,0,1,1,1,0,1,11,4.8895207149,0,0,0,0.6666667,0,789,4.4780486537007367E-5,0,2.5819778E-5,343,0.6666667,0,0,55,0,0,0
1058709871,Bill_Templeton,10,469,39,196,1,263,31.7958403914,30-39,430,4,0,0,0,0,0,0,0,0,0,0,0,0,474,790,4.4780486537007367E-5,0,0,487,0,0,0,200,0,0,0
46390071,TWIT_ANTHONY,10,408,63,172,2,14,25.3050417182,20-29,435,4,1,1,2,2,1,1,1,1,0,2.6808524730492474E-4,0,0.41666666,475,791,1.0554020357834843E-4,5.0330927E-5,5.1639556E-5,488,0.41666666,3,0,200,0,0,0
205431257,MusekalTweet,10,4701,116,99,6,24,40.561963423,40-49,680,6,1,1,2,2,1,1,1,1,0,2.6808524730492474E-4,0,0.33333334,475,791,7.148201222578987E-5,5.0330927E-5,5.1639556E-5,488,0.33333334,0,0,200,0,0,0
429535598,valadka,10,140,49,115,0,0,15.531667525,10-19,398,3,1,1,2,2,1,1,10,4.5501828525,0,3.672052307997992E-4,0,0.47619048,0,135,6.426165024369353E-5,5.0330927E-5,5.1639556E-5,99,0.47619048,0,0,141,0,0,0
927949176,tara_taylor,10,186,42,109,0,15,23.7200098665,20-29,355,3,1,1,2,2,1,1,12,4.8768793174,0,7.573563798275226E-4,0,0.6666667,0,135,5.789187202949618E-5,5.0330927E-5,5.1639556E-5,343,0.6666667,0,0,183,0,0,0
53116283,jaredeverett,10,120,63,58,3,1,21.8777814628,20-29,329,2,0,0,0,0,0,0,0,0,0,0,0,0,476,792,4.4780486537007367E-5,0,0,489,0,0,0,120,0,0,0
606759900,CarolynMLB,10,131,13,35,0,13,19.731608251,10-19,143,3,1,1,2,2,1,1,2,1.5,0,2.9162299782298695E-4,0,1,397,685,8.243867784171844E-5,5.0330927E-5,5.1639556E-5,414,1,1,0,136,0,0,0
132407522,hoopstarscanada,10,5093,2320,483,40,3,56.5005328249,50-59,753,6,5,4,9,9,5,4,2,1.4285714286,12281.8166666667,0.0019720898,0.1527777778,0.56666666,0,105,2.4297069527246773E-4,1.5099278E-4,1.5491867E-4,343,0.56666666,2,0,200,0,0,0
1187048804,naonao5d,10,7092,703,755,0,0,41.5897546186,40-49,534,7,1,1,2,2,1,1,9,4.6221048354,0,8.096601273418801E-4,0,0,0,135,7.54503506542261E-5,5.0330927E-5,5.1639556E-5,148,0,0,0,201,0,0,0
116228737,MurrayDBcom,10,163,36,151,1,24,15.8666134137,10-19,246,3,1,2,3,3,1,2,11,5.0650142219,319.489494554,2.932121771718519E-4,0,0,0,135,5.653769893325286E-5,5.0330927E-5,5.1639556E-5,106,0,0,0,161,0,0,0
281329064,trentworkman,10,226,70,199,0,22,19.1433376322,10-19,517,4,0,0,0,0,0,0,0,0,0,0,0,0,477,793,4.4780486537007367E-5,0,0,490,0,0,0,199,0,0,0
18124468,wrongkate,10,7016,289,465,12,36,46.5154107787,40-49,708,6,2,0,2,2,2,0,0,0,0,0.0023106692,0,0,0,71,5.1174693243596224E-5,7.549639E-5,0,283,0,3,0,200,0,0,0
16343593,MarjiStevens,10,6867,217,505,13,116,44.7747253517,40-49,571,7,0,0,0,0,0,0,0,0,0,0,0,0.8333333,478,794,5.8138540981807526E-5,0,0,491,0.8333333,0,1,199,1,0.0050251256,0
796706216,mecollicott,10,1394,118,252,3,2,43.9634622729,40-49,609,5,1,1,2,2,1,1,11,4.2876879317,0,9.717801158195605E-4,0,0.47368422,0,135,6.053228585658387E-5,5.0330927E-5,5.1639556E-5,283,0.47368422,0,0,200,0,0,0
857342886,rkocis94,10,185,80,152,0,30,19.5928429759,10-19,402,3,0,0,0,0,0,0,0,0,0,0,0,0.5833333,479,795,5.034065667458013E-5,0,0,492,0.5833333,3,1,188,1,0.0053191489,0
111146102,novosada,10,4011,271,625,1,5,31.7528712235,30-39,604,6,1,2,3,3,1,2,10,4.0292563998,0,0.0023859154,0.1666666667,0.5,0,135,5.504239042477541E-5,5.0330927E-5,5.1639556E-5,505,0.5,9,0,199,0,0,0
397232213,jaredjaywesley,10,65,16,111,0,0,18.1376993648,10-19,97,2,0,1,1,1,0,1,12,4.919983753,0,0,0,0.6403509,0,796,6.076479078357097E-5,0,2.5819778E-5,353,0.6403509,0,0,68,0,0,0
1272293930,Civitatem_Civis,10,7,2,30,0,1,24.3680667981,20-29,317,1,0,0,0,0,0,0,0,0,0,0,0,0.6805556,480,797,4.4780486537007367E-5,0,0,493,0.6805556,0,0,13,0,0,0
35798442,mynameisangie_,10,1037,106,118,0,20,28.895532411,20-29,606,4,5,6,11,11,5,6,1,1,4.6666666667,0.0017437982,0.0818181818,0.53333336,365,636,2.3638338785183269E-4,1.5099278E-4,1.5491867E-4,376,0.53333336,19,0,197,0,0,0
156462489,whilewalking,10,431,22,98,1,87,15.4064772372,10-19,311,3,0,1,1,1,0,1,1,1,0,0,0,0,466,798,4.4780486537007367E-5,0,2.5819778E-5,494,0,0,0,193,0,0,0
629768935,MassCrafter,10,1063,58,196,3,143,29.6157741734,20-29,517,5,1,0,1,1,1,0,0,0,0,8.883848818176531E-4,0,0.25,0,82,6.075012402162314E-5,5.0330927E-5,0,257,0.25,0,0,198,0,0,0
152687100,JdoubleL,10,606,36,162,1,229,28.3990053863,20-29,531,3,1,1,2,2,1,1,2,1.75,0,3.4431758687926704E-4,0,0,211,417,1.428353307999102E-4,5.0330927E-5,5.1639556E-5,261,0,7,0,199,0,0,0
162494640,WathenPF,10,831,44,130,1,2,30.5602171062,30-39,584,5,0,0,0,0,0,0,0,0,0,0,0,0,481,799,4.4780486537007367E-5,0,0,495,0,2,0,198,0,0,0
24978284,mikofox,10,1818,27,125,0,0,22.4622286522,20-29,358,4,0,0,0,0,0,0,0,0,0,0,0,1,482,801,5.034065667458013E-5,0,0,496,1,0,0,198,0,0,0
296543799,kamil_kamarudin,10,4585,141,186,1,468,42.0887454183,40-49,676,6,0,0,0,0,0,0,0,0,0,0,0,0,483,802,4.4780486537007367E-5,0,0,497,0,6,0,200,0,0,0
26898604,DanielDravotCFC,10,8015,452,1131,7,600,43.5679764575,40-49,712,7,1,1,2,2,1,1,10,3.641609102,0,0.0143493568,0,0,0,135,5.085283022889121E-5,5.0330927E-5,5.1639556E-5,353,0,0,0,200,0,0,0
448602773,sarapalafox96,10,1642,195,201,1,135,28.8838520496,20-29,573,5,0,0,0,0,0,0,0,0,0,0,0,0,484,803,4.4780486537007367E-5,0,0,498,0,10,0,193,0,0,0
18844199,jeffsbrownlee,10,1958,276,460,9,8,41.7159012039,40-49,547,5,1,1,2,2,1,1,11,4.5778138968,0,0.0028049298,0,0.71117425,0,135,1.9159323477806273E-4,5.0330927E-5,5.1639556E-5,505,0.71117425,0,0,200,0,0,0
103413969,justcaty,10,30842,393,401,9,18,38.2413968686,30-39,742,8,1,1,2,2,1,1,1,1,0,2.6808524730492474E-4,0,0,485,804,2.9852402567743944E-4,5.0330927E-5,5.1639556E-5,499,0,12,0,200,0,0,0
26678366,cydnaaaaay,10,44874,643,466,14,1188,44.9530460918,40-49,770,9,1,1,2,2,1,1,1,1,0,2.6808524730492474E-4,0,0,485,804,2.9852402567743944E-4,5.0330927E-5,5.1639556E-5,499,0,30,0,202,0,0,0
73430683,scottsancton,10,1699,121,414,1,9,26.9525508965,20-29,529,6,0,1,1,1,0,1,11,4.8895207149,0,0,0,0.6213235,0,805,4.4780486537007367E-5,0,2.5819778E-5,343,0.6213235,2,3,200,3,0.015,0
176548718,mtremblay2010,10,4205,257,270,5,14,34.7571428255,30-39,607,6,0,1,1,1,0,1,10,4.1799350122,0,0,0,1,0,808,4.4780486537007367E-5,0,2.5819778E-5,267,1,4,0,200,0,0,0
522269341,DanTurner84,10,4553,65,141,0,1924,42.4495504706,40-49,671,7,1,1,2,2,1,1,10,4.1617228769,0,0.0018912833,0,0.45,0,135,6.319560310061268E-5,5.0330927E-5,5.1639556E-5,71,0.45,4,4,200,4,0.02,0
598497297,cormier1027,10,1316,85,324,0,12,31.3748053464,30-39,564,6,0,1,1,1,0,1,11,4.3009748172,0,0,0,0.5,0,809,4.4780486537007367E-5,0,2.5819778E-5,257,0.5,7,0,200,0,0,0
86614774,Grahamashby1953,10,1142,19,39,0,10,15.4936000924,10-19,443,5,0,0,0,0,0,0,0,0,0,0,0,0.78571427,486,810,4.4780486537007367E-5,0,0,500,0.78571427,1,2,200,2,0.01,0
595193381,ChazzChazz4,10,10511,535,428,0,613,48.2104406687,40-49,712,7,0,0,0,0,0,0,0,0,0,0,0,0,487,811,4.4780486537007367E-5,0,0,501,0,1,0,201,0,0,0
396794234,nickpoveda,10,3867,336,246,1,285,43.6400426254,40-49,708,6,0,0,0,0,0,0,0,0,0,0,0,0,488,812,4.4780486537007367E-5,0,0,502,0,3,0,199,0,0,0
242093891,axelneitor13,10,1001,113,206,0,32,38.3453705938,30-39,624,5,0,0,0,0,0,0,0,0,0,0,0,0,489,813,4.4780486537007367E-5,0,0,503,0,11,0,200,0,0,0
1195945369,SICKOFSPINNERS,10,73,2,17,0,0,15.0957851927,10-19,60,3,0,0,0,0,0,0,0,0,0,0,0,0.5,490,814,4.4780486537007367E-5,0,0,504,0.5,0,0,96,0,0,0
411294090,DylanParsons14,10,1551,5384,210,1,642,42.089302907,40-49,655,5,0,0,0,0,0,0,0,0,0,0,0,0,491,815,4.4780486537007367E-5,0,0,506,0,7,0,200,0,0,0
399371605,VivianBell1,10,828,24,60,2,267,27.5854617462,20-29,407,5,0,1,1,1,0,1,10,4.0982940699,0,0,0,0.5,0,816,4.4780486537007367E-5,0,2.5819778E-5,99,0.5,0,1,200,1,0.005,0
37263962,CPCDRE,10,12847,991,921,1,112,44.5315004834,40-49,734,7,1,1,2,2,1,1,1,1,0,2.6808524730492474E-4,0,0,492,818,2.9852402567743944E-4,5.0330927E-5,5.1639556E-5,507,0,11,0,200,0,0,0
203057848,NappyCP,10,33479,1647,589,2,135,35.9641697303,30-39,798,8,1,1,2,2,1,1,1,1,0,2.6808524730492474E-4,0,0,492,818,2.9852402567743944E-4,5.0330927E-5,5.1639556E-5,507,0,4,0,200,0,0,0
44946908,DustyMullinax,10,4532,263,273,0,5,28.4160494008,20-29,635,6,0,0,0,0,0,0,0,0,0,0,0,0,493,819,4.4780486537007367E-5,0,0,508,0,17,0,200,0,0,0
867117816,mateu_ebooks,10,4321,66,2,4,0,41.4672841506,40-49,646,5,1,1,2,2,1,1,1,1,0,2.6808524730492474E-4,0,0,494,820,2.9852402567743944E-4,5.0330927E-5,5.1639556E-5,509,0,1,0,200,0,0,0
59604112,Katdraken,10,57572,1222,619,31,7974,50.1436565547,50-59,838,9,1,1,2,2,1,1,1,1,0,2.6808524730492474E-4,0,0,494,820,2.9852402567743944E-4,5.0330927E-5,5.1639556E-5,509,0,3,0,201,0,0,0
294509806,yusriyusoff,10,7543,156,208,3,5,44.0366017634,40-49,721,7,0,0,0,0,0,0,0,0,0,0,0,0,495,821,4.4780486537007367E-5,0,0,510,0,0,0,200,0,0,0
506492079,dommythekid,10,1565,134,118,1,1179,41.0540622842,40-49,604,5,0,0,0,0,0,0,0,0,0,0,0,0,496,822,4.4780486537007367E-5,0,0,511,0,3,0,200,0,0,0
608467477,opamp99,10,2995,2,35,0,0,16.0632857838,10-19,87,4,0,0,0,0,0,0,0,0,0,0,0,0,497,823,4.4780486537007367E-5,0,0,512,0,0,0,200,0,0,0
358193491,ZazenMedia,10,896,215,211,4,0,30.3509753048,30-39,542,5,0,0,0,0,0,0,0,0,0,0,0,0,498,824,4.4780486537007367E-5,0,0,513,0,1,1,200,1,0.005,0
296504381,mADtivity,10,59544,1385,1640,83,5,46.1822746157,40-49,685,9,2,1,3,3,2,1,11,6.5538399025,268.1029156905,7.640484702722396E-4,0,0,0,135,1.3476949278548228E-4,7.549639E-5,7.7459335E-5,148,0,4,0,202,0,0,0
19304663,Miss_mobile_web,10,4127,4485,4099,126,242,57.5211393087,50-59,733,7,6,6,12,12,6,6,10,5.5542462414,24869.3213661062,0.0018422539,0,0,0,135,4.7187643742849705E-4,1.7615824E-4,1.5491867E-4,148,0,15,0,200,0,0,0
81793090,andreas_rieger,10,414,250,738,3,1,32.1182507606,30-39,395,4,0,2,2,2,0,2,11,6.5468940317,0,0,0,0,0,825,4.4780486537007367E-5,0,2.5819778E-5,148,0,0,0,200,0,0,0
957344324,DHChelmsford,10,88,57,82,4,0,35.8189296541,30-39,388,3,1,1,2,2,1,1,1,1,0,2.6808524730492474E-4,0,0,58,209,2.9852402567743944E-4,5.0330927E-5,5.1639556E-5,47,0,0,0,117,0,0,0
21312083,_katieconway,10,873,360,367,9,15,40.0072452072,40-49,608,5,1,1,2,2,1,1,11,6.5538399025,0,3.9457209880663067E-4,0,0,0,135,1.0207987623313145E-4,5.0330927E-5,5.1639556E-5,148,0,4,0,200,0,0,0
516074406,ThomasNishantha,10,932,253,651,1,2,48.2275478109,40-49,511,5,1,1,2,2,1,1,11,6.5538399025,0,3.9457209880663067E-4,0,0,0,135,1.0207987623313145E-4,5.0330927E-5,5.1639556E-5,148,0,0,0,200,0,0,0
163405115,amsterdamremco,10,1395,183,689,2,5,33.991769598,30-39,534,5,0,0,0,0,0,0,0,0,0,0,0,0,499,826,4.4780486537007367E-5,0,0,514,0,2,0,200,0,0,0
17078094,subha26,10,28090,1049,1371,66,1891,37.8793213146,30-39,783,8,0,1,1,1,0,1,1,1,0,0,0,0.47076023,249,827,5.3801070870540714E-5,0,2.5819778E-5,253,0.47076023,3,1,200,1,0.005,0
714467522,DrJulieGosselin,10,263,39,90,0,2,19.7183853558,10-19,393,4,1,1,2,2,1,1,11,4.2198293377,0,0.0034014508,0,0.4679487,0,135,8.824254053903965E-5,5.0330927E-5,5.1639556E-5,283,0.4679487,2,1,200,1,0.005,0
500664166,CitizensPlatNG,10,25106,9524,33,34,1,62.0114975174,60-69,861,6,4,0,4,4,4,0,0,0,0,0.0010744996,0,0,0,265,2.026609634700362E-4,1.2582731E-4,0,205,0,1,0,201,0,0,0
262153595,Charles_McD,10,64,12,310,0,10,16.8149155262,10-19,99,3,0,0,0,0,0,0,0,0,0,0,0,0,500,828,4.4780486537007367E-5,0,0,515,0,0,0,59,0,0,0
1195118856,saleamen,10,62,17,128,0,2,25.128241004,20-29,135,2,0,1,1,1,0,1,10,4.2437043054,0,0,0,0.6,0,829,4.4780486537007367E-5,0,2.5819778E-5,257,0.6,2,0,65,0,0,0
597569522,Mes2Cents,10,190,6,36,0,0,19.8788762157,10-19,106,3,0,1,1,1,0,1,11,4.7083671812,0,0,0,0,0,830,4.4780486537007367E-5,0,2.5819778E-5,267,0,2,6,200,6,0.03,0
184862799,diamond_d2,10,1458,60,164,1,970,27.8272005115,20-29,570,5,1,1,2,2,1,1,11,6.5538399025,0,3.9457209880663067E-4,0,0,0,135,1.0207987623313145E-4,5.0330927E-5,5.1639556E-5,148,0,0,0,199,0,0,0
133752834,SDCC_unknown,10,230,19,24,0,0,16.9474539834,10-19,314,3,1,0,1,1,1,0,0,0,0,0.0044254402,0,0,0,112,4.9086537551101265E-5,5.0330927E-5,0,353,0,0,0,200,0,0,0
345794855,LeslieJolliffe,10,159,19,44,0,0,27.6253433078,20-29,346,4,0,1,1,1,0,1,11,4.5808285946,0,0,0,0,0,832,4.4780486537007367E-5,0,2.5819778E-5,257,0,0,0,188,0,0,0
509633597,DavidScottson,10,153,100,292,1,10,21.6334094435,20-29,372,3,1,1,2,2,1,1,11,4.1340918326,0,0.0068339082,0,0.54761904,0,135,4.9285300708083014E-5,5.0330927E-5,5.1639556E-5,353,0.54761904,2,0,153,0,0,0
111088978,SpaTimeEdmonton,10,69,38,229,2,0,37.4310141073,30-39,409,4,1,3,4,4,1,3,11,4.0093457944,0,4.056974693553632E-4,0.1666666667,0.5,0,135,5.5813821265702704E-5,5.0330927E-5,5.1639556E-5,353,0.5,15,0,119,0,0,0
286278904,bailey_jade,10,1260,103,219,0,1022,38.5933381576,30-39,569,5,3,3,6,6,3,3,10,3.4697277529,133.9979904124,0.0276372444,0,0,0,135,5.453962795646596E-5,1.00661855E-4,1.0327911E-4,99,0,6,0,200,0,0,0
1264972752,MsMeganMack,10,129,30,192,0,20,26.2018979942,20-29,137,4,0,1,1,1,0,1,10,4.0211210398,0,0,0,0.33333334,0,833,4.4780486537007367E-5,0,2.5819778E-5,257,0.33333334,0,0,167,0,0,0
436366250,DanielleDozier,10,4038,1489,114,53,67,55.1916790334,50-59,739,6,0,0,0,0,0,0,0,0,0,0,0,0,501,834,4.4780486537007367E-5,0,0,516,0,1,0,200,0,0,0
325184070,Lady_KK_,10,465,251,235,14,98,35.9918392536,30-39,501,4,0,0,0,0,0,0,0,0,0,0,0,0,502,835,4.4780486537007367E-5,0,0,517,0,7,0,199,0,0,0
121651119,pavlosky4,10,24379,934,1033,7,664,52.350402209,50-59,778,8,3,5,8,8,3,5,14,9.6984965461,4485.2499999999,0.0011199471,0.0178571429,0.05,0,135,2.1360904807522066E-4,1.00661855E-4,1.0327911E-4,148,0.05,15,0,198,0,0,0
517877177,Sindical_cl,10,694,205,302,1,2,42.0052422154,40-49,542,4,1,5,6,6,1,5,12,7.7135310849,0,8.550376980862657E-4,0.1333333333,0.25,0,135,6.79464955354548E-5,5.0330927E-5,5.1639556E-5,148,0.25,14,0,199,0,0,0
1222500780,FabienLeonard,10,10,11,48,0,0,12.4824719478,10-19,10,1,0,0,0,0,0,0,0,0,0,0,0,0,503,836,4.4780486537007367E-5,0,0,518,0,0,0,13,0,0,0
37912191,japeworthy,10,581,19,35,1,6,18.7029010363,10-19,378,3,0,0,0,0,0,0,0,0,0,0,0,0.54545456,504,837,6.165495409841676E-5,0,0,519,0.54545456,1,14,200,13,0.065,0
610370629,davidstuckless,10,135,9,25,0,0,22.5711650578,20-29,340,3,1,1,2,2,1,1,11,4.5392117026,0,0.0011289716,0,0,0,135,5.036056706056615E-5,5.0330927E-5,5.1639556E-5,505,0,0,0,141,0,0,0
33662678,ashleyynicole94,10,3036,272,258,0,565,42.6331688336,40-49,686,6,2,2,4,4,2,2,1,1,0,5.875113113304263E-4,0.0833333333,1,505,838,2.985240256774393E-4,7.549639E-5,7.7459335E-5,520,1,22,0,200,0,0,0
455306009,coarirae,10,6598,351,206,0,1709,34.028568002,30-39,719,7,2,2,4,4,2,2,1,1,0,5.875113113304263E-4,0.0833333333,1,505,838,2.985240256774393E-4,7.549639E-5,7.7459335E-5,520,1,27,0,200,0,0,0
29591741,donnwatt,10,66,19,36,0,1,12.8994027935,10-19,129,2,0,0,0,0,0,0,0,0,0,0,0,0.5,506,839,4.4780486537007367E-5,0,0,521,0.5,0,0,69,0,0,0
1089926084,MonetteScott,10,1394,24,225,0,66,44.7877053658,40-49,563,6,0,1,1,1,0,1,10,4.1551584078,0,0,0,0.5972222,0,840,4.4780486537007367E-5,0,2.5819778E-5,505,0.5972222,40,0,201,0,0,0
710248489,Emily_Jean_12,10,964,187,188,0,503,39.9599190221,30-39,600,5,2,2,4,4,2,2,1,1,0,5.875113113304263E-4,0.0833333333,1,505,838,2.985240256774393E-4,7.549639E-5,7.7459335E-5,520,1,28,0,200,0,0,0
17213033,JoeyCuba,10,152,32,99,0,5,19.6014222043,10-19,192,1,1,1,2,2,1,1,12,5.5778138968,0,5.553232397408342E-4,0,0,0,135,7.003356437602543E-5,5.0330927E-5,5.1639556E-5,283,0,0,0,150,0,0,0
614784729,FunFanWebs,10,20744,253,10,0,0,19.4799355281,10-19,281,5,2,0,2,2,2,0,0,0,0,5.361704946098507E-4,0.5,1,46,188,8.505369883587177E-5,7.549639E-5,0,116,1,0,0,201,0,0,0
411611799,naxete1989,10,1915,117,153,0,21,36.825954305,30-39,667,6,0,0,0,0,0,0,0,0,0,0,0,0,507,841,4.4780486537007367E-5,0,0,522,0,26,0,198,0,0,0
14485907,tamtar,10,7602,161,167,7,287,60.6321296613,60-69,705,6,1,1,2,2,1,1,12,5.2673709874,0,3.63447957478101E-4,0,0,0,135,6.57575833059089E-5,5.0330927E-5,5.1639556E-5,257,0,5,0,200,0,0,0
888682813,2013talk,10,1295,301,987,0,1,26.968191454,20-29,477,6,0,0,0,0,0,0,0,0,0,0,0,0,508,842,4.4780486537007367E-5,0,0,523,0,0,0,196,0,0,0
380016963,oectasudelem,10,687,80,58,2,1,33.5762212052,30-39,524,4,4,1,5,5,4,1,11,4.0739536774,0,0.009069625,0.15,0.25,0,135,5.4307177586428385E-5,1.2582731E-4,1.2909889E-4,257,0.25,4,0,200,0,0,0
59641324,justskp,10,2937,152,655,2,51,35.2329945996,30-39,570,6,0,1,1,1,0,1,1,1,0,0,0,0.5,0,843,4.4780486537007367E-5,0,2.5819778E-5,257,0.5,1,0,200,0,0,0
480280640,fouadbey,10,149,42,92,1,0,19.247094058,10-19,368,2,0,0,0,0,0,0,0,0,0,0,0,0,509,844,4.4780486537007367E-5,0,0,524,0,0,0,154,0,0,0
226710176,jessecrowecpga,10,6279,889,1413,15,13,46.2921968771,40-49,732,7,1,1,2,2,1,1,5,3.4444444444,0,2.6808524730492474E-4,0,0,0,696,7.569917912644684E-5,5.0330927E-5,5.1639556E-5,343,0,0,0,200,0,0,0
1033371643,jumisupa,10,42,15,144,0,2,23.374529937,20-29,150,2,0,0,0,0,0,0,0,0,0,0,0,0,510,845,4.4780486537007367E-5,0,0,525,0,0,0,52,0,0,0
245839288,carolyn1775,10,471,37,162,0,0,21.3573355193,20-29,607,4,0,0,0,0,0,0,0,0,0,0,0,0,511,846,4.4780486537007367E-5,0,0,526,0,0,0,199,0,0,0
557995848,BradTapson,10,265,27,107,1,105,27.2886864532,20-29,388,4,0,0,0,0,0,0,0,0,0,0,0,0,512,847,4.4780486537007367E-5,0,0,527,0,2,2,200,1,0.005,0
300400577,TartsnTattoos,10,3467,300,387,6,45,40.9976642984,40-49,636,6,0,0,0,0,0,0,0,0,0,0,0,0.6666667,513,848,4.94405029247494E-5,0,0,528,0.6666667,2,0,199,0,0,0
49774237,steelheadtroy,10,102,19,73,0,3,13.0346706108,10-19,31,3,0,0,0,0,0,0,0,0,0,0,0,0,514,849,4.4780486537007367E-5,0,0,529,0,0,1,114,1,0.0087719298,0
321852329,totallyluke,10,562,64,171,1,24,29.1497800421,20-29,587,5,0,0,0,0,0,0,0,0,0,0,0,0.5131579,515,850,6.47304162589144E-5,0,0,530,0.5131579,11,1,200,1,0.005,0
926125051,brin_jones,10,61,16,40,0,0,13.8833241606,10-19,76,1,0,0,0,0,0,0,0,0,0,0,0,0,516,851,4.4780486537007367E-5,0,0,531,0,0,0,61,0,0,0
330539177,PRBdata,10,1770,1085,345,61,3,54.4239191626,50-59,692,5,1,0,1,1,1,0,0,0,0,5.909815395312531E-4,0,0,0,76,6.16366293081432E-5,5.0330927E-5,0,99,0,1,0,200,0,0,0
1110761798,Thatcherist,10,81,17,36,0,5,17.9145535175,10-19,176,3,0,1,1,1,0,1,11,4.1230706742,0,0,0,0,0,852,4.4780486537007367E-5,0,2.5819778E-5,353,0,3,1,88,1,0.0113636364,0
368090766,radicalyfeliz,10,43363,951,398,7,55,39.6074699763,30-39,755,9,3,1,4,4,3,1,15,10.6980902072,0.5,0.0010212855,0.1666666667,0.6666667,0,135,1.1854297784842988E-4,1.00661855E-4,1.0327911E-4,148,0.6666667,7,0,200,0,0,0
169631777,Spoogicus,10,487,31,111,0,5,17.1299232928,10-19,468,3,0,0,0,0,0,0,0,0,0,0,0,0,517,853,4.4780486537007367E-5,0,0,532,0,0,0,200,0,0,0
621406056,mmail8,10,16,2,12,0,2,14.9690845959,10-19,32,1,0,0,0,0,0,0,0,0,0,0,0,0,518,854,4.4780486537007367E-5,0,0,533,0,0,0,17,0,0,0
1117017337,Canada_Bikes,10,134,120,178,3,0,40.2865832277,40-49,426,3,1,2,3,3,1,2,10,4.6611133685,0,6.635245766170422E-4,0.1666666667,0.5,0,135,5.526371413847151E-5,5.0330927E-5,5.1639556E-5,71,0.5,2,0,136,0,0,0
286320498,1_Non_Blonde,10,974,28,29,0,3,19.8157066905,10-19,573,5,0,0,0,0,0,0,0,0,0,0,0,0,519,855,4.4780486537007367E-5,0,0,534,0,0,2,200,1,0.005,0
34533812,stevechacon,10,2705,141,128,2,42,37.2865872893,30-39,676,5,0,0,0,0,0,0,0,0,0,0,0,0,520,856,4.4780486537007367E-5,0,0,535,0,13,0,200,0,0,0
65418383,DianaIdibe,10,4026,257,250,1,482,41.7742106958,40-49,619,5,0,1,1,1,0,1,11,4.0991064175,0,0,0,0,0,857,4.4780486537007367E-5,0,2.5819778E-5,99,0,24,0,200,0,0,0
98507630,mrperki,10,1802,70,191,0,337,32.0326042556,30-39,599,5,1,1,2,2,1,1,11,4.6168224299,0,4.051586751820466E-4,0,0,0,135,4.956356489926546E-5,5.0330927E-5,5.1639556E-5,505,0,3,0,200,0,0,0
370453743,randTRUMP09,10,1030,60,179,0,148,35.5112782619,30-39,540,5,1,1,2,2,1,1,2,1.5,0,2.9162299782298695E-4,0,0,258,486,2.29874507414389E-4,5.0330927E-5,5.1639556E-5,271,0,21,0,198,0,0,0
127895254,heroicseas,10,28732,1113,55,85,0,42.5695345684,40-49,767,8,2,0,2,2,2,0,0,0,0,0.0021178686,0,0,0,51,5.386422510199382E-5,7.549639E-5,0,71,0,1,0,200,0,0,0
614436248,Kauly_97,10,8265,199,175,0,1,43.7212963736,40-49,722,7,2,2,4,4,2,2,7,3.696969697,65,5.977399357982716E-4,0,0,38,176,2.16825276720144E-4,7.549639E-5,7.7459335E-5,88,0,35,0,201,0,0,0
1203590904,SilveykkgHolli,10,3,1,6,0,0,,,2,0,0,0,0,0,0,0,0,0,0,0,0,0,521,859,4.4780486537007367E-5,0,0,536,0,0,0,9,0,0,0
288067030,KweschnMedia,10,10610,720,527,9,708,42.7107149421,40-49,729,7,1,1,2,2,1,1,11,4.2624949208,0,0.0021401536,0,0,0,135,5.2731590636623866E-5,5.0330927E-5,5.1639556E-5,303,0,26,0,200,0,0,0
344029955,TL_Raww,10,4470,140,120,0,1913,41.3315275389,40-49,696,6,0,0,0,0,0,0,0,0,0,0,0,0,522,860,4.4780486537007367E-5,0,0,537,0,13,0,200,0,0,0
36098759,Ellzabob,10,158,26,152,0,337,13.1898573515,10-19,166,3,0,0,0,0,0,0,0,0,0,0,0,0.8,523,861,4.4780486537007367E-5,0,0,538,0.8,0,2,158,2,0.0126582278,0
70973856,phomme,10,6935,212,205,12,5,29.2020554118,20-29,563,6,0,0,0,0,0,0,0,0,0,0,0,0,524,862,4.4780486537007367E-5,0,0,539,0,0,0,199,0,0,0
32655878,Friendshipgal,10,216,20,46,0,0,15.7326965635,10-19,290,3,0,3,3,3,0,3,11,4.0219333875,0,0,0.3333333333,0.6666667,0,863,5.034065667458013E-5,0,2.5819778E-5,353,0.6666667,0,12,200,12,0.06,0
37609340,martin_fff,10,1906,298,101,14,2,46.0947636967,40-49,676,5,1,0,1,1,1,0,0,0,0,0.0016916632,0,0.5,0,100,4.590057717206838E-5,5.0330927E-5,0,71,0.5,0,0,200,0,0,0
208104339,YorktonThisWeek,10,1216,313,30,5,0,42.2786395224,40-49,518,2,1,0,1,1,1,0,0,0,0,0.0010049865,0,0.16666667,0,56,5.642797875698315E-5,5.0330927E-5,0,353,0.16666667,3,0,200,0,0,0
1236477440,TobinCdnPoli,10,39,11,35,0,9,21.4543139108,20-29,113,2,1,3,4,4,1,3,11,4.0605444941,12.7669441494,0.0163321031,0.0833333333,0.33333334,0,135,4.890456961082401E-5,5.0330927E-5,5.1639556E-5,353,0.33333334,3,0,47,0,0,0
395456938,nicktata88,10,648,120,191,0,515,30.3281842429,30-39,582,4,1,1,2,2,1,1,1,1,0,2.6808524730492474E-4,0,0,525,864,2.9852402567743944E-4,5.0330927E-5,5.1639556E-5,540,0,2,0,197,0,0,0
38022839,Kabadyundi,10,3851,193,346,1,149,40.11890771,40-49,657,6,3,5,8,8,3,5,2,1.2857142857,0.25,0.0010813324,0.1607142857,0.75,0,105,1.3119079198735354E-4,1.00661855E-4,1.0327911E-4,343,0.75,14,0,196,0,0,0
356647010,Desilien13,10,2175,151,95,2,63,43.1294762696,40-49,664,5,5,5,10,10,5,5,2,1.2857142857,4916.9,0.0017160865,0.0777777778,0.6,0,105,2.1372900131690463E-4,1.5099278E-4,1.5491867E-4,343,0.6,24,0,198,0,0,0
713563368,ballneverstop5,10,2805,114,74,1,320,,,683,6,2,2,4,4,2,2,3,1.8571428571,0,7.276439593679461E-4,0.0833333333,1,0,105,1.0573736370420982E-4,7.549639E-5,7.7459335E-5,343,1,41,0,200,0,0,0
249366006,josh_cota,10,6655,274,399,4,685,43.6795852335,40-49,703,7,1,1,2,2,1,1,1,1,0,2.6808524730492474E-4,0,0,525,864,2.9852402567743944E-4,5.0330927E-5,5.1639556E-5,540,0,4,0,199,0,0,0
97782957,CanadianOwl92,10,1331,28,88,0,18,29.8203950883,20-29,582,5,1,0,1,1,1,0,0,0,0,6.667841174120822E-4,0,0.62222224,0,73,5.884376685910263E-5,5.0330927E-5,0,505,0.62222224,1,0,200,0,0,0
345765280,Jerskuh,10,1586,115,249,2,92,35.724673372,30-39,602,5,0,0,0,0,0,0,0,0,0,0,0,0,526,865,4.4780486537007367E-5,0,0,541,0,2,0,200,0,0,0
1204587288,GroovereqoArdit,10,33,11,93,0,0,11.7341444214,10-19,11,1,0,0,0,0,0,0,0,0,0,0,0,0,527,866,4.4780486537007367E-5,0,0,542,0,0,0,33,0,0,0
296560575,ChristeezyNRG,10,5386,73,150,0,2188,22.0236993694,20-29,525,2,0,0,0,0,0,0,0,0,0,0,0,0,528,867,4.4780486537007367E-5,0,0,543,0,0,0,200,0,0,0
897074468,Mioratoria,10,23,23,128,0,1,19.9663513632,10-19,382,2,0,0,0,0,0,0,0,0,0,0,0,0,529,868,4.4780486537007367E-5,0,0,544,0,3,0,23,0,0,0
30072340,MrTree2013,10,2054,74,80,0,130,29.4556201135,20-29,580,5,0,0,0,0,0,0,0,0,0,0,0,0,530,869,4.4780486537007367E-5,0,0,545,0,0,0,200,0,0,0
1184200088,WowIvanTweets,10,360,12,110,0,58,24.6246914539,20-29,225,4,0,1,1,1,0,1,10,4.2656376929,0,0,0,0.33333334,0,870,5.036611457069258E-5,0,2.5819778E-5,71,0.33333334,3,7,200,7,0.035,0
709766389,HoboWally,10,33,10,26,0,0,18.9670330971,10-19,290,1,0,1,1,1,0,1,11,4.5349309504,0,0,0,0.33333334,0,871,4.4780486537007367E-5,0,2.5819778E-5,257,0.33333334,1,0,34,0,0,0
142860040,rchavarri,10,7824,618,1463,2,627,43.8661685537,40-49,687,7,2,7,9,9,2,7,12,7.7119057294,4088.9333333333,0.0013042789,0.0694444444,0.14285715,0,135,1.1648178928206347E-4,7.549639E-5,7.7459335E-5,148,0.14285715,22,0,200,0,0,0
142039570,tetecarrerouge,10,2303,136,77,2,164,40.9074134391,40-49,663,5,1,1,2,2,1,1,10,4.4286875254,0,0.0013830865,0,0.4909091,0,135,7.592899470596356E-5,5.0330927E-5,5.1639556E-5,267,0.4909091,23,0,200,0,0,0
837676586,_dylanabel,10,2646,158,268,1,1595,40.6378302462,40-49,630,6,0,0,0,0,0,0,0,0,0,0,0,0,531,872,4.4780486537007367E-5,0,0,546,0,8,0,200,0,0,0
25025529,ChelsCalabrese,10,3223,343,330,15,85,60.2222137945,60-69,631,6,0,0,0,0,0,0,0,0,0,0,0,0,532,873,4.4780486537007367E-5,0,0,547,0,1,0,200,0,0,0
90776169,50shadesofTGO,10,3440,153,597,1,307,41.4285232736,40-49,661,6,0,1,1,1,0,1,11,4.371242892,0,0,0,0,0,874,4.4780486537007367E-5,0,2.5819778E-5,343,0,19,0,198,0,0,0
532460250,SteveHLeDrew,10,27,51,63,1,0,19.4012522743,10-19,151,2,1,1,2,2,1,1,11,4.8305566843,0,7.100633545355803E-4,0,0,0,135,5.062817101684591E-5,5.0330927E-5,5.1639556E-5,267,0,0,0,28,0,0,0
461286070,DramaQueencpc,10,1073,748,2000,4,17,40.5769976992,40-49,587,5,0,0,0,0,0,0,0,0,0,0,0,0,533,875,4.4780486537007367E-5,0,0,548,0,4,0,200,0,0,0
5708752,andymckay,10,6339,707,362,64,10,47.9212045473,40-49,718,6,0,0,0,0,0,0,0,0,0,0,0,0,534,876,4.807502566858628E-5,0,0,549,0,1,0,200,0,0,0
537369806,ArturoReina,10,702,216,481,0,76,40.5053332502,40-49,587,4,2,3,5,5,2,3,1,1,0,6.41307390834641E-4,0.15,1,535,877,2.3261649057882062E-4,7.549639E-5,7.7459335E-5,555,1,63,0,200,0,0,0
196978441,gappersonnel,10,458,316,262,0,0,46.9115544038,40-49,603,4,0,0,0,0,0,0,0,0,0,0,0,0,536,878,4.4780486537007367E-5,0,0,550,0,13,0,200,0,0,0
514818535,Andy_Fila,10,44203,475,338,1,1234,41.0042954916,40-49,794,8,10,10,20,20,10,10,5,2.303030303,534.9634920635,0.0045355271,0.0368421053,0.2888889,38,176,5.809521152581806E-4,2.768201E-4,2.8401756E-4,88,0.2888889,56,0,201,0,0,0
705987434,KarenSainteLuce,10,3826,426,240,2,45,37.2917442797,30-39,712,6,12,13,25,25,12,13,6,2.5757575758,203.4916666667,0.0055841277,0.0616666667,0.41025642,38,176,6.121819184744287E-4,3.27151E-4,3.3565713E-4,88,0.41025642,26,0,200,0,0,0
916993710,Yannick_strong,10,3294,134,130,0,5,41.4766964885,40-49,603,6,6,8,14,14,6,8,6,2.7878787879,15.6257936508,0.0033274856,0.1208791209,0.76785713,38,176,3.6270088139101766E-4,1.7615824E-4,1.8073844E-4,88,0.76785713,17,0,199,0,0,0
944615180,LalaneLm,10,4470,190,103,0,58,45.0539773206,40-49,636,5,7,6,13,13,7,6,6,2.8484848485,15.7507936508,0.0036285908,0.0897435897,0.64285713,38,176,3.828825330814431E-4,2.0132371E-4,2.0655822E-4,88,0.64285713,32,0,201,0,0,0
186483691,Jahlys_FAMOUS,10,2984,132,145,1,6,46.1119320733,40-49,694,6,2,5,7,7,2,5,7,3.2121212121,1.075,0.0010861188,0.119047619,0.45,38,176,1.233561932973685E-4,7.549639E-5,7.7459335E-5,88,0.45,31,0,201,0,0,0
66871543,hayer432,10,14531,1036,914,36,172,49.264247849,40-49,736,7,1,1,2,2,1,1,13,8.7106867127,4900,8.550376980862657E-4,0.5,0.5,0,135,6.79464955354548E-5,5.0330927E-5,5.1639556E-5,148,0.5,0,0,200,0,0,0
479759692,Marie_Saara,10,5410,463,183,0,59,43.8378990973,40-49,706,6,11,9,20,20,11,9,7,3.0909090909,88.0031746032,0.0050350256,0.0710526316,0.4090909,38,176,6.035113145857291E-4,3.0198556E-4,2.8401756E-4,88,0.4090909,27,0,200,0,0,0
311098314,jhonatha_S,10,1191,134,143,0,2,35.446966226,30-39,599,5,0,0,0,0,0,0,0,0,0,0,0,0,537,879,4.4780486537007367E-5,0,0,551,0,1,0,200,0,0,0
542967914,CarooowM,10,9591,285,146,2,220,35.9283591803,30-39,742,7,8,7,15,15,8,7,7,3.3333333333,4.525,0.0041300124,0.1095238095,0.71428573,38,176,4.892771068841905E-4,2.2648917E-4,2.32378E-4,88,0.71428573,25,0,200,0,0,0
495139374,rexbanner24,10,558,74,405,0,10,41.7561520362,40-49,522,5,1,1,2,2,1,1,11,4.5790329134,0,7.903983819523864E-4,0,0.33333334,0,135,5.676719020611344E-5,5.0330927E-5,5.1639556E-5,283,0.33333334,13,0,200,0,0,0
998659356,ProFeministBro,10,1152,176,53,0,40,44.8405131902,40-49,618,5,0,1,1,1,0,1,12,5.4951259139,0,0,0,0,0,880,4.4780486537007367E-5,0,2.5819778E-5,257,0,12,0,198,0,0,0
891259729,oosakaoosaka1,10,2603,41,26,0,0,38.3379217751,30-39,592,0,0,0,0,0,0,0,0,0,0,0,0,0,538,881,4.4780486537007367E-5,0,0,552,0,0,0,200,0,0,0
552494270,wastedsundays,10,249,13,44,0,4,27.9495641806,20-29,420,4,0,1,1,1,0,1,12,4.6226645004,0,0,0,0,0,882,4.4780486537007367E-5,0,2.5819778E-5,353,0,0,0,200,0,0,0
81290051,louisa_faux,10,233,9,33,1,19,15.74156519,10-19,150,3,0,0,0,0,0,0,0,0,0,0,0,0,539,883,4.851922726889002E-5,0,0,553,0,0,0,199,0,0,0
1195903140,Bobopolis,10,49,18,37,0,5,23.2239296771,20-29,292,2,0,0,0,0,0,0,0,0,0,0,0,0.5833333,540,884,4.4780486537007367E-5,0,0,554,0.5833333,1,0,57,0,0,0
324400171,46erGlenn,10,513,25,87,0,0,20.3052778945,20-29,454,4,0,1,1,1,0,1,11,4.4865962632,0,0,0,0,0,885,4.9228986117376785E-5,0,2.5819778E-5,257,0,1,0,200,0,0,0
326941453,HollyCassano,10,2587,708,1959,8,174,49.3157692685,40-49,624,6,3,3,6,6,3,3,2,1.25,0.5,9.631556311462233E-4,0.1,0.8333333,211,417,3.413644345773779E-4,1.00661855E-4,1.0327911E-4,261,0.8333333,39,0,200,0,0,0
753378097,Celia1_Gorda,10,1878,196,233,0,7,41.4189727048,40-49,680,6,3,3,6,6,3,3,1,1,0.5,9.373231759113425E-4,0.1,0.8333333,535,877,3.3147779322674866E-4,1.00661855E-4,1.0327911E-4,555,0.8333333,164,0,200,0,0,0
1013316650,paulajavaloyes,10,737,94,118,0,19,39.2394622415,30-39,620,4,3,2,5,5,3,2,2,1.3333333333,0,9.373231759113425E-4,0.15,1,535,877,2.9852402567743933E-4,1.00661855E-4,1.0327911E-4,555,1,181,0,200,0,0,0
1066150808,8consu8,10,367,44,31,0,1,37.5331380979,30-39,607,5,3,3,6,6,3,3,1,1,0.5,9.373231759113425E-4,0.1,0.8333333,535,877,3.3147779322674866E-4,1.00661855E-4,1.0327911E-4,555,0.8333333,180,0,200,0,0,0
21875285,joewozny,10,1007,820,893,12,0,44.324193476,40-49,590,5,1,1,2,2,1,1,10,4.1552214547,0,0.0032403136,0,0,0,135,4.845255995854407E-5,5.0330927E-5,5.1639556E-5,71,0,1,0,200,0,0,0
309251929,DannyCaladay,10,36736,2429,1848,119,0,47.372163912,40-49,724,5,7,8,15,15,7,8,8,4.5282405526,22108.2180555797,0.0023538696,0.0047619048,0.027777778,0,135,3.24648096592183E-4,2.0132371E-4,2.0655822E-4,148,0.027777778,0,0,201,0,0,0
99491292,AmZo89,10,296,199,257,0,11,31.2608280352,30-39,568,4,0,0,0,0,0,0,0,0,0,0,0,0,541,886,4.4780486537007367E-5,0,0,556,0,6,0,198,0,0,0
352091107,AtheistOutlet,10,86,25,104,0,3,17.6719571673,10-19,428,4,0,1,1,1,0,1,11,4.7485783916,0,0,0,0.52380955,0,887,4.839308717829337E-5,0,2.5819778E-5,99,0.52380955,0,0,92,0,0,0
455627762,SEO_Stream,10,6327,181,73,6,12,41.4104418092,40-49,546,4,0,0,0,0,0,0,0,0,0,0,0,0,542,888,4.4780486537007367E-5,0,0,557,0,0,0,200,0,0,0
64190875,OMSAG,10,20687,369,95,23,43,46.571280645,40-49,655,5,0,0,0,0,0,0,0,0,0,0,0,0,543,889,4.4780486537007367E-5,0,0,558,0,0,0,200,0,0,0
606076956,mkayy_sweezy,10,2574,158,214,0,679,32.3554098918,30-39,667,6,1,1,2,2,1,1,1,1,0,2.6808524730492474E-4,0,0,544,890,2.9852402567743944E-4,5.0330927E-5,5.1639556E-5,560,0,15,0,199,0,0,0
288198163,DeviIinDisguise,10,3511,706,145,0,108,39.7457090635,30-39,601,6,0,0,0,0,0,0,0,0,0,0,0,0,545,891,4.4780486537007367E-5,0,0,559,0,0,0,201,0,0,0
320527513,Mu_rii_uhh33,10,7349,323,505,0,917,44.3786394754,40-49,739,7,1,1,2,2,1,1,1,1,0,2.6808524730492474E-4,0,0,544,890,2.9852402567743944E-4,5.0330927E-5,5.1639556E-5,560,0,31,0,200,0,0,0
186307153,karenatsharon,10,914,55,71,5,33,46.2196251622,40-49,613,5,0,0,0,0,0,0,0,0,0,0,0,0,546,892,4.850547416264142E-5,0,0,561,0,2,0,200,0,0,0
20872037,markalannixon,10,31148,230,841,2,37,49.192085972,40-49,735,8,0,1,1,1,0,1,11,4.538586515,0,0,0,0.5,0,893,5.115688777847722E-5,0,2.5819778E-5,283,0.5,2,0,201,0,0,0
591457191,MiamiSeoCompany,10,504,96,75,0,26,42.7309136892,40-49,598,5,0,1,1,1,0,1,1,1,0,0,0,0,0,894,4.4780486537007367E-5,0,2.5819778E-5,148,0,7,0,200,0,0,0
757072891,CpcUTT,10,14,93,239,1,0,23.4916977431,20-29,174,1,0,0,0,0,0,0,0,0,0,0,0,0,547,895,4.4780486537007367E-5,0,0,562,0,0,0,15,0,0,0
822263544,courtneystodd,10,7,7,31,0,0,17.6350146565,10-19,27,1,0,0,0,0,0,0,0,0,0,0,0,0,548,896,4.4780486537007367E-5,0,0,563,0,0,0,8,0,0,0
344564284,YayanneGzuup,10,2069,120,134,1,210,42.805493172,40-49,634,5,0,0,0,0,0,0,0,0,0,0,0,0,549,897,4.4780486537007367E-5,0,0,564,0,5,0,198,0,0,0
367958676,X_Tiiponpon,10,701,174,155,0,13,46.7976888903,40-49,688,5,2,2,4,4,2,2,7,3.5151515152,143.1,6.234123083837369E-4,0,0,38,176,1.778402311966145E-4,7.549639E-5,7.7459335E-5,88,0,42,0,201,0,0,0
393486248,JuliannePaton,10,533,68,187,1,9,22.8793319529,20-29,527,4,0,0,0,0,0,0,0,0,0,0,0,0,550,898,4.4780486537007367E-5,0,0,565,0,0,0,200,0,0,0
717701984,RetroHardGamer,10,572,1122,1169,13,3,48.8883233665,40-49,613,4,1,1,2,2,1,1,1,1,0,2.6808524730492474E-4,0,0,133,310,2.9852402567743944E-4,5.0330927E-5,5.1639556E-5,134,0,11,0,200,0,0,0
1179520423,8BitGamerbot,10,2501,5232,3484,3,53,42.5482015726,40-49,575,6,0,0,0,0,0,0,0,0,0,0,0,0,551,899,4.4780486537007367E-5,0,0,566,0,0,0,201,0,0,0
808979192,ogfdsgdsgdf,10,4718,0,1,0,0,,,0,0,0,0,0,0,0,0,0,0,0,0,0,0,552,900,4.4780486537007367E-5,0,0,567,0,0,0,200,0,0,0
876252438,senate2020,10,2339,141,161,0,9,47.2309847524,40-49,686,6,1,1,2,2,1,1,2,1.5,0,2.9162299782298695E-4,0,0,553,901,2.29874507414389E-4,5.0330927E-5,5.1639556E-5,568,0,5,0,200,0,0,0
1242439537,FilomenaFerraro,10,32,6,19,0,0,23.0746452114,20-29,86,2,0,2,2,2,0,2,11,4.0727051178,0,0,0.5,1,0,902,4.4780486537007367E-5,0,2.5819778E-5,257,1,0,0,32,0,0,0
587512782,NanahMeenah,10,11905,770,412,5,119,47.5004776373,40-49,759,7,2,2,4,4,2,2,1,1,2,5.382408138703652E-4,0,0,553,901,4.3582306220354E-4,7.549639E-5,7.7459335E-5,568,0,143,0,201,0,0,0
373942398,TjayElbee,10,6449,249,259,0,29,49.9333060741,40-49,717,7,1,1,2,2,1,1,2,1.5,0,2.9162299782298695E-4,0,0,553,901,2.29874507414389E-4,5.0330927E-5,5.1639556E-5,568,0,91,0,200,0,0,0
29458252,miss_nik,10,1970,130,486,2,11,27.1872857688,20-29,560,6,0,0,0,0,0,0,0,0,0,0,0,1,554,903,6.541145475649478E-5,0,0,569,1,2,0,200,0,0,0
180981592,KiaraJabib,10,46936,334,191,7,122,42.1225744469,40-49,813,9,2,2,4,4,2,2,3,1.8,8,5.886419863784071E-4,0,0,72,228,3.162593808625975E-4,7.549639E-5,7.7459335E-5,62,0,78,0,201,0,0,0
372212694,Cmeant,10,789,60,54,0,22,35.7386220891,30-39,574,5,1,3,4,4,1,3,11,4.2901259651,2460.3735530064,4.2668330504765057E-4,0,0,0,135,1.1515517574033093E-4,5.0330927E-5,5.1639556E-5,257,0,11,0,200,0,0,0
232012377,KarenPao18,10,20666,177,156,1,91,42.3329716075,40-49,782,8,1,1,2,2,1,1,4,2.6,0,2.937875119025617E-4,0,0,72,228,1.7918963213425684E-4,5.0330927E-5,5.1639556E-5,62,0,46,0,201,0,0,0
1199108329,AnonOpsNow,10,2,26649,203,1,5,42.1101257161,40-49,714,3,0,2,2,2,0,2,1,1,0,0,0.5,1,0,904,4.4780486537007367E-5,0,2.5819778E-5,99,1,3,0,7,0,0,0
924456414,asderi90,10,557,38,95,0,31,22.5273978351,20-29,397,3,0,0,0,0,0,0,0,0,0,0,0,0,555,905,4.4780486537007367E-5,0,0,570,0,1,0,200,0,0,0
729460368,ChechaLpda,10,14000,296,224,1,42,45.4179787059,40-49,707,6,1,1,2,2,1,1,1,1,0,2.6808524730492474E-4,0,0,556,906,2.9852402567743944E-4,5.0330927E-5,5.1639556E-5,579,0,18,0,201,0,0,0
46510052,KPCareers,10,1688,1575,590,67,86,45.3917185312,40-49,626,4,1,0,1,1,1,0,0,0,0,2.4460721920661915E-4,0,0,557,907,8.284390166388585E-5,5.0330927E-5,0,573,0,2,0,200,0,0,0
609720071,tj__07,10,766,237,332,2,38,33.3949432789,30-39,570,5,2,1,3,3,2,1,1,1,1,5.136971427636863E-4,0,0,558,908,4.3582306220354E-4,7.549639E-5,5.1639556E-5,575,0,16,0,199,0,0,0
151348519,Wesby_,10,21905,647,500,7,49,41.0440115212,40-49,744,8,1,1,2,2,1,1,1,1,0,2.9055859915108867E-4,0,0,558,908,4.1496852829177067E-4,5.0330927E-5,5.1639556E-5,575,0,16,0,200,0,0,0
27446256,Celtic_Light,10,9704,227,201,10,677,47.3613232871,40-49,694,8,4,5,9,9,4,5,10,3.566436408,134.2570674314,0.0147782822,0.0416666667,0.25,0,135,5.7807961791135786E-5,1.2582731E-4,1.2909889E-4,99,0.25,1,0,12,0,0,0
323447431,OliviaCailyn,10,3327,472,394,1,184,41.9663447913,40-49,697,6,0,0,0,0,0,0,0,0,0,0,0,0,559,909,4.4780486537007367E-5,0,0,571,0,10,0,200,0,0,0
311285130,john_henise,10,563,134,233,3,37,36.246296076,30-39,591,4,0,0,0,0,0,0,0,0,0,0,0,0,560,910,4.4780486537007367E-5,0,0,572,0,11,0,200,0,0,0
58894431,KarlSonkin,10,359,81,235,9,1,38.4299241092,30-39,382,4,0,1,1,1,0,1,1,1,0,0,0,0,557,911,4.4780486537007367E-5,0,2.5819778E-5,573,0,0,0,200,0,0,0
391177648,DMJ_D,10,3089,67,113,0,183,27.6544495526,20-29,592,6,0,0,0,0,0,0,0,0,0,0,0,0.5,561,912,4.745703283487946E-5,0,0,574,0.5,2,0,200,0,0,0
432108764,mmbeau,10,997,185,267,0,243,41.3216096425,40-49,599,4,0,1,1,1,0,1,2,1.5,0,0,0,0,558,913,4.4780486537007367E-5,0,2.5819778E-5,575,0,20,0,198,0,0,0
940324717,mj52046600,10,173,1,8,0,0,41.6469577782,40-49,510,5,1,0,1,1,1,0,0,0,0,0.001209719,0,0.33333334,0,91,4.9880384396875296E-5,5.0330927E-5,0,505,0.33333334,48,0,200,0,0,0
40804489,Rchlfth,10,857,596,2001,11,274,43.5040651183,40-49,550,5,0,0,0,0,0,0,0,0,0,0,0,0,562,914,4.4780486537007367E-5,0,0,576,0,1,0,201,0,0,0
1093740716,AmauriAAmador,10,686,69,93,1,69,41.3546581859,40-49,598,5,1,1,2,2,1,1,1,1,0,2.6808524730492474E-4,0,0,563,915,2.9852402567743944E-4,5.0330927E-5,5.1639556E-5,577,0,39,0,201,0,0,0
1132363542,Duaardi_0722,10,77,51,199,0,21,27.839725852,20-29,432,3,1,1,2,2,1,1,1,1,0,2.6808524730492474E-4,0,0,563,915,2.9852402567743944E-4,5.0330927E-5,5.1639556E-5,577,0,12,0,129,0,0,0
1117861206,casr_ca,10,70,13,110,0,1,13.9120429219,10-19,94,2,0,0,0,0,0,0,0,0,0,0,0,0.6666667,564,916,4.4780486537007367E-5,0,0,578,0.6666667,1,0,76,0,0,0
412343347,CPCami,10,9526,285,249,0,603,43.4523211325,40-49,688,7,1,1,2,2,1,1,1,1,0,2.6808524730492474E-4,0,0,556,906,2.9852402567743944E-4,5.0330927E-5,5.1639556E-5,579,0,7,0,201,0,0,0
220191842,Asekible,10,2650,391,607,3,176,49.9650177107,40-49,644,6,1,0,1,1,1,0,0,0,0,4.2725702284040736E-4,0,0,0,31,7.927442740923612E-5,5.0330927E-5,0,148,0,5,0,199,0,0,0
242566644,Izzy_Queen,10,1017,179,88,0,4,33.0679103457,30-39,625,5,0,0,0,0,0,0,0,0,0,0,0,0,565,917,4.4780486537007367E-5,0,0,580,0,17,0,196,0,0,0
393666869,xAaronMackenzie,10,2614,241,237,0,590,42.5218557727,40-49,712,6,0,0,0,0,0,0,0,0,0,0,0,0,566,918,4.4780486537007367E-5,0,0,581,0,3,0,196,0,0,0
471915675,SwaranSoftIndia,10,5581,1800,1385,16,8,36.6590759344,30-39,611,6,2,2,4,4,2,2,9,5.7143437627,0,8.538349227260185E-4,0.0833333333,1,0,135,1.4429347136352738E-4,7.549639E-5,7.7459335E-5,148,1,40,0,200,0,0,0
274433778,amandhacaldista,10,4408,370,570,0,83,36.581736223,30-39,706,6,0,0,0,0,0,0,0,0,0,0,0,0,567,919,4.4780486537007367E-5,0,0,582,0,12,0,200,0,0,0
250159277,Harringtonkent,10,24176,1750,2002,57,6659,43.5874111485,40-49,775,8,5,9,14,14,5,9,9,3.8728159285,942.24134136,0.0065070525,0.043956044,0.18055555,0,135,8.455345966911259E-5,1.5099278E-4,1.5491867E-4,303,0.18095239,5,0,201,0,0,-0.00039684
431677460,MPeters74,10,1494,74,90,1,13,31.9203976879,30-39,592,5,11,15,26,26,11,15,10,3.5030475416,1058.219707865,0.1074427808,0.1,0.35620916,0,135,9.252029376029987E-5,3.0198556E-4,3.0983734E-4,353,0.35666665,0,0,200,0,0,-0.00045749
79184926,AndresMusta,10,845,77,158,1,72,35.5684633706,30-39,538,5,6,7,13,13,6,7,11,3.745631857,219.50748686,0.0121744288,0.0576923077,0.19444445,0,135,7.570739520808636E-5,1.7615824E-4,1.8073844E-4,257,0.1952381,1,0,201,0,0,-0.00079365
1038301598,ChantingWoman,10,6335,279,664,4,41,47.2707740349,40-49,630,7,32,42,74,74,32,42,9,3.1227143438,2859.1721982912,0.2228556921,0.0583117364,0.29965156,0,135,2.3911596554946818E-4,8.304603E-4,8.5205265E-4,99,0.30185184,20,0,212,0,0,-0.00220028
332884767,Quig40,10,8792,510,921,16,66,35.8318456672,30-39,713,7,30,43,73,73,30,43,10,3.1125558716,16367.5760675186,0.3229320746,0.0585996956,0.28646934,0,135,1.7603147993049747E-4,7.8012934E-4,8.0041314E-4,353,0.2890095,16,0,200,0,0,-0.00254016
240318436,bmyska,10,6708,1502,1799,21,5655,53.372587411,50-59,751,7,66,77,143,143,66,77,10,3.0109711499,20518.6736268552,0.6965603854,0.0475228996,0.2838828,0,135,3.115104004890227E-4,0.0016860861,0.0017299252,353,0.28651685,161,0,201,0,0,-0.00263405
554476689,st3v3turn3r,10,2109,221,265,7,29,46.7069803913,40-49,658,6,9,8,17,17,9,8,10,3.8240552621,584.0010105052,0.0205784675,0.0808823529,0.35555556,0,135,1.2502968236275584E-4,2.5165462E-4,2.5819778E-4,257,0.35833332,12,0,200,0,0,-0.00277776
19388993,jrdnovotny,10,1419,290,574,2,12,43.7215944128,40-49,607,6,8,14,22,22,8,14,10,3.2754977651,1817.7256544794,0.0991331135,0.0476190476,0.1978022,0,135,8.827363022842374E-5,2.2648917E-4,2.32378E-4,353,0.20073892,27,1,200,1,0.005,-0.00293672
213023643,Calgary62,10,5096,133,70,8,26,32.6845261001,30-39,632,6,13,12,25,25,13,12,10,3.5302722471,227.9478077554,0.1535658601,0.08,0.489011,0,135,1.0017536579996571E-4,3.5231648E-4,3.6147688E-4,353,0.49346405,8,0,200,0,0,-0.00445305
20094273,LeighPatrick,10,25098,4215,3932,56,20,61.1097689467,60-69,798,9,79,77,156,156,79,77,10,2.9825274279,26548.5446392486,0.7581543298,0.0423904053,0.25947693,0,135,4.475203880301868E-4,0.002013237,0.0020655822,353,0.2639662,245,0,201,0,0,-0.00448927
273657076,fieldpro,10,2570,147,257,2,10,35.1067475235,30-39,643,6,13,19,32,32,13,19,10,3.3169443316,2051.7899279518,0.1724653359,0.0816532258,0.4239766,0,135,1.1279567400486304E-4,3.5231648E-4,3.6147688E-4,353,0.42857143,4,0,200,0,0,-0.00459483
1056066385,Anonymous44cana,10,1914,784,1484,11,246,50.3321614454,50-59,753,7,1,33,34,34,1,33,9,3.2738336714,170.7821224398,2.6808524730492474E-4,0.0659536542,0.11079545,0,328,4.707508571488513E-5,5.0330927E-5,5.1639556E-5,99,0.11587302,40,0,201,0,0,-0.00507757
368522365,cdmercer7,10,1096,405,1333,3,216,41.8128778143,40-49,615,5,4,17,21,21,4,17,10,3.3384802926,581.5227341123,0.0079776211,0.1047619048,0.24264705,0,135,6.778648671354497E-5,1.2582731E-4,1.2909889E-4,257,0.24810606,2,0,200,0,0,-0.00545901
21622781,MikeSeager,10,5809,1795,2002,32,111,50.5871635321,50-59,669,7,34,36,70,70,34,36,10,3.2592442097,5838.3568878738,0.3654903568,0.0714285714,0.39551282,0,135,1.745883963199134E-4,8.807912E-4,9.036922E-4,353,0.4010101,23,0,202,0,0,-0.00549728
1028667224,TomFortington,10,1389,115,262,1,161,46.8255890625,40-49,602,6,24,30,54,54,24,30,9,3.1861032101,2697.992980632,0.158156653,0.0670859539,0.2764706,0,135,1.3141004314125003E-4,6.291366E-4,6.4549444E-4,99,0.28235817,21,0,199,0,0,-0.00588757
448319574,CSSA_CILA,10,116,278,26,8,0,44.241016424,40-49,647,2,15,3,18,18,15,3,11,4.6233238521,3049.3933710106,0.0978546293,0.1176470588,0.26190478,0,135,1.8395491395129245E-4,4.0264742E-4,3.6147688E-4,353,0.26797387,61,1,156,1,0.0064102564,-0.00606909
14950403,mjecclestone,10,9742,575,458,53,59,50.3519014179,50-59,722,7,13,6,19,19,13,6,11,4.2726533929,8630.0889728778,0.0234152132,0.0555555556,0.23076923,0,135,2.6959108036295985E-4,3.5231648E-4,3.6147688E-4,267,0.23684211,88,0,201,0,0,-0.00607288
325022623,PrairieStorm2,10,16237,1143,1442,25,254,42.4993358977,40-49,765,8,68,74,142,142,68,74,9,2.906948395,27384.1573746299,0.6759722911,0.0447507741,0.26964912,0,135,4.0460156721052636E-4,0.001736417,0.0017815647,353,0.2765249,117,0,203,0,0,-0.00687578
397488530,BLacey12,10,2234,173,141,2,5,44.7767696108,40-49,638,6,21,10,31,31,21,10,11,3.6054449411,566.6570733754,0.2536552618,0.1322580645,0.40513834,0,135,1.3929866227402573E-4,5.536402E-4,5.680351E-4,353,0.41264367,31,0,200,0,0,-0.00750533
149196780,mballism,10,1288,245,431,7,185,57.5330726311,50-59,558,5,11,9,20,20,11,9,10,3.3986184478,1091.194696788,0.0375250411,0.0789473684,0.37121212,0,135,8.174168803187132E-5,3.0198556E-4,3.0983734E-4,71,0.37908497,11,0,200,0,0,-0.00787285
262244948,heritagektown,10,4251,1334,1994,19,2430,48.1884874332,40-49,642,6,14,28,42,42,14,28,10,3.2893132873,5208.6184554987,0.1291552992,0.0894308943,0.27217743,0,135,1.0396004694810879E-4,3.7748195E-4,3.8729666E-4,353,0.28012684,25,0,199,0,0,-0.00794941
931039604,UnbrokenSpirit2,10,1403,529,637,4,414,46.3362876915,40-49,567,5,8,9,17,17,8,9,10,4.0747663551,3753.9340292369,0.0095659117,0.0845588235,0.5555556,0,135,1.5326326427188224E-4,2.2648917E-4,2.32378E-4,303,0.56363636,2,0,199,0,0,-0.00808076
25947220,QueerVancouver,10,6488,325,228,13,179,60.8504269539,60-69,711,7,10,4,14,14,10,4,11,3.9719626168,165.1638806469,0.0217851922,0.0934065934,0.24545455,0,135,9.266131844766525E-5,2.768201E-4,2.8401756E-4,71,0.25367647,17,0,201,0,0,-0.00822192
54937843,JohnnieOil,10,30249,1171,1218,52,174,49.0172101756,40-49,771,8,56,56,112,112,56,56,10,3.1661926046,6129.4585686351,0.6337400663,0.0682110682,0.3717758,0,135,3.238750532723047E-4,0.0014344314,0.0014717274,353,0.38,32,0,200,0,0,-0.0082242
1012122006,nativeadvocate,10,12267,234,425,5,1714,50.0377829385,50-59,700,8,8,4,12,12,8,4,10,3.8199918732,1107.3627808672,0.0449926072,0.0606060606,0.25,0,135,8.968660401449514E-5,2.2648917E-4,2.32378E-4,99,0.25824177,30,0,201,0,0,-0.00824177
94165248,chrisc0ttingham,10,1666,12948,12776,86,38,48.6207966209,40-49,740,7,8,8,16,16,8,8,10,3.5514018692,499.1247686588,0.0577940509,0.0625,0.23333333,0,135,9.100706218358824E-5,2.2648917E-4,2.32378E-4,353,0.24175824,7,0,36,0,0,-0.00842491
251584824,pbtrue1,10,33772,2008,2209,60,1006,44.922572488,40-49,744,9,15,17,32,32,15,17,10,3.6038195855,5342.1069790662,0.0174672501,0.0544354839,0.23421052,0,135,1.8468198204808967E-4,4.0264742E-4,4.1311645E-4,303,0.24285714,9,0,200,0,0,-0.00864662
868595665,songsjml,10,4915,802,1974,7,168,48.551917287,40-49,641,7,6,10,16,16,6,10,10,3.3986184478,7854.6794571338,0.0204081474,0,0,0,135,8.439582214010783E-5,1.7615824E-4,1.8073844E-4,257,0.009090909,10,0,200,0,0,-0.009090909
63258578,miaaculpa,10,71012,3213,2932,128,476,52.8333457953,50-59,869,10,11,11,22,22,11,11,9,3.6781796018,2054.3954591976,0.014141418,0.025974026,0.2090909,0,135,1.3805773549335895E-4,3.0198556E-4,3.0983734E-4,303,0.21895425,12,0,201,0,0,-0.00986335
860415787,83Cindylee,10,5209,1516,1534,41,599,56.2365109335,50-59,697,7,10,11,21,21,10,11,10,3.9853718001,161.8981541031,0.0123298997,0.0880952381,0.6181818,0,135,1.440616508295392E-4,2.768201E-4,2.8401756E-4,303,0.6282051,2,0,200,0,0,-0.0100233
424257469,libertycrucial,10,4004,1400,1896,36,1702,50.5270565675,50-59,733,7,6,8,14,14,6,8,10,3.3973994311,3744.6130465085,0.0212376062,0.032967033,0.11111111,0,135,6.976610450108004E-5,1.7615824E-4,1.8073844E-4,353,0.121212125,5,0,199,0,0,-0.010101015
1004515592,GrowtheRight,10,569,73,166,0,151,40.3375526998,40-49,508,5,12,20,32,32,12,20,11,3.6972775295,957.3327794123,0.0339015109,0.0947580645,0.3631579,0,135,9.651109090146447E-5,3.27151E-4,3.3565713E-4,353,0.37380952,19,0,200,0,0,-0.01065162
267813818,alissagolob,10,1504,693,1126,15,13,48.2572197634,40-49,695,6,30,18,48,48,30,18,11,3.8756603007,12209.4540926081,0.0896122338,0.0496453901,0.17842741,0,135,2.3448889569187075E-4,7.8012934E-4,8.0041314E-4,353,0.1891892,118,1,200,1,0.005,-0.01076179
991670881,shedancestibet,10,2943,863,830,26,8265,58.492627304,50-59,749,7,9,9,18,18,9,9,10,3.7444128403,404.9313427935,0.0245354075,0.0490196078,0.3888889,0,135,9.203011725024548E-5,2.5165462E-4,2.5819778E-4,99,0.4,41,0,201,0,0,-0.0111111
833513995,lfay_lorraine,10,7210,408,2001,7,1050,49.619584645,40-49,612,8,1,9,10,10,1,9,11,3.8098334011,151.2509518527,0.0012435489,0.1777777778,0.3611111,0,135,5.663405276729366E-5,5.0330927E-5,5.1639556E-5,257,0.3723077,1,0,202,0,0,-0.0111966
87561702,Athapeese,10,983,157,209,4,36,43.4993616872,40-49,593,5,27,26,53,53,27,26,10,3.3336042259,1485.7327927163,0.1694161969,0.0638606676,0.30846775,0,135,1.854916296706174E-4,7.0463296E-4,7.2295376E-4,99,0.31976745,16,0,200,0,0,-0.0112997
27349747,eli_d_m,10,6589,801,875,33,143,51.9667335788,50-59,729,7,43,36,79,79,43,36,9,3.0698902885,20400.4865616784,0.2787644288,0.0517689062,0.1883164,0,135,2.782036499762381E-4,0.0011072804,0.0011360702,99,0.19965577,51,1,199,1,0.0050251256,-0.01133937
204584481,KarenRegis,10,63405,1012,858,47,146,41.5990287817,40-49,736,10,4,6,10,10,4,6,10,4.118244616,143.8283338877,0.0038279554,0.0444444444,0.097222224,0,135,7.095309690278279E-5,1.2582731E-4,1.2909889E-4,303,0.10909091,3,0,201,0,0,-0.011868686
40191477,JohnnyJesus,10,45189,1273,665,32,5831,42.3315288536,40-49,783,9,64,71,135,135,64,71,10,3.0711093052,11331.4065889387,0.6568736917,0.0630182421,0.2722318,0,135,3.0964563190830785E-4,0.0016357551,0.0016782855,353,0.28454545,122,9,204,9,0.0441176471,-0.01231365
629785384,lefty_religion,10,924,385,75,6,43,44.594253291,40-49,618,6,27,17,44,44,27,17,10,3.5062982527,342.6796457869,0.2965694452,0.1183932347,0.47536945,0,135,1.490977004083795E-4,7.0463296E-4,7.2295376E-4,353,0.4876894,49,0,200,0,0,-0.01231995
380382923,Exigenomicon,10,2031,157,274,4,14,39.3575490108,30-39,619,5,11,14,25,25,11,14,10,3.5635920358,521.4489516493,0.0404482333,0.0983333333,0.35661766,0,135,1.386646916309634E-4,3.0198556E-4,3.0983734E-4,257,0.36896402,7,10,200,10,0.05,-0.01234636
881505384,MrDanielGilman,10,472,284,340,8,46,44.6778654065,40-49,593,4,16,17,33,33,16,17,11,4.0463226331,27166.9190373643,0.0283419506,0.0568181818,0.20562771,0,135,2.4440011221558365E-4,4.2781286E-4,4.1311645E-4,353,0.21833333,58,1,199,1,0.0050251256,-0.01270562
320990339,justlynnp,10,586,32,13,2,1,30.9229650813,30-39,451,5,7,0,7,7,7,0,0,0,0,0.0253813465,0.2142857143,0.4047619,0,64,9.177894549910046E-5,2.0132371E-4,0,71,0.4181818,7,0,200,0,0,-0.0134199
219007676,NeilJEdmondson,10,31112,1867,1456,59,64,52.5981577771,50-59,818,8,101,90,191,191,101,90,10,2.9991873222,41587.7821576606,0.7828227792,0.0310002756,0.17026056,0,135,6.642610827161915E-4,0.0025668773,0.0026336173,353,0.18471552,211,0,202,0,0,-0.01445496
400768822,Spakwus,10,3776,529,1505,6,1829,46.0472558709,40-49,638,7,24,42,66,66,24,42,9,3.0410402275,4721.7953107312,0.1282115636,0.0613053613,0.24041812,0,135,1.8244634479808676E-4,6.291366E-4,6.4549444E-4,99,0.2551308,11,0,199,0,0,-0.01471268
976907744,progpatriot,10,1931,5502,5361,79,242,57.3188474878,50-59,737,7,23,0,23,23,23,0,0,0,0,0.0285245556,0.104743083,0.2055336,0,12,2.1745477602923546E-4,6.0397113E-4,0,303,0.22068965,10,0,200,0,0,-0.01515605
375290882,mattlensen,10,324,225,322,0,35,38.6302482791,30-39,638,6,21,19,40,40,21,19,10,3.5042665583,1972.7951830084,0.0635363963,0.0846153846,0.32615384,0,135,1.1850131861871016E-4,5.536402E-4,5.4221536E-4,257,0.3415916,25,1,193,1,0.0051813472,-0.01543776
264138087,joshdneufeld,10,1849,969,537,31,231,54.1870984997,50-59,704,5,18,15,33,33,18,15,10,3.8106460788,9539.3577520322,0.0292836597,0.0520833333,0.2777778,0,135,2.8527510095674306E-4,4.781438E-4,4.64756E-4,283,0.29333332,236,2,200,2,0.01,-0.01555552
723293880,ModelCDN,10,2387,2965,3227,38,208,49.8770553836,40-49,652,6,36,49,85,85,36,49,10,3.1848841934,4049.0860738158,0.4580184685,0.0778711485,0.39215687,0,135,1.720232663701787E-4,9.311221E-4,9.553318E-4,353,0.4077441,19,0,200,0,0,-0.01558723
917466355,MasonCui,10,350,22,60,1,12,30.9871156955,30-39,525,5,7,11,18,18,7,11,10,3.6696464852,187.1787098714,0.0707173137,0.0816993464,0.3409091,0,135,7.218811379507398E-5,2.0132371E-4,2.0655822E-4,353,0.35714287,14,1,202,1,0.004950495,-0.01623377
628605608,bigbobby53,10,3164,247,244,6,76,45.684127844,40-49,709,7,22,19,41,41,22,19,10,3.3425436814,11732.3071149006,0.0340630323,0.0475609756,0.15343915,0,135,1.7553904287769684E-4,5.7880563E-4,5.938549E-4,257,0.16984127,38,0,200,0,0,-0.01640212
273201959,Wetaskijen,10,20391,719,1046,22,334,40.310449396,40-49,749,8,68,93,161,161,68,93,10,2.9357984559,28890.6148244827,0.7296423201,0.0516692547,0.18781856,0,135,4.116967883636959E-4,0.001736417,0.0017815647,353,0.20446666,32,3,205,3,0.0146341463,-0.0166481
1268250757,JillianLCurtin,10,1,4,13,0,0,14.1518828172,10-19,25,1,3,3,6,6,3,3,10,3.856562373,2664.3547664264,0.006340654,0.0666666667,0.33333334,0,135,7.506839962053695E-5,1.00661855E-4,1.0327911E-4,99,0.35,0,0,11,0,0,-0.01666666
409886625,JanieceStaton,10,69227,611,742,37,130,42.8750288308,40-49,727,10,4,3,7,7,4,3,10,4.2446160098,238.8283970893,0.0052315963,0.0238095238,0.05,0,135,9.505472391790929E-5,1.2582731E-4,1.2909889E-4,303,0.06666667,2,0,201,0,0,-0.01666667
211550181,chrissanislo,10,5171,289,273,21,6,46.8301142328,40-49,700,7,4,1,5,5,4,1,10,4.4884193417,36.2592869233,0.006485068,0.1,0.25,0,135,5.974611646844029E-5,1.2582731E-4,1.2909889E-4,505,0.26666668,16,0,200,0,0,-0.01666668
539656934,freehorse68,10,8896,386,446,3,95,42.7434811522,40-49,718,8,36,36,72,72,36,36,10,2.9983746445,16714.5784370504,0.3489146018,0.0442097027,0.22037652,0,135,2.4761589506407415E-4,9.311221E-4,9.553318E-4,353,0.2373512,78,0,199,0,0,-0.01697468
124799936,jsaxberg,10,682,218,404,5,63,39.3555632344,30-39,580,4,16,21,37,37,16,21,10,3.4750101585,4810.8773438798,0.0443946993,0.0653153153,0.28787878,0,135,1.5179096093547538E-4,4.2781286E-4,4.3893623E-4,257,0.30509412,12,3,200,3,0.015,-0.01721534
79889696,victorhernand,10,20996,973,2000,4,298,47.4774241961,40-49,659,8,2,7,9,9,2,7,10,5.7427874848,174307.027272727,0.0013310394,0.0555555556,0.11904762,0,135,1.3500596123575283E-4,7.549639E-5,7.7459335E-5,148,0.13636364,10,0,201,0,0,-0.01731602
211223603,kerrymurraynl,10,918,256,474,6,5,43.7383950139,40-49,596,4,15,18,33,33,15,18,9,3.3921170256,3204.5272744433,0.044412204,0.0814393939,0.40643275,0,135,1.1522485126335708E-4,4.0264742E-4,4.1311645E-4,343,0.42414173,8,0,200,0,0,-0.01770898
198943825,Resedico,10,7187,461,517,14,2,49.8890540713,40-49,740,7,39,52,91,91,39,52,9,3.0243803332,12475.6061763151,0.3995787496,0.0601953602,0.25499094,0,135,2.7325067970091204E-4,0.0010066185,0.0010327911,353,0.27366608,68,0,201,0,0,-0.01867514
896105796,jeremyj_schmidt,10,1011,178,212,9,88,48.2292808887,40-49,598,5,13,10,23,23,13,10,10,3.6993092239,1495.1382826392,0.0313413743,0.0494071146,0.21904762,0,135,1.2749223417913522E-4,3.5231648E-4,3.6147688E-4,283,0.23809524,17,0,200,0,0,-0.01904762
880770732,mscreefeather,10,574,207,526,4,122,42.7234685418,40-49,565,5,26,33,59,59,26,33,10,3.0902072328,13361.5132800901,0.1801429451,0.056691993,0.27629232,0,135,1.5739911684344309E-4,6.794675E-4,6.97134E-4,99,0.2955975,7,1,200,1,0.005,-0.01930518
15331235,claudlemire,10,23769,1165,1626,20,1683,54.2426620811,50-59,765,8,70,56,126,126,70,56,10,2.9512393336,29986.2911991086,0.6617472835,0.0526349206,0.22184356,0,135,4.535835052354686E-4,0.0017867478,0.0018332042,353,0.24168375,77,2,200,2,0.01,-0.01984019
285709236,DannyHozack,10,2884,1921,2039,19,33,49.7732675102,40-49,694,7,72,82,154,154,72,82,10,3.0841121495,37846.3062302658,0.6831203931,0.0398947458,0.23034997,0,135,4.948896367489712E-4,0.0018370788,0.0018848438,353,0.2504043,50,0,212,0,0,-0.02005433
354330741,discombed,10,17938,1529,1878,41,5,42.521440997,40-49,682,8,11,9,20,20,11,9,10,4.0914262495,1122.0611602471,0.0132331298,0.0815789474,0.35897437,0,135,1.4166743114579205E-4,3.0198556E-4,3.0983734E-4,303,0.3791209,1,0,201,0,0,-0.02014653
559049672,jlynnda60,10,37227,470,620,12,15819,39.3020934162,30-39,744,9,11,13,24,24,11,13,9,3.3075985372,227.3313675413,0.0664690649,0.1086956522,0.40833333,0,135,9.450996158583506E-5,3.0198556E-4,3.0983734E-4,99,0.42857143,104,0,197,0,0,-0.0202381
224142741,Robert_MacKay_,10,2847,53,23,1,75,47.6481354145,40-49,686,7,6,1,7,7,6,1,11,4.3238520926,43.9823688868,0.0203662176,0.119047619,0.21428572,0,135,6.533189204672669E-5,1.7615824E-4,1.8073844E-4,71,0.23484848,70,0,209,0,0,-0.02056276
30026134,akaratedad,10,1613,84,185,1,30,36.1760730452,30-39,637,6,2,4,6,6,2,4,11,3.9195449004,14.7478216126,0.0060739241,0.1333333333,0.5,0,135,5.207237300980639E-5,7.549639E-5,7.7459335E-5,257,0.5208333,1,1,200,1,0.005,-0.0208333
429182236,awjrector,10,585,105,101,4,86,40.5500584431,40-49,615,5,18,14,32,32,18,14,10,3.4290938643,187.1999702149,0.2681916687,0.1401209677,0.60952383,0,135,1.1752419760932737E-4,4.781438E-4,4.905758E-4,353,0.6304348,7,0,199,0,0,-0.02091097
1018772598,mccwpg,10,388,36,93,0,3,30.7017278993,30-39,460,4,7,10,17,17,7,10,10,3.3961804145,435.9583424963,0.0532857714,0.0698529412,0.4,0,135,7.696035259250136E-5,2.0132371E-4,2.0655822E-4,99,0.42105263,2,0,200,0,0,-0.02105263
379529949,Dorion12,10,4720,409,677,2,1341,44.9537016748,40-49,673,7,33,47,80,80,33,47,9,2.9833401056,8021.4382109889,0.1991192864,0.0525316456,0.24884367,0,135,1.6090350864121468E-4,8.556257E-4,8.7787246E-4,99,0.27041742,7,0,201,0,0,-0.02157375
489609031,RobAlexandr,10,216,38,35,0,0,23.840214529,20-29,532,3,6,4,10,10,6,4,11,4.2515237708,741.1160888194,0.0222404295,0.0888888889,0.36666667,0,135,1.146922305219598E-4,1.7615824E-4,1.8073844E-4,353,0.3888889,32,0,198,0,0,-0.02222223
394181481,L2HT,10,6708,159,216,2,625,47.7147365785,40-49,669,7,23,27,50,50,23,27,9,3.2535554653,812.4129399795,0.178238077,0.0853061224,0.3655914,0,135,1.558633596086205E-4,6.0397113E-4,6.196747E-4,99,0.3878205,25,0,200,0,0,-0.0222291
115034238,PeggyMacKinnon,10,3333,640,1096,24,122,48.4310542396,40-49,674,6,13,14,27,27,13,14,11,3.655830963,9155.856680595,0.0283957215,0.037037037,0.20476191,0,135,1.3450888221662512E-4,3.5231648E-4,3.6147688E-4,343,0.22727273,17,0,202,0,0,-0.02251082
22717349,Piikaaksin,10,20286,770,1139,15,282,48.9750278615,40-49,734,7,49,28,77,77,49,28,9,3.19707436,6472.8593543316,0.2869698774,0.0674982912,0.23476052,0,135,2.496709186439643E-4,0.0012582731,0.0012909889,99,0.257273,56,0,199,0,0,-0.02251248
119220499,sabinechidiac,10,2248,248,613,3,5,47.2657618024,40-49,623,6,16,19,35,35,16,19,11,3.6017878911,1959.9869670923,0.0643017996,0.0781512605,0.2987013,0,135,1.1211862958865434E-4,4.2781286E-4,4.3893623E-4,353,0.3213213,9,2,200,2,0.01,-0.02262
403813939,LibFail99,10,6802,802,1034,20,102,48.3435157763,40-49,753,7,88,105,193,193,88,105,9,2.8533116619,71788.0749244353,0.7472544663,0.034191494,0.1763136,0,135,4.5096801560423166E-4,0.0022397263,0.0022979602,353,0.19916345,29,0,198,0,0,-0.02284985
344827349,WrightIdea_,10,4438,1023,1214,18,85,,,739,7,46,57,103,103,46,57,10,3.1873222267,4866.608115737,0.5486132542,0.0677707976,0.3306011,0,135,3.0939806210159633E-4,0.0011827768,0.0012135296,353,0.35361895,35,0,197,0,0,-0.02301785
94451943,Erethizon,10,2853,136,214,0,77,46.3024163381,40-49,687,7,11,12,23,23,11,12,10,3.4278748476,7976.2736059892,0.0392909734,0.0217391304,0.07692308,0,135,1.0635134389692763E-4,3.0198556E-4,3.0983734E-4,257,0.1,17,1,200,1,0.005,-0.02307692
242394505,ChrisQuines,10,9356,351,684,13,1478,54.0124904298,50-59,744,7,32,40,72,72,32,40,10,3.2027631044,6095.8856596112,0.3541058707,0.0694444444,0.2548759,0,135,1.96049044686548E-4,8.304603E-4,8.5205265E-4,353,0.2780112,35,0,200,0,0,-0.0231353
1154111378,NanticokeNDN,10,2269,108,266,3,540,43.8497469333,40-49,543,6,17,24,41,41,17,24,10,3.2962210484,1618.9304932968,0.1362797715,0.0884146341,0.4293478,0,135,1.2007385558705344E-4,4.5297833E-4,4.64756E-4,99,0.45262095,3,0,201,0,0,-0.02327315
23259960,trevorcharles,10,680,360,1006,16,12,46.4712850622,40-49,589,5,16,18,34,34,16,18,10,3.4469727753,16440.2248461881,0.0336057042,0.0454545455,0.21315789,0,135,2.8161615848828933E-4,4.2781286E-4,4.1311645E-4,283,0.23658536,108,4,200,4,0.02,-0.02342747
353460946,Toronto_John63,10,9452,552,1278,14,31,52.3060957982,50-59,703,8,2,4,6,6,2,4,10,3.7805770012,82.091772161,0.0070533131,0.0333333333,0.16666667,0,135,4.860271978742561E-5,7.549639E-5,7.7459335E-5,257,0.1904762,24,1,201,1,0.0049751244,-0.02380953
1232241829,CalgaryLabour,10,43,24,77,0,1,21.5958857683,20-29,77,2,3,3,6,6,3,3,10,3.7610727347,55.4047577574,0.014753644,0.1,0.5,0,135,5.3858737459477347E-5,1.00661855E-4,1.0327911E-4,257,0.52380955,3,0,48,0,0,-0.02380955
21545704,ndnstyl,10,61038,1508,1813,43,843,43.7594025284,40-49,774,10,50,29,79,79,50,29,9,3.20438846,6803.3114053979,0.2893198938,0.0710808179,0.23571429,0,135,2.8427495100528423E-4,0.0012834386,0.0013168086,99,0.25957376,46,0,204,0,0,-0.02385947
494331490,Rhino_Bob,10,14828,247,215,7,250,51.1225700937,50-59,756,8,9,7,16,16,9,7,10,3.6290125965,735.7024996369,0.0245588488,0.0875,0.18589744,0,135,8.46336558002605E-5,2.5165462E-4,2.5819778E-4,257,0.2099567,60,0,201,0,0,-0.02405926
94021685,bcbluecon,10,44010,1428,45,63,7,56.2309645415,50-59,844,9,98,4,102,102,98,4,10,3.8399024787,5994.4832404703,0.7272580861,0.0915356242,0.16431728,0,135,7.482421233865777E-4,0.0024913808,0.0025045185,353,0.18845578,713,1,206,1,0.0048543689,-0.0241385
389001407,faceless_corp,10,1478,174,972,0,193,37.1725221264,30-39,624,6,6,16,22,22,6,16,9,3.3693620479,1128.7525261241,0.0343830694,0.0974025974,0.29166666,0,135,8.233171565708395E-5,1.7615824E-4,1.8073844E-4,99,0.3159664,3,0,194,0,0,-0.02429974
104644390,codyincalgary,10,11812,6149,4841,97,1618,72.4287142569,70-79,786,8,135,150,285,285,135,150,10,2.8094270622,170836.774701881,0.9777458295,0.019705955,0.10349379,0,135,0.0010065817,0.003422503,0.0035114898,353,0.12785213,275,0,201,0,0,-0.02435834
41186732,BlueDuPage,10,119592,10521,6408,663,520,60.4679594223,60-69,940,9,49,39,88,88,49,39,10,3.3803331979,66996.8414102192,0.0572962531,0.0167189133,0.08,0,135,7.538004146926524E-4,0.0012582731,0.0012651691,303,0.104371585,121,0,213,0,0,-0.024371585
29024261,andyingy,10,2696,302,948,2,1126,49.127013438,40-49,636,7,6,0,6,6,6,0,0,0,0,0.0141109654,0.0666666667,0.1,0,13,6.630710439037869E-5,1.7615824E-4,0,505,0.125,39,0,6,0,0,-0.025
599313676,mixedbagmag,10,2154,689,2000,8,214,45.2930484599,40-49,639,6,3,9,12,12,3,9,10,3.6176351077,418.5497999436,0.0129889412,0.0833333333,0.2,0,135,7.045551174030772E-5,1.00661855E-4,1.0327911E-4,99,0.225,8,0,199,0,0,-0.025
17435582,rwpickard,10,9604,729,379,30,692,50.6536083948,50-59,739,7,18,9,27,27,18,9,9,3.4607882974,3485.7932842586,0.0528954107,0.0313390313,0.10263158,0,135,1.4241965789428085E-4,4.781438E-4,4.905758E-4,71,0.12770563,36,0,203,0,0,-0.02507405
51743331,philelder,10,614,146,268,4,1,26.463814225,20-29,522,4,15,17,32,32,15,17,10,3.2531491264,2576.5194802028,0.0616213262,0.0493951613,0.23391813,0,135,1.0578508824901917E-4,4.0264742E-4,4.1311645E-4,353,0.259009,4,0,200,0,0,-0.02509087
501845170,BadScienceWatch,10,316,740,131,31,1,48.5705827514,40-49,645,3,15,3,18,18,15,3,11,4.0914262495,1559.2324036377,0.0319396906,0.0620915033,0.125,0,135,1.832619170804917E-4,4.0264742E-4,4.1311645E-4,283,0.15019763,22,0,200,0,0,-0.02519763
116282012,LawyerToronto,10,1042,445,300,17,3,52.7665546222,50-59,639,4,8,5,13,13,8,5,10,3.8338073954,2817.0492522958,0.0130906003,0.0384615385,0.11111111,0,135,6.778323348232385E-5,2.2648917E-4,2.0655822E-4,257,0.13636364,7,0,200,0,0,-0.02525253
43605411,smilalady,10,5020,365,616,13,79,51.392287193,50-59,714,7,7,10,17,17,7,10,9,3.5778138968,246.3327606354,0.0284838667,0.0919117647,0.2651515,0,135,7.332256387590619E-5,2.0132371E-4,2.0655822E-4,99,0.2904762,20,0,196,0,0,-0.0253247
550250082,SheilaGunnReid,10,44021,2193,1112,70,9710,56.2634633675,50-59,852,9,127,111,238,238,127,111,10,3.028850061,48110.602273984,1,0.0342871326,0.15098096,0,135,7.401361406100789E-4,0.0032211794,0.0033049316,353,0.17635658,1035,3,207,3,0.0144927536,-0.02537562
844180087,brmf_rm,10,722,245,241,4,1,44.4930055616,40-49,630,5,16,19,35,35,16,19,10,3.4132466477,4879.9626062936,0.0304538525,0.0411764706,0.18947369,0,135,1.1898781763490813E-4,4.2781286E-4,4.3893623E-4,257,0.21509972,13,0,200,0,0,-0.02562603
1025227592,KadsEdu,10,2312,69,88,1,120,42.839270022,40-49,603,6,7,4,11,11,7,4,11,3.8935392117,137.6813958061,0.0125208289,0.0909090909,0.15555556,0,135,7.160961050610265E-5,2.0132371E-4,2.0655822E-4,257,0.18131869,12,0,200,0,0,-0.02576313
287260619,AlbertaGrl,10,15283,1800,947,46,530,53.1277142341,50-59,781,8,100,102,202,202,100,102,10,2.9146688338,59562.7420577081,0.8553323091,0.0391606325,0.14123094,0,135,4.512521251575749E-4,0.0025417118,0.0026077975,353,0.16727036,238,6,207,6,0.0289855072,-0.02603942
26904707,hiltonjohn,10,9433,1112,1302,17,211,54.2152399935,50-59,747,8,61,66,127,127,61,66,10,3.0662332385,25990.1146896887,0.60741195,0.0526809149,0.24325675,0,135,4.806255622508336E-4,0.0015602587,0.0016008263,353,0.26980197,32,0,200,0,0,-0.02654522
360975668,Metchitoweweyin,10,3311,489,684,12,152,52.1012366931,50-59,716,6,52,52,104,104,52,52,9,3.0804550996,12507.2210108736,0.2996724552,0.0582524272,0.234375,0,135,2.3573844629391565E-4,0.0013337695,0.0013684483,99,0.26092798,47,2,200,2,0.01,-0.02655298
38807340,Bell_Mobility,10,3739,21641,486,284,4,82.0529069086,80-89,827,6,16,4,20,20,16,4,11,3.8455912231,2217.6176760231,0.0256096301,0.0052631579,0.011029412,0,135,1.0749836906193662E-4,4.2781286E-4,4.3893623E-4,505,0.03809524,32,0,200,0,0,-0.027065828
146060152,wcgirl1,10,93428,4467,3320,164,14,56.2016253055,50-59,908,10,26,24,50,50,26,24,10,3.2925639984,27691.7458145204,0.0424174309,0.0244897959,0.14387465,0,135,2.556012578403604E-4,6.794675E-4,6.97134E-4,303,0.17096774,74,0,204,0,0,-0.02709309
18435883,Dwayne_Nashkawa,10,1428,542,634,18,79,42.2037061962,40-49,629,5,18,17,35,35,18,17,9,3.336854937,1158.163898585,0.1210067375,0.0831932773,0.29528984,0,135,1.3783994797693583E-4,4.781438E-4,4.905758E-4,99,0.3224359,0,0,199,0,0,-0.02714606
212467098,brock_hamley,10,936,447,467,4,6,50.3715894338,50-59,615,5,42,0,42,42,42,0,0,0,0,0.3186103487,0.1295005807,0.23461092,0,57,2.1854922608418445E-4,0.0010821149,0,353,0.26190478,20,2,200,2,0.01,-0.02729386
1005583597,GwitchinKris,10,980,527,482,9,781,51.5089981319,50-59,691,5,43,24,67,67,43,24,9,3.3140999594,3450.3201853839,0.2650244291,0.1042514699,0.2658371,0,135,2.3048536723448577E-4,0.0011072804,0.0011360702,99,0.29326513,71,0,200,0,0,-0.02742803
33699810,1anhaga,10,4709,240,255,9,611,47.9559753889,40-49,690,7,16,6,22,22,16,6,10,3.5607476636,3692.8986499193,0.0858322411,0.0346320346,0.106617644,0,135,1.2165358833688427E-4,4.2781286E-4,4.3893623E-4,99,0.13423645,22,0,199,0,0,-0.027618806
565405613,DCProfessor1,10,34486,1229,2000,41,5613,56.2269349874,50-59,787,9,11,3,14,14,11,3,9,4.3701747257,762.6513310571,0.0095924341,0.0054945055,0.018181818,0,135,1.4198681673109487E-4,3.0198556E-4,3.0983734E-4,303,0.045833334,37,0,202,0,0,-0.027651516
577083469,GreensN_A,10,252,106,155,2,7,26.5115032282,20-29,475,4,3,5,8,8,3,5,10,3.533929297,564.5565241446,0.0127366067,0.0714285714,0.35,0,135,6.412636651310935E-5,1.00661855E-4,1.0327911E-4,283,0.37777779,7,1,200,1,0.005,-0.02777779
370384969,DonMartinYEG,10,265,2212,1651,39,202,53.5255824205,50-59,757,8,117,115,232,232,117,115,9,2.7147501016,136791.087720022,0.8299098861,0.0195551575,0.12281533,0,135,5.537956395686698E-4,0.0029695246,0.0030467338,353,0.15064877,60,0,103,0,0,-0.02783344
379576582,lachildress,10,741,110,399,2,28,40.7579167622,40-49,497,5,16,29,45,45,16,29,10,3.3080048761,4614.0933176906,0.1148240924,0.0984848485,0.3296371,0,135,1.2523372496197414E-4,4.2781286E-4,4.3893623E-4,99,0.35753933,4,0,197,0,0,-0.02790223
576155831,MaiaWildwood,10,446,68,336,1,36,35.4964721256,30-39,494,4,4,13,17,17,4,13,9,3.2742787485,1090.2947392874,0.020179936,0.0551470588,0.17307693,0,135,5.8162855332192026E-5,1.2582731E-4,1.2909889E-4,343,0.20158103,11,0,200,0,0,-0.0285041
226376868,maddysteves,10,3342,199,588,2,35,43.8671700826,40-49,644,6,17,18,35,35,17,18,11,3.6257618854,1090.7691575355,0.0786923019,0.1025210084,0.33152175,0,135,1.1504075922224366E-4,4.5297833E-4,4.64756E-4,353,0.3600713,58,2,200,2,0.01,-0.02854955
19088288,bannerite,10,38198,4778,4644,119,3698,64.8270851454,60-69,804,9,30,31,61,61,30,31,10,3.2629012597,32851.2778035215,0.0514392836,0.0289617486,0.16666667,0,135,3.55461055673498E-4,7.8012934E-4,8.0041314E-4,303,0.19551282,78,0,201,0,0,-0.02884615
767540082,Pixxiedust666,10,5727,220,435,1,846,42.7422470422,40-49,577,7,9,9,18,18,9,9,9,3.6184477855,942.9139542066,0.0173100092,0.0588235294,0.24545455,0,135,9.408832830889317E-5,2.5165462E-4,2.5819778E-4,99,0.2747253,5,0,200,0,0,-0.02927075
38465211,sciencepolicy,10,1333,4682,2479,187,4,52.9064968451,50-59,696,5,30,18,48,48,30,18,10,3.4095895977,19803.6348259102,0.0564621923,0.0319148936,0.12197581,0,135,3.6316366914029597E-4,7.8012934E-4,8.0041314E-4,283,0.15151516,33,0,201,0,0,-0.02953935
1040925522,HQ_Anon,10,520,679,386,7,12,44.642879527,40-49,622,4,7,7,14,14,7,7,9,3.6212921577,75.0939889076,0.0155452666,0.1703296703,0.3560606,0,135,9.444536390843463E-5,2.0132371E-4,2.0655822E-4,99,0.3857143,6,0,198,0,0,-0.0296537
390737393,MikeGuglielmin,10,220,98,328,1,3,16.7893855981,10-19,477,3,3,8,11,11,3,8,10,3.6367330354,157.0854262354,0.0108937285,0.1272727273,0.44642857,0,135,6.005644742515216E-5,1.00661855E-4,1.0327911E-4,505,0.47619048,3,3,200,3,0.015,-0.02976191
967227373,VE7KPM,10,3397,489,245,14,99,49.4748052713,40-49,706,7,24,23,47,47,24,23,10,3.5310849248,2103.1348174418,0.2630772787,0.0980573543,0.3110517,0,135,1.46045025814368E-4,6.291366E-4,6.4549444E-4,353,0.34102565,45,0,205,0,0,-0.02997395
147774520,agthsmkt,10,6475,311,182,13,152,55.9122697792,50-59,743,7,30,0,30,30,30,0,0,0,0,0.3179101639,0.2149425287,0.38850576,0,9,1.5450380672230054E-4,7.8012934E-4,0,353,0.4185606,74,0,207,0,0,-0.03005484
363497817,AntNom,10,80576,48608,46681,151,3177,56.7256029486,50-59,886,10,11,9,20,20,11,9,8,3.6225111743,74074.9039500577,0.0148398157,0,0,0,135,3.6082167050950577E-4,3.0198556E-4,2.8401756E-4,148,0.030303031,9,0,202,0,0,-0.030303031
92864379,Albertaardvark,10,8428,1108,1056,40,119,53.0776175168,50-59,764,7,92,81,173,173,92,81,9,3.0463226331,41876.0927729374,0.7762226806,0.0387820944,0.19161616,0,135,6.034326325784743E-4,0.002340388,0.0024012392,353,0.22250524,96,4,200,4,0.02,-0.03088908
996478027,TeamNewman2013,10,51,39,229,0,1,33.7661449954,30-39,462,4,11,30,41,41,11,30,11,3.5749695246,957.8335553418,0.0264162614,0.112804878,0.3229885,0,135,1.0822464335707081E-4,3.0198556E-4,3.0983734E-4,353,0.3555102,22,0,150,0,0,-0.0325217
220576066,yeepoa,10,2179,192,420,3,365,45.3423840381,40-49,640,6,15,29,44,44,15,29,10,3.268996343,1527.6589283411,0.0889146824,0.0687103594,0.21827957,0,135,1.2967792297280292E-4,4.0264742E-4,4.1311645E-4,99,0.25085035,49,0,199,0,0,-0.03257078
1023659581,Terry24681865,10,6231,201,841,8,10693,50.5920736403,50-59,655,7,4,7,11,11,4,7,10,3.8622511174,89.3643699284,0.0091990735,0.0545454545,0.23809524,0,135,6.429769578384189E-5,1.2582731E-4,1.2909889E-4,99,0.27083334,6,0,199,0,0,-0.0327381
612496685,speakup4sci,10,2421,262,184,17,6,49.6490869365,40-49,639,6,33,14,47,47,33,14,10,3.673709874,7801.7128198246,0.0694632934,0.0545790934,0.18181819,0,135,3.591142451839886E-4,8.556257E-4,8.262329E-4,283,0.21464646,125,1,206,1,0.0048543689,-0.03282827
216822870,JBSmokyday,10,1106,1115,1033,33,140,44.3095561462,40-49,627,5,40,46,86,86,40,46,9,2.9934985778,11358.814270958,0.2573092548,0.0488372093,0.21411765,0,135,2.3209490075428937E-4,0.001031784,0.0010586109,99,0.24701619,15,1,200,1,0.005,-0.03289854
745649389,AdamOsborne77,10,100,34,205,0,0,17.62859422,10-19,138,2,3,7,10,10,3,7,11,3.80292564,53.4772374121,0.0222359805,0.1111111111,0.2857143,0,135,6.364863449974524E-5,1.00661855E-4,1.0327911E-4,353,0.31868133,0,0,111,0,0,-0.03296703
1007314507,beaverclan1,10,2829,106,313,2,19,41.0757069737,40-49,500,7,26,29,55,55,26,29,9,3.1852905323,4460.6267908817,0.170318483,0.0774410774,0.33511585,0,135,1.6489897216648438E-4,6.794675E-4,6.97134E-4,99,0.3682927,4,0,201,0,0,-0.03317685
90511247,jeanjean3,10,62921,825,782,19,3651,42.5198086111,40-49,760,10,8,7,15,15,8,7,10,3.7667614791,512.3245813948,0.0143431753,0.1142857143,0.46666667,0,135,9.664207547104569E-5,2.2648917E-4,2.32378E-4,267,0.5,4,0,201,0,0,-0.03333333
250834460,verbum_sap,10,819,22,23,2,0,21.342334958,20-29,509,4,3,0,3,3,3,0,0,0,0,0.0404029207,0.1666666667,0.33333334,0,99,5.800399479745888E-5,1.00661855E-4,0,353,0.36666667,0,0,200,0,0,-0.03333333
381630487,GordWaldie,10,2462,179,314,11,5,41.9880972806,40-49,633,5,4,3,7,7,4,3,11,4.3039414872,1337.3491180503,0.0074428644,0.0238095238,0.16666667,0,135,7.41140185367892E-5,1.2582731E-4,1.2909889E-4,99,0.2,7,0,200,0,0,-0.03333333
558965990,PhilipHogan1,10,266,42,79,3,7,30.7127737382,30-39,299,3,0,2,2,2,0,2,11,4.3237205524,0,0,0.5,0.5,0,202,6.200024288120118E-5,0,2.5819778E-5,99,0.53333336,0,0,200,0,0,-0.03333336
1081371031,Gump130,10,106,14,46,0,1,15.2151686011,10-19,74,3,1,4,5,5,1,4,10,3.9158878505,0,0.0160468577,0.2,0.5,0,135,4.990831526219965E-5,5.0330927E-5,5.1639556E-5,99,0.53333336,0,0,146,0,0,-0.03333336
952580750,Erkin_TO,10,186,15,32,0,0,42.3376298321,40-49,560,4,2,0,2,2,2,0,0,0,0,0.0033965807,0.5,0.5,0,97,8.468084169521435E-5,7.549639E-5,0,505,0.53333336,75,0,200,0,0,-0.03333336
365103761,WesternUTories,10,228,163,181,5,1,40.8820307576,40-49,553,4,20,13,33,33,20,13,11,3.6013815522,768.8494431676,0.0802784712,0.1107954545,0.3577075,0,135,1.4390544435026595E-4,5.2847475E-4,5.4221536E-4,353,0.39112905,33,2,200,2,0.01,-0.03342155
64545499,Jenn_McCreath,10,21818,755,1677,12,3275,53.2603122827,50-59,744,8,19,25,44,44,19,25,9,3.3486387647,7365.2581432357,0.0469226293,0.0507399577,0.17096774,0,135,1.4915441703848852E-4,5.0330925E-4,5.1639555E-4,343,0.20461309,44,1,204,1,0.0049019608,-0.03364535
336821732,CharleneDesroch,10,12657,270,107,8,17,48.9614413934,40-49,749,8,33,14,47,47,33,14,10,3.4583502641,1700.5115155588,0.1734161258,0.0869565217,0.25714287,0,135,2.1408919577667681E-4,8.556257E-4,8.7787246E-4,99,0.2909804,129,0,201,0,0,-0.03383753
7417792,WernerPatels,10,26870,763,455,47,0,48.8561742337,40-49,740,8,33,14,47,47,33,14,10,3.3185696871,5546.306340927,0.3041348034,0.0712303423,0.1981982,0,135,2.9994056535061344E-4,8.556257E-4,8.7787246E-4,353,0.23224044,17,0,203,0,0,-0.03404224
149317195,PeggyatHome,10,24362,1573,1040,33,626,49.474413103,40-49,777,9,97,93,190,190,97,93,10,3.0121901666,48410.9037099741,0.7266159496,0.0275410749,0.16124119,0,135,4.2152534542915193E-4,0.0024662153,0.0025303382,353,0.19569702,69,2,202,2,0.0099009901,-0.03445583
365592531,Matante_Loulou,10,320,35,181,0,5,27.0515352589,20-29,471,4,2,6,8,8,2,6,11,4.1848841934,906.0746577271,0.0011355401,0.0892857143,0.3,0,135,8.602545336804117E-5,7.549639E-5,7.7459335E-5,267,0.3345588,4,1,197,1,0.0050761421,-0.0345588
1099809654,thunderdrums75,10,3393,346,454,7,621,52.7341199675,50-59,725,7,65,71,136,136,65,71,9,2.9223892727,19087.7967801336,0.368053606,0.0430283224,0.21240601,0,135,3.636414803703437E-4,0.0016609206,0.0017041053,99,0.24728169,320,0,201,0,0,-0.03487568
269666410,ChrisBataluk,10,3121,697,1360,15,4,40.8591677254,40-49,703,6,37,58,95,95,37,58,10,3.0459162942,8409.923757017,0.4026096256,0.0667413214,0.2717514,0,135,2.5906266036628743E-4,9.562876E-4,9.811516E-4,353,0.30911645,5,0,199,0,0,-0.03736505
191422128,BeverlyTaft,10,593,129,124,0,81,35.7331646183,30-39,554,5,12,7,19,19,12,7,9,3.6322633076,469.6242677695,0.0360595756,0.1023391813,0.35897437,0,135,1.071302556110171E-4,3.27151E-4,3.3565713E-4,257,0.3970588,9,1,200,1,0.005,-0.03808443
952619623,BaronOldsfield,10,300,14,46,0,9,21.8024823457,20-29,508,4,3,5,8,8,3,5,10,3.7496952458,226.2198905204,0.0283428561,0.1428571429,0.53333336,0,135,5.793600286367986E-5,1.00661855E-4,1.0327911E-4,353,0.5714286,18,3,203,3,0.0147783251,-0.03809524
745795364,MusingGma,10,1452,30,38,0,1347,40.9906318247,40-49,556,6,6,5,11,11,6,5,10,3.5119869972,444.7490499302,0.0995056129,0.1909090909,0.5,0,135,6.903318061116266E-5,1.7615824E-4,1.8073844E-4,353,0.53846157,8,0,201,0,0,-0.03846157
115797743,ArtisteNow,10,5577,165,1075,0,1,40.1978473108,40-49,559,6,2,19,21,21,2,19,9,3.3628606258,383.6882538349,0.0035955426,0.0738095238,0.1491228,0,135,5.646948725713735E-5,7.549639E-5,7.7459335E-5,267,0.18774703,2,0,201,0,0,-0.03862423
1230441554,LeviINM,10,196,225,245,3,53,44.8380152847,40-49,597,4,43,41,84,84,43,41,9,3.0812677773,9313.0096010129,0.2596502102,0.0446069994,0.23635523,0,135,2.4793185698462043E-4,0.0011072804,0.0011360702,99,0.2750503,44,0,196,0,0,-0.03869507
24306594,PMagouirk,10,6211,509,341,10,2947,51.7567634145,50-59,746,7,19,18,37,37,19,18,9,3.1767574157,2344.4045746673,0.1289318823,0.0563063063,0.32894737,0,135,1.4621465451342984E-4,5.0330925E-4,5.1639555E-4,99,0.36774194,119,0,200,0,0,-0.03879457
33309569,patriciatomala,10,248,140,632,0,10,29.5853692511,20-29,456,4,2,4,6,6,2,4,10,3.5644047135,96.7739300813,0.0164252051,0.1,0.41666666,0,135,5.054200281046808E-5,7.549639E-5,7.7459335E-5,353,0.45555556,4,1,199,1,0.0050251256,-0.0388889
11582802,JonSThompson,10,518,265,301,15,31,43.288435468,40-49,612,4,9,5,14,14,9,5,10,3.6395774076,2838.4795418768,0.0475421185,0.1098901099,0.25454545,0,135,1.4797051668233495E-4,2.5165462E-4,2.5819778E-4,283,0.29347825,19,0,198,0,0,-0.0389328
829418706,bdubs06,10,1215,108,241,3,26,44.180226731,40-49,673,6,5,11,16,16,5,11,11,3.5749695246,955.6208801026,0.0113594492,0.0583333333,0.16363636,0,135,7.93126873888398E-5,1.5099278E-4,1.5491867E-4,257,0.2032967,8,0,200,0,0,-0.03966034
138616596,windspeakernews,10,7370,5537,148,142,1,59.9325209134,50-59,771,6,157,4,161,161,157,4,10,3.7501015847,13336.488673886,0.6188953947,0.0472049689,0.08112853,0,135,0.0011190499,0.003976143,0.0040020654,99,0.12080017,207,0,204,0,0,-0.03967164
1219831238,IanBaranov,10,155,38,131,0,1,40.3645072712,40-49,481,4,4,15,19,19,4,15,10,3.4750101585,112.8134482507,0.0662677602,0.2485380117,0.60833335,0,135,7.033455147369856E-5,1.2582731E-4,1.2909889E-4,353,0.6483333,9,7,156,7,0.0448717949,-0.03999995
271649526,politicalicia,10,1178,292,498,6,1,32.144071653,30-39,552,5,22,25,47,47,22,25,10,3.2218610321,8315.8933376608,0.0611344353,0.0684551341,0.25053763,0,135,1.8170754195166313E-4,5.7880563E-4,5.938549E-4,257,0.29105264,1,2,200,2,0.01,-0.04051501
989106043,x3jennax3,10,2930,299,944,2,42,48.3063393243,40-49,681,7,5,9,14,14,5,9,9,3.6371393742,5158.2061627718,0.0133923887,0.0604395604,0.15454546,0,135,6.478652004222204E-5,1.5099278E-4,1.5491867E-4,99,0.1952381,10,0,201,0,0,-0.04069264
30966415,tbeaudrymellor,10,5092,1011,766,30,314,49.7346317656,40-49,741,7,23,10,33,33,23,10,11,3.8102397399,1707.8447675902,0.0652328655,0.0994318182,0.25,0,135,1.696761186534835E-4,6.0397113E-4,6.196747E-4,257,0.29069766,47,1,200,1,0.005,-0.04069766
250170548,Teresa_Kelly,10,1601,250,304,7,4,42.133772062,40-49,565,6,6,8,14,14,6,8,10,3.7106867127,720.0542206563,0.0132679384,0.0549450549,0.2857143,0,135,7.538612772133026E-5,1.7615824E-4,1.8073844E-4,257,0.3267974,1,1,200,1,0.005,-0.0410831
1005258452,bearclannation,10,2279,595,329,17,91,54.73379768,50-59,735,6,71,37,108,108,71,37,10,3.1848841934,9142.671391176,0.3482078334,0.0619591554,0.18208374,0,135,5.856291794110004E-4,0.0018119133,0.0018332042,99,0.22318758,291,2,203,2,0.0098522167,-0.04110384
534790063,MarilynGMurray,10,557,31,157,0,0,13.4129683904,10-19,341,5,2,6,8,8,2,6,11,3.7334416904,60.7963509068,0.0030859737,0.1428571429,0.4,0,135,5.4755031691375564E-5,7.549639E-5,7.7459335E-5,257,0.44117647,0,1,200,1,0.005,-0.04117647
171805432,JasonCossette,10,2843,947,1174,31,11,,,641,6,4,7,11,11,4,7,10,3.3965867534,2077.1992288043,0.0231821319,0.1,0.3809524,0,135,6.623224142224856E-5,1.2582731E-4,1.2909889E-4,257,0.42222223,0,0,200,0,0,-0.04126983
594984816,noneofitwastrue,10,8346,157,189,2,9,35.4215654213,30-39,715,7,11,7,18,18,11,7,9,3.4498171475,928.3065459849,0.08583078,0.068627451,0.24358974,0,135,8.612204420673587E-5,3.0198556E-4,3.0983734E-4,353,0.285,68,0,200,0,0,-0.04141026
431323952,MajaRabasovic,10,6637,176,496,2,893,38.2355036024,30-39,727,7,3,3,6,6,3,3,11,4.4490044697,229.6316463021,0.0029535469,0.0333333333,0.16666667,0,135,6.122531020542295E-5,1.00661855E-4,1.0327911E-4,505,0.20833333,16,0,200,0,0,-0.04166666
952101181,Cree8Dawn,10,1220,141,122,7,246,48.8644561188,40-49,630,6,26,16,42,42,26,16,10,3.3677366924,1609.1048692796,0.1699760028,0.0830429733,0.31746033,0,135,1.546372107749203E-4,6.794675E-4,6.97134E-4,99,0.3596154,81,0,198,0,0,-0.04215507
968015432,NoToBill115,10,1767,305,147,2,19,44.7794666397,40-49,671,6,24,22,46,46,24,22,10,3.4754164974,9490.657014307,0.0308614868,0.0280193237,0.09425288,0,135,1.7737946599831808E-4,6.291366E-4,6.4549444E-4,257,0.13650794,67,1,199,1,0.0050251256,-0.04225506
632592632,not_Klaatu,10,1737,285,650,8,42,50.1790706012,50-59,670,6,31,37,68,68,31,37,10,3.2828118651,16343.8615818014,0.0749787059,0.0357769974,0.15563299,0,135,3.1626080425754284E-4,8.0529484E-4,8.262329E-4,283,0.19799659,123,0,200,0,0,-0.0423636
255124676,YasmenHasan,10,7640,527,1088,9,203,48.5158065163,40-49,740,7,5,3,8,8,5,3,10,3.788703779,271.2858195584,0.0118390459,0.0357142857,0.2,0,135,8.186313929906882E-5,1.5099278E-4,1.5491867E-4,505,0.24264705,57,0,201,0,0,-0.04264705
272247146,niipomakii,10,14552,844,647,40,136,52.1807045621,50-59,779,8,40,34,74,74,40,34,9,3.1393742381,5372.4499217782,0.2609756956,0.0683080341,0.25930852,0,135,2.479755056498993E-4,0.001031784,0.0010586109,99,0.3027972,27,0,200,0,0,-0.04348868
17203795,ShaktiLila,10,209,217,1755,3,306,39.9300416496,30-39,415,4,9,46,55,55,9,46,9,3.0999593661,5228.1235182343,0.0513212961,0.096969697,0.2173913,0,135,8.217549387013305E-5,2.5165462E-4,2.5819778E-4,99,0.26122525,1,0,198,0,0,-0.04383395
395335392,GitchieCheechoo,10,1160,247,191,1,142,41.5924920212,40-49,631,5,13,9,22,22,13,9,10,3.8175538399,130.7046552203,0.0645077628,0.1082251082,0.23202614,0,135,1.116867258962227E-4,3.5231648E-4,3.6147688E-4,99,0.27635327,38,0,197,0,0,-0.04432713
528820859,MetroGraham,10,1941,210,80,14,0,45.7937994816,40-49,605,4,5,2,7,7,5,2,10,3.9699309224,161.1949610975,0.01166477,0.0238095238,0.06666667,0,135,5.920452454510088E-5,1.5099278E-4,1.5491867E-4,505,0.11111111,4,0,200,0,0,-0.04444444
381198439,benfreeland,10,656,199,289,4,17,53.1594104681,50-59,573,5,2,4,6,6,2,4,11,4.1674116213,79.4647131268,0.0106943433,0.1666666667,0.4,0,135,6.754060995913574E-5,7.549639E-5,7.7459335E-5,353,0.44444445,5,0,200,0,0,-0.04444445
336541205,CAN_politNews,10,818,2080,2288,26,0,43.9931564522,40-49,598,5,83,91,174,174,83,91,9,2.6761479074,154403.054341994,0.2838575105,0.003288818,0.020425227,0,135,3.378145537199454E-4,0.002113899,0.0021688615,99,0.06506042,4,0,200,0,0,-0.044635193
1049560369,cheezwitham,10,3231,187,291,0,1587,48.0101610774,40-49,619,7,6,6,12,12,6,6,10,3.9179195449,576.8717556919,0.0072624342,0.0151515152,0.13333334,0,135,8.360801241502366E-5,1.7615824E-4,1.8073844E-4,303,0.17857143,2,0,201,0,0,-0.04523809
814062072,ShitNewsNetwork,10,33,11,48,0,0,16.9066178591,10-19,41,2,3,3,6,6,3,3,10,3.9382364892,34.1714444884,0.0053759058,0.1,0.41666666,0,135,5.7605003293792934E-5,1.00661855E-4,1.0327911E-4,99,0.46190476,3,0,32,0,0,-0.0452381
193309305,PhilOllenberg,10,5490,309,312,9,17,44.9951035955,40-49,703,7,5,4,9,9,5,4,11,4.3177570093,2497.9414384706,0.0119960076,0.1666666667,0.3392857,0,135,7.440549459754054E-5,1.5099278E-4,1.5491867E-4,257,0.3846154,18,0,200,0,0,-0.0453297
187654680,AWC_Calgary,10,5432,267,365,11,637,45.2519723659,40-49,535,6,30,24,54,54,30,24,9,3.2230800488,2568.3453765699,0.1892262677,0.070230608,0.2789916,0,135,2.061372008161741E-4,7.8012934E-4,8.0041314E-4,99,0.32457912,5,0,199,0,0,-0.04558752
588017994,JohnKleinRegina,10,5794,471,593,17,2864,38.7057508519,30-39,728,7,27,29,56,56,27,29,10,3.3132872816,13615.1191081923,0.0558507148,0.0337662338,0.14015152,0,135,2.0339244617804887E-4,7.0463296E-4,7.2295376E-4,257,0.18585859,51,0,200,0,0,-0.04570707
271762869,happytovote,10,4462,402,960,9,34,40.0403812244,40-49,650,7,20,41,61,61,20,41,10,3.1714750102,10059.1051093209,0.2062846491,0.0601092896,0.22134146,0,135,1.2712918826035047E-4,5.2847475E-4,5.4221536E-4,353,0.26736844,4,1,199,1,0.0050251256,-0.04602698
291126048,YQRosie,10,3652,287,431,11,411,39.0966235561,30-39,610,6,16,12,28,28,16,12,10,3.7582283625,1415.7616120206,0.0488531811,0.0727513228,0.21842106,0,135,1.3054636590450498E-4,4.2781286E-4,4.3893623E-4,257,0.26458037,0,6,198,5,0.0252525253,-0.04615931
26248921,Opus420,10,4664,268,211,3,1808,46.3673202531,40-49,661,7,10,8,18,18,10,8,10,3.5396180414,5389.2804628402,0.0265799491,0.0751633987,0.3181818,0,135,1.1816638892718579E-4,2.768201E-4,2.8401756E-4,505,0.365,28,0,207,0,0,-0.0468182
101146132,LegionJJ,10,111239,26718,283,298,529,65.6508760638,60-69,965,10,11,1,12,12,11,1,1,1,15.1908699402,0.028000764,0.053030303,0.08181818,0,23,8.849326779477698E-4,3.0198556E-4,2.5819778E-4,99,0.12878788,33,0,201,0,0,-0.0469697
225141669,WaterPortal,10,2134,876,618,46,16,50.9863102246,50-59,667,5,11,9,20,20,11,9,10,3.6168224299,2186.4059715016,0.0264212476,0.0210526316,0.13636364,0,135,1.1241291786200411E-4,3.0198556E-4,3.0983734E-4,283,0.18333334,25,0,200,0,0,-0.0469697
471373072,CarolynBuffalo,10,3494,595,749,13,19,44.6058610295,40-49,631,7,62,48,110,110,62,48,10,3.0223486388,21284.0788071383,0.3607445747,0.0435362802,0.18634102,0,135,3.989428385678955E-4,0.0015854242,0.001626646,99,0.23396227,2,1,194,1,0.0051546392,-0.04762125
46381669,CONDESCENDANT,10,15419,1897,2019,33,396,55.7357956035,50-59,783,8,26,32,58,58,26,32,9,3.247460382,12706.1513133451,0.0691648579,0.0426497278,0.18319328,0,135,2.576829292788284E-4,6.794675E-4,6.97134E-4,343,0.23083025,117,1,201,1,0.0049751244,-0.04763697
161783335,Newswriter22,10,28800,1237,600,83,36,44.9762682044,40-49,797,9,15,3,18,18,15,3,11,4.0650142219,2892.9309926303,0.0289586166,0.0751633987,0.18571429,0,135,1.1156293650330947E-4,4.0264742E-4,4.1311645E-4,257,0.23376623,24,0,201,0,0,-0.04805194
1097270467,Idlenomoreyeg,10,5813,950,1480,22,0,57.166457919,50-59,737,4,60,53,113,113,60,53,10,2.9252336449,41650.0828993908,0.2663287501,0.0324747155,0.13933748,0,135,3.6276446607440364E-4,0.0015350933,0.0015750064,99,0.18807456,219,1,208,1,0.0048076923,-0.04873708
354570485,R_Cardinal,10,3475,445,898,6,38,43.0494584554,40-49,695,6,32,38,70,70,32,38,10,2.99634295,17236.7008836932,0.2011956091,0.0472049689,0.16714975,0,135,1.9659414900694274E-4,8.304603E-4,8.5205265E-4,99,0.21603677,13,1,200,1,0.005,-0.04888702
607871339,lumiere022,10,39602,892,896,22,1138,43.2735884542,40-49,761,9,18,12,30,30,18,12,10,3.333197887,4857.1017122102,0.0532311254,0.0609195402,0.14855072,0,135,1.4178670942374997E-4,4.781438E-4,4.905758E-4,267,0.19767442,18,1,207,1,0.0048309179,-0.0491237
1033928792,Los_Indio,10,952,542,927,8,511,48.0284199114,40-49,676,5,65,84,149,149,65,84,9,2.9244209671,42618.8346160249,0.3333245815,0.0322419735,0.13995007,0,135,3.5030246516252626E-4,0.0016609206,0.0017041053,99,0.18933797,33,0,200,0,0,-0.0493879
15816745,NBToryGal,10,5650,218,407,12,9,39.0976008362,30-39,628,6,30,36,66,66,30,36,10,3.1418122714,4758.5446313831,0.3336351585,0.0561771562,0.26346153,0,135,2.621899696221627E-4,7.8012934E-4,8.0041314E-4,353,0.31311476,3,2,200,2,0.01,-0.04965323
15419003,lexinc,10,1054,72,284,3,35,42.3998625657,40-49,548,5,11,20,31,31,11,20,10,3.3096302316,1142.7769699797,0.0687476442,0.0634408602,0.23571429,0,135,1.0554720828052856E-4,3.0198556E-4,3.0983734E-4,99,0.2855219,15,0,200,0,0,-0.04980761
78812863,avdhuman,10,59476,1946,1434,10,5,45.7346448154,40-49,649,9,4,1,5,5,4,1,11,4.1523770825,2545.4722413498,0.024626649,0,0,0,135,9.287224043364554E-5,1.2582731E-4,1.0327911E-4,99,0.05,0,0,206,0,0,-0.05
315042301,rparmar958,10,1597,117,493,1,29,28.3496541761,20-29,470,6,1,4,5,5,1,4,11,4.0800487607,6.8915423754,0.0011902671,0.3,0.45,0,135,7.465414031345078E-5,5.0330927E-5,5.1639556E-5,71,0.5,1,3,200,3,0.015,-0.05
474986645,foodethosfarm,10,614,351,839,12,1,42.462363321,40-49,554,5,2,4,6,6,2,4,10,3.9081674116,97.9574977483,0.0030715937,0.0333333333,0.083333336,0,135,5.34427861415813E-5,7.549639E-5,7.7459335E-5,257,0.13333334,0,0,200,0,0,-0.050000004
1276647637,otcimow,10,124,23,144,0,37,55.7855244407,50-59,695,7,47,56,103,103,47,56,9,3.0816741162,10906.7827723818,0.268626515,0.0495907101,0.19393939,0,135,2.7078478585268337E-4,0.0012079423,0.0012393494,99,0.2441201,306,2,222,2,0.009009009,-0.05018071
362102805,E_YELLOWFLY,10,885,725,1544,10,0,35.7371297941,30-39,548,5,4,7,11,11,4,7,9,3.4526615197,333.8153089054,0.0393998436,0.0545454545,0.21428572,0,135,6.958463330211504E-5,1.2582731E-4,1.2909889E-4,99,0.2651515,0,0,200,0,0,-0.05086578
28058648,kwcmb,10,4217,273,381,4,516,45.7539935195,40-49,686,6,28,27,55,55,28,27,9,3.1113368549,3482.7453345561,0.1914703511,0.0555555556,0.33620688,0,135,1.8379699054554583E-4,7.297984E-4,7.487736E-4,99,0.3871795,28,0,200,0,0,-0.05097262
332284449,NoWarNow2011,10,45478,3099,3278,68,993,47.2834192081,40-49,788,9,18,24,42,42,18,24,9,3.340511987,9733.0769372377,0.0358215039,0.0162601626,0.06837607,0,135,1.379542494127921E-4,4.781438E-4,4.905758E-4,99,0.11942959,23,0,201,0,0,-0.05105352
75073306,karenscian,10,9086,1400,548,64,21,56.6186221625,50-59,748,7,16,5,21,21,16,5,10,3.7748882568,3824.7630215105,0.031989745,0.0357142857,0.104166664,0,135,1.2333572016521842E-4,4.2781286E-4,4.1311645E-4,505,0.15526316,43,0,200,0,0,-0.051096496
622367096,tlmporter,10,990,147,286,2,468,36.287263852,30-39,538,5,12,15,27,27,12,15,10,3.3917106867,1883.9013365062,0.1028865991,0.0769230769,0.375,0,135,1.2714390163213644E-4,3.27151E-4,3.3565713E-4,99,0.42615384,10,0,199,0,0,-0.05115384
442824167,LePoliticard,10,11806,600,600,5,46,34.8726269487,30-39,699,8,16,13,29,29,16,13,10,3.7098740349,4615.2671293183,0.0296275281,0.0751231527,0.19480519,0,135,1.307656748905158E-4,4.2781286E-4,4.1311645E-4,267,0.24596775,8,2,199,2,0.0100502513,-0.05116256
120482978,jdeq,10,5009,406,576,14,16,55.9010803203,50-59,685,7,11,13,24,24,11,13,10,3.5822836245,6033.2169690397,0.0199360041,0.0434782609,0.17142858,0,135,1.521035511104695E-4,3.0198556E-4,2.8401756E-4,257,0.2228261,16,1,199,1,0.0050251256,-0.05139752
309558781,KellyRek,10,64514,2535,2766,131,26276,47.0013892037,40-49,813,9,7,13,20,20,7,13,10,3.5916294189,2776.4895003577,0.0085510873,0.0052631579,0.010989011,0,135,9.568721235094596E-5,2.0132371E-4,2.0655822E-4,303,0.0625,24,0,201,0,0,-0.051510989
16216473,Kevin_Wright,10,887,286,363,11,12,39.0933873671,30-39,556,5,25,26,51,51,25,26,9,3.19707436,2626.6041130496,0.1203848046,0.0709803922,0.33563218,0,135,1.7828343019609666E-4,6.54302E-4,6.7131425E-4,257,0.38740122,16,2,200,2,0.01,-0.05176904
15432179,raulpacheco,10,19939,3809,2178,290,1480,62.6055397056,60-69,775,8,25,22,47,47,25,22,10,3.3409183259,12271.4356718186,0.0654869158,0.0161887142,0.08461539,0,135,2.2851691594287925E-4,6.54302E-4,6.7131425E-4,71,0.13663663,40,0,201,0,0,-0.05202124
70445552,BigShoey,10,5934,358,126,13,76,32.0401202995,30-39,715,7,15,15,30,30,15,15,10,3.4567249086,1305.8022125512,0.1643271692,0.1206896552,0.33992094,0,135,1.0730046987661283E-4,4.0264742E-4,4.1311645E-4,353,0.3921371,5,1,199,1,0.0050251256,-0.05221616
169125181,jasongariepy,10,1036,601,541,17,55,46.6654028293,40-49,668,5,11,15,26,26,11,15,10,3.4400650142,907.6429192291,0.07529212,0.0769230769,0.26143792,0,135,1.327987577834377E-4,3.0198556E-4,3.0983734E-4,353,0.31376517,11,0,200,0,0,-0.05232725
18460152,seanshaw,10,8993,721,499,50,6,50.5050055434,50-59,747,7,15,14,29,29,15,14,10,3.4490044697,2799.9949246693,0.0466316557,0.0775862069,0.2631579,0,135,1.283302733792253E-4,4.0264742E-4,3.8729666E-4,257,0.3155242,41,2,200,2,0.01,-0.0523663
285796366,jdumes98,10,368,108,181,1,1,36.145735691,30-39,542,4,11,10,21,21,11,10,10,3.5266151971,577.3717085455,0.0329998671,0.0857142857,0.31868133,0,135,7.834823795183456E-5,3.0198556E-4,3.0983734E-4,505,0.37142858,18,1,200,1,0.005,-0.05274725
274090688,Blackwell_Rez,10,1658,778,1432,7,23,38.1626190267,30-39,614,6,17,22,39,39,17,22,9,3.1316537993,2829.5145791543,0.1047206222,0.0391363023,0.18577075,0,135,1.2866428560301486E-4,4.5297833E-4,4.64756E-4,99,0.23867595,0,0,200,0,0,-0.0529052
18117300,Proud_Canadian1,10,28943,1343,1673,74,178,46.2358011371,40-49,780,8,66,62,128,128,66,62,9,2.9536773669,67855.5681208708,0.471302241,0.031988189,0.0974359,0,135,5.784017682771064E-4,0.0016860861,0.0017299252,353,0.15051387,143,2,202,2,0.0099009901,-0.05307797
41032055,eaglespirit44,10,4406,325,603,14,75,41.3808518863,40-49,652,5,16,23,39,39,16,23,9,3.1653799269,1946.9757262961,0.1353160079,0.0809716599,0.27116403,0,135,1.2161648678160215E-4,4.2781286E-4,4.3893623E-4,99,0.32456142,1,0,200,0,0,-0.05339739
14522779,rockermom53,10,17344,908,1991,19,1016,58.3730744351,50-59,774,8,5,9,14,14,5,9,10,3.7582283625,478.1424365043,0.0046792274,0.0164835165,0.055555556,0,135,7.499491801414388E-5,1.5099278E-4,1.5491867E-4,303,0.10909091,35,0,201,0,0,-0.053535354
185472553,KAL301,10,62964,1364,767,15,12316,47.3356817618,40-49,779,9,41,25,66,66,41,25,9,3.1011783828,9859.2293224085,0.2258654217,0.041958042,0.15448505,0,135,3.53615047781283E-4,0.0010569495,0.0010844307,99,0.20805065,58,0,201,0,0,-0.0535656
237973831,JasonRondeau,10,3649,293,272,5,551,44.7979399572,40-49,684,6,6,5,11,11,6,5,11,4.4664770419,498.4220472509,0.013419021,0.0636363636,0.19642857,0,135,9.130125263969044E-5,1.7615824E-4,1.8073844E-4,343,0.25,9,0,200,0,0,-0.05357143
517121805,MemersBooth,10,6726,531,1203,9,5289,49.9047542383,40-49,732,7,29,50,79,79,29,50,9,2.9739943113,14660.9070141348,0.1452655016,0.0387861084,0.14150943,0,135,1.9898385040466546E-4,7.549639E-4,7.745933E-4,99,0.19537815,81,0,188,0,0,-0.05386872
50285275,Tibet_TW,10,63429,2398,2553,93,149,47.3810412447,40-49,803,10,12,17,29,29,12,17,10,3.3522958147,2235.4202131777,0.0314219781,0.0357142857,0.17320262,0,135,9.289688775323502E-5,3.27151E-4,3.3565713E-4,99,0.22727273,89,0,201,0,0,-0.05407011
331376866,manny_ottawa,10,8808,538,298,9,45,54.517388754,50-59,757,7,48,18,66,66,48,18,10,3.4185290532,3500.9133960735,0.4005375476,0.0804195804,0.21606335,0,135,4.2026092850054966E-4,0.0012331076,0.0012393494,353,0.2707016,179,2,202,2,0.0099009901,-0.05463825
125417632,Chris_Gorman,10,4367,27830,22124,147,24,63.7776223883,60-69,742,7,121,119,240,240,121,119,9,2.6420154409,254197.328675722,0.5177787227,0.0060669456,0.037651606,0,135,6.465753098357272E-4,0.0030701866,0.0031500128,353,0.09246895,25,0,202,0,0,-0.054817344
16580153,BrockWHarrison,10,7079,1750,900,53,3,58.8536455473,50-59,757,7,71,34,105,105,71,34,10,3.3100365705,11845.4487291964,0.5512710181,0.0667582418,0.18630315,0,135,7.169135723087898E-4,0.0018119133,0.0018332042,353,0.24122748,74,2,200,2,0.01,-0.05492433
25230293,markleahy,10,480,49,124,2,4,39.8034927731,30-39,499,5,6,4,10,10,6,4,10,3.8013002844,202.9818030733,0.0221139883,0.0666666667,0.36666667,0,135,8.80370783843593E-5,1.7615824E-4,1.8073844E-4,505,0.42166665,14,1,199,1,0.0050251256,-0.05499998
50458600,ArnellTF,10,8742,1008,1376,17,1130,54.9788646908,50-59,741,7,95,102,197,197,95,102,9,2.8167411621,68781.9249829174,0.4809844306,0.0239303843,0.13939041,0,135,5.647554833969324E-4,0.0024158845,0.0024786987,99,0.19447331,168,0,201,0,0,-0.0550829
288521315,CooperMatheson,10,809,184,219,1,250,44.7787566015,40-49,580,5,9,8,17,17,9,8,10,3.5343356359,2336.245976475,0.0722999949,0.1139705882,0.38636363,0,135,1.3392017012261553E-4,2.5165462E-4,2.32378E-4,353,0.44155845,12,3,200,3,0.015,-0.05519482
40359136,jobeth69,10,2138,250,886,2,56,45.5202237405,40-49,642,6,3,5,8,8,3,5,9,3.9849654612,134.4140954482,0.0032025571,0.1071428571,0.16666667,0,135,6.263197561416128E-5,1.00661855E-4,1.0327911E-4,99,0.22222222,2,0,200,0,0,-0.05555555
24597118,charlielapin,10,17102,253,320,6,200,59.5349613095,50-59,740,8,3,3,6,6,3,3,10,4.1475010158,73.9918039174,0.0087252322,0.1,0.5,0,135,6.0086853027491336E-5,1.00661855E-4,1.0327911E-4,267,0.5555556,6,0,201,0,0,-0.0555556
240911396,Gnomelita,10,235,29,100,1,10,20.2532183246,20-29,437,3,3,5,8,8,3,5,10,3.6919951239,26.6025767318,0.016279365,0.0892857143,0.45,0,135,6.082606018413667E-5,1.00661855E-4,1.0327911E-4,257,0.50574714,2,4,200,4,0.02,-0.05574714
634080059,RachelAnnSnow,10,16777,1074,890,30,172,52.2999233756,50-59,787,8,68,55,123,123,68,55,9,2.9752133279,18503.802457749,0.3753889631,0.0413168066,0.19111894,0,135,4.567654864752056E-4,0.001736417,0.0017815647,99,0.24742769,128,0,202,0,0,-0.05630875
356262824,GregT_theMetis,10,1879,255,386,8,14,47.7086980623,40-49,647,6,23,10,33,33,23,10,10,3.4522551808,5131.1929729408,0.1105128089,0.0388257576,0.12862319,0,135,1.946591777403198E-4,6.0397113E-4,6.196747E-4,99,0.18498942,63,2,200,2,0.01,-0.05636623
18165715,paulcip,10,5943,1632,1996,68,0,50.6452605805,50-59,657,6,3,5,8,8,3,5,11,3.8143031288,123.6943013379,0.0113505385,0.0714285714,0.35,0,135,1.1434332057510807E-4,1.00661855E-4,1.0327911E-4,71,0.40643275,0,1,200,1,0.005,-0.05643275
818034576,writepaintlove,10,11107,964,1441,25,7283,56.7226038416,50-59,765,8,31,52,83,83,31,52,9,3.064607883,29221.4234644535,0.1860435959,0.0602409639,0.25113124,0,135,2.474723020218718E-4,8.0529484E-4,8.262329E-4,99,0.30769232,64,0,201,0,0,-0.05656108
1071955452,Wendego1763,10,1700,529,185,6,325,49.4151110944,40-49,667,6,66,11,77,77,66,11,9,3.3563592036,8831.0163491701,0.2744768516,0.0644224197,0.12877847,0,135,3.2219872778063247E-4,0.0016860861,0.0016782855,99,0.18543418,75,0,196,0,0,-0.05665571
19825011,Jamie_Brace,10,11257,680,1003,11,1993,51.4612116098,50-59,745,8,21,22,43,43,21,22,8,3.2905323039,10005.8488389273,0.0555502709,0.057585825,0.21296297,0,135,1.5615864115659046E-4,5.536402E-4,5.680351E-4,343,0.26969856,30,1,201,1,0.0049751244,-0.05673559
607054668,HenryMcRandall1,10,1314,689,1992,14,1,40.8065512158,40-49,626,5,6,15,21,21,6,15,10,3.3279154815,2940.0366834895,0.0135856707,0.0071428571,0.016666668,0,135,5.900594277364418E-5,1.7615824E-4,1.8073844E-4,99,0.07368421,0,0,200,0,0,-0.057017542
381114629,King_Rob674,10,592,89,358,0,7,38.163391802,30-39,500,5,11,17,28,28,11,17,10,3.4937017473,441.8067418536,0.1530306972,0.0753968254,0.32026145,0,135,1.0507987120313746E-4,3.0198556E-4,3.0983734E-4,353,0.37731093,11,0,199,0,0,-0.05704948
66076712,acimowin,10,7365,1330,1183,32,2948,52.1184519216,50-59,730,7,91,77,168,168,91,77,9,2.9280780171,40196.2368561984,0.4593204315,0.0341103507,0.14525034,0,135,5.530246128740039E-4,0.0023152225,0.0023495997,99,0.20232509,52,1,199,1,0.0050251256,-0.05707475
391760598,HobbesBruce,10,1357,77,233,4,31,40.732093577,40-49,634,6,5,6,11,11,5,6,10,3.4327509143,1252.0742892244,0.0503796757,0.0272727273,0.2,0,135,6.864574659727764E-5,1.5099278E-4,1.5491867E-4,283,0.25714287,10,0,200,0,0,-0.05714287
492492626,christibelcourt,10,4178,1911,1345,30,2161,56.7273469765,50-59,772,7,135,72,207,207,135,72,9,2.9548963836,64364.3891023559,0.5514333403,0.0292200178,0.09171456,0,135,6.756664594930674E-4,0.003422503,0.0034598503,99,0.14912948,341,0,199,0,0,-0.05741492
16474992,winterthur,10,136025,4332,4732,289,78,48.3959135312,40-49,853,10,17,21,38,38,17,21,10,3.573344169,7276.6595796867,0.026876027,0.0312944523,0.1005291,0,135,1.9980386179907456E-4,4.5297833E-4,4.64756E-4,303,0.15853658,10,0,201,0,0,-0.05800748
41831995,PoliticalBee,10,79154,4389,4813,338,99156,45.9526913349,40-49,762,10,17,28,45,45,17,28,9,3.3287281593,12561.3942100556,0.0317537172,0.0252525253,0.10449736,0,135,1.7949131680577952E-4,4.5297833E-4,4.64756E-4,303,0.16260162,4,0,201,0,0,-0.05810426
311969504,Slyb24,10,418,146,421,1,6,34.2180783083,30-39,407,4,6,6,12,12,6,6,9,3.6940268184,143.6230462699,0.0139670434,0.0606060606,0.26190478,0,135,9.389283841519495E-5,1.7615824E-4,1.8073844E-4,99,0.32051283,2,0,198,0,0,-0.05860805
242038643,tammyrobert,10,6338,1638,930,76,11,54.8007209915,50-59,760,7,19,9,28,28,19,9,11,4.0044697278,5657.5020473214,0.0655296051,0.0767195767,0.17748918,0,135,1.8742196607068906E-4,5.0330925E-4,4.64756E-4,257,0.23613086,109,0,201,0,0,-0.05864168
257644524,wapimaskwa69,10,21988,1309,1505,43,10,50.3709057233,50-59,775,8,78,64,142,142,78,64,9,2.7976432345,75102.8087010859,0.5329699999,0.0193287384,0.098313764,0,135,4.1291032667926524E-4,0.0019880715,0.0020397624,99,0.15729032,74,0,202,0,0,-0.058976556
459490133,JeffCorntassel,10,3443,1678,1205,58,45,53.2558689986,50-59,757,7,67,59,126,126,67,59,9,2.9890288501,26479.90638102,0.3126845547,0.0255873016,0.13022774,0,135,6.220361735623668E-4,0.0017112514,0.0017557449,99,0.18938786,77,0,198,0,0,-0.05916012
45627934,leenaminifie,10,1573,692,945,28,345,61.7241605002,60-69,629,6,16,19,35,35,16,19,9,3.3307598537,2793.625159557,0.1113711288,0.0731092437,0.270751,0,135,2.0090446453547266E-4,4.2781286E-4,4.3893623E-4,99,0.3299595,3,0,198,0,0,-0.0592085
268538413,ActivistKent,10,698,770,630,17,71,49.8867243982,40-49,743,7,47,36,83,83,47,36,10,3.3380739537,15583.0266117518,0.16625074,0.0454011167,0.15422077,0,135,2.4478669875316946E-4,0.0012079423,0.0012393494,257,0.21345322,124,3,200,3,0.015,-0.05923245
185630556,votelau,10,6401,422,607,19,1347,49.2129955931,40-49,707,7,38,54,92,92,38,54,10,2.9341731004,33327.6537563662,0.1925063669,0.0272336359,0.09836066,0,135,2.7326180681607246E-4,9.814531E-4,0.0010069713,257,0.15764415,65,0,200,0,0,-0.05928349
906466254,wjthompson99,10,264,90,402,0,4,29.1961383125,20-29,333,4,3,5,8,8,3,5,9,3.6407964242,1090.2624069404,0.0120942077,0.0714285714,0.35,0,135,6.54659909020361E-5,1.00661855E-4,1.0327911E-4,71,0.40952381,1,1,199,1,0.0050251256,-0.05952381
24116965,campbelljustin,10,9618,534,801,15,119,48.2183696541,40-49,735,7,42,41,83,83,42,41,10,3.1344981715,86400.2493321761,0.2513201712,0.0339406406,0.15986395,0,135,2.861873970319508E-4,0.0010821149,0.0011102505,353,0.21949404,52,6,203,6,0.0295566502,-0.05963009
700306736,EverythingElse4,10,1505,61,399,1,0,25.2778051297,20-29,582,6,3,7,10,10,3,7,11,3.7415684681,308.7232261545,0.0050628909,0.1111111111,0.17857143,0,135,5.5310551557435315E-5,1.00661855E-4,1.0327911E-4,257,0.23856209,3,0,196,0,0,-0.05999066
16180559,Roseblue,10,41576,5788,5166,318,41,56.5369778344,50-59,831,8,33,46,79,79,33,46,10,3.3124746038,47128.6069914979,0.1906030455,0.02937358,0.1359852,0,135,4.247669710152758E-4,8.556257E-4,8.7787246E-4,353,0.19600938,143,1,201,1,0.0049751244,-0.06002418
40863827,Jesus_H_Chris,10,3186,5783,265,79,718,57.2495080001,50-59,770,6,18,3,21,21,18,3,10,4.0796424218,14097.5099443399,0.0204941172,0.0023809524,0.0029239766,0,135,2.474708602934156E-4,4.781438E-4,3.6147688E-4,106,0.06333333,39,0,200,0,0,-0.0604093534
71390388,AlbertaAltruist,10,17596,1027,139,41,0,58.2887737382,50-59,774,8,53,9,62,62,53,9,10,3.5217391304,2807.1304869813,0.4414226403,0.1166049709,0.2557652,0,135,3.877024434850623E-4,0.001358935,0.0013684483,353,0.31651017,256,3,202,3,0.0148514851,-0.06074497
286014324,politicalham,10,567,158,456,1,0,63.7383090775,60-69,520,4,4,13,17,17,4,13,11,3.6830556684,114.9914146842,0.0357556761,0.1764705882,0.3956044,0,135,7.631966267303751E-5,1.2582731E-4,1.2909889E-4,353,0.4564394,2,0,200,0,0,-0.060835
61213720,CTVW5,10,1349,3276,140,139,1,59.0320144225,50-59,741,5,44,1,45,45,44,1,1,1,748.1509804312,0.0832132587,0.0070707071,0.009513742,0,10,3.936290420858129E-4,0.0011324459,0.0010844307,71,0.071428575,229,0,198,0,0,-0.061914833
186500600,msewen,10,2778,843,1115,57,39,49.0858645693,40-49,698,7,22,26,48,48,22,26,10,3.1235270215,11803.9587465781,0.0732298588,0.0265957447,0.14307693,0,135,1.358155682713901E-4,5.7880563E-4,5.938549E-4,71,0.20555556,12,0,200,0,0,-0.06247863
201487651,mabastarache,10,112,152,162,3,4,30.0724490833,30-39,505,3,4,4,8,8,4,4,11,4.3579845591,187.3773891447,0.0040626612,0.0714285714,0.3,0,135,7.115677231148063E-5,1.2582731E-4,1.2909889E-4,505,0.36263737,2,2,115,2,0.0173913043,-0.06263737
541927759,alanna_newman,10,2251,418,746,8,686,48.4718814767,40-49,673,6,26,37,63,63,26,37,10,3.2295814709,10431.2028203668,0.1150952016,0.0540194572,0.20641026,0,135,1.8072209006553443E-4,6.794675E-4,6.97134E-4,353,0.2690972,152,2,201,2,0.0099502488,-0.06268694
72966878,w_izzard,10,7278,5117,5070,41,180,56.8610118006,50-59,729,7,35,45,80,80,35,45,10,2.9760260057,40375.9380682957,0.2661851509,0.0337025316,0.13067785,0,135,2.7341824768415735E-4,9.0595667E-4,9.29512E-4,353,0.19343366,8,0,200,0,0,-0.06275581
517664013,CarolAnnAudet,10,1893,89,150,1,11,36.5947001977,30-39,570,6,12,8,20,20,12,8,10,3.59488013,120.178960543,0.0753546773,0.1131578947,0.34285715,0,135,1.234163947985674E-4,3.27151E-4,3.3565713E-4,99,0.40574712,7,1,199,1,0.0050251256,-0.06288997
11267302,ajproc,10,88036,2399,1707,131,854,59.7218870682,50-59,796,10,17,9,26,26,17,9,11,3.6680211296,1773.5395007045,0.0690091165,0.0492307692,0.19485295,0,135,2.320676758822866E-4,4.5297833E-4,4.64756E-4,353,0.2579365,23,0,200,0,0,-0.06308355
287695900,funnyhaircut,10,2896,235,775,6,36,25.8194369304,20-29,595,6,10,26,36,36,10,26,10,3.1377488826,4497.9013505191,0.1162830809,0.0698412698,0.23692308,0,135,1.0821003305123294E-4,2.768201E-4,2.8401756E-4,353,0.30021143,2,0,193,0,0,-0.06328835
16173574,oberhoffner,10,10275,1375,829,58,22,61.5268084773,60-69,764,7,46,27,73,73,46,27,10,3.2389272653,10368.9821722869,0.2406646561,0.0487062405,0.17021276,0,135,3.9541940192790355E-4,0.0011827768,0.0011877097,353,0.23363096,94,1,200,1,0.005,-0.0634182
1164339799,theMcBane,10,5083,432,789,11,4239,56.5838854239,50-59,741,7,10,18,28,28,10,18,10,3.3242584315,4515.0830053007,0.033570519,0.0291005291,0.12418301,0,135,9.803953592233545E-5,2.768201E-4,2.8401756E-4,267,0.18769231,18,0,205,0,0,-0.0635093
22330357,Canadian_Hockey,10,21955,7694,33,397,0,49.6379571617,40-49,736,5,9,0,9,9,9,0,0,0,0,0.016594184,0,0,0,40,7.179973849982399E-5,2.5165462E-4,0,99,0.06363636,2,0,201,0,0,-0.06363636
52474769,Icarus2009,10,14512,253,454,6,44,42.1707479806,40-49,648,8,8,5,13,13,8,5,10,3.6651767574,372.335311884,0.0358590172,0.0448717949,0.07575758,0,135,8.308751731456816E-5,2.2648917E-4,2.32378E-4,71,0.13947369,2,0,201,0,0,-0.06371611
38038939,Pjhwalsh,10,4306,472,434,8,181,45.7674224607,40-49,727,7,32,24,56,56,32,24,10,3.3181633482,4285.7603675994,0.3149505166,0.0762987013,0.27809387,0,135,3.1862088682472827E-4,8.304603E-4,8.5205265E-4,353,0.34190533,18,5,200,5,0.025,-0.06381146
627055000,DianeOrihel,10,488,195,330,5,8,53.4648848954,50-59,690,5,53,49,102,102,53,49,10,3.1588785047,44600.4451695515,0.1029766755,0.0201902543,0.09860859,0,135,5.145873075441259E-4,0.001358935,0.001394268,283,0.16251297,437,4,203,4,0.0197044335,-0.06390438
969591588,tjbtories,10,64,74,289,1,0,22.4432183721,20-29,232,3,16,28,44,44,16,28,11,3.4185290532,1943.3833565255,0.1068345209,0.1020084567,0.32512316,0,135,1.4664834798072E-4,4.2781286E-4,4.3893623E-4,353,0.38925803,13,10,83,6,0.0722891566,-0.06413487
134511670,d_joue,10,29654,1222,870,25,119,56.7879380013,50-59,786,8,12,9,21,21,12,9,9,3.6533929297,636.2007148455,0.0303899403,0.1047619048,0.275,0,135,9.293141483815619E-5,3.27151E-4,3.3565713E-4,267,0.3394737,8,0,201,0,0,-0.0644737
37597963,naomisayers00,10,25874,1727,1588,67,2295,53.6118871798,50-59,774,8,49,48,97,97,49,48,10,3.0499796831,28381.9315621092,0.2420230822,0.0299613402,0.12231638,0,135,4.526811064983569E-4,0.0012582731,0.0012651691,99,0.18685693,42,1,201,1,0.0049751244,-0.06454055
44316923,MylanTootoosis,10,837,740,248,18,304,46.4324292925,40-49,679,5,41,0,41,41,41,0,0,0,0,0.2154805052,0.1286585366,0.20792682,0,54,2.3757321685406662E-4,0.0010569495,0,99,0.27338436,4,0,199,0,0,-0.06545754
29620023,benrachinger,10,8896,396,437,6,1036,65.2467544068,60-69,695,8,3,2,5,5,3,2,11,4.2238927265,26.7630350312,0.0048328298,0.1,0.16666667,0,135,6.374519948202205E-5,1.00661855E-4,1.0327911E-4,99,0.23214285,24,0,201,0,0,-0.06547618
102716123,SLangeneggerCBC,10,10772,2706,753,105,4,62.5345799688,60-69,771,8,68,17,85,85,68,17,10,3.4380333198,16538.2983406519,0.1901079248,0.0518207283,0.122914836,0,135,6.754058163234933E-4,0.001736417,0.0017299252,257,0.1884058,186,51,201,51,0.2537313433,-0.065490964
22104519,zita_dulock,10,13711,1139,1760,44,634,51.0529620571,50-59,771,8,27,50,77,77,27,50,10,3.0958959772,9708.6524249877,0.2457732907,0.0526315789,0.1923077,0,135,1.6900869199498874E-4,7.0463296E-4,7.2295376E-4,353,0.25786746,31,0,201,0,0,-0.06555976
96909650,meganseason,10,2563,557,666,5,1104,63.7972092185,60-69,686,6,32,0,32,32,32,0,0,0,0,0.1596049444,0.0756048387,0.12096774,0,26,2.2038588899398221E-4,8.304603E-4,0,99,0.18660022,16,1,200,1,0.005,-0.06563248
17143599,prowomanprolife,10,2546,467,244,34,7,45.50993018,40-49,605,4,18,11,29,29,18,11,11,4.082486794,8765.3820536124,0.039533229,0.092364532,0.3105263,0,135,2.0583166501963974E-4,4.781438E-4,4.905758E-4,353,0.37651822,32,1,200,1,0.005,-0.06599192
268906600,Lizzsicle,10,361,20,131,0,6,19.5834285614,10-19,351,4,3,4,7,7,3,4,10,3.7114993905,3587.9234111298,0.0093690094,0.0476190476,0.25,0,135,6.836388666133253E-5,1.00661855E-4,1.0327911E-4,99,0.31617647,1,2,200,2,0.01,-0.06617647
15427232,CandiceKei,10,21778,981,1999,33,58,55.6915062537,50-59,690,6,22,27,49,49,22,27,10,3.6745225518,3013.4951775147,0.0606652051,0.068877551,0.23891129,0,135,1.356567573910933E-4,5.7880563E-4,5.938549E-4,353,0.30520266,30,5,200,5,0.025,-0.06629137
635074627,larouxb,10,2536,103,447,4,309,39.1951511605,30-39,636,5,2,4,6,6,2,4,9,3.5709061357,212.9023952325,0.0054686961,0.1,0.25,0,135,8.632082637205774E-5,7.549639E-5,7.7459335E-5,99,0.31650245,9,0,200,0,0,-0.06650245
16493164,Kaymee,10,124705,2601,896,129,6625,59.4414934513,50-59,889,10,67,32,99,99,67,32,9,3.2409589598,13570.9105096669,0.2816745505,0.0458668316,0.12699,0,135,3.6542239229355806E-4,0.0017112514,0.0017557449,99,0.19361702,152,0,202,0,0,-0.06662702
583550400,RyuIkan,10,4495,117,131,1,665,32.3734617273,30-39,631,6,2,4,6,6,2,4,10,3.8183665177,7.1975234546,0.0100858184,0.1333333333,0.5,0,135,5.199494790661027E-5,7.549639E-5,7.7459335E-5,257,0.56666666,2,2,200,2,0.01,-0.06666666
351012642,kls_73,10,10226,263,309,23,6,54.261132758,50-59,707,8,1,4,5,5,1,4,11,3.9357984559,54.3411359813,0.002567832,0,0,0,135,4.6606580470265185E-5,5.0330927E-5,5.1639556E-5,99,0.06666667,6,0,202,0,0,-0.06666667
1124513556,canuckfan16,10,550,28,149,0,0,36.7034554288,30-39,516,6,1,2,3,3,1,2,11,4.5363673304,2452,0.0021612129,0,0,0,135,4.891256269731482E-5,5.0330927E-5,5.1639556E-5,505,0.06666667,13,0,200,0,0,-0.06666667
51039730,Sandenn,10,3500,189,380,1,21,42.9589966254,40-49,730,7,10,13,23,23,10,13,9,3.3807395368,3411.4472276886,0.0308874826,0.0533596838,0.24725275,0,135,9.93241345633767E-5,2.768201E-4,2.8401756E-4,505,0.3140394,47,0,200,0,0,-0.06678665
498909753,JoanneDNLIB,10,1471,331,492,9,4,47.9641699016,40-49,677,5,16,21,37,37,16,21,10,3.5615603413,4687.6739827942,0.0340209226,0.0623123123,0.21333334,0,135,1.28900287475313E-4,4.2781286E-4,4.3893623E-4,343,0.2804878,28,0,199,0,0,-0.06715446
194641299,vandongene,10,24628,1149,1146,10,5368,46.4086240063,40-49,733,8,28,25,53,53,28,25,10,3.2897196262,7846.9364566931,0.2194403583,0.064586357,0.23781513,0,135,1.9612553353813577E-4,7.297984E-4,7.2295376E-4,353,0.3052729,50,7,200,6,0.03,-0.06745777
526919381,Anonchimp,10,28411,1778,950,57,5348,61.23087957,60-69,815,9,26,15,41,41,26,15,8,3.4420967087,7519.0716514382,0.0398930986,0.0420731707,0.16615385,0,135,2.1034982244699172E-4,6.794675E-4,6.97134E-4,99,0.23440285,134,0,201,0,0,-0.068249
291497597,Marchand_Phil,10,870,153,336,4,24,40.3414901881,40-49,556,5,10,10,20,20,10,10,10,3.6481105242,242.4758889873,0.0397140393,0.1526315789,0.5604396,0,135,1.1929223721677289E-4,2.768201E-4,2.8401756E-4,257,0.6287879,24,5,200,5,0.025,-0.0683483
490997129,YukonHulk,10,4891,611,535,15,489,50.5744160361,50-59,735,7,48,8,56,56,48,8,10,3.6111336855,15885.5153922252,0.2043958986,0.0548701299,0.11333334,0,135,2.9685458972985494E-4,0.0012331076,0.0012651691,99,0.1817988,75,1,201,1,0.0049751244,-0.06846546
40952193,hyperman514,10,12966,1045,1513,15,489,59.1805235196,50-59,777,8,13,21,34,34,13,21,9,3.279561154,2566.7052088566,0.0294728462,0.0659536542,0.22529644,0,135,1.2393416989118006E-4,3.5231648E-4,3.6147688E-4,267,0.29390243,4,0,200,0,0,-0.06860599
39532535,MichaelCeci,10,3709,950,613,46,1,45.729818124,40-49,698,6,20,12,32,32,20,12,10,3.6277935798,11325.6917634067,0.0468141427,0.0574596774,0.145,0,135,1.3955051456690236E-4,5.2847475E-4,5.4221536E-4,353,0.21370968,37,0,200,0,0,-0.06870968
207800925,clarevsa,10,3702,333,751,10,9,45.0844024641,40-49,667,6,31,46,77,77,31,46,10,3.2169849655,9919.682010716,0.1434371085,0.0543403964,0.20952821,0,135,1.5995563574211873E-4,8.0529484E-4,8.262329E-4,353,0.27929986,40,1,200,1,0.005,-0.06977165
599375374,Oldunionist,10,1832,75,237,0,25,36.6022342711,30-39,533,6,8,14,22,22,8,14,10,3.293783015,1806.7550178291,0.0265875452,0.0584415584,0.24175824,0,135,8.111372763705442E-5,2.2648917E-4,2.32378E-4,257,0.31155303,4,0,200,0,0,-0.06979479
421369568,ShannanLittle,10,63,22,25,0,10,45.1449515977,40-49,566,4,15,11,26,26,15,11,10,3.548557497,3168.6754694359,0.0511469106,0.0369230769,0.12091503,0,135,1.0713447083249241E-4,4.0264742E-4,4.1311645E-4,257,0.19076923,82,1,205,1,0.0048780488,-0.0698542
365561959,ajeshilling,10,2114,227,541,5,361,43.0980920045,40-49,636,6,8,15,23,23,8,15,10,3.2271434376,1238.7465966529,0.0683161991,0.0691699605,0.1875,0,135,1.2107774922460421E-4,2.2648917E-4,2.32378E-4,99,0.25738916,2,0,200,0,0,-0.06988916
377540405,Jamiastar,10,51197,1456,955,59,8513,48.3814001937,40-49,773,9,17,17,34,34,17,17,9,3.247460382,12710.0929910384,0.0528882703,0.0258467023,0.09090909,0,135,1.4350344288438898E-4,4.5297833E-4,4.64756E-4,303,0.16096866,24,0,201,0,0,-0.07005957
15612072,gregsdouglas,10,4813,981,1263,17,6,59.1302450661,50-59,669,6,24,40,64,64,24,40,10,3.0511986997,8540.0962362771,0.2327673471,0.0572916667,0.23109756,0,135,1.719621231011968E-4,6.291366E-4,6.4549444E-4,353,0.3016063,10,0,200,0,0,-0.07050874
132171287,midgelambert,10,3677,550,592,14,15,46.1223672723,40-49,709,6,34,41,75,75,34,41,10,3.0698902885,16686.5765119841,0.2308151834,0.0331531532,0.14154589,0,135,2.2456685835670238E-4,8.807912E-4,8.7787246E-4,353,0.21228771,29,4,199,4,0.0201005025,-0.07074182
207612347,StrategicThghts,10,22397,2593,513,109,1,56.7178954362,50-59,796,8,112,16,128,128,112,16,10,3.4238114588,24671.947266515,0.2772437525,0.0306348425,0.055814315,0,135,7.069973874780995E-4,0.0028436973,0.0028659953,71,0.12686674,252,0,202,0,0,-0.071052425
354743403,M_Almaleki,10,2883,85,155,1,1229,39.2892602452,30-39,655,5,1,3,4,4,1,3,10,3.7891101178,33.0105433998,0.0044446574,0.0833333333,0.33333334,0,135,4.640878291292658E-5,5.0330927E-5,5.1639556E-5,505,0.4047619,4,1,199,1,0.0050251256,-0.07142856
253086457,TOTigerLilly,10,18405,1220,1999,34,1052,46.0400669655,40-49,753,8,19,24,43,43,19,24,10,3.1869158879,2487.0494755465,0.1447000908,0.0658914729,0.30833334,0,135,1.7856488744853594E-4,5.0330925E-4,5.1639555E-4,99,0.3805121,13,0,201,0,0,-0.07217876
898819561,AdrienneLKing,10,313,125,132,2,5,42.8892144335,40-49,553,4,13,11,24,24,13,11,10,3.5607476636,1099.3667191021,0.1026485894,0.0887681159,0.4010989,0,135,1.4863945004064285E-4,3.5231648E-4,3.6147688E-4,257,0.47368422,33,0,200,0,0,-0.07258532
473689699,Anonymiss_News,10,30129,13420,110,180,44,48.4757142726,40-49,891,8,14,1,15,15,14,1,1,1,126.9000708085,0.0397565222,0.1047619048,0.16483517,0,23,8.776906856735587E-4,3.7748195E-4,3.6147688E-4,99,0.2375,22,0,201,0,0,-0.07266483
442249363,god_sucks,10,19245,3552,450,106,228,48.2521802749,40-49,865,9,13,4,17,17,13,4,10,4.1023973994,12347.9014964258,0.0116746457,0.0220588235,0.06410257,0,135,2.0365963263390942E-4,3.5231648E-4,3.0983734E-4,99,0.1368421,62,0,201,0,0,-0.07273953
11698322,hjarche,10,28660,7729,874,862,3939,,,839,8,9,4,13,13,9,4,9,3.8114587566,3847.3727355243,0.0098830869,0.0128205128,0.055555556,0,135,1.4803219189020474E-4,2.5165462E-4,2.5819778E-4,267,0.12857144,29,0,201,0,0,-0.073015884
373670338,SunDancePiper,10,9633,555,350,22,490,51.0884265746,50-59,736,7,7,8,15,15,7,8,9,3.5392117026,5146.0100135101,0.0243146373,0.0333333333,0.23214285,0,135,1.2063735729186531E-4,2.0132371E-4,2.0655822E-4,99,0.30555555,7,0,201,0,0,-0.0734127
312660421,OSConservatives,10,584,357,1127,8,1,45.55281812,40-49,623,4,53,79,132,132,53,79,10,2.9715562779,43898.5273022611,0.3431965154,0.0412907703,0.12482469,0,135,3.2116198269494987E-4,0.001358935,0.001394268,353,0.19831294,88,0,200,0,0,-0.07348825
176614741,mrklvngstn,10,245,135,249,3,3,40.0923645773,40-49,574,4,7,8,15,15,7,8,10,3.8919138562,1295.5826368431,0.0106817944,0.0571428571,0.25,0,135,7.579474893230007E-5,2.0132371E-4,2.0655822E-4,505,0.32352942,12,2,197,2,0.0101522843,-0.07352942
600348686,JosephDubonnet,10,463,126,365,1,6,43.1204781997,40-49,526,4,5,11,16,16,5,11,10,3.5347419748,1517.7812014302,0.016105643,0.0583333333,0.2,0,135,7.638895017153032E-5,1.5099278E-4,1.5491867E-4,257,0.27380952,23,0,200,0,0,-0.07380952
95672811,noleftandright,10,4396,409,571,19,115,42.1716401996,40-49,683,6,13,17,30,30,13,17,10,3.4181227143,1596.4658957873,0.0796306457,0.0724137931,0.18379447,0,135,1.842472607573073E-4,3.5231648E-4,3.6147688E-4,353,0.25762713,14,1,200,1,0.005,-0.07383266
266986977,Myles_Courchene,10,1628,102,250,0,16,39.2121863404,30-39,568,5,2,8,10,10,2,8,10,3.7188134905,52.6033416467,0.0066778573,0.0888888889,0.17857143,0,135,5.962207522202629E-5,7.549639E-5,7.7459335E-5,99,0.25274727,4,0,200,0,0,-0.07417584
18999763,CBCCommunity,10,20965,7030,1388,417,92,62.3915199555,60-69,786,8,82,16,98,98,82,16,9,3.2669646485,53713.3585373315,0.1861412903,0.0068377867,0.012605042,0,135,5.422576164190153E-4,0.0020887335,0.0020139427,71,0.08694097,38,0,200,0,0,-0.074335928
90179903,clclyne,10,259,84,329,8,148,43.9701400343,40-49,517,4,2,7,9,9,2,7,10,3.6680211296,164.9760002853,0.0084209607,0.0972222222,0.21428572,0,135,5.346314274193987E-5,7.549639E-5,7.7459335E-5,99,0.2888889,4,0,200,0,0,-0.07460318
373244712,chris_gallaway,10,396,235,303,3,120,42.1350040108,40-49,568,4,23,25,48,48,23,25,10,3.3807395368,2322.4658663502,0.0934342955,0.0616134752,0.27463055,0,135,1.6044063453459783E-4,6.0397113E-4,6.196747E-4,257,0.34927535,22,3,200,3,0.015,-0.0746448
113243765,chrisjmcclure,10,11254,738,739,35,26,50.8786239674,50-59,729,7,21,25,46,46,21,25,9,3.0711093052,8637.4043980446,0.1314217981,0.0371980676,0.21,0,135,2.0379000558218003E-4,5.536402E-4,5.680351E-4,353,0.28469944,24,0,206,0,0,-0.07469944
533253197,ThatsSOReilly,10,1471,260,318,3,149,51.8985070825,50-59,610,6,8,10,18,18,8,10,10,3.5794392523,14541.5329565764,0.0155157161,0.0163398693,0.1,0,135,1.1234394768747632E-4,2.2648917E-4,2.32378E-4,283,0.175,2,0,201,0,0,-0.075
128712259,idesofjulius,10,32512,666,1345,8,2106,65.2214274689,60-69,774,9,17,23,40,40,17,23,10,3.4006501422,3362.8331328083,0.1247934735,0.0621794872,0.25,0,135,1.6015136373942953E-4,4.5297833E-4,4.64756E-4,353,0.32520324,96,0,203,0,0,-0.07520324
61011254,ToryLineDuJour,10,4692,530,1708,13,1,43.5391600432,40-49,679,6,32,54,86,86,32,54,10,3.0016253555,22575.373308647,0.2974519911,0.0558139535,0.14201054,0,135,2.3901872046424314E-4,8.304603E-4,8.5205265E-4,353,0.2172471,11,0,200,0,0,-0.07523656
163298152,JJVenky,10,5537,138,357,6,332,49.8540675257,40-49,695,7,19,14,33,33,19,14,10,3.5932547745,5551.1209971805,0.0362771736,0.0662878788,0.22463769,0,135,1.9491894540595616E-4,5.0330925E-4,5.1639555E-4,283,0.3,47,0,200,0,0,-0.07536231
217583369,CommieZombies,10,4191,437,618,13,52,45.54653021,40-49,731,6,21,29,50,50,21,29,9,3.0365704998,20874.8334685142,0.1671862197,0.0240816327,0.08645276,0,135,1.3582603322648276E-4,5.536402E-4,5.4221536E-4,353,0.16219158,56,0,200,0,0,-0.07573882
243225102,UFCW401,10,765,269,184,3,0,46.7080863238,40-49,596,5,24,21,45,45,24,21,10,3.4510361642,5182.6903315886,0.0957181,0.0580808081,0.15462185,0,135,1.8909147420313277E-4,6.291366E-4,6.4549444E-4,257,0.23095737,37,10,203,10,0.0492610837,-0.07633552
772919785,myfriendbatman,10,1284,213,219,4,129,40.9689402816,40-49,569,5,23,26,49,49,23,26,10,3.1641609102,2370.6445992656,0.1295948139,0.0331632653,0.20615384,0,135,1.6132709661855775E-4,6.0397113E-4,6.196747E-4,99,0.28294572,11,0,200,0,0,-0.07679188
21269439,pattyk13,10,2422,124,276,1,269,45.9015309836,40-49,647,6,11,20,31,31,11,20,10,3.4055262089,995.0915294606,0.071238875,0.0731182796,0.23160173,0,135,1.0494828785367013E-4,3.0198556E-4,3.0983734E-4,99,0.30840337,20,0,200,0,0,-0.07680164
277316485,KHildebrand78,10,533,113,264,6,2,43.2946289585,40-49,624,5,5,8,13,13,5,8,10,3.4754164974,1308.6186636042,0.0050197748,0.0320512821,0.14285715,0,135,7.669425236128342E-5,1.5099278E-4,1.5491867E-4,257,0.21978022,15,0,200,0,0,-0.07692307
415086565,SHNaWz,10,646,235,254,0,277,22.3464977002,20-29,530,5,4,5,9,9,4,5,10,3.5119869972,222.7174833641,0.0259692921,0.0416666667,0.25,0,135,8.063481726032703E-5,1.2582731E-4,1.2909889E-4,257,0.32692307,3,0,199,0,0,-0.07692307
951406202,ILOVEMELSMYTH,10,3247,208,2001,0,1,29.9187103221,20-29,605,6,2,4,6,6,2,4,10,3.5794392523,2741.2696638015,0.0146258392,0.1,0.33333334,0,135,5.10507863272777E-5,7.549639E-5,7.7459335E-5,71,0.41025642,18,0,200,0,0,-0.07692308
552642409,hurtucarl,10,1023,531,1172,5,45,43.3618076445,40-49,629,5,8,20,28,28,8,20,9,3.2665583096,9106.9311453503,0.0307891364,0.0502645503,0.13947369,0,135,8.68083190138169E-5,2.2648917E-4,2.32378E-4,267,0.21666667,5,0,200,0,0,-0.07719298
20644763,YoSammiSam,10,16507,1401,227,26,471,54.2164874903,50-59,782,8,16,7,23,23,16,7,9,3.6448598131,397.5397221912,0.0383420527,0.1027667984,0.38333333,0,135,1.2903463993322987E-4,4.2781286E-4,4.3893623E-4,99,0.46052632,52,0,202,0,0,-0.07719299
42376010,siksaapo,10,3870,579,1474,10,139,43.9139622137,40-49,618,6,60,98,158,158,60,98,9,2.7744819179,29963.2593109798,0.3592658313,0.0357171652,0.14020202,0,135,3.3558396250107524E-4,0.0015350933,0.0015750064,99,0.21755679,10,0,197,0,0,-0.07735477
602446013,marshall_rita,10,2290,222,461,2,297,47.1373017678,40-49,624,6,25,36,61,61,25,36,10,3.1560341325,6077.2315213762,0.1415283147,0.0404371585,0.15860598,0,135,2.0264290481754197E-4,6.54302E-4,6.7131425E-4,99,0.23596826,49,0,193,0,0,-0.07736228
275815874,LiseFrigault,10,558,85,106,1,1,40.7741789977,40-49,579,4,10,11,21,21,10,11,10,3.5822836245,2798.5178896445,0.0531653778,0.0976190476,0.24285714,0,135,1.0260150986162493E-4,2.768201E-4,2.8401756E-4,99,0.32034633,13,0,200,0,0,-0.07748919
298619156,SeerLen,10,15808,1235,1999,24,3437,41.7005984525,40-49,743,7,10,17,27,27,10,17,8,3.5416497359,2453.2461177123,0.0199726873,0.0598290598,0.2720588,0,135,1.11884881460391E-4,2.768201E-4,2.8401756E-4,99,0.34980237,16,0,201,0,0,-0.07774357
14721346,TimGoos,10,6128,720,941,50,25,53.8160121371,50-59,673,7,10,10,20,20,10,10,10,3.5136123527,881.997589361,0.049153151,0.0289473684,0.1590909,0,135,1.1555027895969922E-4,2.768201E-4,2.8401756E-4,353,0.23692308,3,0,197,0,0,-0.07783218
83748727,FaithGoldy,10,12450,1398,724,29,4,65.0085594158,60-69,761,7,79,25,104,104,79,25,10,3.3693620479,32952.4036202451,0.467327339,0.039021658,0.10079342,0,135,6.70843595722529E-4,0.002013237,0.0020655822,353,0.17864923,195,0,201,0,0,-0.07785581
256215901,Colton_Ness,10,4299,421,1026,5,305,44.6177432265,40-49,688,6,20,30,50,50,20,30,10,3.3023161317,3691.2121542933,0.2014786358,0.0783673469,0.22672673,0,135,1.6773928019129034E-4,5.2847475E-4,5.4221536E-4,353,0.30473113,6,4,200,4,0.02,-0.0780044
46919079,Terrilltf,10,22557,1715,1983,55,1672,58.0165139168,50-59,755,9,86,88,174,174,86,88,8,2.7631044291,67305.9272786696,0.4529455053,0.0286027506,0.15319149,0,135,4.8050832980785544E-4,0.0021893953,0.0022463207,99,0.23125827,87,0,223,0,0,-0.07806678
91158266,snowlions,10,37921,9897,10007,111,2,47.077183073,40-49,804,9,30,31,61,61,30,31,9,3.1369362048,29350.8677418917,0.0893864668,0.0144808743,0.10537634,0,135,2.2587638839713823E-4,7.8012934E-4,8.0041314E-4,99,0.18350755,51,0,201,0,0,-0.07813121
17479221,thekatieyak,10,5580,228,880,9,33,37.3941648025,30-39,636,6,8,10,18,18,8,10,9,3.4774481918,838.1867551526,0.0259622279,0.0588235294,0.34444445,0,135,8.94259671279317E-5,2.2648917E-4,2.32378E-4,257,0.4227941,0,0,201,0,0,-0.07834965
26037015,Koldkanuck,10,464,25,81,1,4,34.3940274568,30-39,504,5,4,4,8,8,4,4,10,3.7350670459,2498.3956447239,0.0300768631,0.0357142857,0.1,0,135,5.528929720467299E-5,1.2582731E-4,1.2909889E-4,353,0.17857143,62,1,197,1,0.0050761421,-0.07857143
462505887,NiagaraLabour,10,216,82,81,2,0,30.9504501637,30-39,408,4,8,3,11,11,8,3,11,4.3218203982,167.6691523197,0.0124807891,0.1090909091,0.25,0,135,9.191236164256597E-5,2.2648917E-4,2.32378E-4,257,0.32857144,16,1,200,1,0.005,-0.07857144
153225560,novascotiarasta,10,91767,1308,352,70,6218,58.394095341,50-59,865,10,19,8,27,27,19,8,10,3.7342543681,5240.5966877964,0.0457576726,0.0256410256,0.09064327,0,135,1.4029473298220736E-4,5.0330925E-4,4.905758E-4,343,0.16935484,54,0,201,0,0,-0.07871157
24836413,RichTweets,10,1369,929,937,25,14,65.2384458226,60-69,694,5,34,32,66,66,34,32,10,3.3246647704,10578.1847023684,0.0910369712,0.0370629371,0.13763066,0,135,2.5426024345840873E-4,8.807912E-4,8.7787246E-4,71,0.2164557,28,2,200,2,0.01,-0.07882504
193154698,dollhouseyyc,10,13500,1265,496,49,35,41.5209498994,40-49,775,8,44,24,68,68,44,24,10,3.3831775701,9929.7751035153,0.1753469533,0.0419227392,0.12411348,0,135,3.8985719150866344E-4,0.0011324459,0.00116189,353,0.20321931,59,1,200,1,0.005,-0.07910583
855136358,TeamJPJT,10,2662,1383,611,16,0,55.8697921457,50-59,708,6,111,35,146,146,111,35,9,3.0369768387,106558.742773985,0.2286502407,0.0168634861,0.041561313,0,135,8.133576263667933E-4,0.0028185318,0.0027368965,505,0.12133995,337,0,200,0,0,-0.079778637
96889124,SteveDesroches,10,2245,1666,264,88,4,52.8192923687,50-59,724,6,14,1,15,15,14,1,11,4.472978464,2851.8743206477,0.0280513818,0.0333333333,0.07692308,0,135,1.1316185739020715E-4,3.7748195E-4,3.8729666E-4,353,0.15686275,15,0,200,0,0,-0.07993967
460413702,SarahAndrews22,10,229,31,95,0,2,16.1096378685,10-19,210,4,5,8,13,13,5,8,10,3.8155221455,18.9133155007,0.0130427976,0.141025641,0.5277778,0,135,8.478287908623472E-5,1.5099278E-4,1.5491867E-4,257,0.60784316,2,7,200,6,0.03,-0.08006536
42553151,TaniaCameron,10,3449,665,404,30,86,52.2068437526,50-59,725,6,65,31,96,96,65,31,9,3.1227143438,27526.280014925,0.3080235133,0.0393640351,0.11977834,0,135,4.866936181104308E-4,0.0016609206,0.0017041053,99,0.19992997,77,0,199,0,0,-0.08015163
15726720,BoardofTrade,10,5332,9545,2428,397,7,57.8778005813,50-59,769,7,50,15,65,65,50,15,10,3.3628606258,19798.7313698883,0.1759690369,0.0399038462,0.088171266,0,135,4.1020732563500024E-4,0.0012834386,0.0012651691,71,0.16859649,91,0,200,0,0,-0.080425224
122067786,WestSideTory,10,4255,473,467,21,77,37.5898263523,30-39,648,6,21,15,36,36,21,15,10,3.5696871191,2996.4748906779,0.0997894199,0.0738095238,0.17063493,0,135,1.584739300973663E-4,5.536402E-4,5.680351E-4,353,0.2513843,3,10,200,10,0.05,-0.08074937
541252471,AndreaLoken,10,7970,453,177,14,275,40.5290533606,40-49,738,7,41,12,53,53,41,12,10,3.7082486794,15222.3208859448,0.0919030108,0.0330188679,0.069767445,0,135,3.041695134936156E-4,0.0010569495,0.0010844307,257,0.15058275,110,1,202,1,0.004950495,-0.080815305
308062165,LukaszukMLA,10,6137,4665,1193,111,203,61.2508345916,60-69,787,7,81,9,90,90,81,9,11,3.9215765949,8372.3859036471,0.379325839,0.0424469413,0.07964469,0,135,6.618085802544867E-4,0.002063568,0.001988123,353,0.16071963,278,1,201,1,0.0049751244,-0.08107494
258549215,sjaroszuk,10,2523,477,943,13,41,55.0438518436,50-59,673,6,32,44,76,76,32,44,10,3.1036164161,8931.2206665473,0.2921830831,0.0431578947,0.1813136,0,135,2.5708595323649554E-4,8.304603E-4,8.5205265E-4,353,0.26252574,18,1,201,1,0.0049751244,-0.08121214
851819298,JamesSanyshyn,10,655,231,998,1,51,43.5240724488,40-49,555,5,13,23,36,36,13,23,9,3.3039414872,2374.5273503841,0.0381338845,0.0682539683,0.24456522,0,135,9.805973222935177E-5,3.5231648E-4,3.6147688E-4,71,0.32610545,13,1,200,1,0.005,-0.08154023
719442583,edahelp1,10,38,43,220,0,2,18.0536410551,10-19,275,2,5,22,27,27,5,22,11,3.5546525803,670.025878568,0.0319395347,0.1894586895,0.38311687,0,135,7.022518570248374E-5,1.5099278E-4,1.5491867E-4,353,0.46470588,15,0,44,0,0,-0.08158901
43803995,thisisshelby1,10,7552,865,1631,12,4680,53.6421657828,50-59,703,7,17,26,43,43,17,26,9,3.2917513206,4909.2450846582,0.0438814756,0.0326688815,0.13675214,0,135,1.402591819808127E-4,4.5297833E-4,4.64756E-4,99,0.21875,22,0,202,0,0,-0.08199786
15142813,BFSingh,10,11289,1904,989,118,42,64.337621702,60-69,749,7,29,17,46,46,29,17,10,3.3998374644,8892.2005374724,0.1093971598,0.0333333333,0.11827957,0,135,3.1610844525774257E-4,7.549639E-4,7.745933E-4,353,0.20065312,19,0,200,0,0,-0.08237355
29480932,powers_rhonda,10,3794,242,694,4,247,42.8688006463,40-49,575,7,24,32,56,56,24,32,10,3.1572531491,4322.1853283759,0.1298569795,0.0525974026,0.18243243,0,135,1.5999430170404098E-4,6.291366E-4,6.4549444E-4,99,0.26489028,5,0,205,0,0,-0.08245785
131986093,bradrichert,10,5802,747,1190,38,62,55.110978716,50-59,696,7,16,19,35,35,16,19,9,3.1621292158,12052.4335452,0.0563848302,0.0302521008,0.13571429,0,135,1.1601465882937168E-4,4.2781286E-4,4.3893623E-4,71,0.21875,22,0,200,0,0,-0.08303571
242846644,Cherylstad,10,711,225,117,12,2,43.3844433517,40-49,562,5,22,12,34,34,22,12,10,3.6347013409,3739.2672595182,0.068996072,0.0481283422,0.18398269,0,135,1.8847958729077867E-4,5.7880563E-4,5.938549E-4,257,0.26726726,18,3,200,3,0.015,-0.08328457
36711954,longpre11,10,11693,315,165,33,20,46.1876885392,40-49,699,7,2,1,3,3,2,1,10,4.7537586347,24.6608493726,0.0011949707,0.1666666667,0.5,0,135,5.445612889716313E-5,7.549639E-5,7.7459335E-5,257,0.5833333,6,0,200,0,0,-0.0833333
317228299,podBROski,10,7802,180,399,4,159,32.7073999628,30-39,686,7,3,4,7,7,3,4,11,3.7224705404,4.8440281369,0.0674062173,0.0714285714,0.5,0,135,6.460405843050285E-5,1.00661855E-4,1.0327911E-4,353,0.5833333,8,0,200,0,0,-0.0833333
16496346,Aotearoanz,10,22555,2139,1843,43,3410,53.1520950928,50-59,732,8,3,3,6,6,3,3,10,3.7379114181,35.8234141797,0.012179452,0.0333333333,0.33333334,0,135,5.639387130805373E-5,1.00661855E-4,1.0327911E-4,99,0.41666666,8,0,201,0,0,-0.08333332
217164328,Ilango74,10,472,111,409,3,3,41.8713242603,40-49,559,4,0,3,3,3,0,3,11,4.3675873274,0,0,0.1666666667,0.33333334,0,567,4.4780486537007367E-5,0,2.5819778E-5,257,0.41666666,0,0,200,0,0,-0.08333332
287905776,BlaineBadiuk,10,1019,79,162,0,16,29.7301391003,20-29,488,5,3,3,6,6,3,3,10,3.878098334,35.7308611625,0.0143268034,0.0333333333,0.16666667,0,135,6.650810170827457E-5,1.00661855E-4,1.0327911E-4,257,0.25,1,2,200,2,0.01,-0.08333333
420318827,DavidCarter52,10,731,292,627,25,0,45.3880224182,40-49,560,4,1,3,4,4,1,3,9,4.1629418935,142.908561101,0.0017567223,0.0833333333,0.16666667,0,135,5.69906247607208E-5,5.0330927E-5,5.1639556E-5,283,0.25,0,1,200,1,0.005,-0.08333333
944264166,Transition_LDN,10,702,212,497,5,0,41.0878988158,40-49,474,5,3,4,7,7,3,4,10,3.6420154409,3017.0135805827,0.005427155,0.0238095238,0.16666667,0,135,7.501753596862371E-5,1.00661855E-4,1.0327911E-4,257,0.25,5,0,200,0,0,-0.08333333
272290840,scott_robb,10,25964,241,321,5,4,40.545306923,40-49,763,9,4,1,5,5,4,1,10,4.0154408777,18.2859167152,0.012344377,0.05,0.16666667,0,135,7.24215476242334E-5,1.2582731E-4,1.2909889E-4,99,0.25,4,0,203,0,0,-0.08333333
353631941,Rob_de_Verteuil,10,261,93,217,6,0,40.0923042932,40-49,468,3,3,2,5,5,3,2,11,4.3466070703,72.634249303,0.003457789,0.1,0.15,0,135,5.208482840238935E-5,1.00661855E-4,1.0327911E-4,353,0.23333333,6,1,200,1,0.005,-0.08333333
1304328403,DavidMacNam,10,3,0,31,0,0,10,10-19,10,0,0,3,3,3,0,3,11,4.3399675061,0,0,0.1666666667,0.16666667,0,761,4.4780486537007367E-5,0,2.5819778E-5,257,0.25,0,0,3,0,0,-0.08333333
21422925,newcybersol,10,5545,181,581,4,9,47.2632375952,40-49,676,7,2,4,6,6,2,4,11,3.7066233239,2670.7106104275,0.0049491249,0.0666666667,0.16666667,0,135,6.490196350534426E-5,7.549639E-5,7.7459335E-5,353,0.25,12,0,199,0,0,-0.08333333
1191666822,dexterpbj,10,276,118,396,0,113,45.5039750184,40-49,597,4,1,2,3,3,1,2,11,4.2568061764,90.5549820704,7.573563798275226E-4,0,0,0,135,5.024690254223004E-5,5.0330927E-5,5.1639556E-5,343,0.083333336,4,0,200,0,0,-0.083333336
474510878,westcoastlegion,10,3232,1157,830,16,1505,54.4610881257,50-59,757,7,25,18,43,43,25,18,8,3.3705810646,4657.5754425482,0.0566017412,0.0503875969,0.21692307,0,135,2.060564962512706E-4,6.54302E-4,6.7131425E-4,99,0.3002699,42,0,198,0,0,-0.08334683
133425731,ru4peace2,10,18216,912,1473,18,411,60.4541773948,60-69,752,8,18,5,23,23,18,5,10,3.5713124746,2342.970576651,0.0430063667,0.0513833992,0.13157895,0,135,1.5140913876864848E-4,4.781438E-4,4.905758E-4,99,0.21494253,46,0,201,0,0,-0.08336358
14388426,bebeasley,10,18099,530,443,17,22,49.3392989202,40-49,752,7,24,13,37,37,24,13,10,3.7037789516,1226.3307252908,0.1149317034,0.0743243243,0.19973545,0,135,2.3285746284112493E-4,6.291366E-4,6.4549444E-4,353,0.28350168,31,0,200,0,0,-0.08376623
199030841,_KelseyIngram,10,1009,435,818,23,2,41.7665715789,40-49,592,5,6,7,13,13,6,7,10,3.6387647298,211.8178964927,0.0245222793,0.0769230769,0.3392857,0,135,1.0690691030954398E-4,1.7615824E-4,1.8073844E-4,505,0.4231307,1,1,198,1,0.0050505051,-0.083845
169670184,rk70534,10,33932,671,2002,26,41,57.3380450313,50-59,735,9,13,17,30,30,13,17,9,3.2344575376,2544.6199854665,0.0746819837,0.0402298851,0.22794117,0,135,1.0703296631379449E-4,3.5231648E-4,3.6147688E-4,99,0.31196582,1,0,201,0,0,-0.08402465
38744285,Phumbling,10,881,54,130,1,9,40.0028764067,40-49,536,4,6,7,13,13,6,7,10,3.6529865908,363.9531276013,0.012819086,0.0320512821,0.11111111,0,135,6.347820736001115E-5,1.7615824E-4,1.8073844E-4,257,0.1952381,20,1,200,1,0.005,-0.08412699
568394674,IanDBruce,10,459,229,262,12,7,46.7744950357,40-49,610,5,7,9,16,16,7,9,9,3.5965054856,875.6023301689,0.02071191,0.0625,0.25555557,0,135,9.251868047126206E-5,2.0132371E-4,2.0655822E-4,71,0.33982685,10,0,200,0,0,-0.08427128
282277983,newbetweeter,10,5110,209,221,2,446,45.9131417739,40-49,714,7,25,15,40,40,25,15,10,3.2527427875,3513.504044519,0.1636041029,0.0602564103,0.22507122,0,135,2.12316817844191E-4,6.54302E-4,6.7131425E-4,99,0.30941176,73,0,201,0,0,-0.08434054
16425076,notsteveharper,10,6686,1052,2000,23,141,46.2028469115,40-49,697,7,23,41,64,64,23,41,9,2.9622104835,18505.9413961159,0.1572231572,0.0233134921,0.09390244,0,135,2.586412354068558E-4,6.0397113E-4,6.196747E-4,353,0.17851347,143,0,200,0,0,-0.08461103
216311666,small_affair,10,30840,1889,1628,81,2917,55.07160663,50-59,791,9,14,14,28,28,14,14,9,3.5298659082,5489.2582822128,0.0472982198,0.0608465608,0.25490198,0,135,1.2916446577156961E-4,3.7748195E-4,3.8729666E-4,99,0.34,41,0,201,0,0,-0.08509802
383973753,ColinScott_NL,10,832,106,315,0,171,40.1219570139,40-49,572,5,5,6,11,11,5,6,10,3.6924014628,645.0932037483,0.0109118729,0.0909090909,0.30357143,0,135,6.106847836423386E-5,1.5099278E-4,1.5491867E-4,343,0.3888889,14,0,200,0,0,-0.08531747
68274372,jimfreeman301,10,2814,143,252,1,10,43.7301611528,40-49,573,6,25,32,57,57,25,32,10,3.0910199106,11561.8033452662,0.0800052498,0.0313283208,0.14488636,0,135,1.417547405408201E-4,6.54302E-4,6.7131425E-4,257,0.23043478,13,1,201,1,0.0049751244,-0.08554842
105391738,ppilarski,10,12917,1425,1131,36,5,50.0609394808,50-59,779,8,54,35,89,89,54,35,10,3.3559528647,14581.8075580908,0.3646343793,0.0508171604,0.15494448,0,135,4.920528901957132E-4,0.0013841004,0.001394268,353,0.24124566,63,1,200,1,0.005,-0.08630118
1237059938,TeamRevoltNow,10,3089,104,71,2,4,46.1539633465,40-49,610,9,29,15,44,44,29,15,9,3.3128809427,4316.6817272501,0.1121769577,0.0237843552,0.0827957,0,135,1.5588127771434208E-4,7.549639E-4,7.745933E-4,99,0.16923077,5,0,238,0,0,-0.08643507
30584980,JimWaterloo,10,2711,168,119,8,3,29.8882083,20-29,592,6,7,5,12,12,7,5,10,3.7529459569,226.1247769818,0.0186536861,0.0984848485,0.375,0,135,7.207115986842256E-5,2.0132371E-4,2.0655822E-4,257,0.46153846,1,1,199,1,0.0050251256,-0.08653846
25760258,PerryMarleau,10,5222,394,671,4,15,46.7672442143,40-49,682,7,7,15,22,22,7,15,10,3.4880130028,3863.5099689692,0.056038192,0.038961039,0.12857144,0,135,7.361479558582417E-5,2.0132371E-4,2.0655822E-4,353,0.21538462,19,1,204,1,0.0049019608,-0.08681318
887037044,4oclockwhistle,10,1200,607,1999,10,89,44.3203449599,40-49,613,6,13,30,43,43,13,30,9,3.1535960991,4803.7576106514,0.03122747,0.0420819491,0.14193548,0,135,1.1294528582276123E-4,3.5231648E-4,3.6147688E-4,343,0.22891866,9,0,200,0,0,-0.08698318
132264502,sarah_harmer,10,1515,9231,69,393,3,80.2343221101,80-89,766,5,91,0,91,91,91,0,0,0,0,0.1981883901,0.0156288156,0.023809524,0,47,8.136101294553814E-4,0.0023152225,0,257,0.11080268,45,0,200,0,0,-0.086993156
100033160,NewWestBC,10,22146,5025,5527,126,0,44.2758857475,40-49,681,9,17,33,50,50,17,33,10,3.3791141812,16489.7552081556,0.1031755017,0.0502040816,0.09460888,0,135,1.9317019153022839E-4,4.5297833E-4,4.64756E-4,353,0.18181819,2,0,201,0,0,-0.08720931
137778787,matt_bowes,10,8022,590,999,19,36,56.2439894285,50-59,742,7,9,16,25,25,9,16,10,3.3494514425,1990.9658073644,0.0294414784,0.0283333333,0.1125,0,135,8.74258549639821E-5,2.5165462E-4,2.5819778E-4,353,0.2,1,0,200,0,0,-0.0875
36126551,RyanHastman,10,8932,1988,420,106,0,62.0542008762,60-69,757,7,62,20,82,82,62,20,10,3.5392117026,4810.8083834256,0.440701744,0.0624811804,0.16845877,0,135,6.592449165351668E-4,0.0015854242,0.001626646,353,0.2560488,41,1,200,1,0.005,-0.08759003
93006802,luckhardtjason,10,5714,98,121,0,25,18.7021484552,10-19,625,7,3,1,4,4,3,1,11,4.1430312881,4.1927093224,0.0079645111,0.0833333333,0.33333334,0,135,8.518037585736659E-5,1.00661855E-4,1.0327911E-4,71,0.42094862,0,0,200,0,0,-0.08761528
258497039,MND1980,10,5753,338,919,7,88,47.4517234414,40-49,700,7,3,7,10,10,3,7,9,3.6672084518,58.863277479,0.0081569615,0.1222222222,0.4047619,0,135,7.179079800180834E-5,1.00661855E-4,1.0327911E-4,267,0.49242425,2,0,201,0,0,-0.08766235
821734045,good_robyn,10,704,27,67,1,10,43.1666477596,40-49,615,6,5,14,19,19,5,14,10,3.5526208858,4964.2439901872,0.0467073434,0.1169590643,0.36813188,0,135,1.0113117151654499E-4,1.5099278E-4,1.5491867E-4,353,0.45614034,59,5,238,5,0.0210084034,-0.08800846
843843476,JimHillyerMP,10,178,139,167,9,0,45.503705427,40-49,555,3,6,9,15,15,6,9,11,4.1438439659,203.8511968482,0.0128610058,0.2619047619,0.33333334,0,135,2.02646657152352E-4,1.7615824E-4,1.8073844E-4,353,0.42137095,50,9,198,9,0.0454545455,-0.08803761
386347049,aVr16,10,424,30,127,0,344,17.5328980088,10-19,288,4,1,5,6,6,1,5,10,3.8667208452,71.8809202653,0.0068719943,0.1,0.15,0,135,5.177301233429324E-5,5.0330927E-5,5.1639556E-5,283,0.23809524,0,0,200,0,0,-0.08809524
42075969,calgaryrants,10,9700,2601,812,152,56,58.2314909735,50-59,756,7,40,24,64,64,40,24,10,3.3701747257,6725.4378299475,0.2802056326,0.0803571429,0.2158688,0,135,3.992640299829495E-4,0.001031784,0.0010586109,353,0.30470195,12,0,200,0,0,-0.08883315
732951152,MohawkWorkers,10,707,712,1485,13,230,49.698403027,40-49,658,5,73,95,168,168,73,95,9,2.7968305567,56961.9476937974,0.3622524272,0.0270530368,0.11683168,0,135,4.345418836512814E-4,0.0018622442,0.0019106636,99,0.20573206,29,0,200,0,0,-0.08890038
30264222,MorganCrockett,10,7831,668,363,26,1784,61.6243126057,60-69,734,7,37,24,61,61,37,24,9,3.1011783828,23731.6055762965,0.132446583,0.0172131148,0.060365852,0,135,2.2898287206640102E-4,9.562876E-4,9.811516E-4,267,0.14927885,55,0,199,0,0,-0.088912998
15395122,stint,10,2507,327,441,9,54,50.1915541003,50-59,659,6,19,21,40,40,19,21,11,3.5298659082,3155.8954078339,0.1547493393,0.0461538462,0.17384616,0,135,1.6985475537362223E-4,5.0330925E-4,5.1639555E-4,353,0.26280195,1,2,200,2,0.01,-0.08895579
590528384,antiillumi,10,5740,253,318,3,55,45.4847589773,40-49,643,6,3,4,7,7,3,4,10,3.9939049167,52.8506302471,0.00355801,0.0476190476,0.25,0,135,7.268988934074358E-5,1.00661855E-4,1.0327911E-4,267,0.3392857,9,0,201,0,0,-0.0892857
378066853,BhoRangzen,10,36473,1517,2004,58,70,44.9733864416,40-49,780,9,10,14,24,24,10,14,9,3.3791141812,2164.9310566081,0.0211441897,0.0434782609,0.20476191,0,135,9.446057265226373E-5,2.768201E-4,2.8401756E-4,99,0.29473683,105,0,201,0,0,-0.08997492
981391872,Common_Causes,10,274,624,498,20,1,50.1713597552,50-59,633,4,73,24,97,97,73,24,9,3.0780170662,44471.5638293975,0.2079871105,0.022766323,0.048479374,0,135,4.778103177249229E-4,0.0018622442,0.0018332042,257,0.13848269,73,0,200,0,0,-0.090003316
352090345,iwolftail,10,34728,366,686,8,451,44.2829710261,40-49,726,8,4,5,9,9,4,5,10,3.6294189354,449.6797958498,0.0152415651,0.0416666667,0.3,0,135,6.968992715631303E-5,1.2582731E-4,1.2909889E-4,505,0.3901099,25,0,201,0,0,-0.0901099
292659175,Diatribenscreed,10,1992,75,137,0,24,40.9905933301,40-49,589,6,12,12,24,24,12,12,10,3.4733848029,1359.6359742024,0.1501330461,0.0778985507,0.3125,0,135,8.84431111411187E-5,3.27151E-4,3.3565713E-4,353,0.40263158,5,0,201,0,0,-0.09013158
220421513,theamazon1,10,8942,455,737,4,976,49.7315559254,40-49,696,7,31,39,70,70,31,39,9,3.0414465664,11026.3839604057,0.1833388258,0.0385093168,0.17987806,0,135,2.3058768314231196E-4,8.0529484E-4,8.262329E-4,99,0.27005583,61,0,201,0,0,-0.09017777
184164307,Tsiehta,10,1957,46,118,4,11,26.8102670672,20-29,622,6,3,2,5,5,3,2,11,5.1015847217,735.8765691014,0.0039866113,0.05,0.33333334,0,135,9.274803935764659E-5,1.00661855E-4,1.0327911E-4,99,0.42380953,1,1,199,1,0.0050251256,-0.09047619
299444560,calg_kiaguy,10,3054,76,68,0,9,45.6522195804,40-49,682,6,8,0,8,8,8,0,0,0,0,0.049356969,0.1071428571,0.17857143,0,43,8.105004836700614E-5,2.2648917E-4,0,99,0.26923078,94,0,206,0,0,-0.09065935
213863609,GhostProf,10,7601,750,322,37,19,50.6315666794,50-59,743,7,6,3,9,9,6,3,10,3.788703779,304.9040479466,0.0332568622,0.0416666667,0.1,0,135,1.2131823834935034E-4,1.7615824E-4,1.8073844E-4,99,0.19090909,2,0,200,0,0,-0.09090909
497731840,Avalon709,10,37295,313,495,8,2412,38.3540813231,30-39,742,9,26,24,50,50,26,24,9,3.1804144657,12991.9615726494,0.0765004109,0.0412244898,0.1399287,0,135,2.1847084667904045E-4,6.794675E-4,6.97134E-4,343,0.23093152,54,0,211,0,0,-0.09100282
808387,MichelleBlanc,10,49835,35554,16979,1963,42,65.9842975772,60-69,879,9,24,14,38,38,24,14,8,3.5058919139,32693.595661107,0.0439078238,0.0227596017,0.06349207,0,135,2.8729724129291067E-4,6.291366E-4,6.196747E-4,267,0.15462185,14,0,200,0,0,-0.09112978
16458926,markalanwhittle,10,15963,943,1669,20,0,53.0085445894,50-59,734,8,25,35,60,60,25,35,10,3.0520113775,15453.3102266741,0.2316899479,0.0437853107,0.2092437,0,135,1.7251047935518108E-4,6.54302E-4,6.7131425E-4,353,0.30055177,12,0,201,0,0,-0.09130807
267967167,StephAubry_CS,10,3495,286,222,12,58,48.8845046439,40-49,662,6,10,10,20,20,10,10,10,3.8403088176,2468.6552927703,0.0142701109,0.0447368421,0.18181819,0,135,1.51663743381993E-4,2.768201E-4,2.8401756E-4,257,0.2731855,44,2,200,1,0.005,-0.09136731
17524392,duncankinney,10,14525,2187,1245,128,23,60.8706677964,60-69,769,7,40,25,65,65,40,25,10,3.4047135311,14575.8446236726,0.126371326,0.0209134615,0.06012951,0,135,3.71278542549099E-4,0.001031784,0.0010069713,353,0.15160407,39,0,201,0,0,-0.09147456
242051914,netminnow,10,89699,1182,1133,59,8405,46.837431753,40-49,769,10,14,4,18,18,14,4,10,3.8569687119,1209.5330905232,0.0413823027,0.045751634,0.10989011,0,135,1.1251052873624112E-4,3.7748195E-4,3.8729666E-4,99,0.20175439,3,0,202,0,0,-0.09186428
770671867,ChilliwackNDP1,10,10856,374,499,8,96,49.8079773092,40-49,690,8,42,48,90,90,42,48,9,2.9272653393,28266.5060536162,0.1368917341,0.0220973783,0.10530612,0,135,2.1118099427667441E-4,0.0010821149,0.0011102505,71,0.19719298,75,0,202,0,0,-0.09188686
926620136,AP_President,10,212,109,232,2,1,40.715204587,40-49,533,4,10,15,25,25,10,15,10,3.5148313694,1264.4247059795,0.0664089806,0.0783333333,0.21052632,0,135,1.1174923589865853E-4,2.768201E-4,2.8401756E-4,353,0.30241936,5,2,199,2,0.0100502513,-0.09189304
487811502,MichaelBroeders,10,636,90,288,1,2,39.8964284142,30-39,525,4,4,9,13,13,4,9,10,3.5465258025,328.2874432024,0.0151190003,0.0833333333,0.25555557,0,135,9.532966662364853E-5,1.2582731E-4,1.2909889E-4,505,0.34757835,7,0,199,0,0,-0.09202278
587873748,SaveTheELA,10,903,706,687,25,4,57.1303143186,50-59,730,5,96,77,173,173,96,77,9,2.9357984559,158791.587072829,0.1899424803,0.0094770803,0.03279939,0,135,7.058775178018821E-4,0.00244105,0.0023754195,283,0.12495025,640,1,201,1,0.0049751244,-0.09215086
77302546,DLynxleg,10,4426,94,311,2,577,44.2160730464,40-49,656,6,4,5,9,9,4,5,10,3.6314506298,53.143668386,0.0270233055,0.0833333333,0.4,0,135,7.193178053675125E-5,1.2582731E-4,1.2909889E-4,99,0.49242425,4,1,200,1,0.005,-0.09242425
570144609,theLLivingstone,10,1115,270,281,8,24,,,641,5,28,14,42,42,28,14,11,3.6261682243,3241.663334767,0.2687449722,0.0975609756,0.31034482,0,135,2.3854665759503711E-4,7.297984E-4,7.487736E-4,353,0.4030303,30,2,200,2,0.01,-0.09268548
163861697,S_EFortin,10,12419,1807,886,49,7,57.5103130308,50-59,784,7,18,16,34,34,18,16,9,3.4290938643,7358.2662633367,0.0311939619,0.0427807487,0.24183007,0,135,1.4807191396048954E-4,4.781438E-4,4.905758E-4,267,0.3346561,41,0,200,0,0,-0.09282603
244600462,Oyekuise,10,58329,976,1999,34,29935,41.7578935674,40-49,744,9,4,4,8,8,4,4,11,3.842340512,3359.8393924632,0.0051823027,0.0178571429,0.05,0,135,1.6262045249650187E-4,1.2582731E-4,1.2909889E-4,303,0.14285715,2,0,200,0,0,-0.09285715
372303687,MikmawRose,10,5320,530,778,5,461,45.2008174637,40-49,695,7,18,14,32,32,18,14,10,3.3856156034,4625.5212150161,0.0794687886,0.0524193548,0.16883117,0,135,1.4525615063382615E-4,4.781438E-4,4.64756E-4,99,0.2617354,13,1,201,1,0.0049751244,-0.09290423
30679892,JayDupes,10,5691,273,704,7,24,45.2814337339,40-49,691,7,13,10,23,23,13,10,10,3.4953271028,2453.3093986418,0.0473484071,0.0909090909,0.33809525,0,135,1.5217501607158937E-4,3.5231648E-4,3.3565713E-4,505,0.43107346,58,0,200,0,0,-0.09297821
37713606,hydroqueen,10,22973,1156,1107,20,76,41.9604682002,40-49,767,8,23,24,47,47,23,24,9,3.2117025599,16254.7341480126,0.0505957812,0.0300647549,0.19927536,0,135,2.3155442812377005E-4,6.0397113E-4,6.196747E-4,343,0.29225588,66,2,202,2,0.0099009901,-0.09298052
17551297,StevenDollansky,10,6257,815,477,39,8,46.8141017905,40-49,724,6,37,14,51,51,37,14,10,3.6310442909,4380.9581282204,0.3277247594,0.0925490196,0.27951637,0,135,3.900856157302448E-4,9.562876E-4,9.811516E-4,353,0.3725542,32,0,200,0,0,-0.09303783
1042548955,liberalhills,10,122,22,133,0,0,18.3360274803,10-19,93,3,4,10,14,14,4,10,10,3.5359609915,342.7766659008,0.0130689267,0.1208791209,0.4,0,135,5.920064319292223E-5,1.2582731E-4,1.2909889E-4,505,0.49384236,2,1,156,1,0.0064102564,-0.09384236
245095160,Erasmus111,10,3523,69,120,6,144,43.0131365875,40-49,609,6,3,1,4,4,3,1,11,4.6172287688,40.6075731594,0.0072310274,0.0833333333,0.33333334,0,135,8.398818418914875E-5,1.00661855E-4,1.0327911E-4,99,0.42727274,9,1,200,1,0.005,-0.0939394
15830174,Emile_BC,10,17378,1509,1265,63,8,68.5437679819,60-69,764,8,53,47,100,100,53,47,10,3.1243396993,37096.7022581905,0.3073323417,0.0287878788,0.128872,0,135,5.07963782350066E-4,0.001358935,0.0013684483,353,0.2228342,116,0,205,0,0,-0.0939622
39871064,GovernmentDroid,10,359145,3440,2198,120,1,41.7100235614,40-49,760,12,9,2,11,11,9,2,10,3.6700528241,334.102311784,0.0258197565,0.0363636364,0.11111111,0,135,7.695065853820674E-5,2.5165462E-4,2.5819778E-4,99,0.20512821,0,0,201,0,0,-0.0940171
18411401,nashvillebound,10,3052,136,467,1,825,43.0056701262,40-49,575,6,9,20,29,29,9,20,10,3.3279154815,1856.3774149516,0.0492337406,0.0701970443,0.17316018,0,135,8.768406324770695E-5,2.5165462E-4,2.5819778E-4,99,0.2672065,21,0,201,0,0,-0.09404632
78898625,7PinkPanther7,10,195629,1264,884,44,2,47.997087501,40-49,880,11,8,7,15,15,8,7,10,3.4563185697,2663.0940854141,0.0203716093,0.0380952381,0.26785713,0,135,1.0885644024749717E-4,2.2648917E-4,2.32378E-4,267,0.36190477,26,0,200,0,0,-0.09404764
84368341,madinuk,10,31746,2151,885,89,11,61.138383242,60-69,787,8,59,10,69,69,59,10,10,3.781389679,9517.599632149,0.2304580944,0.0232310315,0.043010753,0,135,4.028197768524307E-4,0.0015099278,0.0015491867,99,0.13711844,67,0,199,0,0,-0.094107687
12046772,JProssa,10,14831,1248,934,29,176,45.509516029,40-49,718,7,30,28,58,58,30,28,10,3.1186509549,12873.1502531949,0.1358182116,0.0284331518,0.11024182,0,135,3.558126287885791E-4,7.8012934E-4,8.0041314E-4,353,0.20442891,7,0,200,0,0,-0.09418709
558827088,mike4mla,10,1338,750,1547,12,19,54.6803818435,50-59,628,5,15,29,44,44,15,29,9,3.0361641609,8271.9122181256,0.0699033401,0.0549682875,0.17096774,0,135,1.401876763571519E-4,4.0264742E-4,4.1311645E-4,71,0.26525974,17,0,200,0,0,-0.094292
197113002,anilainyyc,10,4197,656,304,18,19,40.9849371457,40-49,692,7,11,10,21,21,11,10,10,3.5071109305,382.9581744983,0.0786224595,0.0833333333,0.4318182,0,135,1.8329920676616007E-4,3.0198556E-4,3.0983734E-4,353,0.5261438,4,0,199,0,0,-0.0943256
20537310,d_phrase,10,24952,669,760,22,31,58.8919023096,50-59,742,7,4,5,9,9,4,5,10,3.8277123121,1349.7629283894,0.0071709672,0.0138888889,0.1,0,135,8.585036290282857E-5,1.2582731E-4,1.2909889E-4,353,0.19444445,11,0,201,0,0,-0.09444445
98248395,PaigeKezima,10,6821,622,593,13,67,51.2943840151,50-59,741,7,61,36,97,97,61,36,10,3.1503453881,22400.9240953588,0.203343412,0.0372637457,0.113696225,0,135,3.984687624553292E-4,0.0015602587,0.0016008263,257,0.20822078,181,0,200,0,0,-0.094524555
502163458,ClimateVoters,10,669,272,43,14,11,48.4940619179,40-49,649,5,22,2,24,24,22,2,10,4.1064607883,574.864969765,0.0464367833,0.0289855072,0.064935066,0,135,1.3298983652834523E-4,5.7880563E-4,5.938549E-4,71,0.15954416,40,0,200,0,0,-0.094609094
538475365,bconnolly00,10,9447,132,137,4,1097,49.5283703024,40-49,704,8,16,6,22,22,16,6,10,3.716781796,1809.5532202185,0.0491374715,0.0411255411,0.09191176,0,135,1.2242724596676175E-4,4.2781286E-4,4.3893623E-4,257,0.18666667,73,0,205,0,0,-0.09475491
708424146,Local617,10,1171,268,331,3,1,42.4011602303,40-49,625,5,10,18,28,28,10,18,10,3.3843965868,2985.5371082003,0.0232083719,0.0502645503,0.123809524,0,135,7.562371719687328E-5,2.768201E-4,2.8401756E-4,257,0.21875,9,0,199,0,0,-0.094940476
48457938,cclar104,10,1229,183,293,1,314,41.4579793011,40-49,602,5,8,9,17,17,8,9,10,3.7947988623,958.1567165064,0.0215131436,0.0625,0.24545455,0,135,8.206220790513926E-5,2.2648917E-4,2.32378E-4,353,0.34047619,12,0,199,0,0,-0.09502164
89052154,CaiMedics,10,1561,248,774,4,16,43.262369403,40-49,633,6,3,6,9,9,3,6,10,3.80658269,499.2018438775,0.0079842704,0.0833333333,0.14285715,0,135,7.022058752493005E-5,1.00661855E-4,1.0327911E-4,343,0.23789173,11,0,200,0,0,-0.09503458
63050686,ryanrutley,10,7208,419,410,18,298,48.6647260607,40-49,698,7,8,7,15,15,8,7,10,3.537586347,951.5272872997,0.0256059289,0.0333333333,0.11818182,0,135,8.76957159777991E-5,2.2648917E-4,2.32378E-4,99,0.21323529,7,0,200,0,0,-0.09505347
16707686,Magnafan,10,1882,150,438,2,4,38.27236935,30-39,560,5,8,10,18,18,8,10,10,3.6570499797,7698.9306740911,0.0651155327,0.0784313725,0.28787878,0,135,1.2902487181723547E-4,2.2648917E-4,2.32378E-4,353,0.38304093,5,0,200,0,0,-0.09516215
823992356,Sophlight,10,2462,518,790,7,301,50.5155151733,50-59,677,6,6,8,14,14,6,8,9,3.4656643641,662.1469881353,0.0152883835,0.0549450549,0.18055555,0,135,8.026769488661426E-5,1.7615824E-4,1.8073844E-4,267,0.2757353,28,0,201,0,0,-0.09517975
499449099,JulianCWolfe,10,215,26,65,0,1,13.1153710366,10-19,470,3,2,3,5,5,2,3,11,4.1015847217,105.2828952475,0.004277422,0.05,0.33333334,0,135,6.538647824457544E-5,7.549639E-5,7.7459335E-5,505,0.42857143,29,0,199,0,0,-0.09523809
934620770,PatBigGeorge,10,563,46,87,1,15,38.2832650061,30-39,470,5,9,9,18,18,9,9,10,3.4063388866,714.2519918909,0.0659030483,0.114379085,0.24285714,0,135,8.881540620080615E-5,2.5165462E-4,2.5819778E-4,99,0.33833334,4,0,200,0,0,-0.0954762
16540752,chrisalecanada,10,5370,304,238,13,7,46.1366407646,40-49,664,6,6,4,10,10,6,4,10,3.5729378302,266.0636293657,0.0239000631,0.0888888889,0.21428572,0,135,9.241421393180225E-5,1.7615824E-4,1.8073844E-4,71,0.3097826,15,0,200,0,0,-0.09549688
18929837,musicbaum,10,37331,1317,1694,29,3715,55.1083842775,50-59,785,9,14,14,28,28,14,14,10,3.2819991873,4620.4977323081,0.0566343955,0.0145502646,0.0952381,0,135,1.1244209418366203E-4,3.7748195E-4,3.8729666E-4,353,0.19076923,42,0,203,0,0,-0.09553113
310942227,SteveRickettsSP,10,2789,105,184,4,2,51.0979300475,50-59,687,6,8,13,21,21,8,13,10,3.5022348639,194.0324855568,0.060923667,0.1357142857,0.41428572,0,135,8.716487823726853E-5,2.2648917E-4,2.32378E-4,353,0.51,63,0,204,0,0,-0.09571428
323291764,WalterPamic,10,479,425,1834,1,12,38.7905895875,30-39,564,5,12,28,40,40,12,28,10,3.2433969931,4033.5329480105,0.1235801083,0.0551282051,0.17857143,0,135,9.364666946073287E-5,3.27151E-4,3.3565713E-4,353,0.27444956,5,0,199,0,0,-0.09587813
390142047,BrockCLS,10,690,320,260,10,46,45.9414638898,40-49,606,5,34,22,56,56,34,22,10,3.4429093864,10373.7904472596,0.0860435973,0.0451298701,0.12126246,0,135,2.1346219500706216E-4,8.807912E-4,9.036922E-4,257,0.21741672,72,1,200,1,0.005,-0.09615426
385748033,BriggsAlexa,10,344,129,339,1,10,40.6592039027,40-49,513,4,11,16,27,27,11,16,10,3.3693620479,3328.234624423,0.0509162144,0.0598290598,0.24632353,0,135,9.512893154575233E-5,3.0198556E-4,3.0983734E-4,353,0.3430931,7,0,200,0,0,-0.09676957
14861810,stevesanterre,10,15436,1353,1658,18,457,54.1497992734,50-59,771,8,45,54,99,99,45,54,8,2.8220235677,69085.0279715429,0.143859834,0.0140177283,0.06986216,0,135,2.663961423306277E-4,0.0011576113,0.0011877097,267,0.16677631,113,0,202,0,0,-0.09691415
199833381,AlChwk,10,862,67,120,1,1,33.3640282859,30-39,573,5,2,2,4,4,2,2,12,4.5871596912,39.7559406922,0.0187938247,0.1666666667,0.25,0,135,6.211685471956512E-5,7.549639E-5,7.7459335E-5,505,0.3472222,2,1,199,1,0.0050251256,-0.0972222
266048357,CampaignLife,10,1651,654,362,27,3,48.8233876454,40-49,707,5,21,15,36,36,21,15,11,4.1284030882,4922.8910787891,0.0333518735,0.0674603175,0.18803419,0,135,2.216428009662466E-4,5.536402E-4,5.4221536E-4,353,0.28531075,72,2,200,2,0.01,-0.09727656
20023516,JohnRiche,10,7849,925,1763,18,641,62.4224574646,60-69,763,7,21,30,51,51,21,30,8,3.2218610321,16891.7892244558,0.048294674,0.0447058824,0.18346775,0,135,1.979308022890266E-4,5.536402E-4,5.680351E-4,343,0.28077403,53,0,202,0,0,-0.09730628
250089059,nwohashtag,10,137382,10227,6203,324,8,57.5456635897,50-59,891,9,14,5,19,19,14,5,9,3.6160097521,17350.014364937,0.0351824163,0.0321637427,0.06666667,0,135,1.3752531315544355E-4,3.7748195E-4,3.8729666E-4,99,0.16428572,14,1,201,1,0.0049751244,-0.09761905
952641019,rjfitz66,10,4560,1222,1266,4,905,52.620305965,50-59,697,6,12,12,24,24,12,12,10,3.4067452255,5767.0115965199,0.1105444203,0.0344202899,0.28030303,0,135,1.0110028112560929E-4,3.27151E-4,3.3565713E-4,353,0.37820512,28,2,196,2,0.0102040816,-0.09790209
615793000,markabel5,10,592,69,163,1,122,37.0239606695,30-39,555,4,2,8,10,10,2,8,10,3.5306785859,277.9772918285,0.0250147766,0.0777777778,0.23214285,0,135,5.79067086432532E-5,7.549639E-5,7.7459335E-5,353,0.33006537,11,22,201,22,0.1094527363,-0.09792252
92834029,Ken_Sanderson,10,4560,438,507,16,18,40.86303541,40-49,677,6,23,23,46,46,23,23,10,3.2060138155,4578.1789206813,0.1053787869,0.0280193237,0.13538462,0,135,3.6001585277843276E-4,6.0397113E-4,6.196747E-4,99,0.23333333,2,0,200,0,0,-0.09794871
28952731,atgiggleswick,10,49619,4661,1987,173,47,46.7802343081,40-49,766,9,9,8,17,17,9,8,10,3.6351076798,3977.7844476204,0.0148399813,0.0330882353,0.16666667,0,135,2.0232674577722135E-4,2.5165462E-4,2.5819778E-4,303,0.2646154,6,0,201,0,0,-0.09794873
411413547,blueeyedmurder,10,1465,52,216,0,5,44.7624122359,40-49,618,6,6,11,17,17,6,11,10,3.3575782202,723.0634212575,0.0201962314,0.0514705882,0.15384616,0,135,6.210442089425875E-5,1.7615824E-4,1.8073844E-4,257,0.2518116,31,1,202,1,0.004950495,-0.09796544
497114732,BarbaraXLow,10,1560,454,518,9,227,46.1662628902,40-49,671,6,33,25,58,58,33,25,9,3.232832182,6224.1611008391,0.1843179387,0.0517241379,0.18207681,0,135,4.697420580934679E-4,8.556257E-4,8.7787246E-4,99,0.28013468,28,0,200,0,0,-0.09805787
538148973,Trillium_Party,10,1456,119,105,2,71,40.0961788307,40-49,634,5,11,9,20,20,11,9,10,3.3140999594,2662.000103855,0.0904748766,0.0368421053,0.20454545,0,135,8.429948146955292E-5,3.0198556E-4,3.0983734E-4,353,0.3026316,8,2,199,2,0.0100502513,-0.09808615
78627903,ChristianConsrv,10,3195,352,76,16,7,51.9629449642,50-59,697,6,31,0,31,31,31,0,0,0,0,0.1993255302,0.0827956989,0.13010752,0,4,3.714934460030873E-4,8.0529484E-4,0,353,0.22869675,88,0,200,0,0,-0.09858923
235122381,GarnettGenuis,10,747,585,516,23,0,45.0169603224,40-49,623,4,26,24,50,50,26,24,10,3.3908980089,4914.0212472324,0.2183798733,0.0575510204,0.28045976,0,135,2.3280147745283777E-4,6.794675E-4,6.97134E-4,353,0.37967688,16,2,200,2,0.01,-0.09921712
158923470,PatrickDavis55,10,662,136,634,2,16,40.6441083026,40-49,495,5,6,11,17,17,6,11,10,3.2811865095,660.0798915908,0.049716348,0.0661764706,0.26363635,0,135,7.331429786853097E-5,1.7615824E-4,1.8073844E-4,353,0.36290324,3,0,200,0,0,-0.09926689
27765177,alexfelsky,10,277,173,480,5,2,43.6609347284,40-49,515,4,13,12,25,25,13,12,9,3.4689150752,1220.4393839374,0.0530686145,0.09,0.35416666,0,135,1.0460946582354624E-4,3.5231648E-4,3.6147688E-4,257,0.4534413,23,0,201,0,0,-0.09927464
20273815,AudreyHuntley,10,16848,1824,627,187,2,54.7696391976,50-59,764,7,48,10,58,58,48,10,10,3.4311255587,5128.9576919001,0.2257973907,0.0520266183,0.10705882,0,135,3.399243594196883E-4,0.0012331076,0.0012651691,99,0.20646021,45,0,199,0,0,-0.09940139
109065918,QMInews,10,11320,2371,387,106,3,57.775777474,50-59,770,7,40,2,42,42,40,2,10,3.6399837464,8542.8566714889,0.1819018229,0.0296167247,0.049358975,0,135,4.880584992996704E-4,0.001031784,0.0010586109,353,0.14876385,24,0,200,0,0,-0.099404875
233426838,SaskNDPYouth,10,842,378,262,13,31,46.2476343275,40-49,646,5,47,28,75,75,47,28,10,3.3730190979,9086.6671843039,0.1622485181,0.0594594595,0.19529411,0,135,2.610692730594748E-4,0.0012079423,0.0012393494,257,0.29507524,75,0,199,0,0,-0.09978113
521879347,DiscourseMag,10,220,560,530,10,8,42.3419703412,40-49,574,3,21,12,33,33,21,12,10,3.2247054043,8632.2443901241,0.0616883502,0.021780303,0.10952381,0,135,2.247620534408752E-4,5.536402E-4,5.680351E-4,99,0.20941357,40,1,200,1,0.005,-0.09988976
70215225,cbeak,10,1504,544,1109,6,351,44.4145023764,40-49,660,6,58,102,160,160,58,102,9,2.8179601788,49124.562841513,0.2746350584,0.0281053459,0.109651625,0,135,3.3026032813747815E-4,0.0014847623,0.0015233669,99,0.20962062,6,0,198,0,0,-0.099968995
159282071,rezboi39,10,16009,433,1176,5,42,44.5939224101,40-49,685,8,11,23,34,34,11,23,10,3.0353514831,5654.559705278,0.0718554531,0.0320855615,0.11660079,0,135,1.0000598410940957E-4,3.0198556E-4,3.0983734E-4,99,0.21657592,26,4,204,4,0.0196078431,-0.09997513
403467578,FreedomTweetCA,10,2100,658,751,2,41,44.320724492,40-49,639,5,4,4,8,8,4,4,10,4.1133685494,1045.495185586,0.0065610907,0,0,0,135,8.130511087871044E-5,1.2582731E-4,1.2909889E-4,303,0.1,22,0,200,0,0,-0.1
432141753,goaliegirlmom31,10,236,91,148,1,14,20.2136591769,20-29,383,4,3,6,9,9,3,6,10,3.6070702966,260.2506196973,0.0098390124,0.0694444444,0.23333333,0,135,5.748161970896257E-5,1.00661855E-4,1.0327911E-4,257,0.33333334,1,0,200,0,0,-0.10000001
944396432,PIPSC_IPFPC,10,598,143,68,4,0,43.9140359501,40-49,580,4,12,10,22,22,12,10,11,3.7245022349,4547.2161977527,0.0237667081,0.0476190476,0.17619048,0,135,1.5063669553220206E-4,3.27151E-4,3.3565713E-4,257,0.27666667,67,2,200,2,0.01,-0.10047619
80945516,TheWpgChamber,10,5846,3846,944,146,28,56.3165053737,50-59,754,7,13,3,16,16,13,3,11,4.3315725315,2383.7028669874,0.0503517869,0.0208333333,0.04945055,0,135,1.5325385957764266E-4,3.5231648E-4,3.6147688E-4,106,0.15,73,0,200,0,0,-0.10054945
506496611,VC_Ocean,10,469,185,308,3,26,52.1313300118,50-59,570,5,7,8,15,15,7,8,9,3.2775294596,913.3009114803,0.0349764174,0.0619047619,0.30555555,0,135,9.249750352023166E-5,2.0132371E-4,2.0655822E-4,505,0.40640393,7,0,200,0,0,-0.10084838
498188801,ClaudeCPoirier,10,895,154,266,6,1,40.6544260269,40-49,581,5,5,5,10,10,5,5,10,3.8841934173,536.2329594871,0.0080260874,0.0444444444,0.35,0,135,1.1872804371598448E-4,1.5099278E-4,1.5491867E-4,257,0.4510582,8,0,200,0,0,-0.1010582
150121687,attaboymort,10,2368,156,334,4,1,28.8277262518,20-29,627,5,7,6,13,13,7,6,10,3.645266152,143.4950620488,0.0230501438,0.0705128205,0.375,0,135,7.828631485037794E-5,2.0132371E-4,2.0655822E-4,505,0.47619048,4,6,200,6,0.03,-0.10119048
521628578,grahamgeoff,10,171,77,151,2,161,23.0882596943,20-29,507,4,7,8,15,15,7,8,10,3.512393336,701.5896884941,0.0197230624,0.0904761905,0.28181818,0,135,7.840680562066312E-5,2.0132371E-4,2.0655822E-4,267,0.38311687,10,1,174,1,0.0057471264,-0.10129869
228394456,traceyram,10,494,81,132,0,0,18.7177943834,10-19,455,4,8,7,15,15,8,7,10,3.7269402682,239.1454838281,0.0196531757,0.080952381,0.375,0,135,7.488329651661368E-5,2.2648917E-4,2.32378E-4,257,0.4763158,4,2,200,1,0.005,-0.1013158
16229679,katiegibbs,10,3166,1285,1704,63,3,51.5796678916,50-59,699,6,42,38,80,80,42,38,10,3.1645672491,41847.7186852992,0.0939953645,0.022943038,0.08785822,0,135,4.2321200534972475E-4,0.0010821149,0.0011102505,283,0.19020203,47,0,200,0,0,-0.10234381
94162094,claysuddaby,10,3494,634,977,21,122,43.2986443914,40-49,662,7,26,16,42,42,26,16,10,3.5168630638,3233.1208385448,0.0797507355,0.0708478513,0.1908046,0,135,2.5726586223731313E-4,6.794675E-4,6.97134E-4,71,0.2932401,7,0,198,0,0,-0.1024355
15264238,polarlawyer,10,130,185,235,10,1,34.2237786445,30-39,523,3,12,14,26,26,12,14,10,3.5615603413,2626.8093713046,0.0568626206,0.0553846154,0.19117647,0,135,1.2578735217963347E-4,3.27151E-4,3.3565713E-4,99,0.2936508,1,0,132,0,0,-0.10247433
1072009236,Polkameister,10,2810,120,136,1,1,51.6923716987,50-59,699,6,16,6,22,22,16,6,11,3.6241365299,4956.5964978534,0.1492306005,0.1103896104,0.25730994,0,135,1.512993852287787E-4,4.2781286E-4,4.1311645E-4,353,0.35987905,215,3,214,3,0.0140186916,-0.10256911
302951386,JoelBReed,10,4019,408,473,7,1,42.8877202295,40-49,715,7,7,7,14,14,7,7,10,3.7882974401,877.1808080165,0.0111146785,0.0769230769,0.26666668,0,135,1.670051403931948E-4,2.0132371E-4,2.0655822E-4,505,0.3693182,6,1,201,1,0.0049751244,-0.10265152
19143481,kotlnc,10,2302,690,1809,36,23,41.9428086517,40-49,600,6,6,14,20,20,6,14,10,3.8488419342,11769.2541927098,0.0032517111,0.0447368421,0.15934066,0,135,1.5115647302662647E-4,1.7615824E-4,1.8073844E-4,267,0.26209676,3,0,200,0,0,-0.1027561
18360735,suepeac,10,1906,74,131,0,43,25.0560438135,20-29,549,6,7,7,14,14,7,7,10,3.8748476229,796.835497671,0.025624007,0.0989010989,0.22727273,0,135,8.450813959339202E-5,2.0132371E-4,2.0655822E-4,353,0.33003953,4,0,200,0,0,-0.1027668
158852785,Mental_Radio,10,2190,330,210,12,2,46.5546882216,40-49,674,6,18,9,27,27,18,9,10,3.5453067859,2553.2113152407,0.0480518576,0.047008547,0.14327486,0,135,1.5679014951435296E-4,4.781438E-4,4.905758E-4,257,0.24630542,67,0,200,0,0,-0.10303056
26417074,liseravary,10,9853,4933,599,103,214,61.2032115114,60-69,791,7,16,7,23,23,16,7,9,3.8130841121,4845.4610322313,0.031561279,0.0415019763,0.08496732,0,135,3.562100848841306E-4,4.2781286E-4,4.1311645E-4,267,0.18817204,62,1,200,1,0.005,-0.10320472
361313270,TransCanada,10,2688,2901,436,83,1,59.9660526271,50-59,783,6,26,4,30,30,26,4,11,3.7330353515,3824.7572236352,0.1614953554,0.0540229885,0.1005291,0,135,2.4441649964968703E-4,6.794675E-4,6.7131425E-4,353,0.20383275,51,0,201,0,0,-0.10330365
17031126,exovirtuelle,10,15742,3017,1157,125,6,61.5731182463,60-69,778,7,24,8,32,32,24,8,9,3.6550182852,3067.5847146421,0.0648697213,0.0776209677,0.2155797,0,135,1.574101492929468E-4,6.291366E-4,6.4549444E-4,267,0.31907308,13,0,200,0,0,-0.10349338
519737251,reppinca,10,5928,714,2002,0,1657,49.3280307101,40-49,693,7,60,124,184,184,60,124,9,2.6940268184,64229.6414671545,0.2852604405,0.0239961986,0.07905262,0,135,3.208994772832364E-4,0.0015350933,0.0015750064,99,0.18288834,76,0,215,0,0,-0.10383572
17141770,bpellerin,10,7765,786,114,56,0,55.2110878085,50-59,711,7,53,4,57,57,53,4,10,4.3953677367,4268.7680821494,0.2946160482,0.0532581454,0.09057239,0,135,7.051511242816461E-4,0.001358935,0.0013684483,353,0.19453782,62,2,201,2,0.0099502488,-0.10396543
260423578,Lynne_Rodier,10,6731,1017,1775,25,169,37.5188410478,30-39,669,7,15,28,43,43,15,28,9,3.1869158879,6530.2325524441,0.0500847378,0.0343300111,0.10960591,0,135,1.374308372454699E-4,4.0264742E-4,4.1311645E-4,267,0.2138009,0,1,200,1,0.005,-0.10419499
185290543,gordperks,10,2438,3970,526,211,5,60.7003464856,60-69,768,6,83,17,100,100,83,17,10,3.5363673304,35228.9195163952,0.1761126973,0.0219191919,0.04628269,0,135,5.872606951183577E-4,0.002113899,0.002091402,257,0.15076871,52,0,200,0,0,-0.10448602
306279729,buck_tracks,10,4856,307,549,12,453,48.1345581961,40-49,682,7,7,7,14,14,7,7,10,3.7021535961,3121.8857987406,0.0102161365,0.0164835165,0.14285715,0,135,8.623549215705731E-5,2.0132371E-4,2.0655822E-4,257,0.24761905,22,0,201,0,0,-0.1047619
190224295,BradCabana,10,17714,1075,498,34,75,46.3158653332,40-49,785,8,27,11,38,38,27,11,8,3.3632669646,8278.7963363769,0.0713690728,0.0540540541,0.14778325,0,135,2.739223730733615E-4,7.0463296E-4,7.2295376E-4,343,0.2526339,73,0,201,0,0,-0.10485065
292460155,AkileChoh,10,322,540,362,15,17,42.4585182682,40-49,626,3,18,13,31,31,18,13,10,3.3734254368,6330.4248227165,0.0778719744,0.0784946237,0.13095239,0,135,2.131733990154622E-4,4.781438E-4,4.3893623E-4,99,0.23623188,3,0,200,0,0,-0.10527949
80475670,WaiYoung,10,1103,1197,360,98,3,49.3777480087,40-49,665,5,67,18,85,85,67,18,10,3.3535148314,18703.7483723022,0.3103881637,0.0605042017,0.11130673,0,135,6.858018434930347E-4,0.0017112514,0.0017299252,353,0.21670762,32,1,200,1,0.005,-0.10540089
45029276,simrath,10,1341,248,770,4,4,53.2556603462,50-59,597,6,15,19,34,34,15,19,10,3.222267371,2077.469539635,0.0971459738,0.0570409982,0.23571429,0,135,1.8495599715798972E-4,4.0264742E-4,4.1311645E-4,505,0.34121394,14,2,199,2,0.0100502513,-0.10549965
259128842,beesenitch,10,4140,162,261,1,43,46.7548833715,40-49,699,6,7,10,17,17,7,10,11,3.7257212515,326.2183439676,0.0195681383,0.1102941176,0.24175824,0,135,7.448065994104585E-5,2.0132371E-4,2.0655822E-4,353,0.34757835,11,0,200,0,0,-0.10582011
487144919,rofoi,10,877,111,677,1,3,45.0222886363,40-49,572,5,6,0,6,6,6,0,0,0,0,0.0182276438,0.0333333333,0.06666667,0,18,1.2106584508191298E-4,1.7615824E-4,0,99,0.17272727,1,0,201,0,0,-0.1060606
38481059,megamouthmedia,10,16769,26960,4329,96,895,68.1154054763,60-69,781,8,12,10,22,22,12,10,10,3.6269809021,1314.0122392212,0.0199511182,0.025974026,0.13636364,0,135,1.3590036511559688E-4,3.27151E-4,3.3565713E-4,71,0.24269006,35,0,200,0,0,-0.10632642
23713082,mjamesanderson,10,2633,456,452,10,116,60.5713373319,60-69,673,6,37,26,63,63,37,26,10,3.3185696871,5624.6381418763,0.1293493453,0.0622119816,0.2207317,0,135,2.8981148308002505E-4,9.562876E-4,9.553318E-4,257,0.32710108,23,0,200,0,0,-0.10636938
274300708,NDPLakeshore,10,369,151,177,5,0,33.0455350851,30-39,460,4,22,10,32,32,22,10,10,3.573344169,884.9921861681,0.0959623147,0.1774193548,0.40153846,0,135,1.491856568962466E-4,5.7880563E-4,5.938549E-4,257,0.5079323,10,4,199,4,0.0201005025,-0.10639384
158766748,uOConservatives,10,694,545,580,23,23,45.2436374126,40-49,632,5,51,41,92,92,51,41,10,3.2129215766,25702.6773151491,0.2071032339,0.0477783086,0.12686567,0,135,3.445778929634435E-4,0.001308604,0.0013426285,353,0.23329526,29,3,200,3,0.015,-0.10642959
25729759,Sattva01,10,21901,615,729,18,23,51.5167477468,50-59,794,9,27,14,41,41,27,14,10,3.3738317757,8077.2659196567,0.2187336263,0.0524390244,0.13162878,0,135,1.5230263181984418E-4,7.0463296E-4,7.2295376E-4,353,0.23845704,73,0,199,0,0,-0.10682826
53542320,mbilek,10,1052,246,272,9,6,41.9151376183,40-49,601,5,23,17,40,40,23,17,10,3.3856156034,6524.5897097321,0.0854700898,0.0858974359,0.25132275,0,135,1.582988640246337E-4,6.0397113E-4,6.196747E-4,257,0.35817683,8,0,200,0,0,-0.10685408
210146775,dcostello48,10,227,46,157,0,0,13.7263439094,10-19,116,4,3,6,9,9,3,6,10,3.6720845185,49.8613154679,0.0095652757,0.1111111111,0.36666667,0,135,6.390672596584317E-5,1.00661855E-4,1.0327911E-4,257,0.47368422,2,1,200,1,0.005,-0.10701755
488916603,RonnieMemo,10,843,195,646,8,138,38.034057135,30-39,503,5,4,12,16,16,4,12,10,3.4469727753,470.8259206053,0.0185128325,0.0916666667,0.21969697,0,135,7.724445149431616E-5,1.2582731E-4,1.2909889E-4,353,0.3268817,9,0,200,0,0,-0.10718473
760462104,HaifischGeweint,10,6465,273,307,6,2550,45.3127231479,40-49,688,7,18,18,36,36,18,18,9,3.1917919545,6393.3760011817,0.0831364672,0.0214285714,0.102380954,0,135,1.439649542866795E-4,4.781438E-4,4.905758E-4,99,0.20967741,8,0,200,0,0,-0.107296456
256099934,PattyMC22,10,1970,433,418,8,1,60.1481362047,60-69,670,6,24,24,48,48,24,24,10,3.2482730597,4431.4206329034,0.1918142098,0.0735815603,0.26209676,0,135,2.2864153962975006E-4,6.291366E-4,6.196747E-4,353,0.36969697,30,0,200,0,0,-0.10760021
99856389,KatyaMoussatova,10,329,162,327,1,38,36.1828361826,30-39,451,4,9,9,18,18,9,9,10,3.7362860626,702.3848691004,0.046038499,0.0490196078,0.22727273,0,135,7.860676478847484E-5,2.5165462E-4,2.5819778E-4,353,0.33516484,7,1,194,1,0.0051546392,-0.10789211
94234643,DCEJennings,10,1785,139,253,0,321,39.0757126296,30-39,619,6,6,9,15,15,6,9,10,3.7151564405,733.1451755164,0.0124594266,0.0857142857,0.32222223,0,135,6.568444299035607E-5,1.7615824E-4,1.8073844E-4,505,0.43014705,14,2,197,2,0.0101522843,-0.10792482
284630825,ashboxlive,10,9415,543,851,12,830,55.3421447573,50-59,713,7,28,35,63,63,28,35,10,3.0162535555,22648.0334509266,0.1818534099,0.0222734255,0.118487395,0,135,3.2564816790496066E-4,7.297984E-4,7.487736E-4,353,0.22654982,32,4,203,4,0.0197044335,-0.108062425
296553576,Erin_M_OToole,10,1083,909,202,19,4,59.7808503915,50-59,703,5,68,6,74,74,68,6,10,3.5542462414,11834.1476351574,0.2481863215,0.0581266198,0.094842285,0,135,6.659175479836964E-4,0.001736417,0.0017815647,353,0.20292448,124,3,200,3,0.015,-0.108082195
273537714,darshisel,10,488,230,202,2,0,32.6930612011,30-39,560,4,10,8,18,18,10,8,10,3.7549776514,6878.8771240253,0.0273688334,0.0522875817,0.17948718,0,135,9.761706517671144E-5,2.768201E-4,2.5819778E-4,257,0.28809524,5,2,198,2,0.0101010101,-0.10860806
292686476,ArmandLaBarge,10,1023,224,353,1,5,43.7098691562,40-49,613,5,5,2,7,7,5,2,10,3.7017472572,281.2014008981,0.0346169624,0.119047619,0.3,0,135,1.1168392193209433E-4,1.5099278E-4,1.5491867E-4,353,0.4088319,8,1,200,1,0.005,-0.1088319
490376149,JarvisGoogoo,10,4742,324,307,2,887,43.5992395419,40-49,705,7,1,5,6,6,1,5,10,3.9366111337,21.6157627378,0.0024917911,0.1333333333,0.2,0,135,5.827607561009861E-5,5.0330927E-5,5.1639556E-5,343,0.3090909,2,0,200,0,0,-0.1090909
22224357,TZohner,10,4359,153,262,2,8,44.866242021,40-49,665,6,8,4,12,12,8,4,10,3.7480698903,88.1684480543,0.0238666493,0.0984848485,0.2638889,0,135,9.095798949476147E-5,2.2648917E-4,2.32378E-4,71,0.3731527,6,1,200,1,0.005,-0.1092638
297568021,bush_wendy,10,2070,357,235,10,49,44.9928845077,40-49,653,6,9,10,19,19,9,10,10,3.5213327915,1386.0753464026,0.0382894506,0.0292397661,0.12878788,0,135,9.27397761110771E-5,2.5165462E-4,2.5819778E-4,99,0.23809524,18,0,201,0,0,-0.10930736
436985128,PeteHelfrich,10,975,239,442,6,5,28.4148377055,20-29,606,5,11,21,32,32,11,21,10,3.2003250711,1984.0275908229,0.0560347446,0.060483871,0.19264069,0,135,1.1374668901943338E-4,3.0198556E-4,3.0983734E-4,353,0.3020202,3,1,200,1,0.005,-0.10937951
61509014,TheLawofWork,10,3630,1656,797,65,1,54.7397298624,50-59,736,6,73,16,89,89,73,16,10,3.4880130028,25018.6432440515,0.139196341,0.0220888662,0.04323308,0,135,4.579519656721564E-4,0.0018622442,0.0018332042,257,0.15266725,75,0,200,0,0,-0.10943417
16335073,ashleyscorpio,10,21122,2659,2409,137,2194,55.5354397933,50-59,746,8,65,44,109,109,65,44,10,3.1995123933,23195.4977662893,0.3294063953,0.0432381923,0.11230637,0,135,5.485155517345097E-4,0.0016609206,0.0017041053,353,0.22183384,33,10,200,10,0.05,-0.10952747
13179482,Tigerlily007,10,2371,228,298,3,119,45.6540744553,40-49,637,6,10,18,28,28,10,18,10,3.3092238927,731.61192016,0.0561292434,0.0714285714,0.24509804,0,135,9.840802926073806E-5,2.768201E-4,2.8401756E-4,99,0.3550505,38,0,205,0,0,-0.10995246
251015682,ahayher,10,2476,300,514,1,6,41.5963258979,40-49,683,6,3,5,8,8,3,5,11,3.7094676961,165.6052756093,0.0389172254,0.1071428571,0.3,0,135,7.490571755949368E-5,1.00661855E-4,1.0327911E-4,353,0.41,7,0,200,0,0,-0.11
145480842,DeronBilous,10,2052,801,749,42,1,49.0204142626,40-49,725,6,53,47,100,100,53,47,10,3.0780170662,32141.0889945539,0.2266016833,0.0294949495,0.122404374,0,135,4.4799795657140233E-4,0.001358935,0.001394268,257,0.2324159,86,3,201,3,0.0149253731,-0.110011526
272632742,cmoon55,10,2061,375,878,11,24,41.677524275,40-49,565,6,25,31,56,56,25,31,9,3.0670459163,7424.3692287743,0.0978031346,0.0597402597,0.22222222,0,135,1.929403032769429E-4,6.54302E-4,6.7131425E-4,71,0.33227944,5,0,200,0,0,-0.11005722
45199534,n00b_blogger,10,1640,126,154,2,468,44.5959936342,40-49,560,5,11,15,26,26,11,15,10,3.4018691589,2848.7639677228,0.0442471421,0.0569230769,0.1764706,0,135,9.508664593647928E-5,3.0198556E-4,3.0983734E-4,505,0.28655463,5,0,199,0,0,-0.11008403
499819985,dghartley1959,10,4046,258,957,3,168,47.5137530355,40-49,681,7,11,15,26,26,11,15,9,3.1166192605,3177.0027687668,0.0410062509,0.0353846154,0.1625,0,135,8.425590841064526E-5,3.0198556E-4,3.0983734E-4,99,0.27272728,7,0,201,0,0,-0.11022728
1080115680,CArgyleOFL,10,366,66,84,2,0,29.6307691493,20-29,167,5,7,7,14,14,7,7,10,3.5355546526,126.7107275996,0.0243614382,0.1373626374,0.45555556,0,135,7.677257545733362E-5,2.0132371E-4,2.0655822E-4,257,0.56593406,0,0,203,0,0,-0.1103785
963122683,LadyofYork,10,10783,748,1991,6,500,51.5616848934,50-59,692,8,51,68,119,119,51,68,9,2.8646891508,40566.7285772461,0.2330058592,0.0304799886,0.108893216,0,135,3.054503839531233E-4,0.001308604,0.0013426285,99,0.21933265,70,0,209,0,0,-0.110439434
541390165,joel_1067,10,307,23,73,1,12,30.2978441788,30-39,506,4,1,4,5,5,1,4,11,3.967899228,0,0.0033205878,0.2,0.41666666,0,135,6.487349637491868E-5,5.0330927E-5,5.1639556E-5,99,0.5272727,2,1,200,1,0.005,-0.11060604
279655508,TIBETANS,10,76535,5053,5519,199,182,55.6115641755,50-59,897,10,23,21,44,44,23,21,9,3.4112149533,5774.0961067063,0.0605666136,0.0253699789,0.1323077,0,135,1.683448540325781E-4,6.0397113E-4,6.196747E-4,99,0.24358974,277,0,201,0,0,-0.11128204
135292251,RitchieTrev,10,2454,452,731,15,17,41.0860837465,40-49,640,6,20,22,42,42,20,22,10,3.1353108492,6523.0289166521,0.0814271952,0.0423925668,0.25108224,0,135,1.8965473135727597E-4,5.2847475E-4,5.4221536E-4,71,0.36253196,2,0,200,0,0,-0.11144972
27371671,Norm_Farrell,10,2808,342,612,6,0,50.3805199123,50-59,686,6,31,49,80,80,31,49,9,2.9788703779,16637.4677978213,0.0835669704,0.0292721519,0.10218703,0,135,2.0950067410287757E-4,8.0529484E-4,8.262329E-4,71,0.21425742,96,1,201,1,0.0049751244,-0.11207039
14363552,alainsaffel,10,17952,2533,1005,212,75,54.1232891801,50-59,735,7,19,17,36,36,19,17,10,3.5062982527,9410.6959289052,0.0800496224,0.0277777778,0.11038961,0,135,2.2439181174704775E-4,5.0330925E-4,5.1639555E-4,353,0.22259136,6,0,200,0,0,-0.11220175
295402999,SimonTresim37,10,2802,2436,2370,15,11,51.2480158475,50-59,686,6,17,16,33,33,17,16,9,3.3640796424,5172.8106884497,0.0371144852,0.0340909091,0.20588236,0,135,1.3359726772024948E-4,4.5297833E-4,4.64756E-4,267,0.3181818,5,0,200,0,0,-0.11229944
221414237,kris_purdy,10,461,120,279,1,0,20.8617597695,20-29,405,4,0,8,8,8,0,8,10,3.5792038993,0,0,0.0892857143,0.10714286,0,273,4.4780486537007367E-5,0,2.5819778E-5,257,0.21978022,1,0,200,0,0,-0.11263736
28893318,sabrinasoti,10,20291,742,1299,24,587,47.1040171929,40-49,722,8,16,24,40,40,16,24,11,3.6578626575,5428.5084696148,0.0507107154,0.0679487179,0.21082622,0,135,1.1982029882515193E-4,4.2781286E-4,4.1311645E-4,353,0.32367346,15,1,200,1,0.005,-0.11284724
178287743,CH_Cartoon,10,1442,2889,749,112,104,50.2746663342,50-59,718,5,45,10,55,55,45,10,10,3.8911011784,24087.4423659078,0.0615934383,0.037037037,0.08309179,0,135,5.360555077382388E-4,0.0011576113,0.0010327911,343,0.19596492,93,1,200,1,0.005,-0.11287313
18666861,Mimiges,10,2714,159,180,2,9,42.3340116396,40-49,632,6,8,3,11,11,8,3,9,3.7334416904,40.3879879043,0.0489361475,0.1272727273,0.25,0,135,1.25603457425194E-4,2.2648917E-4,2.32378E-4,99,0.36290324,20,1,198,1,0.0050505051,-0.11290324
464918785,TradeEthically,10,117274,2907,2908,85,6,50.7034248976,50-59,718,10,7,10,17,17,7,10,10,3.2230800488,3442.0034389732,0.0395619243,0.0036764706,0.015151516,0,135,7.154945180344332E-5,2.0132371E-4,2.0655822E-4,99,0.12865497,0,0,201,0,0,-0.113503454
474546826,CharleyCanucky,10,22849,724,1785,5,1092,41.7450497176,40-49,784,9,18,27,45,45,18,27,10,3.1873222267,4409.7643961783,0.196204913,0.048989899,0.1908046,0,135,1.805930909200322E-4,4.781438E-4,4.905758E-4,353,0.3044466,66,36,205,36,0.1756097561,-0.113642
215406950,BrettMineer,10,10765,1788,1530,68,24,60.3818015566,60-69,758,7,45,21,66,66,45,21,9,3.2466477042,13982.8089027349,0.1908070505,0.0431235431,0.11170213,0,135,4.0655098136158037E-4,0.0011576113,0.0011877097,71,0.22575589,21,0,200,0,0,-0.11405376
274214651,rabbitupnorth,10,3219,134,314,9,666,42.9255820356,40-49,660,6,5,4,9,9,5,4,10,3.9878098334,1920.8918045044,0.0124343286,0.0277777778,0.2,0,135,7.81387450241186E-5,1.5099278E-4,1.5491867E-4,257,0.31428573,3,0,200,0,0,-0.11428573
234909466,opticverve,10,11626,264,307,3,828,45.6540875309,40-49,692,7,10,10,20,20,10,10,10,3.4782608696,958.2349527112,0.0472432061,0.0368421053,0.12820514,0,135,2.379894382373353E-4,2.768201E-4,2.8401756E-4,99,0.24252874,6,0,198,0,0,-0.1143236
16871500,dawnskarma,10,1030,287,781,3,6,38.123867756,30-39,536,5,6,18,24,24,6,18,10,3.3124746038,1094.9077522005,0.0308738302,0.0507246377,0.14052288,0,135,1.2086583657882202E-4,1.7615824E-4,1.8073844E-4,99,0.2557652,3,0,195,0,0,-0.11524232
14195066,matness,10,16493,2430,1909,131,7552,,,779,8,53,48,101,101,53,48,9,3.0552620886,36087.0594540431,0.1439285577,0.0206930693,0.08989071,0,135,4.4537082150766983E-4,0.001358935,0.001394268,267,0.2051478,101,1,200,1,0.005,-0.11525709
322615343,arsenaultashton,10,396,211,201,2,5,42.7397360469,40-49,671,6,11,9,20,20,11,9,10,3.4205607477,1344.5023771157,0.0860140251,0.0447368421,0.26363635,0,135,8.466604178277168E-5,3.0198556E-4,3.0983734E-4,353,0.37916666,21,0,189,0,0,-0.11553031
224366663,ItsRyanClayton,10,8355,1655,1890,74,12,65.8833786466,60-69,759,7,41,44,85,85,41,44,9,3.0963023161,18589.074840699,0.1127485754,0.037535014,0.09933436,0,135,3.4925038064918454E-4,0.0010569495,0.0010844307,71,0.21506011,154,0,201,0,0,-0.11572575
833988769,CandiceBergenMP,10,336,896,416,24,5,49.5121816276,40-49,654,4,80,30,110,110,80,30,10,3.3937423811,30668.5022707381,0.3485375396,0.0445371143,0.092215255,0,135,9.158040738099111E-4,0.0020384025,0.0020655822,353,0.2080821,88,1,200,1,0.005,-0.115866845
420351613,wildwalkerwoman,10,48413,1371,792,77,1726,52.6527243275,50-59,779,9,16,11,27,27,16,11,9,3.5424624137,1573.5485071188,0.0425851128,0.0299145299,0.07631579,0,135,1.321837556379307E-4,4.2781286E-4,4.3893623E-4,99,0.1923077,30,0,201,0,0,-0.11599191
216475552,darrenhill1,10,4313,1523,847,72,5,52.1885978924,50-59,731,7,20,16,36,36,20,16,10,3.4140593255,4939.6398988473,0.0640790725,0.0619047619,0.19,0,135,1.9221800087561476E-4,5.2847475E-4,5.4221536E-4,257,0.30625364,31,0,200,0,0,-0.11625364
18547284,scotthpayne,10,4468,770,1461,30,4,44.6784587566,40-49,686,6,52,88,140,140,52,88,9,2.867533523,54880.5637237562,0.1906256554,0.0221479959,0.07144457,0,135,4.0612688140266215E-4,0.0013337695,0.0013684483,257,0.18773612,23,6,200,6,0.03,-0.11629155
217251219,iiibooo,10,12061,1704,1787,70,5,43.4392133723,40-49,770,7,15,14,29,29,15,14,9,3.440877692,3396.9310414739,0.0311697069,0.0467980296,0.25,0,135,1.6928923726516296E-4,4.0264742E-4,4.1311645E-4,267,0.36640212,3,0,199,0,0,-0.11640212
21379617,Manitobalex,10,32815,337,285,22,91,46.3301739863,40-49,774,8,9,0,9,9,9,0,0,0,0,0.0272082106,0.1805555556,0.29166666,0,21,9.999365261716786E-5,2.5165462E-4,0,353,0.40808824,13,0,202,0,0,-0.11642158
960221840,ZE_CAN,10,1834,72,90,1,134,39.6830212714,30-39,568,6,10,9,19,19,10,9,10,3.4859813084,1088.0943013471,0.0351202966,0.0555555556,0.17582418,0,135,9.888452263375596E-5,2.768201E-4,2.8401756E-4,99,0.2923077,30,0,199,0,0,-0.11648352
379906635,ashman213,10,249,31,75,0,0,32.8715828408,30-39,378,4,2,4,6,6,2,4,11,4.0134091833,12.1830189789,0.0053054548,0.1333333333,0.3,0,135,5.1793337863069414E-5,7.549639E-5,7.7459335E-5,257,0.41666666,1,2,200,1,0.005,-0.11666666
123662862,ItsMeMarisol,10,43662,779,621,29,518,38.7249537725,30-39,727,9,3,2,5,5,3,2,11,4.3713937424,215.2315079365,0.0114228572,0.05,0.083333336,0,135,6.570566793854326E-5,1.00661855E-4,1.0327911E-4,303,0.2,1,0,201,0,0,-0.116666664
1013523684,Daniel_Nikpayuk,10,1967,354,423,5,109,48.8546100314,40-49,668,6,37,43,80,80,37,43,9,2.9362047948,25962.0308949845,0.1992325333,0.0246835443,0.13319239,0,135,2.356354255016566E-4,9.562876E-4,9.811516E-4,99,0.25,89,0,203,0,0,-0.11680761
832349402,ndp_vinorth,10,2877,65,68,6,8,27.9838363215,20-29,359,6,13,1,14,14,13,1,10,3.8232425843,47.8507702721,0.0526899777,0.1703296703,0.3525641,0,135,1.2352658911244323E-4,3.5231648E-4,3.6147688E-4,257,0.4695652,3,5,216,5,0.0231481481,-0.1170011
398688825,h_mulligan,10,4738,618,957,15,369,46.004833533,40-49,692,7,18,25,43,43,18,25,10,3.3075985372,8133.1992273321,0.0567262559,0.0459579181,0.2,0,135,1.5572711994186537E-4,4.781438E-4,4.905758E-4,343,0.31721312,12,0,200,0,0,-0.11721312
19793293,AnthonyMartinNS,10,10349,1372,1142,55,30,53.8545639214,50-59,744,7,21,24,45,45,21,24,10,3.5087362861,5769.6664755498,0.0574785301,0.053030303,0.22354497,0,135,2.834778764193477E-4,5.536402E-4,5.680351E-4,343,0.34095162,8,1,200,1,0.005,-0.11740665
121785205,RonnieNDP,10,1953,149,374,4,451,44.0573048505,40-49,600,6,20,27,47,47,20,27,9,3.2218610321,5198.1697904023,0.06626758,0.0740055504,0.18151261,0,135,1.3044458560397039E-4,5.2847475E-4,5.4221536E-4,257,0.29973552,42,1,200,1,0.005,-0.11822291
473482276,BradLafortune,10,3829,463,876,12,283,48.5163606386,40-49,697,7,58,75,133,133,58,75,9,2.8362454287,46927.7094960848,0.2650802351,0.0260309866,0.10431972,0,135,3.574875055102489E-4,0.0014847623,0.0015233669,257,0.22267513,55,0,200,0,0,-0.11835541
1173231918,E4Dca,10,100,176,311,8,0,52.4275983959,50-59,651,3,45,34,79,79,45,34,10,3.2202356766,40706.1576757929,0.0890349718,0.0243427459,0.07350272,0,135,4.4827532763138067E-4,0.0011576113,0.0011360702,283,0.19208072,142,0,115,0,0,-0.118578
272517144,NikSpohr,10,1366,395,419,26,1,42.8924676799,40-49,649,5,30,18,48,48,30,18,10,3.5396180414,3102.7598964488,0.1043676707,0.1201241135,0.28603604,0,135,1.937905850315161E-4,7.8012934E-4,8.0041314E-4,257,0.40462962,23,0,200,0,0,-0.11859358
229545816,cluimes,10,1941,963,1095,10,24,56.6694369413,50-59,685,6,35,22,57,57,35,22,10,3.7054043072,2319.6209656072,0.2405442467,0.0648496241,0.1974359,0,135,3.8110748815959434E-4,9.0595667E-4,9.036922E-4,353,0.3160667,5,1,200,1,0.005,-0.1186308
258673327,vradrian99,10,1975,209,824,3,2,38.7954923148,30-39,583,6,3,13,16,16,3,13,10,3.283218204,511.2745661473,0.020328211,0.0666666667,0.1474359,0,135,6.251477190312775E-5,1.00661855E-4,1.0327911E-4,71,0.26612905,0,0,200,0,0,-0.11869315
214494357,DartmouthDerek,10,7181,1149,1501,22,653,59.4624759833,50-59,755,7,34,30,64,64,34,30,9,3.107679805,37041.2291742955,0.1019069535,0.0200892857,0.09166667,0,135,2.4598618084809096E-4,8.807912E-4,9.036922E-4,343,0.21037851,45,0,200,0,0,-0.11871184
27261031,johnkapp,10,18702,554,788,7,2073,52.7882179932,50-59,740,8,27,45,72,72,27,45,10,3.0451036164,17558.2354137458,0.0960547533,0.0361893584,0.13091788,0,135,1.8326877034857613E-4,7.0463296E-4,7.2295376E-4,257,0.24993443,18,0,201,0,0,-0.11901655
142699843,MlleAuroreB,10,29684,388,348,21,615,,,768,8,4,3,7,7,4,3,10,3.8980089395,102.9870949644,0.0127838303,0.0476190476,0.33333334,0,135,7.046748824431264E-5,1.2582731E-4,1.2909889E-4,257,0.45238096,2,0,200,0,0,-0.11904762
406294981,RayMcLennan1,10,13116,671,1082,5,74,38.1868510643,30-39,664,7,5,7,12,12,5,7,10,3.3535148314,537.9976495847,0.0434249836,0.0075757576,0.04761905,0,135,7.436757069406228E-5,1.5099278E-4,1.5491867E-4,353,0.16666667,3,0,201,0,0,-0.11904762
759031160,TimDFowler,10,1357,87,139,0,151,40.3119103504,40-49,620,5,2,3,5,5,2,3,11,3.9000406339,108.1285437937,0.0067771957,0.05,0.33333334,0,135,5.5810698578089855E-5,7.549639E-5,7.7459335E-5,257,0.45238096,12,0,200,0,0,-0.11904762
716501756,CopperBronzed,10,12531,281,157,4,471,53.0517993968,50-59,748,8,19,9,28,28,19,9,10,3.4526615197,1265.4787986949,0.1026305361,0.0515873016,0.19005848,0,135,2.6843727478085763E-4,5.0330925E-4,5.1639555E-4,99,0.30917874,57,0,202,0,0,-0.11912026
264003758,NadineMBailey,10,3753,490,362,20,14,40.3131845574,40-49,676,6,17,6,23,23,17,6,10,3.5286468915,1635.8232805478,0.0638330147,0.0533596838,0.14705883,0,135,1.6498591508486057E-4,4.5297833E-4,4.64756E-4,257,0.26638657,20,0,200,0,0,-0.11932774
138956534,NDPmc33,10,3553,291,561,2,171,43.4562103666,40-49,682,6,18,9,27,27,18,9,10,3.4819179195,1371.837208465,0.0866090639,0.0997150997,0.24675325,0,135,1.636267753712627E-4,4.781438E-4,4.905758E-4,257,0.3661013,21,11,200,11,0.055,-0.11934805
26854642,gjsproule,10,911,1812,2000,80,65,46.5364007819,40-49,618,5,41,58,99,99,41,58,10,3.0442909386,30609.969415489,0.2703585159,0.0278293135,0.11857924,0,135,4.0146655398267756E-4,0.0010569495,0.0010586109,353,0.23793103,3,0,200,0,0,-0.11935179
250448044,mclabradore,10,15794,526,347,11,11,47.9006657256,40-49,768,8,27,14,41,41,27,14,9,3.6420154409,5121.255315291,0.067486091,0.0554878049,0.16666667,0,135,2.7329324841562864E-4,7.0463296E-4,7.2295376E-4,343,0.28601876,30,3,202,3,0.0148514851,-0.11935209
257144050,ZachFleish,10,1024,249,484,3,5,38.201197464,30-39,593,5,5,1,6,6,5,1,10,4.0999593661,118.9749817092,0.0088905965,0.0666666667,0.13333334,0,135,6.945595479766388E-5,1.5099278E-4,1.5491867E-4,257,0.25274727,3,0,200,0,0,-0.11941393
1099121384,bsnomore,10,282,200,884,0,8,42.5383602599,40-49,511,4,7,25,32,32,7,25,10,3.4010564811,227.7145424546,0.075769171,0.091733871,0.23666666,0,135,7.997652052183486E-5,2.0132371E-4,2.0655822E-4,353,0.35618347,3,1,198,1,0.0050505051,-0.11951681
1051948640,BCPolitico,10,96,142,551,0,0,20.2484776959,20-29,243,4,7,17,24,24,7,17,10,3.4595692808,775.524572314,0.0131096325,0.115942029,0.24853802,0,135,6.24244698224075E-5,2.0132371E-4,2.0655822E-4,71,0.36868685,0,0,109,0,0,-0.12014883
24851229,kirstenmay13,10,773,303,761,4,15,37.3318514712,30-39,503,5,16,22,38,38,16,22,10,3.3628606258,1604.4079076196,0.0735019688,0.0889046942,0.23280424,0,135,1.0354224309473308E-4,4.2781286E-4,4.3893623E-4,353,0.35328013,4,5,198,5,0.0252525253,-0.12047589
145703064,M_Snopes,10,1346,494,787,6,41,51.9789600724,50-59,638,5,19,19,38,38,19,19,10,3.3291344982,4648.2185175663,0.0647897022,0.0490753912,0.21376811,0,135,1.8128206254523584E-4,5.0330925E-4,5.1639555E-4,257,0.33426574,3,1,167,1,0.005988024,-0.12049763
22700185,peterlouwe,10,2912,1305,1261,22,4,46.6316528912,40-49,642,6,16,20,36,36,16,20,10,3.1210889882,10270.6370538765,0.0605079479,0.0071428571,0.039473683,0,135,1.9165358922912978E-4,4.2781286E-4,4.3893623E-4,71,0.160148,8,0,200,0,0,-0.120674317
63542749,SusanRab,10,838,260,386,6,4,39.352089533,30-39,609,5,12,12,24,24,12,12,10,3.5583096302,3159.072418971,0.0259944789,0.0434782609,0.12916666,0,135,1.1510137792610677E-4,3.27151E-4,3.3565713E-4,257,0.25,1,0,200,0,0,-0.12083334
14696380,PatHanlon,10,6619,353,1112,23,3,41.3538190689,40-49,662,7,4,10,14,14,4,10,11,3.7269402682,3942.609701506,0.0223402798,0.043956044,0.12727273,0,135,9.366164443498463E-5,1.2582731E-4,1.2909889E-4,353,0.24833333,0,0,200,0,0,-0.1210606
30268687,jennahussein,10,489,238,536,3,55,50.5880762025,50-59,543,4,2,3,5,5,2,3,10,3.7935798456,65.894026457,0.0124447458,0.15,0.41666666,0,135,1.369297300185063E-4,7.549639E-5,7.7459335E-5,505,0.5378788,11,0,200,0,0,-0.12121214
336185834,JeffBuchananNDP,10,298,246,179,22,5,45.6104831247,40-49,581,4,24,14,38,38,24,14,10,3.4672897196,5257.3771160072,0.066923847,0.0697012802,0.20512821,0,135,1.5589571559009992E-4,6.291366E-4,6.4549444E-4,257,0.3263647,12,0,200,0,0,-0.12123649
6013662,infil00p,10,39867,2008,1384,138,3042,45.7222114044,40-49,770,9,19,9,28,28,19,9,9,3.6448598131,5667.0626761542,0.0457594854,0.0291005291,0.053333335,0,135,1.9415180752583173E-4,5.0330925E-4,4.905758E-4,71,0.17487922,10,0,199,0,0,-0.121545885
174137795,WoodfordCKNW980,10,17277,3504,1710,155,2,54.1346034958,50-59,784,8,73,26,99,99,73,26,10,3.3624542869,18349.3040562764,0.2137608048,0.0353535354,0.07121349,0,135,5.968548944695687E-4,0.0018622442,0.0018848438,71,0.19333915,131,0,203,0,0,-0.12212566
626639419,politicalpoints,10,2188,808,671,10,1,51.2228437082,50-59,675,5,63,103,166,166,63,103,9,2.6879317351,98377.3241200957,0.2151469649,0.0124497992,0.028413488,0,135,3.7598755752461804E-4,0.0016105897,0.001626646,505,0.15080369,55,2,200,2,0.01,-0.122390202
25636566,grahamur,10,974,1431,1961,40,117,46.5870481135,40-49,579,5,7,9,16,16,7,9,10,3.4169036977,1389.9478660907,0.0122898285,0.0458333333,0.17777778,0,135,1.4271826443618967E-4,2.0132371E-4,2.0655822E-4,283,0.30040324,4,1,200,1,0.005,-0.12262546
237901118,Robert_Johnston,10,348,223,468,12,1,34.270300744,30-39,552,3,12,4,16,16,12,4,11,4.0174725721,661.8347523117,0.0223595799,0.0458333333,0.12179487,0,135,1.1702051979021944E-4,3.27151E-4,3.3565713E-4,283,0.24456522,2,20,200,15,0.075,-0.12277035
357877628,iankokomo_01,10,2960,246,1703,2,66,41.7610924068,40-49,629,6,6,19,25,25,6,19,10,3.4705404307,782.1074385978,0.0450314038,0.1066666667,0.22894737,0,135,1.1249344809427318E-4,1.7615824E-4,1.8073844E-4,353,0.35191637,1,0,200,0,0,-0.122969
811289166,TxAnon,10,6516,833,1141,11,4105,53.215295598,50-59,739,7,92,100,192,192,92,100,9,2.7817960179,147262.663721912,0.2344448208,0.0119437173,0.05045045,0,135,6.81504332072574E-4,0.002340388,0.0023754195,99,0.17386007,247,0,289,0,0,-0.12340962
485043632,1_Car_Guy,10,17046,924,2000,16,1129,39.1541407478,30-39,763,8,14,21,35,35,14,21,10,3.3982121089,5003.6496067106,0.0374558448,0.0512605042,0.21645021,0,135,1.478350734971075E-4,3.7748195E-4,3.8729666E-4,343,0.34017545,13,0,200,0,0,-0.12372524
185852300,SinAspen,10,7671,533,930,11,1040,45.7868885756,40-49,726,7,53,88,141,141,53,88,9,2.8569687119,58255.8012802398,0.2388812678,0.0211246201,0.081333,0,135,4.534490285917001E-4,0.001358935,0.001394268,257,0.20517015,72,1,200,1,0.005,-0.12383715
855360626,trishqualtrough,10,596,88,220,0,19,38.0065553949,30-39,512,5,12,19,31,31,12,19,10,3.4099959366,2193.6442683843,0.0266889382,0.052688172,0.20263158,0,135,8.821019395854009E-5,3.27151E-4,3.3565713E-4,257,0.32670453,22,0,200,0,0,-0.12407295
25849601,sbaranski,10,6938,2181,1054,75,26,62.0575964101,60-69,754,7,72,23,95,95,72,23,10,3.3644859813,21391.5792720494,0.3478639047,0.0354983203,0.07467532,0,135,6.870413769012772E-4,0.0018370788,0.0018332042,353,0.19877419,97,0,200,0,0,-0.12409887
185947193,MVLibertas,10,55807,660,611,18,3,45.4887664419,40-49,785,9,26,26,52,52,26,26,10,3.2885006095,11539.555558321,0.2364233218,0.0475113122,0.14864865,0,135,3.9431414507479386E-4,6.794675E-4,6.97134E-4,353,0.27317956,42,2,203,2,0.0098522167,-0.12453091
33089851,monettechris,10,1252,240,405,10,12,32.7412938399,30-39,567,5,7,5,12,12,7,5,10,3.6135717188,359.5665908698,0.0286002677,0.1060606061,0.4107143,0,135,1.4421717307639607E-4,2.0132371E-4,2.0655822E-4,505,0.5352657,2,0,199,0,0,-0.1245514
959017472,PhilJFBoychuk,10,346,94,372,1,2,41.9702140717,40-49,579,4,9,19,28,28,9,19,10,3.2519301097,2754.4854293895,0.0241623221,0.0489417989,0.1404762,0,135,1.1396660114703814E-4,2.5165462E-4,2.5819778E-4,257,0.2653419,32,0,200,0,0,-0.1248657
221355278,LJNor,10,1734,219,700,2,63,42.4411485911,40-49,526,6,3,10,13,13,3,10,10,3.5969118245,283.3065394023,0.0106570709,0.0641025641,0.15555556,0,135,8.676892603523139E-5,1.00661855E-4,1.0327911E-4,71,0.2804878,10,1,202,1,0.004950495,-0.12493224
911582797,CrossingTheT,10,649,184,687,0,41,30.1834021039,30-39,473,5,5,8,13,13,5,8,10,3.4286875254,3539.771613853,0.0174690177,0.0064102564,0.017857144,0,135,7.828396947845113E-5,1.5099278E-4,1.5491867E-4,283,0.14285715,2,0,200,0,0,-0.125000006
431867067,allisoncorey,10,2305,230,770,1,257,42.222640512,40-49,628,5,15,40,55,55,15,40,10,3.1682242991,5616.3953614741,0.088099807,0.0760942761,0.17663345,0,135,1.0210041975986707E-4,4.0264742E-4,4.1311645E-4,353,0.30187267,8,0,200,0,0,-0.12523922
44238517,StephHerold,10,26332,9063,5598,620,12,61.4200134097,60-69,889,7,15,10,25,25,15,10,10,3.6936204795,9660.6697410275,0.0287092443,0.0166666667,0.05882353,0,135,1.492167290469121E-4,4.0264742E-4,3.8729666E-4,257,0.18461539,21,0,201,0,0,-0.12579186
40697478,JamesJJRyan,10,5319,1192,1976,22,15,51.3618522054,50-59,743,7,54,52,106,106,54,52,10,3.0743600163,51478.9001879135,0.1518479501,0.0364779874,0.07969188,0,135,4.69893691255592E-4,0.0013841004,0.001394268,257,0.20567833,94,0,202,0,0,-0.12598645
24952644,brianlabelle,10,10159,837,223,42,81,50.191219558,50-59,744,7,38,9,47,47,38,9,10,3.5351483137,3703.3572234617,0.1640444876,0.0397779833,0.09886202,0,135,2.957521353934328E-4,9.814531E-4,0.0010069713,257,0.22508772,31,0,201,0,0,-0.1262257
327747513,John_Acton,10,996,59,133,0,0,27.1905627017,20-29,366,5,6,14,20,20,6,14,9,3.3587972369,2009.9781751954,0.0211137611,0.0473684211,0.13186814,0,135,7.048133352535397E-5,1.7615824E-4,1.8073844E-4,257,0.25833333,1,1,199,1,0.0050251256,-0.12646519
497410944,NafizNDP,10,3438,408,1601,4,2,34.7408838561,30-39,611,6,56,133,189,189,56,133,8,2.7208451849,101557.335330893,0.2019014143,0.0352358437,0.09617862,0,135,4.2174669121556745E-4,0.0014344314,0.0014717274,257,0.22267026,47,2,200,2,0.01,-0.12649164
475308891,iChinadian,10,12997,445,205,22,0,41.5462941251,40-49,735,8,6,3,9,9,6,3,9,3.527021536,588.2108292986,0.0211605827,0.0138888889,0.04761905,0,135,7.329699973660596E-5,1.7615824E-4,1.8073844E-4,505,0.17424242,17,0,208,0,0,-0.12662337
25487241,talkingfrog,10,16649,602,33,17,72,55.3976726638,50-59,738,8,30,0,30,30,30,0,0,0,0,0.1369973192,0.0551724138,0.09425288,0,77,2.7643903708904696E-4,7.8012934E-4,0,99,0.22098215,89,0,201,0,0,-0.12672927
319749893,dvmlifestyle,10,2633,72,524,0,163,29.0711439353,20-29,593,6,5,8,13,13,5,8,10,3.5457131247,39.2142906716,0.0802512281,0.0833333333,0.39285713,0,135,7.410198682866628E-5,1.5099278E-4,1.5491867E-4,353,0.51960784,6,0,200,0,0,-0.12675071
351237761,JoshPringleSSM,10,503,152,449,5,3,31.3191926424,30-39,489,4,4,7,11,11,4,7,11,3.8805363673,13.3860152399,0.0407846949,0.1636363636,0.3,0,135,7.380895520300858E-5,1.2582731E-4,1.2909889E-4,353,0.42682928,0,0,200,0,0,-0.12682928
267728489,annickdes,10,2207,491,666,6,5,45.5340187543,40-49,692,6,11,14,25,25,11,14,10,3.516050386,2537.7809531378,0.0222229779,0.0633333333,0.23333333,0,135,1.392247801937767E-4,3.0198556E-4,3.0983734E-4,267,0.36021507,5,0,200,0,0,-0.12688174
610195349,Vav_j,10,1914,148,402,3,222,41.666984004,40-49,584,6,12,18,30,30,12,18,10,3.1962616822,3418.3177268373,0.0596214094,0.0356321839,0.15789473,0,135,1.1324103908864216E-4,3.27151E-4,3.3565713E-4,257,0.2851852,16,0,200,0,0,-0.12729047
93675048,ValLali,10,3155,312,852,4,23,46.2052995878,40-49,623,6,9,13,22,22,9,13,10,3.5152377082,609.1421167169,0.0326411606,0.0952380952,0.41758242,0,135,1.151248803676207E-4,2.5165462E-4,2.5819778E-4,257,0.544898,6,1,201,1,0.0049751244,-0.12731558
622384821,ryanjamula,10,296,194,231,3,8,40.4671811604,40-49,600,4,24,22,46,46,24,22,9,3.3673303535,7791.0828097516,0.0879618346,0.068115942,0.25123152,0,135,1.7534042968167803E-4,6.291366E-4,6.4549444E-4,257,0.3787561,23,0,201,0,0,-0.12752458
590650380,BradLeeSev,10,2170,114,243,0,111,44.3696720286,40-49,576,5,21,36,57,57,21,36,9,3.0698902885,10101.9532351234,0.0845019187,0.039160401,0.118589744,0,135,1.4058025208163718E-4,5.536402E-4,5.680351E-4,99,0.24627976,31,1,212,1,0.0047169811,-0.127690016
124295860,MakinsonAQ,10,2383,660,903,16,22,42.2224166373,40-49,681,6,58,43,101,101,58,43,10,3.154002438,27052.5257594594,0.2043929185,0.0425742574,0.15332429,0,135,4.260041473464425E-4,0.0014847623,0.0015233669,257,0.28113025,39,15,199,15,0.0753768844,-0.12780596
169259398,JamesWoodHerald,10,4829,1984,602,98,0,58.752691781,50-59,735,6,68,11,79,79,68,11,10,3.5895977245,10954.7949146078,0.365538755,0.0509574813,0.101875536,0,135,8.716294091971283E-4,0.001736417,0.0017557449,353,0.2298414,33,4,200,4,0.02,-0.127965864
308865688,mcbriena,10,1932,541,785,8,1,43.880715207,40-49,675,6,27,33,60,60,27,33,10,3.118244616,13144.1566717542,0.115927103,0.0296610169,0.14962122,0,135,2.859649422903394E-4,7.0463296E-4,7.2295376E-4,353,0.2777778,19,0,199,0,0,-0.12815658
413423918,MPJoySmith,10,459,955,472,48,0,47.1088899219,40-49,705,4,37,14,51,51,37,14,11,3.8179601788,11208.8069015905,0.1666344923,0.071372549,0.1358885,0,135,3.8850262583297994E-4,9.562876E-4,9.811516E-4,353,0.2642089,67,13,199,13,0.0653266332,-0.1283204
232683104,CoastEmergency,10,1945,739,2001,35,26,40.7334995726,40-49,586,6,2,5,7,7,2,5,10,3.9301097115,52.4383990735,0.007534485,0.119047619,0.1904762,0,135,5.449043069387584E-5,7.549639E-5,7.7459335E-5,71,0.31904763,0,0,200,0,0,-0.12857143
58684655,Adam_Stirling,10,16841,1534,333,80,78,53.1808604601,50-59,775,8,33,2,35,35,33,2,11,4.2990654206,135.2302295481,0.1078953778,0.081512605,0.12310606,0,135,3.709235122832979E-4,8.556257E-4,8.7787246E-4,71,0.25174826,45,0,200,0,0,-0.1286422
455145030,DomenicShelley,10,805,61,282,0,10,43.2247268359,40-49,610,6,13,43,56,56,13,43,9,2.9272653393,4999.2632435724,0.0562292621,0.0334415584,0.093023255,0,135,8.345660126582117E-5,3.5231648E-4,3.6147688E-4,99,0.22186427,29,0,201,0,0,-0.128841015
96074076,MatthewLou,10,460,186,320,3,6,32.6956053306,30-39,522,5,4,3,7,7,4,3,10,3.5826899634,577.26235178,0.0236065175,0.0238095238,0.05,0,135,8.11512412993586E-5,1.2582731E-4,1.2909889E-4,71,0.17948718,2,0,200,0,0,-0.12948718
268896921,A_Man_From_TO,10,1385,406,1192,7,22,44.786716739,40-49,624,5,30,58,88,88,30,58,9,2.9439252336,32865.3137285733,0.0743909964,0.0208986416,0.053379953,0,135,1.6572437034721225E-4,7.8012934E-4,8.0041314E-4,257,0.18355796,23,0,200,0,0,-0.130178007
840925669,missmaplesleafs,10,517,41,213,1,235,26.2404633375,20-29,455,5,2,6,8,8,2,6,10,3.7224705404,73.8126420158,0.0177241582,0.1785714286,0.33333334,0,135,5.019494915922081E-5,7.549639E-5,7.7459335E-5,99,0.46363637,5,0,199,0,0,-0.13030303
192427701,Stephen_G_Moore,10,2821,361,254,16,1,,,661,5,28,13,41,41,28,13,10,3.5644047135,2534.1585267125,0.0980719738,0.0792682927,0.22183909,0,135,1.892295652562066E-4,7.297984E-4,7.487736E-4,257,0.3521858,12,4,185,4,0.0216216216,-0.13034671
107516300,mtlunasea,10,6038,1200,1542,45,1294,46.7813777577,40-49,761,8,10,14,24,24,10,14,8,3.4827305973,1119.1925868282,0.0237017252,0.0688405797,0.32380953,0,135,1.1257868643882019E-4,2.768201E-4,2.8401756E-4,99,0.45424837,4,0,200,0,0,-0.13043884
117482770,johnluton,10,1140,161,113,4,3,40.8193096627,40-49,543,4,6,2,8,8,6,2,11,4.4225924421,290.6334040411,0.0091983915,0.125,0.17857143,0,135,7.166100728945432E-5,1.7615824E-4,1.8073844E-4,71,0.3090909,5,2,200,2,0.01,-0.13051947
257144150,EVCoffeehouse,10,697,637,1028,31,20,42.7274484595,40-49,653,5,7,7,14,14,7,7,10,3.6598943519,3900.7652578907,0.0227345046,0.021978022,0.06944445,0,135,1.1984734683943261E-4,2.0132371E-4,2.0655822E-4,257,0.2,7,0,199,0,0,-0.13055555
251116380,BradButtMP,10,3413,1654,725,91,3,53.6810325023,50-59,683,5,65,15,80,80,65,15,10,3.5180820805,11005.9865135266,0.2488032395,0.0705696203,0.122475855,0,135,7.0554854241658E-4,0.0016609206,0.0016524658,353,0.25307345,34,7,200,7,0.035,-0.130597595
286985249,VE3ZKS,10,11941,335,956,8,218,36.2594207255,30-39,711,8,32,45,77,77,32,45,9,3.1519707436,12120.6386796436,0.128543415,0.0647641832,0.1480698,0,135,2.276227483321189E-4,8.304603E-4,8.5205265E-4,257,0.2787337,25,9,203,8,0.039408867,-0.1306639
32936416,jamesbridges16,10,1822,215,566,4,19,42.5733323392,40-49,591,6,9,11,20,20,9,11,10,3.4701340918,534.6076347717,0.0253232941,0.1026315789,0.34065935,0,135,1.2252183367870105E-4,2.5165462E-4,2.5819778E-4,505,0.471875,16,6,200,6,0.03,-0.13121565
518046429,RZaichkowski,10,969,172,276,0,10,48.8076891516,40-49,588,5,11,12,23,23,11,12,9,3.5091426249,2164.0976452054,0.0472079234,0.057312253,0.25641027,0,135,1.5820668682052201E-4,3.0198556E-4,3.0983734E-4,257,0.38813815,24,0,200,0,0,-0.13172788
268539428,Miss782,10,733,182,739,2,45,36.58765911,30-39,513,5,8,16,24,24,8,16,9,3.3665176757,5374.117411271,0.0252009266,0.0326086957,0.10294118,0,135,1.020079022918562E-4,2.2648917E-4,2.32378E-4,283,0.23467231,4,0,200,0,0,-0.13173113
227150191,seemetrolling,10,9582,358,1376,4,3999,45.4357715207,40-49,701,8,2,5,7,7,2,5,11,3.5940674523,119.0455644259,0.0051644498,0.0476190476,0.15,0,135,5.603373621892101E-5,7.549639E-5,7.7459335E-5,257,0.28181818,7,0,200,0,0,-0.13181818
529786217,dylanxpowell,10,6929,451,384,9,4216,49.2718965787,40-49,723,7,11,4,15,15,11,4,10,3.6757415685,4885.768088505,0.0326828012,0.0333333333,0.06818182,0,135,1.4392899921327693E-4,3.0198556E-4,3.0983734E-4,99,0.2,8,0,201,0,0,-0.13181818
21576515,alexabboud,10,18354,1911,697,98,963,58.1134998228,50-59,766,8,23,5,28,28,23,5,10,3.6135717188,1457.6794896438,0.0812876288,0.0476190476,0.11462451,0,135,2.926812165883812E-4,6.0397113E-4,6.196747E-4,353,0.246531,18,0,200,0,0,-0.13190649
581438207,BenDayle,10,3853,95,195,2,27,31.5106776914,30-39,547,7,12,10,22,22,12,10,10,3.5371800081,1868.9591952806,0.0305884656,0.0497835498,0.14583333,0,135,9.469687742277924E-5,3.27151E-4,3.3565713E-4,257,0.2777778,6,8,204,8,0.0392156863,-0.13194447
15031337,Geoff_Sharpe,10,9222,1829,1960,79,112,67.7501788895,60-69,761,7,79,61,140,140,79,61,9,2.9536773669,72170.3892943995,0.2831353641,0.027286742,0.07132188,0,135,5.100837491066581E-4,0.002013237,0.0020655822,505,0.2034583,72,0,201,0,0,-0.13213642
227143079,PrairieTweeter,10,5399,172,101,6,38,45.0292824574,40-49,664,7,9,2,11,11,9,2,11,3.8691588785,494.5419220499,0.0396260236,0.0545454545,0.125,0,135,9.964640937465303E-5,2.5165462E-4,2.5819778E-4,283,0.25714287,14,0,200,0,0,-0.13214287
331655040,BrianONDP,10,403,342,466,20,0,41.1424182777,40-49,572,4,31,24,55,55,31,24,10,3.3474197481,6298.2278669518,0.1023793718,0.0912457912,0.19242424,0,135,1.7035943417312687E-4,8.0529484E-4,8.262329E-4,257,0.32458204,4,1,200,1,0.005,-0.1321578
541582069,OpSharePanda,10,4535,2576,1726,59,4080,39.2579486471,30-39,780,8,20,15,35,35,20,15,8,3.5156440471,5596.6533881281,0.0470104068,0.0420168067,0.1904762,0,135,1.7481719778097895E-4,5.2847475E-4,5.4221536E-4,99,0.3227513,11,0,198,0,0,-0.1322751
273223103,MP_Host,10,180,65,451,0,13,34.9600922811,30-39,433,4,7,30,37,37,7,30,11,3.5168630638,1151.0201994751,0.0602293455,0.1403903904,0.26666668,0,135,6.874678673118247E-5,2.0132371E-4,2.0655822E-4,353,0.39935064,10,3,200,3,0.015,-0.13268396
875907876,AndersonforMLA,10,858,107,180,10,1,49.1631021303,40-49,657,6,7,6,13,13,7,6,10,3.895977245,116.049283952,0.017153009,0.108974359,0.30555555,0,135,8.654650136439959E-5,2.0132371E-4,2.0655822E-4,71,0.43833333,182,0,200,0,0,-0.13277778
215503616,CanonFan007D,10,1017,70,424,2,5,24.0741449052,20-29,398,5,5,5,10,10,5,5,11,3.7557903291,656.6100181217,0.0598378024,0.0888888889,0.2857143,0,135,6.761457480317765E-5,1.5099278E-4,1.5491867E-4,353,0.41897234,0,0,201,0,0,-0.13325804
16727909,earthdroplet,10,311,63,181,0,12,18.0259694988,10-19,272,3,2,1,3,3,2,1,10,3.935392117,0,0.0102734451,0.1666666667,0.5,0,135,5.744702824758924E-5,7.549639E-5,7.7459335E-5,283,0.6333333,1,0,200,0,0,-0.1333333
85229508,rileysmithphoto,10,5609,1047,735,25,44,47.6990105415,40-49,707,7,4,2,6,6,4,2,11,4.4859813084,5364.9498678905,0.0077572774,0.1,0.5,0,135,1.0157216431284551E-4,1.2582731E-4,1.2909889E-4,343,0.6333333,15,0,200,0,0,-0.1333333
544158224,thehelmetmag,10,51512,1275,1996,32,0,50.9189014207,50-59,701,9,3,1,4,4,3,1,2,1.6666666667,7359,0.0071026631,0.0833333333,0.16666667,0,62,5.4724855663500774E-5,1.00661855E-4,1.0327911E-4,99,0.3,2,0,202,0,0,-0.13333333
220851657,deetee128,10,5483,683,1228,18,325,44.167492812,40-49,706,7,1,4,5,5,1,4,10,4.0292563998,68.4097906574,0.0026278461,0.05,0.16666667,0,135,6.151372717866791E-5,5.0330927E-5,5.1639556E-5,505,0.3,2,0,200,0,0,-0.13333333
347414353,nmoore_33,10,796,102,507,0,14,19.3619818462,10-19,571,5,3,0,3,3,3,0,0,0,0,0.0143213748,0.1666666667,0.33333334,0,93,7.060886463409848E-5,1.00661855E-4,0,353,0.46666667,0,2,201,2,0.0099502488,-0.13333333
597968245,cosmicpoutine,10,32220,3183,2283,19,15112,43.0894681647,40-49,787,8,4,3,7,7,4,3,10,3.7533522958,355.1519623995,0.0110409896,0.0238095238,0.16666667,0,135,6.465426197155841E-5,1.2582731E-4,1.2909889E-4,505,0.3,32,0,200,0,0,-0.13333333
16116004,JPGallant,10,8333,371,398,13,32,56.7321433048,50-59,730,7,11,8,19,19,11,8,10,3.6298252743,1945.3979639467,0.0197319833,0.0380116959,0.2,0,135,2.0692948758394204E-4,3.0198556E-4,3.0983734E-4,505,0.33333334,38,0,200,0,0,-0.13333334
16194080,jimnewt,10,5346,16334,16987,70,322,55.0636922664,50-59,715,7,4,4,8,8,4,4,8,3.9000406339,9723.6994390287,0.0203318657,0,0,0,135,1.057052422573548E-4,1.2582731E-4,1.2909889E-4,148,0.13333334,1,0,200,0,0,-0.13333334
1130456989,rikobrinkman,10,295,64,63,3,26,42.7107536405,40-49,495,5,13,13,26,26,13,13,9,3.4437220642,1603.6831248056,0.0411964936,0.0630769231,0.13095239,0,135,1.0043098831433215E-4,3.5231648E-4,3.6147688E-4,505,0.26458037,7,3,200,3,0.015,-0.13362798
428057122,ILiveHereBC,10,5687,275,515,7,67,46.82518399,40-49,686,7,32,31,63,63,32,31,9,3.0190979277,13097.3405607661,0.1267096388,0.0330261137,0.10606061,0,135,1.9070342564491986E-4,8.304603E-4,8.262329E-4,99,0.23970297,15,0,206,0,0,-0.13364236
100893562,5gatos,10,10094,392,945,9,400,46.2939882981,40-49,721,7,9,21,30,30,9,21,10,3.3531084925,3271.9715725166,0.0664649515,0.0425287356,0.13571429,0,135,1.2293877534008804E-4,2.5165462E-4,2.5819778E-4,353,0.26936027,10,0,200,0,0,-0.13364598
433867215,JehCOh13,10,3554,401,541,3,1019,44.3188509182,40-49,710,6,35,36,71,71,35,36,9,2.9154815116,20387.903232359,0.1504617377,0.0094567404,0.061561562,0,135,1.8036128046208333E-4,9.0595667E-4,9.29512E-4,99,0.1952381,10,1,200,1,0.005,-0.133676538
14103847,garychisholm,10,1156,163,268,6,8,36.6554307053,30-39,560,5,2,4,6,6,2,4,10,3.9613978058,5.4796149677,0.0058800695,0.1,0.33333334,0,135,7.141302880969611E-5,7.549639E-5,7.7459335E-5,257,0.46703297,3,1,200,1,0.005,-0.13369963
1138100232,wrychrd,10,808,148,396,5,17,46.7810714971,40-49,581,5,5,5,10,10,5,5,9,3.6924014628,5063.016416458,0.0128317135,0.0222222222,0.04761905,0,135,7.74165254905639E-5,1.5099278E-4,1.5491867E-4,71,0.18131869,13,0,200,0,0,-0.13369964
17546396,mikes_r,10,5351,810,756,48,0,49.6702271743,40-49,694,6,20,12,32,32,20,12,10,3.5245835026,1130.5001036443,0.0717527566,0.1260080645,0.2846154,0,135,3.433725975766674E-4,5.2847475E-4,5.4221536E-4,505,0.41863355,17,0,198,0,0,-0.13401815
275342624,Poet_Moglica,10,1233,987,1985,59,1413,46.8400754539,40-49,639,5,16,37,53,53,16,37,9,3.1625355547,4506.038616786,0.0519267891,0.0602322206,0.18243243,0,135,1.986291321646906E-4,4.2781286E-4,4.3893623E-4,505,0.31684983,90,0,200,0,0,-0.1344174
44060922,b_scheller,10,31390,1038,707,26,16562,55.5696582804,50-59,784,8,34,33,67,67,34,33,9,3.0446972775,14924.68185558,0.1514079172,0.0212573496,0.15240642,0,135,1.9746771198042427E-4,8.807912E-4,9.036922E-4,99,0.2872807,83,0,202,0,0,-0.13487428
1137791304,butthunder,10,279,12,19,0,69,13.4410238165,10-19,533,4,8,3,11,11,8,3,10,3.5814709468,358.6978102711,0.0247503489,0.0454545455,0.125,0,135,8.075066321915018E-5,2.2648917E-4,2.32378E-4,99,0.2602339,36,0,208,0,0,-0.1352339
170361954,Jason_Heisler,10,3121,1002,962,15,17,45.2546593339,40-49,693,6,4,5,9,9,4,5,10,3.6042259244,235.4040481316,0.0492616165,0.0972222222,0.4,0,135,7.163257272580966E-5,1.2582731E-4,1.2909889E-4,353,0.53571427,0,0,201,0,0,-0.13571427
318550526,Bajabreeze22,10,417,147,935,1,1,23.8047533775,20-29,361,5,7,18,25,25,7,18,9,3.1206826493,3015.1030647528,0.027924109,0.055,0.16013072,0,135,1.0483303324096954E-4,2.0132371E-4,2.0655822E-4,71,0.29600778,0,2,197,1,0.0050761421,-0.13587706
576929601,PrairieNDP,10,638,384,386,10,14,43.1306412916,40-49,657,5,59,41,100,100,59,41,9,3.0300690776,26702.7927993736,0.2145218755,0.0446464646,0.15013169,0,135,4.283912129980885E-4,0.0015099278,0.0015491867,257,0.28612494,60,2,200,1,0.005,-0.13599325
197131222,SahraMaclean,10,1701,422,472,10,11,41.0761368299,40-49,648,6,27,25,52,52,27,25,10,3.1881349045,8255.3996209023,0.1165472782,0.036199095,0.16229838,0,135,1.7415869377610335E-4,7.0463296E-4,7.2295376E-4,257,0.2983631,6,0,199,0,0,-0.13606472
398778457,BrianStorsethMP,10,313,806,590,32,0,46.0888881899,40-49,637,4,56,25,81,81,56,25,10,3.5010158472,7836.9314424684,0.3097666608,0.0700617284,0.14254808,0,135,7.547133561833384E-4,0.0014344314,0.0014459075,353,0.27862078,7,15,200,15,0.075,-0.1360727
15049217,CanadaGood,10,3503,206,259,8,201,42.4927436812,40-49,585,5,6,4,10,10,6,4,11,4.0361641609,427.7980059839,0.0112147644,0.0333333333,0.055555556,0,135,1.2045151599800823E-4,1.7615824E-4,1.8073844E-4,71,0.19166666,10,3,200,3,0.015,-0.136111104
28127520,Sultan_Sadat,10,799,413,2000,4,352,36.3872196918,30-39,510,5,30,61,91,91,30,61,9,3.0097521333,18981.9634217863,0.1000244595,0.0473748474,0.13147497,0,135,2.126799120035879E-4,7.8012934E-4,8.0041314E-4,257,0.26800394,5,1,204,1,0.0049019608,-0.13652897
19193229,Tamarijuana,10,2927,646,864,16,99,62.5207461077,60-69,640,6,19,22,41,41,19,22,10,3.1223080049,7330.7183925146,0.0700274716,0.0402439024,0.14021164,0,135,1.963904213891156E-4,5.0330925E-4,5.1639555E-4,505,0.2767507,13,0,201,0,0,-0.13653906
227245275,JeffreyGriese,10,1226,399,736,15,721,53.318127839,50-59,608,5,15,16,31,31,15,16,10,3.4234051199,1148.534027049,0.1293747374,0.0537634409,0.18809524,0,135,1.128087314855337E-4,4.0264742E-4,4.1311645E-4,353,0.3252101,0,50,200,50,0.25,-0.13711486
17224196,helesialuke,10,2671,1127,2001,42,135,61.0466948159,60-69,689,6,36,36,72,72,36,36,9,3.1458756603,11999.0797232212,0.1031005148,0.0404929577,0.11795919,0,135,3.280612064300104E-4,9.311221E-4,9.553318E-4,71,0.25532946,51,0,200,0,0,-0.13737027
543799267,TorranceCoste,10,1147,255,400,4,26,60.3534667141,60-69,660,6,27,31,58,58,27,31,9,3.1072734661,21114.2795744778,0.0805923185,0.0208711434,0.08151261,0,135,2.942005939663252E-4,7.0463296E-4,7.2295376E-4,71,0.21930946,130,4,210,3,0.0142857143,-0.13779685
443655020,CoyoteDreams,10,4002,211,259,4,916,33.1905498315,30-39,648,7,9,7,16,16,9,7,9,3.6107273466,706.8131268921,0.0449024273,0.0708333333,0.15384616,0,135,8.756766947860485E-5,2.5165462E-4,2.5819778E-4,99,0.29166666,2,0,200,0,0,-0.1378205
776270952,hempsterbc,10,7820,937,1907,9,7561,51.0764637629,50-59,679,7,69,108,177,177,69,108,9,2.6639577408,90673.8154106967,0.2967457581,0.0172380586,0.0674729,0,135,3.31996591347161E-4,0.0017615824,0.0018073844,99,0.20542724,65,0,209,0,0,-0.13795434
879209971,pdesilva1,10,3522,468,1181,10,164,46.5886525851,40-49,624,6,19,38,57,57,19,38,9,3.1678179602,12701.3841887148,0.0675086012,0.0291353383,0.08974359,0,135,1.6024789513143287E-4,5.0330925E-4,5.1639555E-4,99,0.22792998,7,1,199,1,0.0050251256,-0.13818639
132344472,JulieEY,10,4185,262,427,5,61,43.3317541098,40-49,677,6,6,7,13,13,6,7,10,3.6038195855,411.3482254419,0.0225262745,0.0512820513,0.18055555,0,135,8.680864499575615E-5,1.7615824E-4,1.8073844E-4,353,0.31878307,12,0,201,0,0,-0.13822752
234632458,Marconomics,10,4898,1456,1482,27,11,61.1276685768,60-69,685,7,57,67,124,124,57,67,9,2.8679398618,70745.1496980798,0.1536887288,0.0156045109,0.08095238,0,135,4.240479621017952E-4,0.0014595968,0.0014975471,267,0.2194586,28,6,205,6,0.0292682927,-0.13850622
377851562,hgCoASt,10,2121,914,1161,18,1,48.8336266849,40-49,693,6,67,69,136,136,67,69,8,2.7675741568,89065.8590686963,0.231825887,0.0116557734,0.05812662,0,135,3.645166477543846E-4,0.0017112514,0.0017557449,99,0.19684874,55,0,200,0,0,-0.13872212
478862368,CEPinfoSCEP,10,925,714,484,15,0,48.7172792755,40-49,673,4,64,37,101,101,64,37,10,3.1288094271,31414.1984158759,0.1851521316,0.0281188119,0.083702214,0,135,3.57326834354466E-4,0.0016357551,0.0016782855,257,0.22282797,91,0,200,0,0,-0.139125756
169986395,ClaireYYZ,10,2965,677,344,26,42,56.0362608762,50-59,712,6,16,7,23,23,16,7,10,3.8053636733,1372.4453541346,0.0405175956,0.0513833992,0.14338236,0,135,1.4558492656813014E-4,4.2781286E-4,4.3893623E-4,257,0.2825312,21,0,199,0,0,-0.13914884
626183808,GuildwoodNDP,10,1030,344,1336,7,2,41.2331980014,40-49,539,5,55,111,166,166,55,111,9,2.8236489232,52361.9812042334,0.1926361803,0.0392479007,0.11074895,0,135,3.47454906161486E-4,0.0014092659,0.0014459075,257,0.24990284,17,3,200,3,0.015,-0.13915389
276713213,s_guilbeault,10,6970,10103,246,253,2,59.9117238826,50-59,770,7,54,1,55,55,54,1,11,4.4888256806,3319.304692897,0.1224425168,0.032996633,0.0524109,0,135,6.93524414231052E-4,0.0013841004,0.0013684483,267,0.19158415,32,0,200,0,0,-0.13917325
1275215894,JanineLexx,10,90,41,282,0,26,46.1868668588,40-49,568,4,7,8,15,15,7,8,10,3.4173100366,648.60870881,0.0237817224,0.0333333333,0.10909091,0,135,7.45577630616436E-5,2.0132371E-4,2.0655822E-4,99,0.24833333,14,0,200,0,0,-0.13924242
32112311,M_Charpentier,10,13604,8537,9339,242,12,55.7843829159,50-59,778,7,29,36,65,65,29,36,9,3.1812271434,35348.7008455615,0.1040302328,0.0211538462,0.07364341,0,135,3.6153654607132794E-4,7.549639E-4,7.487736E-4,267,0.2131001,20,0,200,0,0,-0.13945669
48708159,jasonkeays,10,18365,2934,1020,45,126,65.9742026523,60-69,849,8,42,27,69,69,42,27,10,3.2629012597,18561.4250255488,0.1085801109,0.044970162,0.11465893,0,135,2.718132407697582E-4,0.0010821149,0.0010844307,267,0.25416666,87,10,207,10,0.0483091787,-0.13950773
34478789,DufferinRider,10,2818,143,407,1,43,49.5567871709,40-49,643,6,11,10,21,21,11,10,10,3.5022348639,6640.5930952464,0.029671507,0.0380952381,0.1969697,0,135,1.375759711198486E-4,3.0198556E-4,3.0983734E-4,257,0.33650795,29,0,204,0,0,-0.13953825
31250479,Lazin_Ryder,10,3785,1594,630,90,381,59.5181705516,50-59,774,7,27,14,41,41,27,14,10,3.5278342137,10811.178947912,0.0640599448,0.0414634146,0.08901515,0,135,2.7410356185700356E-4,7.0463296E-4,6.97134E-4,71,0.22868852,17,0,134,0,0,-0.13967337
596610030,scriven42,10,2653,203,431,0,36,42.4696267923,40-49,611,6,7,13,20,20,7,13,10,3.4851686306,2895.1857139134,0.021524728,0.0236842105,0.08974359,0,135,9.045636558256375E-5,2.0132371E-4,2.0655822E-4,505,0.22943723,5,2,197,2,0.0101522843,-0.13969364
76114077,CommonSenseSoc,10,83975,1642,1184,100,41,46.3238433142,40-49,862,10,45,39,84,84,45,39,10,3.0650142219,39528.4829607561,0.1543999991,0.0100401606,0.046768706,0,135,3.8007862848041203E-4,0.0011576113,0.0011877097,353,0.18656899,66,0,202,0,0,-0.139800284
851805686,jim_mochuk,10,1686,90,316,0,2,41.3085771069,40-49,548,6,9,13,22,22,9,13,10,3.261682243,1301.7369889828,0.0363390255,0.0346320346,0.17948718,0,135,7.494029665517869E-5,2.5165462E-4,2.5819778E-4,71,0.31932774,3,0,201,0,0,-0.13984056
65111698,socialist_ca,10,1683,961,482,56,19,49.2462363103,40-49,698,5,29,11,40,40,29,11,10,3.6436407964,3739.4450901834,0.0793305346,0.0416666667,0.09280303,0,135,1.7548862483596664E-4,7.549639E-4,7.745933E-4,257,0.23276836,61,19,200,18,0.09,-0.13996533
32444591,KyleSeeback,10,898,873,110,79,3,51.2568306441,50-59,683,5,55,1,56,56,55,1,11,4.8382771231,380.1715056462,0.2025647338,0.0938311688,0.12491582,0,135,7.542606432532307E-4,0.0014092659,0.0014200878,353,0.26541275,36,1,200,1,0.005,-0.14049693
374637511,traceyselkirk,10,3775,207,252,6,7,41.6489096747,40-49,657,7,11,5,16,16,11,5,11,3.7029662739,2268.3462869848,0.0208393338,0.0375,0.09615385,0,135,1.2193942197604842E-4,3.0198556E-4,3.0983734E-4,257,0.23692308,8,0,198,0,0,-0.14076923
16755552,GarethPerry314,10,8421,583,1411,30,14,49.4869026617,40-49,736,7,21,34,55,55,21,34,10,3.0597318163,9058.6572270754,0.0837011707,0.0414141414,0.11217949,0,135,2.4303484066694412E-4,5.536402E-4,5.680351E-4,257,0.25315437,43,2,202,2,0.0099009901,-0.14097488
205463662,1001cjd,10,6442,233,466,9,1680,43.21157561,40-49,693,7,1,3,4,4,1,3,11,4.20438846,16.2448277744,0.0017052293,0.0833333333,0.33333334,0,135,5.821878056691204E-5,5.0330927E-5,5.1639556E-5,353,0.47435898,1,0,200,0,0,-0.14102564
150829276,nathanegrundy,10,985,259,479,3,24,43.6472924326,40-49,576,5,23,15,38,38,23,15,10,3.3096302316,5460.9025994205,0.0790356142,0.0654338549,0.2008547,0,135,1.8768271796288125E-4,6.0397113E-4,6.196747E-4,505,0.34208754,23,0,200,0,0,-0.14123284
1087315136,DeSmogCanada,10,84,482,1199,21,3,49.1495486611,40-49,597,4,41,50,91,91,41,50,9,2.8585940675,46240.200987386,0.1373176921,0.0137973138,0.06734694,0,135,3.2147814111519325E-4,0.0010569495,0.0010844307,99,0.20860806,33,1,109,1,0.0091743119,-0.14126112
855146994,JudithRenaud,10,4272,446,974,11,3,46.7918067798,40-49,633,6,14,28,42,42,14,28,9,3.1288094271,12334.872746392,0.0453633046,0.0423925668,0.10606061,0,135,1.7840477951525102E-4,3.7748195E-4,3.8729666E-4,505,0.24741824,30,0,200,0,0,-0.14135763
1041121530,ShnickKing,10,528,67,212,0,192,24.4838029154,20-29,403,5,4,10,14,14,4,10,10,3.472978464,181.3600510284,0.0368413513,0.0934065934,0.31111112,0,135,6.845771587426957E-5,1.2582731E-4,1.2909889E-4,99,0.4526316,2,0,199,0,0,-0.14152048
159578935,KristofTO,10,8124,383,659,16,4,49.333199444,40-49,725,7,17,24,41,41,17,24,9,3.2173913043,15085.7098214171,0.0298144413,0.0158536585,0.044334974,0,135,1.4687094783952226E-4,4.5297833E-4,4.3893623E-4,505,0.18609023,25,0,201,0,0,-0.141755256
270646972,stephEmerrill,10,2514,575,972,14,13,47.4391643527,40-49,682,6,18,29,47,47,18,29,10,3.164973588,13546.9810842582,0.0588173372,0.0226641998,0.086021505,0,135,1.870344333719445E-4,4.781438E-4,4.905758E-4,283,0.22797203,29,1,200,1,0.005,-0.141950525
275699060,TroyMorgan1977,10,4157,236,515,4,2,54.9298875006,50-59,726,7,48,81,129,129,48,81,9,2.8951645672,54700.1763080649,0.1289356931,0.0228318798,0.07927171,0,135,2.8734624297762924E-4,0.0012331076,0.0012651691,505,0.2213734,618,0,226,0,0,-0.14210169
1170530546,CUPE129,10,224,88,406,2,7,42.3193317589,40-49,519,5,12,27,39,39,12,27,10,3.2828118651,6014.7089089031,0.0301980957,0.0580296896,0.16009852,0,135,1.20843402350371E-4,3.27151E-4,3.0983734E-4,257,0.30227274,102,0,201,0,0,-0.14217422
28997331,SGMLaw,10,3122,749,162,35,138,48.5078067203,40-49,696,6,26,2,28,28,26,2,11,4.2954083706,767.204476621,0.0580639532,0.0343915344,0.046153847,0,135,1.9860991682851982E-4,6.794675E-4,6.7131425E-4,257,0.1884058,13,0,200,0,0,-0.142251953
923744418,HuronbruceNDP,10,80,157,721,7,0,27.6529589042,20-29,348,3,17,25,42,42,17,25,10,3.2893132873,1564.471837382,0.0752787352,0.1097560976,0.28024194,0,135,9.715400766862627E-5,4.5297833E-4,4.64756E-4,257,0.42278782,3,0,90,0,0,-0.14254588
1177019420,Mrezramacdonald,10,89,58,227,0,1,25.0579862643,20-29,346,3,2,5,7,7,2,5,10,3.5022348639,5247.0986745758,0.017029218,0.0714285714,0.2,0,135,5.292896724327566E-5,7.549639E-5,7.7459335E-5,353,0.34285715,2,0,101,0,0,-0.14285715
26593129,StephenLeahy,10,4296,1067,155,98,11,58.3938779813,50-59,713,7,29,2,31,31,29,2,10,3.7622917513,1346.4067026125,0.0633528428,0.0365591398,0.070197046,0,135,3.180417126576165E-4,7.549639E-4,7.745933E-4,283,0.2132285,72,0,201,0,0,-0.143031454
403738810,NoRelishPlease,10,6885,387,932,7,152,47.5192186049,40-49,717,7,12,14,26,26,12,14,10,3.3921170256,5129.6726387533,0.0384152695,0.0446153846,0.19583334,0,135,9.684545950102759E-5,3.27151E-4,3.3565713E-4,505,0.33888888,17,0,200,0,0,-0.14305554
11244852,chadrogers,10,7871,1448,1990,31,5,62.7371826688,60-69,735,7,57,31,88,88,57,31,10,3.4250304754,15540.2346469704,0.2641587248,0.0359195402,0.08764569,0,135,7.349890598639209E-4,0.0014595968,0.0014975471,353,0.23079528,31,0,200,0,0,-0.14314959
97931967,DelroyDyer,10,4478,921,1993,22,14,43.7275296334,40-49,674,6,18,33,51,51,18,33,10,3.2490857375,12225.2034802311,0.0904809141,0.0470588235,0.13513513,0,135,2.1257532448591427E-4,4.781438E-4,4.905758E-4,353,0.27843413,8,1,200,1,0.005,-0.143299
391084315,AMacEwen,10,3470,430,519,14,5,53.5141653558,50-59,669,6,47,47,94,94,47,47,10,2.960585128,43725.1200552614,0.1340621034,0.0146419584,0.062289562,0,135,3.614525750055207E-4,0.0012079423,0.0012393494,257,0.20648916,49,0,200,0,0,-0.144199598
165533527,kriegercartoons,10,2073,784,798,30,6,47.0099406124,40-49,697,6,19,11,30,30,19,11,10,3.7001219017,5782.557099334,0.0527097152,0.0517241379,0.15526316,0,135,1.639998323135567E-4,5.0330925E-4,5.1639555E-4,71,0.29959515,23,1,200,1,0.005,-0.14433199
887825390,DanJMeades,10,595,628,1150,8,1,44.5115703023,40-49,700,5,62,69,131,131,62,69,9,2.8772856562,51402.3729221336,0.2171376418,0.02501468,0.07655446,0,135,5.582427859057552E-4,0.0015854242,0.001626646,257,0.2209331,36,1,200,1,0.005,-0.14437864
122780332,brodiesovereign,10,4533,878,2001,18,17,46.6613686126,40-49,680,7,10,24,34,34,10,24,10,3.3596099147,3623.6493615231,0.0320649601,0.0534759358,0.14,0,135,1.3847494662369247E-4,2.768201E-4,2.8401756E-4,71,0.28451177,5,0,200,0,0,-0.14451177
256952235,jessiesitnick,10,723,163,336,6,3,41.744401182,40-49,574,5,2,7,9,9,2,7,10,3.4485981308,606.1921614212,0.014889612,0.0555555556,0.0952381,0,135,5.676157838426801E-5,7.549639E-5,7.7459335E-5,99,0.23976608,2,0,199,0,0,-0.14452798
272237849,TippiStar,10,5906,265,235,3,177,46.1708568404,40-49,657,6,7,7,14,14,7,7,10,3.5839089801,82.8807764717,0.051170779,0.0659340659,0.26785713,0,135,7.755711102242106E-5,2.0132371E-4,2.0655822E-4,99,0.4125,45,0,201,0,0,-0.14464287
374545627,brenda_slomka,10,4639,345,333,11,22,46.7994772621,40-49,684,6,10,10,20,20,10,10,10,3.6107273466,3681.6527982442,0.0191698738,0.0315789474,0.12878788,0,135,1.669902975017662E-4,2.768201E-4,2.8401756E-4,283,0.2735043,29,2,200,2,0.01,-0.14471642
22244391,ParmGill,10,1569,1548,185,102,5,50.6045869511,50-59,701,5,64,6,70,70,64,6,11,4.1304347826,3967.271209559,0.19016333,0.0602484472,0.086480185,0,135,7.570160829890211E-4,0.0016357551,0.001626646,353,0.23122187,56,23,200,23,0.115,-0.144741685
176207343,bobzimmermp,10,3465,1079,172,99,2,51.047259234,50-59,729,6,52,7,59,59,52,7,10,3.838683462,4751.3725754799,0.2173431662,0.0897136178,0.12928022,0,135,6.876171293973286E-4,0.0013337695,0.0013426285,353,0.27438325,47,15,200,12,0.06,-0.14510303
38499453,HFX_Lauren,10,9905,808,1091,16,89,50.2086559001,50-59,709,7,19,17,36,36,19,17,10,3.6298252743,3488.7203407865,0.0408994779,0.0531746032,0.23376623,0,135,2.107514739194198E-4,5.0330925E-4,5.1639555E-4,343,0.37890938,65,1,201,1,0.0049751244,-0.14514315
105208870,phpndp,10,2766,439,426,12,1,48.1632634886,40-49,661,6,53,22,75,75,53,22,10,3.5363673304,10890.9895780263,0.1703883899,0.0654054054,0.15940714,0,135,3.2336526554269546E-4,0.001358935,0.0013426285,257,0.30460367,95,4,212,4,0.0188679245,-0.14519653
293082921,bowman_law,10,1086,972,1944,32,126,43.5557385037,40-49,616,5,19,19,38,38,19,19,10,3.466070703,9286.7537456868,0.0489335508,0.0177809388,0.044334974,0,135,2.0187290007023446E-4,5.0330925E-4,4.905758E-4,257,0.18953635,10,0,200,0,0,-0.145201376
1076505421,Mwindtalker,10,1737,286,738,1,597,50.213049451,50-59,631,6,34,67,101,101,34,67,9,2.8236489232,21380.4159790826,0.1779082441,0.0314851485,0.103018105,0,135,2.1174053491560977E-4,8.807912E-4,9.036922E-4,99,0.24859422,69,0,235,0,0,-0.145576115
462273510,scmackay,10,184,21,174,0,3,32.5632776993,30-39,497,4,3,5,8,8,3,5,10,3.9012596505,490.6669540715,0.0033706864,0.0892857143,0.26666668,0,135,7.427986935183217E-5,1.00661855E-4,1.0327911E-4,505,0.4122807,7,0,187,0,0,-0.14561402
109926974,canadianeast,10,72054,511,427,54,46,41.5452999121,40-49,721,9,3,4,7,7,3,4,9,3.8000812678,71.4855886534,0.0152481,0.0714285714,0.13333334,0,135,8.081571878142604E-5,1.00661855E-4,1.0327911E-4,99,0.27916667,10,0,201,0,0,-0.14583333
379207097,kylefarq,10,11971,699,1339,37,33,46.6016112725,40-49,762,8,62,31,93,93,62,31,9,3.1552214547,27654.3229174332,0.2090940081,0.0219728845,0.046287045,0,135,3.8973848419995974E-4,0.0015854242,0.001626646,99,0.19212177,136,1,205,1,0.0048780488,-0.145834725
66112820,Calculator60,10,8571,298,229,4,3,44.0315198733,40-49,661,7,7,8,15,15,7,8,9,3.4388459976,999.6729694826,0.0318576063,0.0761904762,0.17424242,0,135,8.920680992051467E-5,2.0132371E-4,2.0655822E-4,71,0.3201581,23,0,200,0,0,-0.14591568
198674651,kreynolds118,10,1939,444,421,16,31,47.2852212509,40-49,647,5,30,13,43,43,30,13,9,3.5469321414,3892.1360378086,0.1097049293,0.0581395349,0.15221775,0,135,2.2645368823385434E-4,7.8012934E-4,8.0041314E-4,71,0.2983051,21,1,200,1,0.005,-0.14608735
217872058,EricOntario,10,4584,847,898,26,228,46.4741377325,40-49,693,7,19,11,30,30,19,11,10,3.4177163755,3996.8752523366,0.062168437,0.0620689655,0.1557971,0,135,1.6531079659928589E-4,5.0330925E-4,5.1639555E-4,505,0.30204082,17,0,200,0,0,-0.14624372
174285518,Crommunist,10,21071,3108,292,117,38,62.6031363067,60-69,797,8,39,6,45,45,39,6,10,3.5363673304,11459.959953005,0.0780334988,0.0126262626,0.023228804,0,135,3.4390539436466775E-4,0.0010066185,0.0010069713,505,0.16983017,67,0,202,0,0,-0.146601366
250941432,knitram24,10,11047,283,835,1,283,31.887213259,30-39,576,8,19,54,73,73,19,54,9,2.9536773669,15881.5291508057,0.0663591566,0.024543379,0.065656565,0,135,1.278798253438695E-4,5.0330925E-4,5.1639555E-4,257,0.21233043,2,1,199,1,0.0050251256,-0.146673865
293866044,MalcolmFrench,10,5702,430,287,17,4,49.05923779,40-49,712,7,33,15,48,48,33,15,10,3.4746038196,4296.5029617038,0.1072457728,0.0616134752,0.19251336,0,135,2.7040621320708886E-4,8.556257E-4,8.7787246E-4,257,0.33919752,48,2,200,2,0.01,-0.14668416
91892348,KhanYEG,10,4608,4542,1538,25,410,55.0345100531,50-59,695,7,36,71,107,107,36,71,10,2.8915075173,55502.4717224355,0.1422792799,0.0186915888,0.059977785,0,135,2.885093371189174E-4,9.311221E-4,9.553318E-4,505,0.20671777,14,1,200,1,0.005,-0.146739985
105306151,SusanGapka,10,15851,1794,1022,104,26,53.9655217683,50-59,736,8,54,21,75,75,54,21,9,3.333197887,15792.6867364581,0.155863266,0.0574774775,0.11792702,0,135,4.991153044463998E-4,0.0013841004,0.0013684483,257,0.26480868,42,2,200,2,0.01,-0.14688166
489914230,BonyMaroniPony,10,7473,251,595,3,31,42.6459889318,40-49,696,8,18,42,60,60,18,42,9,2.9561154002,13110.8382768189,0.0678103203,0.0254237288,0.07530454,0,135,1.544216158997469E-4,4.781438E-4,4.905758E-4,71,0.22218987,30,1,201,1,0.0049751244,-0.14688533
200231908,battisctv,10,1618,1812,194,67,4,55.4536432081,50-59,733,5,21,4,25,25,21,4,11,4.4169036977,3246.4859851804,0.0464044134,0.0583333333,0.10869565,0,135,3.430873399177211E-4,5.536402E-4,5.4221536E-4,343,0.25581396,6,0,200,0,0,-0.14711831
394245906,1loriking,10,12426,580,922,25,4,51.394742344,50-59,722,8,24,22,46,46,24,22,9,3.1556277936,13493.2271791719,0.105132712,0.0256038647,0.08494624,0,135,2.5920504082614307E-4,6.291366E-4,6.4549444E-4,71,0.23212026,13,10,199,8,0.040201005,-0.14717402
633806492,GagganGill,10,811,220,304,1,5,41.9341728342,40-49,530,5,14,11,25,25,14,11,10,3.4530678586,4455.2231887686,0.0543151486,0.0516666667,0.18333334,0,135,1.1441311593160187E-4,3.7748195E-4,3.8729666E-4,353,0.33068782,8,0,196,0,0,-0.14735448
966467131,ParalegalOnt,10,1309,135,279,0,0,43.7602692971,40-49,634,5,14,20,34,34,14,20,10,3.258025193,4298.0522804041,0.0736948174,0.0356506239,0.12252964,0,135,1.2024280935203829E-4,3.7748195E-4,3.8729666E-4,99,0.2703193,34,0,198,0,0,-0.14778966
120919393,Badger_Janzen,10,1911,134,174,1,124,49.2586712102,40-49,689,6,26,28,54,54,26,28,9,3.1056481105,6879.0573266419,0.0777371303,0.0174703005,0.06111111,0,135,1.7341810786321855E-4,6.794675E-4,6.97134E-4,99,0.20931143,105,0,200,0,0,-0.14820032
442383920,OccupyNerds,10,19712,793,736,26,240,37.7332825731,30-39,659,8,27,14,41,41,27,14,9,3.3165379927,6347.8719049036,0.0897232873,0.0219512195,0.07539683,0,135,1.8122473460474754E-4,7.0463296E-4,7.2295376E-4,99,0.22360483,7,0,208,0,0,-0.148208
160190953,Lead_Sta,10,8786,300,444,11,35,43.2362194489,40-49,652,7,10,10,20,20,10,10,10,3.487606664,1518.9910784809,0.0184754164,0.05,0.13333334,0,135,1.7500759922728886E-4,2.768201E-4,2.8401756E-4,283,0.2820513,11,4,202,3,0.0148514851,-0.14871796
746959880,Potriote,10,1383,87,191,1,63,41.4366626297,40-49,484,5,5,8,13,13,5,8,10,3.5497765136,456.7808732285,0.0134575347,0.0576923077,0.30357143,0,135,7.106502730225685E-5,1.5099278E-4,1.5491867E-4,505,0.4523077,13,8,200,8,0.04,-0.14873627
95462457,stwoball,10,1678,67,71,5,13,42.5169831783,40-49,564,6,3,1,4,4,3,1,10,4.1068671272,13.6554335345,0.0117270272,0.0833333333,0.33333334,0,135,6.049550339329925E-5,1.00661855E-4,1.0327911E-4,99,0.48214287,4,0,199,0,0,-0.14880953
21610572,buddhaontheroad,10,7730,393,795,17,329,50.4292950003,50-59,711,6,7,9,16,16,7,9,10,3.5457131247,1355.8366120268,0.015895966,0.0416666667,0.12878788,0,135,1.234962014436607E-4,2.0132371E-4,2.0655822E-4,257,0.2780127,3,0,202,0,0,-0.14922482
266237186,EcoDivaNomi,10,1504,276,564,5,7,30.8349555756,30-39,540,5,6,8,14,14,6,8,9,3.372612759,983.6360296192,0.0241707798,0.032967033,0.14285715,0,135,6.901007773762548E-5,1.7615824E-4,1.8073844E-4,99,0.29210526,0,0,200,0,0,-0.14924811
563166754,WildRoseCanada,10,25,86,193,3,1,30.6105811791,30-39,499,2,10,22,32,32,10,22,10,3.2312068265,5087.8697822235,0.0829470316,0.0564516129,0.11640212,0,135,1.5452771642531453E-4,2.768201E-4,2.8401756E-4,353,0.2657143,3,0,26,0,0,-0.14931218
260559024,paulfaoro,10,523,641,422,24,1,46.5856834778,40-49,616,4,30,11,41,41,30,11,10,3.7098740349,2598.2251894802,0.089376343,0.0701219512,0.16451614,0,135,2.8315101479532505E-4,7.8012934E-4,8.0041314E-4,71,0.31390977,9,0,199,0,0,-0.14939363
481033058,CraigerPequeno,10,1564,322,1176,0,150,45.6697253793,40-49,634,6,43,127,170,170,43,127,9,2.5619666802,97370.5110235604,0.1667563185,0.0117298991,0.030099321,0,135,2.5961562891513204E-4,0.0011072804,0.0011360702,99,0.17967398,30,10,199,6,0.0301507538,-0.149574659
425252248,ProfCyr,10,531,229,247,3,0,40.3477441686,40-49,573,4,4,3,7,7,4,3,10,3.8399024787,45.5616114207,0.0152867756,0.1428571429,0.45,0,135,1.0144338624269273E-4,1.2582731E-4,1.2909889E-4,257,0.5997537,10,1,200,1,0.005,-0.1497537
128908662,ChanginJen,10,5698,557,573,17,2,46.240383962,40-49,716,7,7,8,15,15,7,8,11,3.5579032913,651.7792675674,0.0295489874,0.0380952381,0.13333334,0,135,8.088035874082407E-5,2.0132371E-4,2.0655822E-4,353,0.28333333,1,0,200,0,0,-0.14999999
22819266,msunielsen,10,1860,334,1625,2,43,40.2851197569,40-49,553,6,1,3,4,4,1,3,10,3.8728159285,182.0603728325,0.0034816823,0,0,0,135,4.726064281692426E-5,5.0330927E-5,5.1639556E-5,257,0.15,1,0,200,0,0,-0.15
48920785,heySMM,10,95131,1644,313,79,16303,57.5518875844,50-59,891,10,6,1,7,7,6,1,10,4.9524583503,184.9616275804,0.0163827384,0.0476190476,0.1,0,135,9.363722422263469E-5,1.7615824E-4,1.8073844E-4,71,0.25,29,1,203,1,0.0049261084,-0.15
273683993,Blubdha,10,49567,875,1913,30,873,45.9217954798,40-49,761,9,25,34,59,59,25,34,9,3.0881755384,11815.7922583289,0.1051902397,0.0359438925,0.09513742,0,135,1.8283062902907837E-4,6.54302E-4,6.7131425E-4,99,0.24537815,35,0,202,0,0,-0.15024073
240760525,JoelWWood,10,12719,821,789,42,2243,55.3175322659,50-59,753,8,21,12,33,33,21,12,10,3.7501015847,4433.3548031859,0.0646796,0.0236742424,0.056923077,0,135,3.5390538004330564E-4,5.536402E-4,5.680351E-4,353,0.20739065,38,0,200,0,0,-0.150467573
147934725,DisturbedeMerde,10,4416,235,385,8,8,43.7562616221,40-49,674,6,7,11,18,18,7,11,10,3.6448598131,4477.2000691707,0.0180662746,0.022875817,0.09090909,0,135,1.7479882304739515E-4,2.0132371E-4,2.0655822E-4,343,0.24147727,6,0,201,0,0,-0.15056818
372343086,Bee_Fowlow,10,999,72,395,0,4,35.0278270299,30-39,582,5,1,5,6,6,1,5,10,3.9943112556,27.7566048088,0.0014397562,0.0666666667,0.15,0,135,5.526400143137827E-5,5.0330927E-5,5.1639556E-5,257,0.3008658,0,0,200,0,0,-0.1508658
112372171,timothy_chu,10,4545,582,374,26,1,48.0594044398,40-49,703,6,37,16,53,53,37,16,10,3.4449410809,5022.4913639308,0.1394779504,0.0555152395,0.14451219,0,135,2.944098286149595E-4,9.562876E-4,9.811516E-4,257,0.29539296,32,1,200,1,0.005,-0.15088077
161849864,neilredknap,10,2997,224,90,8,0,43.1069026606,40-49,670,6,29,15,44,44,29,15,10,3.4782608696,4731.6805936923,0.1119829368,0.0697674419,0.20430107,0,135,2.080993570452044E-4,7.549639E-4,7.745933E-4,257,0.35521886,39,3,200,3,0.015,-0.15091779
100235515,rbatherson,10,6121,1647,2001,36,8,50.8475497556,50-59,736,7,24,26,50,50,24,26,10,3.3250711093,14248.8109309578,0.113288607,0.0432653061,0.19310345,0,135,3.9572248221882655E-4,6.291366E-4,6.4549444E-4,343,0.34409064,27,0,201,0,0,-0.15098719
399360633,durhamndp,10,1098,312,79,7,0,44.7203886162,40-49,658,6,70,15,85,85,70,15,10,3.5778138968,8455.2632527424,0.2353356833,0.074929972,0.14808294,0,135,4.235938659013685E-4,0.0017867478,0.0018073844,257,0.29946604,87,6,201,6,0.0298507463,-0.1513831
325315594,Beaches_E_York,10,813,848,2001,26,514,31.8320682343,30-39,530,5,7,12,19,19,7,12,10,3.6078829744,2006.6750392768,0.0219255592,0.0760233918,0.22527473,0,135,9.685038142688804E-5,2.0132371E-4,2.0655822E-4,505,0.37670067,1,0,200,0,0,-0.15142594
470696857,raincoastmist,10,789,37,80,0,17,22.4585298579,20-29,521,5,2,2,4,4,2,2,10,3.9874034945,11.2357702688,0.0090133284,0.0833333333,0.16666667,0,135,5.815297842670152E-5,7.549639E-5,7.7459335E-5,99,0.3181818,2,0,200,0,0,-0.15151513
352556797,ghost_station,10,3903,327,566,2,945,33.3005923404,30-39,588,6,2,4,6,6,2,4,9,3.9292970337,117.3999691517,0.001305773,0.0333333333,0.16666667,0,135,6.492986587826148E-5,7.549639E-5,7.7459335E-5,343,0.3181818,0,0,200,0,0,-0.15151513
212483779,SuraiaSahar,10,961,276,492,4,37,40.2730188476,40-49,631,5,9,13,22,22,9,13,10,3.4388459976,1343.2081424541,0.0286716247,0.0194805195,0.06666667,0,135,8.957992096753307E-5,2.5165462E-4,2.5819778E-4,99,0.21825397,7,0,200,0,0,-0.1515873
311568175,sas_robin,10,9448,611,1692,8,10987,49.9537886039,40-49,731,7,27,49,76,76,27,49,9,2.935392117,24838.8361373,0.0906652116,0.0163157895,0.05529412,0,135,2.3236250905314394E-4,7.0463296E-4,7.2295376E-4,267,0.20722413,47,0,201,0,0,-0.15193001
58321430,nickofthenorth,10,2583,426,870,14,4,41.0631087197,40-49,637,6,12,16,28,28,12,16,10,3.4278748476,2146.4982200611,0.0431260445,0.0476190476,0.19607843,0,135,1.1784008223778346E-4,3.27151E-4,3.3565713E-4,257,0.3480769,15,0,175,0,0,-0.15199847
290895809,CPoliticalScene,10,401,61,18,2,0,25.2735839662,20-29,527,2,8,2,10,10,8,2,10,3.9488013003,2511.4049421337,0.0211216148,0.0111111111,0.017857144,0,135,8.813968622206045E-5,2.2648917E-4,2.0655822E-4,505,0.16993465,38,0,200,0,0,-0.152077506
500001852,Alex_Huet,10,1011,443,1204,3,37,39.9815002311,30-39,625,5,45,77,122,122,45,77,9,2.9187322227,33145.6436666146,0.1687387632,0.0384094296,0.13420968,0,135,3.500981215159851E-4,0.0011576113,0.0011877097,257,0.28642073,17,7,200,7,0.035,-0.15221105
205988930,SteveFilipovic,10,9383,666,1083,31,1948,54.1117633219,50-59,740,8,61,86,147,147,61,86,8,2.7606663958,85069.4457443073,0.1815566093,0.0096915479,0.03511598,0,135,2.9651220422218015E-4,0.0015602587,0.0016008263,99,0.18772894,165,0,201,0,0,-0.15261296
1267663496,Politicalog,10,8,37,212,0,0,17.2096651077,10-19,47,2,8,21,29,29,8,21,10,3.0662332385,4956.8021130493,0.01939618,0.0197044335,0.056277055,0,135,6.505272849418631E-5,2.2648917E-4,2.32378E-4,505,0.20897436,0,0,8,0,0,-0.152697305
16367019,bulldog11,10,757,131,171,2,34,34.7197945249,30-39,542,4,4,4,8,8,4,4,10,3.5497765136,75.2464747922,0.0346166895,0.0357142857,0.2,0,135,7.82843282304817E-5,1.2582731E-4,1.2909889E-4,353,0.3529412,2,0,197,0,0,-0.1529412
370852503,ARIApensions,10,1365,662,1997,14,3,46.5128037093,40-49,656,5,12,32,44,44,12,32,10,3.2206420154,11118.5272314608,0.0349675178,0.0179704017,0.041269843,0,135,1.246167083737699E-4,3.27151E-4,3.3565713E-4,257,0.19424883,4,0,199,0,0,-0.152978987
333016219,nsynd,10,271,240,163,8,2,37.504995475,30-39,548,4,17,9,26,26,17,9,10,3.6091019911,2568.164809902,0.0568862945,0.0738461538,0.23099415,0,135,1.4821509336897798E-4,4.5297833E-4,4.64756E-4,257,0.38405797,14,0,200,0,0,-0.15306382
272498805,williamefwilson,10,6493,1194,198,31,3,48.3668106557,40-49,713,7,62,1,63,63,62,1,11,4.4774481918,3212.5628448524,0.1365427164,0.0204813108,0.030209934,0,135,3.254772693094396E-4,0.0015854242,0.0016008263,505,0.183301,11,0,207,0,0,-0.153091066
18100698,logangamble,10,3162,109,146,2,18,39.5402956477,30-39,633,6,5,5,10,10,5,5,11,3.8147094677,922.3776349555,0.0144208823,0.0555555556,0.16666667,0,135,7.290079952402513E-5,1.5099278E-4,1.5491867E-4,257,0.31985295,2,0,200,0,0,-0.15318628
462214859,hampton_stephen,10,2918,673,348,19,41,47.3620016353,40-49,668,6,67,16,83,83,67,16,10,3.4360016254,12634.2701522931,0.2209672832,0.0434910373,0.09255533,0,135,3.6645261242368443E-4,0.0017112514,0.0017557449,257,0.24577379,75,1,202,1,0.004950495,-0.15321846
387970645,rmfaris,10,10250,799,1699,37,108,40.5616398083,40-49,755,8,27,46,73,73,27,46,10,2.9687119057,22113.4025327001,0.1110058939,0.028348554,0.09141157,0,135,2.2210818402020678E-4,7.0463296E-4,7.2295376E-4,71,0.24480979,15,4,201,4,0.0199004975,-0.15339822
22505409,cwilhelmson,10,8530,1785,1790,101,14,58.793895298,50-59,735,7,36,26,62,62,36,26,10,3.2612759041,20331.3031617649,0.1019595833,0.0245901639,0.07585825,0,135,4.059018734290695E-4,9.311221E-4,9.553318E-4,71,0.22946317,42,0,200,0,0,-0.15360492
261487188,poshbirdQ,10,63400,1018,911,40,4213,50.0268988383,50-59,787,9,7,7,14,14,7,7,10,3.483949614,2830.839647455,0.0228203666,0.010989011,0.035714287,0,135,8.823649500810968E-5,2.0132371E-4,2.0655822E-4,99,0.18939394,0,0,200,0,0,-0.153679653
91035609,sassa26_ca2003,10,2533,521,985,9,16,45.9829604239,40-49,660,6,37,46,83,83,37,46,9,3.0524177164,35023.3478204088,0.10700456,0.0276226859,0.09124579,0,135,3.014008254129403E-4,9.562876E-4,9.811516E-4,257,0.24552245,30,0,200,0,0,-0.15427666
449849480,AdamskiPeter,10,2204,76,113,1,12,42.2499519501,40-49,613,5,10,5,15,15,10,5,10,3.6216984965,360.3153969262,0.0346448308,0.0476190476,0.13636364,0,135,9.072085416041986E-5,2.768201E-4,2.8401756E-4,505,0.29064038,20,0,200,0,0,-0.15427674
274818699,Mark_Hosak,10,1070,164,451,6,3,26.234555254,20-29,576,5,11,19,30,30,11,19,10,3.2933766761,966.4750200763,0.0386915715,0.0655172414,0.21315789,0,135,1.2796249178661584E-4,3.0198556E-4,3.0983734E-4,257,0.36763236,0,3,196,3,0.0153061224,-0.15447447
74660931,keithjs,10,9009,213,181,8,726,53.3031107818,50-59,728,8,22,18,40,40,22,18,9,3.2312068265,22802.0756947606,0.0707402024,0.0051282051,0.023715414,0,135,2.982480909883669E-4,5.7880563E-4,5.938549E-4,505,0.17829457,36,0,201,0,0,-0.154579156
240707282,nocomment84,10,89,58,175,1,1,20.6432112834,20-29,375,3,11,9,20,20,11,9,10,3.7626980902,644.7793925521,0.0478357833,0.1210526316,0.36813188,0,135,1.6258955038267765E-4,3.0198556E-4,3.0983734E-4,257,0.5228571,3,4,90,4,0.0444444444,-0.15472522
32391060,tarashields,10,28035,1706,1793,38,348,47.9241732013,40-49,788,9,4,2,6,6,4,2,10,4.1109305161,67.5740936513,0.0145576311,0.1,0.33333334,0,135,7.531919820236652E-5,1.2582731E-4,1.2909889E-4,505,0.48809522,41,0,200,0,0,-0.15476188
48519675,leftnewsorg,10,5927,634,219,46,1,47.254436787,40-49,637,6,31,12,43,43,31,12,10,3.548557497,3548.3159719045,0.0828926437,0.0459579181,0.13205644,0,135,2.5513113267625645E-4,8.0529484E-4,8.262329E-4,257,0.2868687,25,2,200,2,0.01,-0.15481226
351220065,PatrickFAQMP,10,540,433,725,8,0,36.2506299671,30-39,609,4,31,42,73,73,31,42,10,2.9264526615,22309.3175103784,0.1532016605,0.0150304414,0.072009295,0,135,3.4350980580171635E-4,8.0529484E-4,8.262329E-4,353,0.22685444,15,1,200,1,0.005,-0.154845145
21060644,RTEditorDerek,10,3463,462,435,15,9,44.3387400976,40-49,652,5,10,19,29,29,10,19,10,3.4465664364,4494.9857625516,0.070949335,0.0566502463,0.14935064,0,135,1.764330448267436E-4,2.768201E-4,2.8401756E-4,353,0.3042017,15,0,200,0,0,-0.15485106
210840159,djgreeens,10,1657,408,918,7,3,46.9163717276,40-49,606,6,12,30,42,42,12,30,10,3.043071922,5958.6490703721,0.0711482178,0.0348432056,0.09892473,0,135,1.1947904915440278E-4,3.27151E-4,3.3565713E-4,71,0.25405702,44,1,200,1,0.005,-0.15513229
123151726,EsmirMilavic,10,33741,1206,1626,50,395,59.7453049586,50-59,769,9,18,19,37,37,18,19,10,3.304754165,4249.2107531604,0.0995230448,0.0518018018,0.16666667,0,135,2.542663629083082E-4,4.781438E-4,4.905758E-4,71,0.32197338,14,0,200,0,0,-0.15530671
708079987,RobFordSearch,10,970,403,817,10,27,43.8411104148,40-49,595,4,11,18,29,29,11,18,10,3.3023161317,13560.9435137044,0.0175708855,0.0061576355,0.015151516,0,135,9.723711845336809E-5,3.0198556E-4,2.8401756E-4,257,0.17051283,21,0,200,0,0,-0.155361314
201265978,DoubleTAP49,10,11841,687,1363,25,710,39.1322171008,30-39,744,7,4,6,10,10,4,6,11,3.8248679399,252.6485658222,0.0673068703,0.0666666667,0.23809524,0,135,6.875277591563347E-5,1.2582731E-4,1.2909889E-4,353,0.3939394,5,0,199,0,0,-0.15584416
938268962,treeline_b,10,89,125,218,7,22,44.4645128056,40-49,566,5,7,8,15,15,7,8,10,3.422998781,511.9312455209,0.0334698397,0.0142857143,0.10714286,0,135,9.36255311913271E-5,2.0132371E-4,2.0655822E-4,99,0.2631579,1,0,62,0,0,-0.15601504
171102859,daly_beauty,10,50487,6807,1795,125,972,65.437592723,60-69,842,9,46,30,76,76,46,30,9,3.1117431938,38416.5210673159,0.121811571,0.0149122807,0.06231884,0,135,6.419528173092301E-4,0.0011827768,0.0012135296,505,0.21880342,139,0,201,0,0,-0.15648458
16135612,leftcoastrant,10,5602,271,438,10,99,52.0959638817,50-59,706,7,27,15,42,42,27,15,10,3.5229581471,4260.7798039339,0.0796470346,0.0528455285,0.11764706,0,135,1.7261174605333042E-4,7.0463296E-4,7.2295376E-4,71,0.27432713,204,0,213,0,0,-0.15668007
27016796,lpchampagne,10,1160,630,1535,14,0,44.6567550507,40-49,628,5,30,45,75,75,30,45,10,3.1320601382,18603.4725246939,0.0978852251,0.0336936937,0.1253469,0,135,4.061640657284634E-4,7.8012934E-4,8.0041314E-4,505,0.2821287,28,4,200,3,0.015,-0.1567818
218671021,johnalanashton,10,4734,499,1098,17,23,56.9175635195,50-59,678,7,33,47,80,80,33,47,10,3.1633482324,10063.1685518947,0.1631922123,0.0579113924,0.19322152,0,135,3.0556931635134974E-4,8.556257E-4,8.7787246E-4,257,0.35006452,44,0,200,0,0,-0.156843
590003661,caro_caron,10,3965,611,755,5,31,52.7373577643,50-59,719,7,6,7,13,13,6,7,10,3.5997561967,712.6546010358,0.0156467736,0.0256410256,0.16666667,0,135,8.597212396560315E-5,1.7615824E-4,1.8073844E-4,267,0.32352942,5,0,201,0,0,-0.15686275
1254880027,AlbertaActivist,10,103,18,127,0,7,36.4291922104,30-39,429,4,5,13,18,18,5,13,10,3.2498984153,1091.763122136,0.0335959433,0.0392156863,0.115384616,0,135,7.042958729983175E-5,1.5099278E-4,1.5491867E-4,257,0.2723077,20,0,184,0,0,-0.156923084
188733067,chartrandm,10,7876,953,1347,15,40,41.5573696428,40-49,723,7,16,25,41,41,16,25,9,3.1869158879,7222.2677062586,0.0408482245,0.0487804878,0.13669951,0,135,1.6267121616481684E-4,4.2781286E-4,4.3893623E-4,267,0.29362285,53,3,202,3,0.0148514851,-0.15692334
17493663,pcz,10,14593,1933,1772,37,304,56.7778199014,50-59,697,8,8,10,18,18,8,10,10,3.4453474197,1227.9488587383,0.0283374938,0.0392156863,0.16363636,0,135,1.8253881288575927E-4,2.2648917E-4,2.32378E-4,71,0.3205645,2,0,200,0,0,-0.15692814
484317938,YoTonyCPC,10,209,95,259,3,1,37.9208880195,30-39,450,4,16,46,62,62,16,46,10,2.9325477448,9584.3720726235,0.0763798806,0.0269698572,0.073913045,0,135,1.5137258059374123E-4,4.2781286E-4,4.3893623E-4,99,0.23147383,11,2,199,2,0.0100502513,-0.157560785
516634980,zak_f_r,10,933,157,386,1,19,30.4523663338,30-39,478,4,8,12,20,20,8,12,10,3.5083299472,625.814125149,0.0357613223,0.0921052632,0.31868133,0,135,1.193755788072185E-4,2.2648917E-4,2.32378E-4,257,0.4767025,4,0,198,0,0,-0.15802117
363464356,SFNDP,10,425,101,75,6,1,27.3985795911,20-29,491,2,11,1,12,12,11,1,11,4.1349045104,17.2761185214,0.0409353758,0.1742424242,0.37272727,0,135,1.2965066037572647E-4,3.0198556E-4,3.0983734E-4,71,0.5307882,0,1,200,1,0.005,-0.15806093
84401415,BillKingLanark,10,1557,414,1020,3,72,54.0506751173,50-59,627,6,11,25,36,36,11,25,10,3.2775294596,3172.0207871907,0.1052511845,0.0682539683,0.21,0,135,1.6379679343393857E-4,3.0198556E-4,3.0983734E-4,353,0.36835444,18,1,200,1,0.005,-0.15835444
337174475,CAS_OFL,10,2582,347,910,6,11,49.869811634,40-49,608,6,25,42,67,67,25,42,10,3.0666395774,19192.795408233,0.0617051102,0.0327905925,0.11575053,0,135,1.9938102947096052E-4,6.54302E-4,6.7131425E-4,257,0.27431566,53,1,202,1,0.004950495,-0.15856513
95105815,jess_mccrae,10,39721,247,349,12,1138,44.7367602786,40-49,771,8,12,10,22,22,12,10,10,3.3384802926,7804.9985546064,0.0527541429,0.0281385281,0.104395606,0,135,1.5105326313462876E-4,3.27151E-4,3.3565713E-4,99,0.26310483,69,0,203,0,0,-0.158709224
559995442,MacDougall1165,10,1865,251,1082,1,16,40.2214381681,40-49,569,6,15,47,62,62,15,47,9,2.9089800894,19704.4810204013,0.0621749011,0.0306716023,0.07215541,0,135,1.6242105964020876E-4,4.0264742E-4,4.1311645E-4,257,0.2315595,13,0,200,0,0,-0.15940409
221019842,SchumannD,10,2787,216,528,3,1216,39.8394394235,30-39,650,6,8,14,22,22,8,14,10,3.5388053637,223.9120463565,0.0716401879,0.0757575758,0.2809524,0,135,1.290734366443107E-4,2.2648917E-4,2.32378E-4,353,0.4405242,7,0,200,0,0,-0.1595718
171606833,LindaFrum,10,85,264,401,3,3,45.6144407072,40-49,539,3,14,12,26,26,14,12,10,3.9715562779,1057.6544412485,0.0913847296,0.12,0.22857143,0,135,4.442526512430273E-4,3.7748195E-4,3.8729666E-4,353,0.3881579,16,0,125,0,0,-0.15958647
863580548,mforden2,10,8211,288,409,4,507,55.3121587091,50-59,677,8,19,26,45,45,19,26,10,3.2279561154,11168.265746884,0.0650632222,0.0292929293,0.11375661,0,135,1.5779941836669908E-4,5.0330925E-4,5.1639555E-4,99,0.273358,42,0,203,0,0,-0.15960139
773659566,ichannels_Mel,10,486,309,763,4,1,36.4691479697,30-39,537,5,38,77,115,115,38,77,9,2.6802112962,55225.9683832129,0.2022327849,0.011136537,0.038948394,0,135,2.668817915993237E-4,9.814531E-4,0.0010069713,99,0.19857232,37,1,200,1,0.005,-0.159623926
16581816,shaminis,10,5416,928,494,24,92,48.365305199,40-49,721,6,59,14,73,73,59,14,10,3.6834620073,5351.8514125569,0.2145612899,0.0764840183,0.15382513,0,135,4.732022565643697E-4,0.0015099278,0.0015233669,257,0.31362614,31,2,200,2,0.01,-0.15980101
485063311,PaulaCornell5,10,1171,503,1287,10,106,48.2211897906,40-49,642,5,3,9,12,12,3,9,10,3.365704998,837.0812135966,0.023131993,0.0378787879,0.097222224,0,135,6.509753254594524E-5,1.00661855E-4,1.0327911E-4,257,0.25735295,2,0,200,0,0,-0.160130726
331998971,LukeAFBradley,10,3988,447,380,8,497,47.0823710052,40-49,719,6,29,27,56,56,29,27,10,3.1767574157,15488.6320257301,0.0988006142,0.0285714286,0.1210084,0,135,2.2030253196747665E-4,7.549639E-4,7.487736E-4,505,0.28117087,50,0,200,0,0,-0.16016247
102570249,michaeltbutler,10,11201,511,1773,14,168,48.039535538,40-49,681,8,15,49,64,64,15,49,10,3.0040633889,13693.3149154543,0.1105227429,0.0280257937,0.07015306,0,135,1.4990822382742112E-4,4.0264742E-4,4.1311645E-4,353,0.23033772,7,0,199,0,0,-0.16018466
711063583,NDPLondon,10,540,129,128,4,1,35.96089704,30-39,513,5,22,10,32,32,22,10,10,3.6391710687,1564.1267162965,0.0675119346,0.0877016129,0.2667984,0,135,1.518067569381629E-4,5.7880563E-4,5.680351E-4,257,0.42734694,14,8,200,8,0.04,-0.16054854
865536330,LdnOntRealty,10,2458,309,770,8,47,50.889079398,50-59,693,6,5,17,22,22,5,17,11,3.5745631857,2646.4827709032,0.0264812397,0.0800865801,0.15789473,0,135,6.46694025634006E-5,1.5099278E-4,1.5491867E-4,353,0.31848854,40,0,202,0,0,-0.16059381
32728797,MathiGir,10,3510,456,1414,14,17,43.4654572259,40-49,648,6,40,72,112,112,40,72,9,2.9557090614,33390.026904481,0.1464795959,0.0412644788,0.11914557,0,135,3.3960340090373096E-4,0.001031784,0.0010327911,257,0.27986634,21,6,200,6,0.03,-0.16072077
940055154,_MarkCameron_,10,746,87,253,0,0,28.5593573225,20-29,416,5,9,14,23,23,9,14,10,3.5132060138,1072.6323758372,0.0233307763,0.0533596838,0.20476191,0,135,7.881993887427443E-5,2.5165462E-4,2.5819778E-4,257,0.3655303,3,0,200,0,0,-0.16076839
567663996,StopHarperBot,10,7528,262,0,6,0,38.1929357699,30-39,718,6,41,0,41,41,41,0,0,0,0,0.1180591556,0.0420731707,0.0652439,0,8,1.6786816134632543E-4,0.0010569495,0,99,0.22606246,70,2,212,2,0.0094339623,-0.16081856
221565757,abitofgrit,10,5021,648,1731,7,11,48.1752586346,40-49,693,6,32,66,98,98,32,66,10,3.0052824055,31120.0624537026,0.1234121327,0.0337681464,0.085338764,0,135,3.754486730582337E-4,8.304603E-4,8.5205265E-4,505,0.24616975,41,1,200,1,0.005,-0.160830986
327533387,MrJoshArless,10,6454,259,717,3,326,47.9702039603,40-49,651,6,19,32,51,51,19,32,9,3.0873628606,9677.7802458492,0.0632063715,0.0407843137,0.14171124,0,135,1.594011096916107E-4,5.0330925E-4,5.1639555E-4,505,0.3026973,29,20,204,17,0.0833333333,-0.16098606
32138687,melaniekarin,10,20168,1083,1142,30,498,51.4429086034,50-59,769,8,12,12,24,24,12,12,10,3.5599349858,2807.3555611178,0.028985673,0.0217391304,0.1,0,135,1.1961683540596241E-4,3.27151E-4,3.3565713E-4,71,0.26108375,11,0,200,0,0,-0.16108375
21243718,erikmistal,10,4029,1524,1715,38,0,53.6814361475,50-59,689,6,31,43,74,74,31,43,10,3.0918325884,15035.2044233637,0.1101372651,0.0403554239,0.15263645,0,135,3.227205270741852E-4,8.0529484E-4,8.262329E-4,505,0.31387445,5,2,200,2,0.01,-0.161238
262323897,MeierMac,10,5956,308,390,5,243,41.7113688141,40-49,608,7,25,32,57,57,25,32,9,2.9670865502,12575.4631883925,0.1017527954,0.015037594,0.07102273,0,135,1.6747270943655136E-4,6.54302E-4,6.7131425E-4,99,0.23229814,19,1,199,1,0.0050251256,-0.16127541
17694287,slocanslim,10,5310,389,377,7,2,39.6810242465,30-39,647,6,17,16,33,33,17,16,10,3.3616416091,5580.8170508175,0.0660934375,0.0473484848,0.108333334,0,135,2.6674541164592447E-4,4.5297833E-4,4.64756E-4,71,0.26971152,3,0,200,0,0,-0.161378186
349946938,angryaesthete,10,6895,384,1573,8,1256,43.8149933161,40-49,698,7,23,61,84,84,23,61,9,3.0276310443,18177.331177416,0.0741865482,0.0294033276,0.08038914,0,135,1.793790891949676E-4,6.0397113E-4,6.196747E-4,257,0.24206446,3,0,200,0,0,-0.16167532
19801825,mari_katz,10,3428,160,445,4,57,29.4661261423,20-29,608,6,9,8,17,17,9,8,10,3.6038195855,254.3499128959,0.036404807,0.1139705882,0.32575756,0,135,7.55034115040472E-5,2.5165462E-4,2.5819778E-4,257,0.48752227,3,0,199,0,0,-0.16176471
23968956,KatyChancey,10,12503,779,681,55,280,51.8313480608,50-59,739,7,5,3,8,8,5,3,10,4.0507923608,562.7685333203,0.0120320211,0.0535714286,0.13333334,0,135,8.667023151679125E-5,1.5099278E-4,1.5491867E-4,283,0.29545453,1,0,200,0,0,-0.16212119
97839765,Northern_Clips,10,45035,1337,21,111,548,50.4797532689,50-59,755,9,14,1,15,15,14,1,11,4.6444534742,595.889690973,0.0398907017,0.019047619,0.03846154,0,135,1.909254307461222E-4,3.7748195E-4,3.3565713E-4,99,0.2008547,8,0,202,0,0,-0.16239316
45214513,eagle3300,10,5897,648,1155,37,54,42.7085650903,40-49,646,7,4,8,12,12,4,8,10,3.6310442909,1626.3363640748,0.0100528909,0.053030303,0.18055555,0,135,1.4386358531788147E-4,1.2582731E-4,1.2909889E-4,303,0.34299517,1,0,200,0,0,-0.16243962
16269084,bobbilou,10,6733,815,1068,24,175,61.3049658162,60-69,665,6,31,40,71,71,31,40,10,3.1084924827,15847.766137891,0.1067906889,0.0356136821,0.13787879,0,135,3.795977207291184E-4,8.0529484E-4,8.0041314E-4,505,0.30049682,13,1,197,1,0.0050761421,-0.16261803
258170457,BLTimpson,10,2160,213,271,5,31,41.9695373875,40-49,625,6,7,6,13,13,7,6,11,4.0097521333,255.1697903251,0.0232913615,0.0833333333,0.2,0,135,7.276136605304193E-5,2.0132371E-4,2.0655822E-4,353,0.3627451,3,1,198,1,0.0050505051,-0.1627451
266620548,camdearlove,10,6037,879,853,47,23,52.456033047,50-59,740,7,49,43,92,92,49,43,9,3.017878911,47942.7534980529,0.1515169638,0.0323698041,0.108757064,0,135,3.4747718616041673E-4,0.0012582731,0.0012909889,257,0.2717766,47,0,200,0,0,-0.163019536
16278418,danlindenas,10,1803,236,344,6,3,42.0693114585,40-49,617,5,14,9,23,23,14,9,10,3.7939861845,557.9028635496,0.0425427066,0.0691699605,0.26190478,0,135,2.3393235227167072E-4,3.7748195E-4,3.8729666E-4,505,0.42517185,4,10,200,10,0.05,-0.16326707
24775854,MitchellDuce,10,330,235,889,1,319,51.3953328844,50-59,553,5,12,40,52,52,12,40,9,3.1507517269,6485.5445280699,0.0503950603,0.0561840121,0.13530779,0,135,1.386382942056111E-4,3.27151E-4,3.3565713E-4,257,0.2987715,27,0,200,0,0,-0.16346371
844099489,crazedmountie,10,2414,89,185,0,5,46.572530525,40-49,595,6,5,6,11,11,5,6,9,3.3527021536,1967.9650509024,0.0129957066,0.0181818182,0.1,0,135,8.456190720035231E-5,1.5099278E-4,1.5491867E-4,505,0.26353276,12,1,202,1,0.004950495,-0.16353276
38494251,amandawi,10,445,463,563,7,1,36.5909729267,30-39,570,4,22,15,37,37,22,15,9,3.5713124746,2938.8467902431,0.0469397958,0.0578078078,0.23369566,0,135,1.90046709769823E-4,5.7880563E-4,5.938549E-4,343,0.39726776,0,0,200,0,0,-0.1635721
83028162,duanenicol,10,2532,371,469,15,18,42.4840762436,40-49,659,6,3,4,7,7,3,4,10,3.7301909793,538.2779105724,0.0096416225,0.0476190476,0.2,0,135,1.0190552187406414E-4,1.00661855E-4,1.0327911E-4,257,0.36363637,6,0,200,0,0,-0.16363637
217084212,myargeau,10,2430,157,212,4,20,26.1056162092,20-29,637,6,6,6,12,12,6,6,11,4.0499796831,49.9457397824,0.0351911566,0.0833333333,0.35714287,0,135,8.937376787994363E-5,1.7615824E-4,1.8073844E-4,353,0.5208333,3,0,200,0,0,-0.16369043
19221008,Hepworks,10,6490,461,986,3,44,53.9287494161,50-59,690,6,21,35,56,56,21,35,10,2.9947175945,31917.5478428516,0.12361078,0.0172077922,0.061877668,0,135,2.9848133336603954E-4,5.536402E-4,5.680351E-4,353,0.2255971,26,0,204,0,0,-0.163719432
187214966,DaisyLouMae,10,3502,552,1634,10,90,41.7455656873,40-49,595,6,4,14,18,18,4,14,10,3.4750101585,2107.306621313,0.0040820246,0.0522875817,0.1,0,135,7.266583416365452E-5,1.2582731E-4,1.0327911E-4,343,0.26374206,0,0,200,0,0,-0.16374206
27682432,trelayne,10,14196,515,917,23,95,50.4381450341,50-59,729,8,24,34,58,58,24,34,8,2.9691182446,22362.3180340139,0.0823898067,0.0163339383,0.07394958,0,135,2.0454610895464536E-4,6.291366E-4,6.4549444E-4,267,0.23781513,24,1,198,1,0.0050505051,-0.16386555
493673019,McRae_ML,10,1130,147,824,3,28,36.7901976338,30-39,559,5,11,50,61,61,11,50,9,2.9195449004,9454.3955727131,0.0488503583,0.0218579235,0.04734694,0,135,1.1413516114367978E-4,3.0198556E-4,3.0983734E-4,71,0.211422,0,0,200,0,0,-0.16407506
542706706,UONDP,10,6662,418,919,7,1,40.3937023661,40-49,553,7,56,64,120,120,56,64,9,2.9654611946,45526.5999994091,0.2035488296,0.031512605,0.12877263,0,135,3.3887176617658E-4,0.0014344314,0.0014717274,257,0.29287875,13,30,271,28,0.1033210332,-0.16410612
494320156,grecoce,10,317,72,200,1,0,32.8369344337,30-39,445,4,6,8,14,14,6,8,10,3.7622917513,59.8600948568,0.0192361751,0.1153846154,0.33333334,0,135,9.147846664784123E-5,1.7615824E-4,1.8073844E-4,257,0.49770114,3,3,200,3,0.015,-0.1643678
424057610,Mike_Peake,10,38769,720,276,33,311,42.6370450807,40-49,740,9,8,2,10,10,8,2,10,3.6911824462,279.6716310951,0.0185931999,0.0555555556,0.14285715,0,135,8.424174309296387E-5,2.2648917E-4,2.32378E-4,99,0.30769232,15,0,203,0,0,-0.16483517
246455540,mpmikea,10,2630,980,257,82,1,48.0875678995,40-49,682,5,37,2,39,39,37,2,11,4.3831775701,319.4338601642,0.1294593645,0.0924426451,0.13138138,0,135,4.413164044225331E-4,9.562876E-4,9.553318E-4,353,0.2962704,22,5,200,5,0.025,-0.16488902
7075582,trasie,10,11740,1147,681,72,129,50.0658787157,50-59,701,7,16,13,29,29,16,13,10,3.336854937,4167.06093405,0.0549845938,0.0357142857,0.10714286,0,135,2.495679995605151E-4,4.2781286E-4,4.3893623E-4,353,0.27239057,4,13,200,13,0.065,-0.16524771
165516074,RaymondAMenard,10,2790,407,465,4,172,49.0370560346,40-49,663,6,26,28,54,54,26,28,9,2.9329540837,27819.3993530934,0.0985931561,0.0087351502,0.049261082,0,135,1.9369719464454183E-4,6.794675E-4,6.97134E-4,505,0.21453373,36,0,204,0,0,-0.165272648
203646071,donnlovett,10,1910,325,551,7,1,45.5086370204,40-49,628,6,22,29,51,51,22,29,10,3.2242990654,6441.9098802575,0.1271510861,0.0556862745,0.18151261,0,135,2.0075655507421398E-4,5.7880563E-4,5.938549E-4,353,0.34696528,48,0,210,0,0,-0.16545267
210138966,stewart_mcgilli,10,732,764,770,23,9,45.1415744325,40-49,633,5,45,50,95,95,45,50,9,2.9849654612,23379.0464533662,0.1645520798,0.0322508399,0.13690476,0,135,3.854332546919235E-4,0.0011576113,0.0011877097,505,0.30244756,7,3,200,3,0.015,-0.1655428
20078507,junekaiser,10,611,180,435,5,38,38.3008201669,30-39,504,5,5,13,18,18,5,13,10,3.5071109305,407.9361205862,0.0208345638,0.0947712418,0.21428572,0,135,8.292307524192554E-5,1.5099278E-4,1.5491867E-4,71,0.37989205,3,1,200,1,0.005,-0.16560633
216940188,True_Tory,10,6201,455,956,14,599,47.8381795405,40-49,689,6,25,36,61,61,25,36,10,3.0410402275,28751.4066411691,0.1155921424,0.0215846995,0.043740574,0,135,2.421526999630329E-4,6.54302E-4,6.7131425E-4,257,0.2093629,29,5,201,5,0.0248756219,-0.165622326
18440389,blunt1,10,2657,801,412,47,73,61.7065619349,60-69,683,6,30,16,46,46,30,16,10,3.3080048761,6751.9074218268,0.1106325597,0.0275362319,0.06349207,0,135,2.8199486899675177E-4,7.8012934E-4,8.0041314E-4,71,0.22932652,15,0,200,0,0,-0.16583445
861557418,vaughndobson,10,657,140,1005,0,15,25.9856630144,20-29,397,4,2,20,22,22,2,20,10,3.3360422592,322.2267118961,0.003759093,0.0909090909,0.15,0,135,7.076597562458815E-5,7.549639E-5,7.7459335E-5,353,0.31611693,2,0,200,0,0,-0.16611693
23676939,ALXV5,10,5211,304,794,12,18,43.2451274,40-49,671,7,11,22,33,33,11,22,9,3.3466070703,7049.7031081768,0.0666845705,0.0615530303,0.13105413,0,135,1.1401930976309062E-4,3.0198556E-4,3.0983734E-4,353,0.2973843,18,0,201,0,0,-0.16633017
1026385562,moosemosesy,10,2355,235,478,3,7,48.4598511745,40-49,685,6,33,34,67,67,33,34,9,2.9703372613,11332.3221236772,0.1745647965,0.0314337404,0.17857143,0,135,2.1979432899743736E-4,8.556257E-4,8.7787246E-4,99,0.3449123,27,1,204,1,0.0049019608,-0.16634087
518011368,effyes,10,1205,98,146,0,31,37.1666813092,30-39,597,5,4,2,6,6,4,2,11,3.9215765949,6.7471176355,0.0422094941,0.1,0.33333334,0,135,7.073809953424697E-5,1.2582731E-4,1.2909889E-4,353,0.5,3,0,200,0,0,-0.16666666
60468248,midwifek,10,3242,262,246,21,22,53.3064740389,50-59,656,6,7,6,13,13,7,6,10,3.738317757,735.3320064776,0.0145688974,0.0705128205,0.25,0,135,1.278825801597065E-4,2.0132371E-4,1.8073844E-4,257,0.41666666,50,0,200,0,0,-0.16666666
443347925,patthomson19,10,667,243,207,1,152,40.1977640717,40-49,629,5,3,2,5,5,3,2,11,4.3092238927,5.1923466807,0.0114279081,0.05,0.33333334,0,135,6.361491487791058E-5,1.00661855E-4,1.0327911E-4,353,0.5,17,1,196,1,0.0051020408,-0.16666666
820019167,LGrayinVan,10,987,189,313,3,307,42.5917533498,40-49,594,5,3,4,7,7,3,4,9,3.5794392523,133.473436461,0.0253254966,0.0476190476,0.33333334,0,135,6.639817027646414E-5,1.00661855E-4,1.0327911E-4,99,0.5,4,0,186,0,0,-0.16666666
1257655196,anonGypsy,10,307,31,116,0,1,43.2626506991,40-49,532,5,1,2,3,3,1,2,9,4.4390739236,0.3,2.6808524730492474E-4,0.1666666667,0.16666667,0,287,4.58919816623078E-5,5.0330927E-5,5.1639556E-5,99,0.33333334,6,0,200,0,0,-0.16666667
18040291,ovadosepeace,10,6537,417,1828,13,4,43.2590093502,40-49,618,6,1,3,4,4,1,3,10,3.8106460788,78.8619612842,0.0068943743,0,0,0,135,4.644480038471271E-5,5.0330927E-5,5.1639556E-5,99,0.16666667,3,0,201,0,0,-0.16666667
395452946,rfbest,10,38,0,0,0,0,12.8994027935,10-19,128,1,2,1,3,3,2,1,1,1,2453,0.0011579534,0,0,0,0,8.093582176612495E-5,7.549639E-5,7.7459335E-5,257,0.16666667,0,0,38,0,0,-0.16666667
374871615,AMAPCEO_member,10,350,49,18,0,4,24.1544367801,20-29,580,4,2,0,2,2,2,0,0,0,0,0.0017941624,0,0,0,94,5.032273845198781E-5,7.549639E-5,0,257,0.16666667,8,0,200,0,0,-0.16666667
198291682,tcd_news,10,17134,917,112,23,9,44.9444634776,40-49,725,7,5,2,7,7,5,2,11,4.1251523771,780.2761071306,0.0098134456,0,0,0,135,7.263513177241664E-5,1.5099278E-4,1.2909889E-4,148,0.16666667,11,0,200,0,0,-0.16666667
267902492,CorrieBanman,10,2397,64,205,2,22,34.7410965479,30-39,616,6,4,4,8,8,4,4,10,3.5286468915,236.5276131197,0.067416985,0.0535714286,0.5,0,135,6.610218886699537E-5,1.2582731E-4,1.2909889E-4,353,0.6666667,0,1,200,1,0.005,-0.1666667
32725169,JasonGaudet,10,676,171,344,5,10,40.4038071199,40-49,582,4,7,9,16,16,7,9,9,3.6017878911,1699.6414746333,0.0153205475,0.0291666667,0.11818182,0,135,8.752761286846366E-5,2.0132371E-4,2.0655822E-4,505,0.285,6,0,201,0,0,-0.16681818
96874375,michaelhaack,10,37769,1245,1379,74,216,55.5482342783,50-59,788,9,40,38,78,78,40,38,10,3.0231613165,23040.5348748263,0.1307125162,0.0193140193,0.06349783,0,135,2.999060824120359E-4,0.001031784,0.0010586109,71,0.23041146,41,0,204,0,0,-0.16691363
454472178,AgLocal30048,10,1180,89,171,0,18,40.4385886832,40-49,575,5,10,8,18,18,10,8,10,3.4563185697,1340.5695817713,0.0403469135,0.0424836601,0.12179487,0,135,9.103006250292215E-5,2.768201E-4,2.8401756E-4,257,0.28876245,7,0,202,0,0,-0.16696758
284838499,tonkin12,10,2362,293,955,4,45,42.2159443378,40-49,562,6,36,101,137,137,36,101,9,2.7399431126,42325.8097083735,0.129747702,0.0182481752,0.046640016,0,135,2.523247974126165E-4,9.311221E-4,9.553318E-4,99,0.21377446,8,2,201,2,0.0099502488,-0.167134444
378826663,CaptainWalbran,10,4035,520,1301,12,293,44.7767744598,40-49,665,7,25,46,71,71,25,46,9,2.9349857781,15514.5261377191,0.0993197319,0.0237424547,0.08200355,0,135,1.8856345013666234E-4,6.54302E-4,6.7131425E-4,257,0.24920987,17,0,198,0,0,-0.16720632
162230121,BentheGood,10,2715,269,124,7,5,46.7971947608,40-49,628,5,16,8,24,24,16,8,10,3.727752946,535.8839605602,0.0502378235,0.0778985507,0.29583332,0,135,1.8973377737929349E-4,4.2781286E-4,4.3893623E-4,257,0.46305418,4,0,200,0,0,-0.16722086
374713557,political_k,10,844,142,814,1,1,37.0926898019,30-39,500,5,10,39,49,49,10,39,10,3.0934579439,4291.4625198761,0.0493764568,0.0663265306,0.14871795,0,135,8.259521010509739E-5,2.768201E-4,2.8401756E-4,505,0.31609446,6,0,199,0,0,-0.16737651
429882018,CooperCeline,10,1508,430,686,8,234,45.3330479961,40-49,662,6,11,8,19,19,11,8,10,3.6030069078,5175.3383499541,0.0199539457,0.0380116959,0.09047619,0,135,1.1591085982324415E-4,3.0198556E-4,3.0983734E-4,267,0.2579832,10,0,201,0,0,-0.16750701
486147303,UMacLeod1,10,3689,86,321,1,0,42.0268486135,40-49,649,7,7,16,23,23,7,16,10,3.1527834214,3491.450328969,0.0386467084,0.0059288538,0.025,0,135,7.038956781530799E-5,2.0132371E-4,2.0655822E-4,99,0.19279908,12,0,200,0,0,-0.16779908
147394203,zachchurchill,10,5138,1406,370,45,62,51.4108180016,50-59,731,7,31,11,42,42,31,11,10,3.7732629013,8447.8822138932,0.0775006081,0.0441347271,0.09893048,0,135,3.3921997953755153E-4,8.0529484E-4,8.0041314E-4,343,0.26676908,56,0,200,0,0,-0.1678386
324871858,arc185,10,2217,432,2001,5,24,40.3996923869,40-49,621,6,19,25,44,44,19,25,9,3.2263307599,5971.6778621634,0.0637747454,0.0597251586,0.21551724,0,135,1.4373041912056538E-4,5.0330925E-4,5.1639555E-4,343,0.3834372,2,2,200,2,0.01,-0.16791996
216609343,hpliszka,10,7314,450,913,12,16,60.1004120314,60-69,704,7,24,15,39,39,24,15,9,3.1511580658,20957.2982894307,0.0889678222,0.0128205128,0.03448276,0,135,2.2193750072884916E-4,6.291366E-4,6.4549444E-4,283,0.20251314,95,0,230,0,0,-0.16803038
275907942,LauraBeeMarie,10,2752,291,550,14,442,39.0905610388,30-39,601,6,5,12,17,17,5,12,9,3.4595692808,925.3914147208,0.0148010886,0.0588235294,0.12087912,0,135,1.4584915120610217E-4,1.5099278E-4,1.5491867E-4,99,0.28903654,5,0,200,0,0,-0.16815742
575511770,TedNOpitzCPC,10,290,161,442,4,2,33.3373712204,30-39,530,4,17,69,86,86,17,69,9,2.7566030069,29013.2046099122,0.0459002966,0.0176470588,0.03878943,0,135,1.556609947180221E-4,4.5297833E-4,4.64756E-4,99,0.20712191,18,1,197,1,0.0050761421,-0.16833248
121742777,tadlouni,10,1000,267,358,8,22,43.3210020993,40-49,606,5,19,20,39,39,19,20,10,3.4030881755,3931.9635298127,0.0621312785,0.0580296896,0.20307693,0,135,1.6404333321469775E-4,5.0330925E-4,5.1639555E-4,505,0.3714178,23,0,198,0,0,-0.16834087
493439413,justice499,10,11915,2539,1979,45,1980,40.8333607187,40-49,787,8,66,37,103,103,66,37,9,3.0158472166,41771.9491228289,0.1857277091,0.0192271083,0.05812662,0,135,4.3112098980638524E-4,0.0016860861,0.0017041053,99,0.22685444,54,0,199,0,0,-0.16872782
53211399,katrinashannon,10,5386,199,402,4,5,27.5891965263,20-29,593,7,21,21,42,42,21,21,9,3.2145469321,5046.7186135183,0.054459683,0.0278745645,0.1005291,0,135,1.8888674078732908E-4,5.536402E-4,5.680351E-4,257,0.26956183,1,0,200,0,0,-0.16903273
271681559,brianwhiteNDP,10,545,455,441,25,2,60.4043096485,60-69,600,4,29,18,47,47,29,18,10,3.4160910199,9053.3921862729,0.109418705,0.0633672525,0.22528736,0,135,3.076236972036608E-4,7.549639E-4,7.745933E-4,257,0.39440992,3,4,200,4,0.02,-0.16912256
40756532,StopWarCa,10,2323,1504,1270,83,1,42.7594503628,40-49,705,6,33,22,55,55,33,22,10,3.3531084925,10075.6554131247,0.0965452703,0.0407407407,0.08535354,0,135,3.5371196786851666E-4,8.556257E-4,8.7787246E-4,71,0.2547525,28,0,200,0,0,-0.16939896
36422158,TweetCanGreen,10,5192,238,256,14,74,39.1273181375,30-39,596,7,14,12,26,26,14,12,9,3.3758634701,4166.6721061971,0.0369603721,0.0338461538,0.10526316,0,135,1.457913978630237E-4,3.7748195E-4,3.8729666E-4,283,0.2746806,1,2,200,2,0.01,-0.16941744
39684793,brianostrander,10,9037,715,1297,11,30,47.8797136188,40-49,697,7,6,17,23,23,6,17,10,3.4067452255,1759.8926864293,0.0544648045,0.0869565217,0.22426471,0,135,9.27964546865769E-5,1.7615824E-4,1.8073844E-4,353,0.39372548,15,1,200,1,0.005,-0.16946077
20268038,FamilyAction,10,26,402,81,21,1,39.5768660469,30-39,574,5,13,2,15,15,13,2,12,5.0772043885,5106.9342321217,0.0828886573,0.0857142857,0.15714286,0,135,3.277008086855755E-4,3.5231648E-4,3.3565713E-4,353,0.32671958,7,0,28,0,0,-0.16957672
542744338,TynaMcNair,10,1354,213,565,2,117,42.6151857259,40-49,575,6,13,17,30,30,13,17,10,3.1312474604,3241.670087053,0.0746492526,0.0183908046,0.06725146,0,135,1.196108193344884E-4,3.5231648E-4,3.6147688E-4,99,0.23689727,5,0,200,0,0,-0.16964581
287752788,Rabnew,10,5149,246,466,4,16,50.7551004128,50-59,704,7,47,43,90,90,47,43,9,2.9422998781,19521.9888295452,0.2004385413,0.0349563046,0.09356351,0,135,2.538931395525717E-4,0.0012079423,0.0012393494,99,0.26342988,193,1,260,1,0.0038461538,-0.16986637
177602450,jodypercy,10,1929,476,1039,14,1,44.2799169578,40-49,668,6,25,46,71,71,25,46,10,3.1930109711,12762.2731834173,0.066235542,0.0426559356,0.14009662,0,135,2.2195050611954282E-4,6.54302E-4,6.7131425E-4,257,0.31000644,44,0,200,0,0,-0.16990982
213751216,cameronsgray,10,1400,856,1802,32,82,63.2714161617,60-69,637,6,23,34,57,57,23,34,9,3.0495733442,17997.1048502517,0.0994211247,0.0310150376,0.09615385,0,135,2.4705849635713105E-4,6.0397113E-4,6.196747E-4,71,0.26608783,13,4,200,4,0.02,-0.16993398
178196480,joshyfraser,10,4371,514,482,19,390,52.4174054928,50-59,680,6,27,13,40,40,27,13,10,3.3908980089,4591.6961518742,0.1379501246,0.0320512821,0.07670455,0,135,2.1608833889551085E-4,7.0463296E-4,7.2295376E-4,505,0.24666667,16,0,199,0,0,-0.16996212
384614410,StewartKiff,10,229,235,423,2,7,29.3580785899,20-29,486,4,13,20,33,33,13,20,10,3.3770824868,2856.1589462258,0.0938486775,0.0511363636,0.16666667,0,135,1.33059169087286E-4,3.5231648E-4,3.6147688E-4,353,0.33715987,4,1,199,1,0.0050251256,-0.1704932
195164291,AllPopGuy,10,9887,728,1796,15,498,59.7722598272,50-59,691,8,53,70,123,123,53,70,9,2.9585534336,34887.253760492,0.1597858166,0.0331867253,0.108580664,0,135,3.5065486613559195E-4,0.001358935,0.001394268,505,0.27917898,45,1,200,1,0.005,-0.170598316
150289374,UFCW1000A,10,1307,631,830,19,6,46.6412443748,40-49,630,5,31,42,73,73,31,42,9,3.1588785047,15858.7178719802,0.090933029,0.0289193303,0.1205074,0,135,2.1136184563872777E-4,8.0529484E-4,8.262329E-4,257,0.2912088,29,0,199,0,0,-0.1707014
16276647,HermanThind,10,4784,447,1157,5,113,46.1407684875,40-49,609,7,40,78,118,118,40,78,8,2.6395774076,104088.621427214,0.1701870743,0.016804288,0.055696204,0,135,3.828943217962984E-4,0.001031784,0.0010586109,505,0.22642516,56,0,212,0,0,-0.170728956
25068722,Youngblut,10,1673,2491,1141,84,44,49.9353182361,40-49,683,6,14,9,23,23,14,9,11,3.6042259244,4499.6168939169,0.0514648068,0.057312253,0.15441176,0,135,1.9575385251477265E-4,3.7748195E-4,3.8729666E-4,353,0.3257468,8,0,200,0,0,-0.17133504
258135801,JulieSLalonde,10,10251,1792,1988,81,9,57.7639780692,50-59,772,7,54,45,99,99,54,45,9,3.0223486388,61196.1577278201,0.1385130518,0.0102040816,0.03720238,0,135,4.4299716522804423E-4,0.0013841004,0.0013684483,257,0.20859706,131,1,201,1,0.0049751244,-0.17139468
271284946,KSeesequasis,10,1596,658,889,16,18,44.4503651374,40-49,647,6,43,45,88,88,43,45,10,2.9410808614,32922.2126858942,0.2124710432,0.0212904911,0.104489796,0,135,3.312836988454005E-4,0.0011072804,0.0011360702,505,0.2759009,24,1,199,1,0.0050251256,-0.171411104
261539076,gayhuckabee,10,6161,735,1532,15,1497,47.8927161567,40-49,704,7,3,6,9,9,3,6,10,3.6334823243,239.8428642591,0.0066148101,0.0138888889,0.033333335,0,135,5.2034253257751715E-5,1.00661855E-4,1.0327911E-4,99,0.20476191,2,0,200,0,0,-0.171428575
51963464,janellenfrench,10,4039,171,276,6,14,40.4565214959,40-49,494,5,2,4,6,6,2,4,10,3.9187322227,0.566272857,0.0086336884,0.2,0.4,0,135,5.899959688858322E-5,7.549639E-5,7.7459335E-5,99,0.5714286,4,0,201,0,0,-0.1714286
557444928,DDesBaillets,10,2674,586,1903,5,36,43.5533872126,40-49,627,6,21,60,81,81,21,60,9,2.8626574563,24992.5393159286,0.0901550421,0.0293209877,0.07824859,0,135,2.0500069955064817E-4,5.536402E-4,5.680351E-4,257,0.24998903,19,1,200,1,0.005,-0.17174044
402172664,KevinGDraper,10,167,48,138,1,1,38.8219322721,30-39,509,4,10,16,26,26,10,16,10,3.3596099147,3563.4006973881,0.0535131688,0.0646153846,0.2254902,0,135,8.409903629604683E-5,2.768201E-4,2.8401756E-4,505,0.3974359,9,0,201,0,0,-0.1719457
27485292,ChrisDawnMonroe,10,24819,1424,1870,50,2962,63.5493061318,60-69,753,8,35,60,95,95,35,60,9,3.0150345388,27541.1258717011,0.1149084081,0.0388577828,0.11736771,0,135,3.670117583753758E-4,9.0595667E-4,9.036922E-4,505,0.28931618,38,0,202,0,0,-0.17194847
28569095,LaurieNorris,10,486,71,135,1,21,39.8465983611,30-39,532,4,11,18,29,29,11,18,10,3.1986997156,1380.4571150212,0.0604282426,0.0431034483,0.17836258,0,135,1.1237464219455001E-4,3.0198556E-4,3.0983734E-4,99,0.35105205,6,1,200,1,0.005,-0.17268947
154571151,mihaychuk,10,5111,828,1963,33,42,47.3081976259,40-49,676,7,27,45,72,72,27,45,9,3.0491670053,28543.6854651055,0.0586417698,0.0156494523,0.055072464,0,135,2.6316868452012763E-4,7.0463296E-4,7.2295376E-4,283,0.22784135,16,1,200,1,0.005,-0.172768886
17291311,LeahvanHouten,10,1765,979,497,33,0,46.9017288527,40-49,663,6,74,37,111,111,74,37,10,3.2157659488,22042.532983348,0.2068974252,0.0464373464,0.12901235,0,135,5.647967463645699E-4,0.0018874097,0.0019364833,505,0.30181992,41,1,200,1,0.005,-0.17280757
270928670,NSchwen,10,544,112,195,2,2,30.2259592614,30-39,449,4,5,8,13,13,5,8,11,4.0637952052,300.8314752486,0.0285854447,0.1282051282,0.1969697,0,135,1.0243344456667103E-4,1.5099278E-4,1.5491867E-4,353,0.36984354,13,2,199,2,0.0100502513,-0.17287384
16437983,WilliamNorman,10,5968,1019,1737,45,37,47.3936575213,40-49,705,7,47,52,99,99,47,52,10,3.0910199106,24889.8902361497,0.1544940424,0.0394763966,0.13365385,0,135,4.929602364831361E-4,0.0012079423,0.0012393494,505,0.3067238,29,2,200,2,0.01,-0.17306995
142408161,CelesteCote,10,6890,847,652,31,151,63.4004776639,60-69,719,7,39,22,61,61,39,22,10,3.2998780983,16267.8752903739,0.0946749414,0.0284153005,0.07585569,0,135,4.252055921048456E-4,0.0010066185,0.0010327911,283,0.24896675,60,0,201,0,0,-0.17311106
312422268,MatBoisvert,10,7638,380,691,9,1,33.7661438422,30-39,663,7,46,60,106,106,46,60,9,2.9134498171,34653.4080344227,0.1784445484,0.0376460018,0.11387388,0,135,4.119972733295338E-4,0.0011827768,0.0012135296,257,0.2870677,17,2,200,2,0.01,-0.17319382
22976448,jayfanmanitoba,10,2314,107,702,1,281,28.0192429327,20-29,366,6,10,25,35,35,10,25,10,3.1527834214,6860.0827180321,0.0312405603,0.0336134454,0.09384616,0,135,1.0538892687637913E-4,2.768201E-4,2.8401756E-4,505,0.26709446,0,7,215,7,0.0325581395,-0.1732483
24031034,daveschulz,10,11898,474,922,11,14,46.7307114779,40-49,678,7,9,10,19,19,9,10,10,3.4079642422,413.0418495155,0.0679447609,0.0730994152,0.24358974,0,135,1.9613922761978924E-4,2.5165462E-4,2.5819778E-4,353,0.41700405,2,0,200,0,0,-0.17341431
363064080,ShayneSangster,10,2543,136,385,4,5,41.7950352123,40-49,560,6,20,25,45,45,20,25,9,3.1665989435,6715.1952873496,0.0741364727,0.0550505051,0.2044335,0,135,1.7276089254085857E-4,5.2847475E-4,5.4221536E-4,257,0.37800634,8,2,207,2,0.0096618357,-0.17357284
67605782,Canadian_Flyboy,10,473,411,1093,7,58,39.6069522196,30-39,534,4,9,21,30,30,9,21,10,3.3230394149,933.0589060383,0.0251289098,0.1114942529,0.27470356,0,135,2.584433140134754E-4,2.5165462E-4,2.5819778E-4,505,0.44828907,8,1,200,1,0.005,-0.17358551
273160093,darcymurray,10,3633,260,771,6,1,39.5906018223,30-39,576,7,7,9,16,16,7,9,10,3.7468508736,1239.8415425717,0.0153489784,0.0625,0.2,0,135,8.212171267998962E-5,2.0132371E-4,2.0655822E-4,257,0.3739496,14,0,199,0,0,-0.1739496
39204895,benfromcanada,10,40133,930,790,64,2547,51.4351360192,50-59,831,9,22,10,32,32,22,10,10,3.4278748476,8284.2822285906,0.0621111047,0.0171370968,0.041538462,0,135,1.4337565338964542E-4,5.7880563E-4,5.938549E-4,99,0.2155102,17,0,201,0,0,-0.173971738
75016616,Stephen_Yardy,10,1873,510,536,15,10,56.2263349206,50-59,687,5,69,36,105,105,69,36,9,3.2450223486,22868.2803509219,0.2182103202,0.0522893773,0.12594937,0,135,4.6745060463320863E-4,0.0017615824,0.0017815647,257,0.2999715,119,10,200,9,0.045,-0.17402213
222819990,SocialDemoMatty,10,797,127,487,2,4,38.0133163228,30-39,543,5,16,31,47,47,16,31,9,3.139780577,15586.464881236,0.0348255127,0.0203515264,0.061491936,0,135,1.3364348412176397E-4,4.2781286E-4,4.3893623E-4,257,0.23558052,3,0,200,0,0,-0.174088584
331666614,AndreaMicieli,10,2079,433,686,8,63,48.036823562,40-49,669,6,48,54,102,102,48,54,9,3.0414465664,21994.2702457138,0.1611688951,0.0427101534,0.15081584,0,135,3.6749326836829405E-4,0.0012331076,0.0012651691,505,0.32496643,136,1,200,1,0.005,-0.17415059
173469798,Earth_NewsRT,10,146152,4229,0,395,0,47.1934241172,40-49,861,10,22,0,22,22,22,0,0,0,0,0.0568146571,0.012987013,0.021645023,0,16,1.63418566556158E-4,5.7880563E-4,0,99,0.19579832,14,0,203,0,0,-0.174153297
346705023,natif8,10,58922,625,976,49,2464,41.4076170414,40-49,736,9,16,17,33,33,16,17,9,3.383583909,3389.2508552623,0.055948961,0.0549242424,0.10591133,0,135,1.389398960505468E-4,4.2781286E-4,4.3893623E-4,267,0.28013468,29,0,202,0,0,-0.17422335
414261042,SeldomSmith,10,5037,510,1470,7,34,43.7013074465,40-49,677,7,30,70,100,100,30,70,9,2.8175538399,39809.1466651613,0.1399288873,0.0178787879,0.05063063,0,135,2.634307673129657E-4,7.8012934E-4,8.0041314E-4,353,0.2249092,8,1,200,1,0.005,-0.17427857
15223577,Johnny222,10,1709,232,294,3,26,40.937518047,40-49,599,5,19,17,36,36,19,17,10,3.5213327915,2632.1733195364,0.0606052454,0.0476190476,0.14666666,0,135,1.4938229689932873E-4,5.0330925E-4,5.1639555E-4,257,0.3212121,13,1,200,1,0.005,-0.17454544
326235711,quito_maggi,10,1751,594,589,17,40,62.7837172238,60-69,682,6,52,48,100,100,52,48,10,3.0463226331,34663.0683622529,0.179558854,0.0294949495,0.10983103,0,135,4.2976897856328316E-4,0.0013337695,0.0013684483,505,0.28449848,149,0,201,0,0,-0.17466745
328112301,robert_kiley,10,2808,693,1157,26,65,48.514550343,40-49,681,6,15,21,36,36,15,21,10,3.3498577814,5925.0725134601,0.0307329511,0.0277777778,0.083076924,0,135,2.0650961261931786E-4,4.0264742E-4,4.1311645E-4,283,0.25790423,23,0,200,0,0,-0.174827306
19110210,una1rose,10,12581,824,1756,22,46,46.1403856507,40-49,685,7,4,13,17,17,4,13,10,3.5136123527,534.1641130848,0.0087494265,0.0220588235,0.029166667,0,135,6.495185076242444E-5,1.2582731E-4,1.2909889E-4,257,0.2042042,2,1,199,1,0.0050251256,-0.175037533
362100154,Nutzo56,10,12360,1109,597,28,1784,58.7173441181,50-59,772,8,30,17,47,47,30,17,9,3.1909792767,9894.8883853643,0.0771036939,0.0231267345,0.105747126,0,135,2.2626529541291138E-4,7.8012934E-4,8.0041314E-4,99,0.28092244,64,0,201,0,0,-0.175175314
46956207,paulchislett,10,8817,650,1707,23,7,44.0237642653,40-49,671,7,12,27,39,39,12,27,10,3.1596911824,7214.1920428044,0.0551082525,0.0344129555,0.0997151,0,135,1.8125815701167052E-4,3.27151E-4,3.3565713E-4,257,0.275,7,0,199,0,0,-0.1752849
81050260,GoldHome,10,520,118,280,0,6,31.5175300995,30-39,459,4,7,9,16,16,7,9,9,3.2458350264,1868.4866664267,0.0288854739,0.025,0.15277778,0,135,8.000312153371382E-5,2.0132371E-4,2.0655822E-4,99,0.32806325,7,0,200,0,0,-0.17528547
382516525,Buswell_FedNDP,10,4625,199,228,2,42,45.4417105982,40-49,702,6,22,22,44,44,22,22,9,3.3746444535,12416.1100493082,0.0668650712,0.0581395349,0.15725806,0,135,2.723725092287671E-4,5.7880563E-4,5.938549E-4,257,0.33255813,66,26,200,21,0.105,-0.17530007
242123168,PhotogShawn,10,2595,207,522,0,11,43.8948207972,40-49,640,6,24,61,85,85,24,61,9,2.8130841121,28380.9343060614,0.0775912278,0.0130252101,0.038797814,0,135,1.6967404647315462E-4,6.291366E-4,6.4549444E-4,505,0.2142031,19,0,200,0,0,-0.175405286
397288315,ChrisMcDonald__,10,1163,153,282,5,75,36.0207551348,30-39,558,5,15,14,29,29,15,14,10,3.4315318976,8870.1977089717,0.0387165127,0.0332512315,0.15686275,0,135,1.4149965789022663E-4,4.0264742E-4,4.1311645E-4,257,0.33236575,1,0,200,0,0,-0.175503
31658445,CorneliusCotter,10,261,121,590,1,0,31.0880628071,30-39,553,3,20,35,55,55,20,35,9,3.1938236489,10731.9640184527,0.0704322779,0.064983165,0.1970128,0,135,1.607179359966174E-4,5.2847475E-4,5.4221536E-4,257,0.37253007,6,1,200,1,0.005,-0.17551727
274012183,elizsamuels,10,3510,554,550,12,292,63.7768909121,60-69,689,6,44,17,61,61,44,17,10,3.4221861032,7481.6925920474,0.1496392631,0.0584699454,0.14051418,0,135,4.8387932777058E-4,0.0011324459,0.00116189,505,0.31609446,65,5,200,5,0.025,-0.17558028
31504538,MakereSH,10,4149,245,520,4,260,41.9085963984,40-49,606,7,11,10,21,21,11,10,9,3.3417310037,1569.6095073584,0.0709644913,0.0476190476,0.23484848,0,135,1.2557153712882096E-4,3.0198556E-4,3.0983734E-4,99,0.4105263,5,0,200,0,0,-0.17567782
41532121,aladdintweets,10,2912,231,1108,7,10,46.6700761761,40-49,624,6,7,7,14,14,7,7,11,3.9516456725,1128.2088966883,0.0169487324,0.021978022,0.07777778,0,135,8.865991277304318E-5,2.0132371E-4,2.0655822E-4,71,0.2536232,22,0,207,0,0,-0.17584542
502004635,rockyp9nes,10,1802,120,216,5,7,39.077258643,30-39,497,6,12,11,23,23,12,11,10,3.458756603,499.3717720329,0.0489176523,0.0434782609,0.12857144,0,135,9.867223562199153E-5,3.27151E-4,3.3565713E-4,99,0.3045977,1,0,200,0,0,-0.17602626
20168768,JElmhirst,10,302,139,299,1,8,40.3894710493,40-49,473,4,6,10,16,16,6,10,10,3.6830556684,242.1273610896,0.0187594376,0.0541666667,0.22222222,0,135,1.550392725200646E-4,1.7615824E-4,1.8073844E-4,505,0.3984127,0,1,200,1,0.005,-0.17619048
24639266,LadySnarksalot,10,98356,1731,782,76,8913,56.2149663326,50-59,827,10,44,18,62,62,44,18,10,3.3831775701,13704.1406425633,0.1090075496,0.0193019566,0.052525252,0,135,3.4676281033654295E-4,0.0011324459,0.00116189,257,0.22873865,116,0,205,0,0,-0.176213398
604655008,YoungLiberalsPE,10,238,248,599,4,57,42.378527725,40-49,542,4,16,16,32,32,16,16,10,3.3295408371,3833.5295631115,0.0669874267,0.0534274194,0.20789474,0,135,1.6652814273891163E-4,4.2781286E-4,4.3893623E-4,505,0.38414633,36,1,200,1,0.005,-0.17625159
146530868,ashedletzky,10,185,135,101,10,0,40.4545180985,40-49,495,3,13,2,15,15,13,2,11,4.5583096302,191.4752167106,0.0193885819,0.0428571429,0.08974359,0,135,1.1885145163168427E-4,3.5231648E-4,3.6147688E-4,71,0.26623377,13,1,200,1,0.005,-0.17649018
460172196,HaltonLiberal,10,1254,210,581,7,1,50.9697227515,50-59,591,6,11,17,28,28,11,17,10,3.5765948801,1586.3111952717,0.0333931641,0.0674603175,0.21052632,0,135,1.2692037677526307E-4,3.0198556E-4,3.0983734E-4,505,0.38701922,7,4,200,4,0.02,-0.1764929
27935316,Teirersias,10,24186,1078,1849,36,347,61.084608874,60-69,776,8,10,17,27,27,10,17,10,3.4384396587,16700.3873646713,0.031952077,0.0185185185,0.05882353,0,135,1.9086897224622712E-4,2.768201E-4,2.8401756E-4,99,0.23537233,52,0,200,0,0,-0.1765488
359011405,SimonDee_,10,942,298,435,1,6,40.9330210783,40-49,609,5,21,24,45,45,21,24,9,2.9658675335,14307.6458269035,0.0866466553,0.0146464646,0.06552707,0,135,1.390205080850868E-4,5.536402E-4,5.680351E-4,505,0.24270353,10,1,200,1,0.005,-0.17717646
538262738,johncmerriman,10,831,49,163,1,225,32.2560549802,30-39,471,5,6,6,12,12,6,6,11,3.928484356,766.1152885778,0.0103659064,0.0303030303,0.16666667,0,135,1.0054508500030311E-4,1.7615824E-4,1.8073844E-4,257,0.34391534,3,2,200,1,0.005,-0.17724867
1273559047,ReignFeral,10,90,4,23,0,13,42.8487866689,40-49,639,5,4,1,5,5,4,1,11,4.9422998781,11.6226937443,0.0058030828,0.05,0.05,0,135,5.4331980804846125E-5,1.2582731E-4,1.0327911E-4,353,0.22727273,352,2,214,2,0.0093457944,-0.17727273
105832299,TBoog06,10,473,99,470,2,28,27.6624142406,20-29,483,4,1,2,3,3,1,2,11,4.6615197074,24.9066631004,0.0019184234,0.1666666667,0.33333334,0,135,6.0621492879642734E-5,5.0330927E-5,5.1639556E-5,343,0.510989,0,0,198,0,0,-0.17765566
62979039,JeromeDowney,10,4743,1058,985,15,885,52.1195004676,50-59,682,6,8,8,16,16,8,8,10,3.7212515238,2434.5441789766,0.0216938978,0.0291666667,0.11111111,0,135,2.1372690333126048E-4,2.2648917E-4,2.32378E-4,343,0.28877005,3,0,200,0,0,-0.17765894
92607766,JusticeLawDev,10,9672,849,1739,36,514,49.0116070107,40-49,720,7,29,51,80,80,29,51,9,2.928484356,29765.1788738215,0.0842159445,0.0121835443,0.041101057,0,135,2.7286692944812586E-4,7.549639E-4,7.745933E-4,257,0.21880782,12,0,201,0,0,-0.177706763
367562844,ehamilt,10,1416,357,340,4,17,43.5227792129,40-49,613,6,15,15,30,30,15,15,8,3.365704998,4815.9811731383,0.0398793104,0.0183908046,0.08455882,0,135,1.5173938806795425E-4,4.0264742E-4,4.1311645E-4,71,0.2623106,9,1,200,1,0.005,-0.17775178
173580066,toronto_rt,10,720860,4327,0,189,0,41.1737993773,40-49,885,11,4,0,4,4,4,0,0,0,0,0.0074641416,0,0,0,39,6.974314190004015E-5,1.2582731E-4,0,353,0.17777778,2,0,191,0,0,-0.17777778
51158869,smitty_1993,10,666,201,396,1,166,48.2255605435,40-49,537,5,5,4,9,9,5,4,10,3.9764323446,1227.0793691592,0.0303935081,0.0138888889,0.1,0,135,7.903495067759242E-5,1.5099278E-4,1.5491867E-4,505,0.2777778,1,0,198,0,0,-0.1777778
164451662,UpThePitt,10,4858,553,533,20,121,48.4316258005,40-49,708,7,7,10,17,17,7,10,10,3.4632263308,664.6769573684,0.0188438433,0.0367647059,0.09848485,0,135,1.2004909795229816E-4,2.0132371E-4,2.0655822E-4,257,0.2764706,8,0,200,0,0,-0.17798575
79015001,colinmckone,10,587,121,205,3,6,23.5460606736,20-29,479,4,8,7,15,15,8,7,10,3.9061357172,154.2355283036,0.0231176232,0.0761904762,0.375,0,135,1.0967556323178658E-4,2.2648917E-4,2.32378E-4,505,0.5534274,1,0,200,0,0,-0.1784274
252109262,V4Daddy,10,19072,202,322,4,87,39.722011386,30-39,755,8,3,3,6,6,3,3,11,3.9760260057,5.6778434491,0.0306533982,0.1,0.25,0,135,5.980839731513856E-5,1.00661855E-4,1.0327911E-4,353,0.42857143,6,0,201,0,0,-0.17857143
34025552,DanielJardine,10,927,354,357,7,4,37.9512724765,30-39,562,5,3,4,7,7,3,4,10,3.8618447785,67.2139460199,0.0048391042,0.0714285714,0.25,0,135,6.537611546928994E-5,1.00661855E-4,1.0327911E-4,505,0.42857143,3,0,199,0,0,-0.17857143
82461587,robertquickert,10,9905,160,204,4,18,43.2527425513,40-49,614,8,3,3,6,6,3,3,10,4.3197887038,256.4498373867,0.0073816601,0,0,0,135,5.515798218195908E-5,1.00661855E-4,1.0327911E-4,267,0.17857143,13,0,201,0,0,-0.17857143
37552089,suestroud,10,8878,559,768,21,97,50.1033505219,50-59,653,8,44,40,84,84,44,40,9,3.064607883,22971.4797374931,0.1541974523,0.0342799771,0.10432496,0,135,2.953683272147043E-4,0.0011324459,0.00116189,71,0.28292605,35,2,204,2,0.0098039216,-0.17860109
68844282,jomac1867,10,2089,557,1200,21,440,42.7868713119,40-49,596,6,12,16,28,28,12,16,10,3.3075985372,24738.9251956046,0.0380010827,0.0092592593,0.05147059,0,135,1.838629897108053E-4,3.27151E-4,3.3565713E-4,267,0.23011364,2,0,200,0,0,-0.17864305
408765727,PJPartington,10,795,219,474,5,1,44.7635467062,40-49,621,5,16,12,28,28,16,12,10,3.4892320195,9781.9669645847,0.0441446548,0.0277777778,0.0882353,0,135,2.5106925578600515E-4,4.2781286E-4,4.3893623E-4,71,0.2670068,18,0,200,0,0,-0.1787715
556301825,UNYANews,10,252,244,393,5,145,40.6568880958,40-49,513,4,2,4,6,6,2,4,11,4.0804550996,31.7021986728,0.0058023594,0.0666666667,0.16666667,0,135,9.795873255082137E-5,7.549639E-5,7.7459335E-5,99,0.34545454,7,0,200,0,0,-0.17878787
276518876,gonzopolecon,10,3607,183,352,1,318,45.7441099525,40-49,676,6,20,20,40,40,20,20,9,3.1909792767,2027.8843596948,0.0891485653,0.0397435897,0.12962963,0,135,1.9124459647606548E-4,5.2847475E-4,5.4221536E-4,99,0.308634,62,0,203,0,0,-0.17900437
20679494,ibushfield,10,5243,1034,1523,50,7,61.5122401161,60-69,686,6,27,43,70,70,27,43,10,2.9662738724,26725.0424985632,0.1033968975,0.0182194617,0.061835747,0,135,4.715549218081111E-4,7.0463296E-4,7.2295376E-4,71,0.2408889,14,0,200,0,0,-0.179053153
28286822,edgytimes,10,5041,761,1981,8,300,46.2876098561,40-49,689,7,37,73,110,110,37,73,9,2.8728159285,31555.4981861082,0.1026941692,0.0190158465,0.05859649,0,135,2.4450743966791246E-4,9.562876E-4,9.811516E-4,99,0.23819989,38,0,204,0,0,-0.1796034
21773382,RichardNorthern,10,1252,517,889,10,7,43.5687237665,40-49,634,5,44,42,86,86,44,42,10,3.1946363267,13752.7750357155,0.1562069722,0.0581395349,0.2085954,0,135,4.123849714339515E-4,0.0011324459,0.00116189,257,0.3882853,22,1,200,1,0.005,-0.1796899
379008073,zb_armstrong,10,9333,756,1052,30,82,61.6170741252,60-69,752,7,52,44,96,96,52,44,10,3.0841121495,37359.6022148316,0.1522947992,0.0277412281,0.10423729,0,135,4.3678079920050905E-4,0.0013337695,0.0013684483,505,0.28396764,99,2,203,2,0.0098522167,-0.17973035
507494424,SteveSlep,10,603,185,580,4,6,39.1058783143,30-39,561,5,28,30,58,58,28,30,9,3.283218204,6369.4001142682,0.0985207872,0.0435571688,0.2548387,0,135,2.3163136218316716E-4,7.297984E-4,7.487736E-4,257,0.4345912,11,4,199,4,0.0201005025,-0.1797525
408952647,Eastofrockies,10,1798,938,1989,6,252,32.5687848586,30-39,643,6,5,9,14,14,5,9,10,3.422998781,2415.3709464474,0.0307375895,0,0,0,135,6.579144540457366E-5,1.5099278E-4,1.5491867E-4,343,0.18014705,9,0,199,0,0,-0.18014705
216243608,yolkregion,10,1264,493,308,5,61,38.9800930489,30-39,613,5,4,6,10,10,4,6,10,3.7765136124,279.6069971646,0.0060977591,0.0444444444,0.10714286,0,135,6.58794290110219E-5,1.2582731E-4,1.2909889E-4,283,0.2875,8,0,200,0,0,-0.18035714
37915527,KellyReganNS,10,9175,1777,576,84,2,54.031576243,50-59,749,7,38,17,55,55,38,17,11,3.8228362454,13597.5483016638,0.0808974235,0.035016835,0.10121457,0,135,5.252069277435192E-4,9.814531E-4,0.0010069713,343,0.28164795,86,1,201,1,0.0049751244,-0.18043338
23241468,JackpineLiam,10,6429,1174,2001,21,896,67.8043743285,60-69,723,7,16,22,38,38,16,22,10,3.3770824868,6864.3933932794,0.0440710422,0.0241820768,0.07010582,0,135,1.6912987323190276E-4,4.2781286E-4,4.3893623E-4,505,0.25064003,17,0,201,0,0,-0.18053421
400419867,995mu,10,10040,31,29,0,472,29.7503205708,20-29,622,7,2,1,3,3,2,1,10,4.035757822,36.1535650534,0.0080131403,0.1666666667,0.16666667,0,135,6.21272234474061E-5,7.549639E-5,7.7459335E-5,505,0.3472222,16,0,203,0,0,-0.18055553
879938671,ZacharyRDM,10,6417,124,98,0,1963,53.3230134714,50-59,736,7,5,4,9,9,5,4,10,3.7139374238,707.0600347105,0.0307013758,0.0138888889,0.035714287,0,135,7.587860510691081E-5,1.5099278E-4,1.5491867E-4,505,0.21637426,112,0,203,0,0,-0.180659973
161107042,sindark,10,2606,236,469,15,460,,,600,6,4,10,14,14,4,10,10,3.5416497359,481.2811622322,0.0085294991,0.032967033,0.07777778,0,135,7.631267999826884E-5,1.2582731E-4,1.2909889E-4,71,0.25889328,3,0,200,0,0,-0.1811155
17738467,tylercameron,10,9311,1287,621,46,1180,55.278611061,50-59,727,7,24,11,35,35,24,11,10,3.5038602194,3675.7220862791,0.1372869316,0.0579831933,0.17166667,0,135,3.102824103864714E-4,6.291366E-4,6.4549444E-4,353,0.35282487,32,0,200,0,0,-0.1811582
93964759,ToulasTake,10,22774,1463,2000,62,293,50.3198799428,50-59,773,8,7,9,16,16,7,9,9,3.6265745632,1085.7742033036,0.0170766991,0.0625,0.19090909,0,135,1.861294202434326E-4,2.0132371E-4,2.0655822E-4,267,0.37209302,10,0,201,0,0,-0.18118393
567814795,BryanLCrockett,10,6866,460,831,14,18,62.2498752194,60-69,733,7,44,58,102,102,44,58,9,2.8691588785,38472.4738579709,0.1676966952,0.0203843914,0.08797814,0,135,3.103918494347897E-4,0.0011324459,0.00116189,505,0.2691622,65,5,209,5,0.023923445,-0.18118406
18200731,Gregor_Ash,10,6392,1832,1494,62,80,54.3009186283,50-59,728,7,32,20,52,52,32,20,10,3.4880130028,20354.8339621645,0.0654142747,0.0377073906,0.15435606,0,135,3.2147690030306356E-4,8.304603E-4,8.262329E-4,343,0.3355917,39,1,200,1,0.005,-0.18123564
359788259,mangoparent,10,6741,891,1759,21,6,37.1456580178,30-39,709,7,25,53,78,78,25,53,10,2.8549370175,43614.7352222877,0.0932371491,0.0143190143,0.043326344,0,135,2.047258268168257E-4,6.54302E-4,6.7131425E-4,505,0.22476415,12,1,199,1,0.0050251256,-0.181437806
515986093,LondonWestNDP,10,460,194,260,6,1,42.7136741577,40-49,543,5,34,21,55,55,34,21,9,3.4351889476,5065.7598131139,0.1185151891,0.0737373737,0.243994,0,135,2.201544552623001E-4,8.807912E-4,8.7787246E-4,257,0.4257716,20,1,200,1,0.005,-0.1817776
501188833,sheila_info,10,2570,415,1072,4,28,48.2524272218,40-49,624,6,28,44,72,72,28,44,9,2.8370581065,28694.5461637652,0.1460954397,0.0148669797,0.054589372,0,135,2.831736150776652E-4,7.297984E-4,7.487736E-4,99,0.23679756,11,2,200,2,0.01,-0.182208188
74179953,SimcoeNorthNDP,10,618,245,595,9,27,45.6035811163,40-49,616,5,36,51,87,87,36,51,9,3.0983340106,12770.8977960731,0.1386445793,0.0669607057,0.18228367,0,135,2.0460027523627115E-4,9.311221E-4,9.553318E-4,257,0.3646514,42,7,201,7,0.0348258706,-0.18236773
561603919,WHHYLs,10,259,173,162,3,0,26.3215542029,20-29,507,4,16,7,23,23,16,7,10,3.895977245,287.4782688028,0.0479174827,0.1126482213,0.31985295,0,135,1.4979875607223605E-4,4.2781286E-4,4.3893623E-4,505,0.5022523,18,1,198,1,0.0050505051,-0.18239935
848955582,Jeff98926622,10,796,93,547,0,11,42.2608854146,40-49,567,5,11,17,28,28,11,17,10,3.3185696871,4212.6891053955,0.0872835009,0.0357142857,0.08658009,0,135,9.981546783405075E-5,3.0198556E-4,3.0983734E-4,353,0.26912567,10,1,199,1,0.0050251256,-0.18254558
40950257,markymark7717,10,12092,954,2001,26,338,47.6743353185,40-49,742,7,23,24,47,47,23,24,8,3.064607883,35195.9557415817,0.0895946886,0.0101757632,0.024955437,0,135,1.8837841583252938E-4,6.0397113E-4,5.938549E-4,99,0.20774032,20,3,203,3,0.0147783251,-0.182784883
22733545,PitchforkTorchz,10,10823,747,442,17,614,51.7559895966,50-59,747,8,66,7,73,73,66,7,9,3.3852092645,9598.9310484463,0.1729910628,0.027587519,0.050881952,0,135,2.9516427255141286E-4,0.0016860861,0.0017299252,99,0.23392436,71,0,203,0,0,-0.183042408
278228855,varota201,10,2000,117,266,1,4,35.5155350723,30-39,617,6,1,5,6,6,1,5,10,3.7379114181,44.1202630571,0.0031955966,0.0333333333,0.05,0,135,5.8177989790408945E-5,5.0330927E-5,5.1639556E-5,505,0.23333333,3,0,199,0,0,-0.18333333
145935577,jkoblovsky,10,6345,1313,1308,82,6,47.4702218896,40-49,714,7,24,23,47,47,24,23,9,3.1564404714,26268.7198449653,0.0507248518,0.0023126735,0.012681159,0,135,1.82469265202969E-4,6.291366E-4,6.196747E-4,505,0.19607843,23,1,200,1,0.005,-0.183397271
996042944,AnonTeach,10,606,104,250,0,46,40.1150079845,40-49,558,4,10,34,44,44,10,34,10,3.1844778545,5686.8226250592,0.0422078771,0.0200845666,0.053475935,0,135,1.0718015836486555E-4,2.768201E-4,2.8401756E-4,99,0.23706293,8,0,198,0,0,-0.183586995
23768120,bdydbl,10,41708,3465,2440,87,77,53.8068303741,50-59,782,9,24,25,49,49,24,25,9,3.1832588379,16671.8116972494,0.0592383011,0.0216836735,0.13333334,0,135,2.2208835882976983E-4,6.291366E-4,6.4549444E-4,505,0.31711915,44,0,202,0,0,-0.18378581
50672511,bajabreeze2355,10,723,113,553,1,7,36.6408418506,30-39,550,5,9,21,30,30,9,21,10,3.2958147095,3076.2134276352,0.0283425049,0.0528735632,0.14935064,0,135,1.0604442951142132E-4,2.5165462E-4,2.5819778E-4,71,0.33333334,6,1,229,1,0.0043668122,-0.1839827
468782243,PublishSphere,10,2192,125,420,2,26,39.8824063906,30-39,558,6,10,6,16,16,10,6,10,3.6265745632,651.7717351089,0.0366647762,0.0666666667,0.16666667,0,135,8.532774102117754E-5,2.768201E-4,2.8401756E-4,99,0.35076922,13,1,200,1,0.005,-0.18410255
635207814,nikkiskuce,10,320,143,175,4,30,44.1555595462,40-49,601,4,10,3,13,13,10,3,9,3.7631044291,234.3015038624,0.0272429334,0.0897435897,0.17424242,0,135,1.1054664391435354E-4,2.768201E-4,2.8401756E-4,71,0.3584656,9,0,200,0,0,-0.18422318
616429626,mikeradan,10,1514,97,234,3,2,41.7044397093,40-49,577,6,6,7,13,13,6,7,10,3.4831369362,1011.3231408466,0.0234020972,0.0769230769,0.2638889,0,135,1.1044833500418896E-4,1.7615824E-4,1.8073844E-4,505,0.4481383,16,3,200,3,0.015,-0.1842494
272809054,ALYS_tweet,10,365,228,306,5,7,22.7621942383,20-29,529,4,18,17,35,35,18,17,10,3.4140593255,2886.6593092735,0.0646548182,0.0504201681,0.17028986,0,135,1.4446504306338102E-4,4.781438E-4,4.905758E-4,505,0.35454544,0,4,200,4,0.02,-0.18425558
221250191,barachoix,10,2991,213,730,5,19,28.3316593821,20-29,588,6,7,22,29,29,7,22,9,3.2381145876,11106.0184631937,0.0159480308,0.0098522167,0.023809524,0,135,1.0844198977529937E-4,2.0132371E-4,2.0655822E-4,257,0.2082353,2,1,200,1,0.005,-0.184425776
17850064,CEamer,10,5552,378,553,33,0,46.0314038369,40-49,671,7,3,5,8,8,3,5,10,3.9967492889,213.4296680833,0.0046707501,0.0892857143,0.1904762,0,135,1.0238055919335763E-4,1.00661855E-4,1.0327911E-4,283,0.375,8,2,200,2,0.01,-0.1845238
25217615,jofo2005,10,9846,887,2001,7,276,44.1503640477,40-49,703,7,33,86,119,119,33,86,9,2.716781796,58400.0009763814,0.1031221072,0.0081185016,0.021651965,0,135,3.0181418038215227E-4,8.556257E-4,8.7787246E-4,99,0.20656717,5,1,200,1,0.005,-0.184915205
113208652,VanBoders,10,4962,512,624,30,10,47.8517509841,40-49,711,7,14,25,39,39,14,25,9,3.1377488826,4101.0547613295,0.0460414489,0.0256410256,0.06878307,0,135,1.4112013191297818E-4,3.7748195E-4,3.8729666E-4,71,0.25385964,11,0,200,0,0,-0.18507657
344009584,a_mcgrath1,10,203,327,1212,10,0,34.0015857949,30-39,518,4,18,36,54,54,18,36,11,3.4461600975,7105.3417833031,0.0964882614,0.0541579315,0.14102565,0,135,3.090508425438052E-4,4.781438E-4,4.905758E-4,353,0.32610562,3,6,200,5,0.025,-0.18507997
40015876,ChadCowie,10,3345,520,551,22,206,45.9362644518,40-49,687,6,40,30,70,70,40,30,10,3.1759447379,14839.0164256735,0.1905366905,0.032505176,0.14634146,0,135,4.677634586087626E-4,0.001031784,0.0010586109,505,0.33152485,77,1,200,1,0.005,-0.18518339
274867725,VoluntaryExit,10,3384,135,462,1,108,29.2872654149,20-29,635,7,9,21,30,30,9,21,9,3.2413652987,2645.1435390391,0.0246304051,0.0218390805,0.047692306,0,135,1.1258434422272616E-4,2.5165462E-4,2.5819778E-4,257,0.2331992,4,0,200,0,0,-0.185506894
514960977,auleduc,10,3558,506,2000,3,20,42.9308791087,40-49,566,6,4,18,22,22,4,18,10,3.2584315319,1269.7670343399,0.0314235728,0.0670995671,0.14705883,0,135,1.1578991352250308E-4,1.2582731E-4,1.2909889E-4,353,0.33259284,1,0,201,0,0,-0.18553401
39040737,KnorthernKnight,10,25607,1595,2001,72,142,54.6465695973,50-59,785,8,9,5,14,14,9,5,10,3.8354327509,1021.0853153496,0.0141078673,0.0164835165,0.055555556,0,135,9.195306060182296E-5,2.5165462E-4,2.5819778E-4,303,0.2413793,3,0,200,0,0,-0.185823744
276761716,artymccomish,10,2089,257,1055,3,7,52.4161517125,50-59,630,6,10,24,34,34,10,24,10,3.3356359204,2023.2350915864,0.0380480349,0.0588235294,0.13817663,0,135,1.7009262035267637E-4,2.768201E-4,2.8401756E-4,505,0.32401314,6,1,200,1,0.005,-0.18583651
369027713,OHIP4IVF,10,2388,1306,2001,16,69,49.5255044911,40-49,688,6,4,11,15,15,4,11,10,3.6371393742,1877.4172128456,0.0060893729,0.0428571429,0.09848485,0,135,7.649635487463607E-5,1.2582731E-4,1.2909889E-4,505,0.28442028,40,0,200,0,0,-0.18593543
494580521,etherproject,10,317,36,124,0,301,31.2139088011,30-39,551,4,4,8,12,12,4,8,10,3.5083299472,2745.9674084108,0.0201621982,0.0151515152,0.033333335,0,135,6.54465301673366E-5,1.2582731E-4,1.2909889E-4,505,0.21937323,10,1,202,1,0.004950495,-0.186039895
15206059,janfromthebruce,10,3006,298,576,7,40,44.894271974,40-49,616,6,29,48,77,77,29,48,9,2.9983746445,19825.3845878494,0.0990221052,0.0276828435,0.096938774,0,135,3.1838697975410406E-4,7.549639E-4,7.745933E-4,257,0.28302994,33,1,201,1,0.0049751244,-0.186091166
18165363,alekt,10,8377,723,515,19,504,54.1140982516,50-59,755,7,35,18,53,53,35,18,10,3.3644859813,11516.7965501438,0.0923473643,0.0199564586,0.057807807,0,135,2.134369892058416E-4,9.0595667E-4,9.036922E-4,257,0.24396396,41,1,200,1,0.005,-0.186156153
41205644,BKJohnstone,10,1703,886,1219,32,90,49.1364628837,40-49,633,6,43,41,84,84,43,41,10,3.20438846,18911.9593975451,0.1399819154,0.0377223178,0.10391327,0,135,5.334618228738211E-4,0.0011072804,0.0011360702,505,0.29038864,42,5,200,4,0.02,-0.18647537
977630929,Astutelypoli,10,247,104,512,0,6,31.6788367423,30-39,428,4,2,20,22,22,2,20,9,3.1873222267,572.8690069776,0.0222780014,0.0606060606,0.10526316,0,135,6.31987199302067E-5,7.549639E-5,7.7459335E-5,71,0.29191467,1,2,200,2,0.01,-0.18665151
20370879,Oemissions,10,38352,496,1530,18,39,48.4386491914,40-49,674,9,23,20,43,43,23,20,9,3.1507517269,5142.145275279,0.0938034207,0.0243632337,0.06818182,0,135,2.2910483516131054E-4,6.0397113E-4,6.196747E-4,99,0.25493664,14,0,205,0,0,-0.18675482
91369352,phunphunphun,10,15282,1340,1385,26,10369,,,768,8,33,35,68,68,33,35,10,3.0418529053,25142.7802690812,0.0925083193,0.0083406497,0.04761905,0,135,2.3201991928887026E-4,8.556257E-4,8.7787246E-4,99,0.23441441,17,0,201,0,0,-0.18679536
201785220,JGBourgeois,10,2922,583,1244,8,2,49.410668954,40-49,674,6,22,36,58,58,22,36,9,3.0690776107,23302.2113315685,0.0638454441,0.0190562613,0.06330014,0,135,2.764398031088233E-4,5.7880563E-4,5.938549E-4,257,0.2501699,12,1,200,1,0.005,-0.18686976
475223296,zeptepe,10,1759,347,922,12,90,45.64581198,40-49,653,5,6,10,16,16,6,10,10,3.5615603413,1994.2563570132,0.0128933299,0.0541666667,0.25555557,0,135,9.351013020029163E-5,1.7615824E-4,1.8073844E-4,343,0.4425087,3,0,200,0,0,-0.18695313
404349157,CascadeTessa,10,17270,571,1226,17,592,37.1612577577,30-39,733,8,21,32,53,53,21,32,9,3.0455099553,11776.0957337575,0.079594726,0.0145137881,0.04804805,0,135,1.874630813598067E-4,5.536402E-4,5.680351E-4,99,0.235164,4,0,201,0,0,-0.18711595
390225936,TheFalconer2011,10,3557,148,345,2,26,39.5707257108,30-39,619,6,10,9,19,19,10,9,10,3.5830963023,666.4605273868,0.0421642182,0.0935672515,0.30128205,0,135,2.2346352208764763E-4,2.768201E-4,2.8401756E-4,257,0.48841584,9,18,200,17,0.085,-0.18713379
223320350,susankim6722,10,2632,228,463,9,50,35.6992518573,30-39,631,5,16,15,31,31,16,15,10,3.3470134092,2598.1543405715,0.0688362645,0.0397849462,0.16081871,0,135,1.6659040118826521E-4,4.2781286E-4,4.3893623E-4,257,0.34815487,6,0,200,0,0,-0.18733616
282282958,WilsonES13,10,1655,223,1169,2,205,46.5684126041,40-49,598,6,30,60,90,90,30,60,9,2.817147501,34031.2935924267,0.1217748944,0.0210986267,0.061443932,0,135,2.2861616587265725E-4,7.8012934E-4,8.0041314E-4,99,0.24880415,25,0,209,0,0,-0.187360218
198122317,WilliamsGarethE,10,2318,324,732,13,9,43.66200233,40-49,619,6,9,20,29,29,9,20,10,3.3315725315,6174.1288893308,0.0239612116,0.0381773399,0.06923077,0,135,1.285557716039825E-4,2.5165462E-4,2.5819778E-4,505,0.25679013,19,3,200,2,0.01,-0.18755936
501433802,ClaudineJacques,10,5371,689,2001,20,150,53.4223720324,50-59,728,6,39,18,57,57,39,18,9,3.3242584315,14674.457831387,0.1266521169,0.0350877193,0.09141414,0,135,2.9131174010026313E-4,0.0010066185,9.811516E-4,257,0.27930683,124,19,247,19,0.0769230769,-0.18789269
360129829,rkn429,10,21822,559,548,26,2242,47.2733396845,40-49,740,8,43,40,83,83,43,40,9,2.9601787891,28165.534991754,0.1603915295,0.0188069351,0.10821256,0,135,2.5639377211121345E-4,0.0011072804,0.0011360702,99,0.2961775,125,0,212,0,0,-0.18796494
271965841,WildRoseMike4MP,10,1288,167,318,17,5,29.076187504,20-29,573,6,6,13,19,19,6,13,9,3.3088175538,1851.1557291619,0.0183237163,0.0263157895,0.08974359,0,135,1.308743021583068E-4,1.7615824E-4,1.8073844E-4,283,0.2777778,0,1,199,1,0.0050251256,-0.18803421
228707979,o5carpapa,10,533,60,141,0,45,41.5983327078,40-49,646,6,23,40,63,63,23,40,9,2.9609914669,10869.2148696044,0.0920665364,0.0168970814,0.06341463,0,135,1.5891552321504662E-4,6.0397113E-4,6.196747E-4,99,0.25158226,120,0,202,0,0,-0.18816763
154592265,CoryJudson,10,14394,797,999,18,9,48.3566110163,40-49,744,8,55,44,99,99,55,44,10,3.247460382,28344.6618325966,0.1544671941,0.0415378273,0.116356105,0,135,4.578309689529179E-4,0.0014092659,0.0014459075,257,0.30460957,67,2,201,2,0.0099502488,-0.188253465
36988297,KeithS462,10,1226,527,1472,25,4,46.9493930235,40-49,607,5,23,54,77,77,23,54,10,3.1064607883,22397.4256998102,0.0793793119,0.038277512,0.10401002,0,135,3.1018121010771923E-4,6.0397113E-4,6.196747E-4,257,0.29234767,1,1,200,1,0.005,-0.18833765
86874273,guinnessgenius,10,4736,83,178,1,49,40.7477596556,40-49,657,6,11,1,12,12,11,1,11,4.6387647298,85.7015215562,0.0346928763,0.0833333333,0.10606061,0,135,8.906441951787533E-5,3.0198556E-4,3.0983734E-4,283,0.29444444,11,1,199,1,0.0050251256,-0.18838383
283368566,OwnYourVote,10,296,74,414,0,0,22.9428163389,20-29,335,5,3,12,15,15,3,12,9,3.2247054043,2462.2493628438,0.0404234403,0.0380952381,0.070512824,0,135,6.643631074022573E-5,1.00661855E-4,1.0327911E-4,353,0.2589372,2,0,199,0,0,-0.188424376
30465899,fstenson,10,827,798,1008,32,3,49.1375936649,40-49,678,4,39,33,72,72,39,33,10,3.0666395774,24212.6987616084,0.1283664757,0.0119327074,0.048097253,0,135,2.4237161819102754E-4,0.0010066185,0.0010327911,99,0.23665667,30,2,199,2,0.0100502513,-0.188559417
234985641,Moerockin,10,1565,145,172,4,0,38.3755697529,30-39,584,5,9,5,14,14,9,5,10,3.7882974401,497.6393185244,0.0238794411,0.0934065934,0.1969697,0,135,8.63575326921867E-5,2.5165462E-4,2.5819778E-4,257,0.38586956,5,1,200,1,0.005,-0.18889986
23130850,DaleJr288,10,21093,662,1998,12,38,45.3108522994,40-49,741,9,24,52,76,76,24,52,9,2.9134498171,19149.065136279,0.0784758634,0.0294736842,0.0637229,0,135,1.9337742567557343E-4,6.291366E-4,6.4549444E-4,257,0.2527776,13,0,199,0,0,-0.1890547
604806474,EkaCoop,10,3519,235,425,6,385,45.2891110333,40-49,633,7,15,26,41,41,15,26,9,3.104022755,11189.4799019416,0.0529773449,0.0164634146,0.052955665,0,135,1.4802748891217047E-4,4.0264742E-4,4.1311645E-4,99,0.2423077,36,0,203,0,0,-0.189352035
143923047,hoplesstwit,10,11534,1243,1535,10,565,54.0757406933,50-59,738,8,14,23,37,37,14,23,10,3.1316537993,7083.7557651388,0.0359526747,0.0045045045,0.02173913,0,135,1.3963173544850259E-4,3.7748195E-4,3.8729666E-4,257,0.21111111,12,0,201,0,0,-0.18937198
19599799,mwlcarter,10,560,194,306,5,2,22.8762548618,20-29,431,3,3,3,6,6,3,3,11,4.3754571312,77.11561801,0.0048154506,0.0666666667,0.25,0,135,1.5704801125995628E-4,1.00661855E-4,1.0327911E-4,257,0.43939394,9,1,200,1,0.005,-0.18939394
137567832,cambridgelibs,10,1499,509,552,20,0,43.7935557557,40-49,653,5,29,29,58,58,29,29,9,3.2238927265,10475.263724641,0.079736609,0.0595886267,0.21408251,0,135,2.894146043461061E-4,7.549639E-4,7.745933E-4,505,0.40378007,14,3,200,3,0.015,-0.18969756
381058048,apoliq,10,2793,295,767,3,107,40.6076171495,40-49,642,6,14,32,46,46,14,32,9,3.114587566,12240.9485159801,0.0405252939,0.0149758454,0.045454547,0,135,1.7264193857349265E-4,3.7748195E-4,3.8729666E-4,267,0.23530997,9,2,200,2,0.01,-0.189855423
206220968,TheresaLubowitz,10,6101,737,374,25,11,67.0966345716,60-69,720,7,67,19,86,86,67,19,10,3.3982121089,12267.3906144926,0.1825531529,0.0473324213,0.121664405,0,135,3.9827937746830577E-4,0.0017112514,0.0017299252,505,0.31164855,56,3,200,3,0.015,-0.189984145
212942917,JeanAProulx,10,1987,332,579,12,50,46.8524625555,40-49,611,5,33,41,74,74,33,41,9,3.0012190167,23312.8952386637,0.1132731122,0.018696779,0.06530612,0,135,3.044189734318188E-4,8.556257E-4,8.7787246E-4,505,0.2554316,57,0,200,0,0,-0.19012548
556331089,NZFoWL,10,14288,650,1988,25,250,40.7350930336,40-49,637,8,5,8,13,13,5,8,9,3.8224299065,240.9149433574,0.0115605292,0.0256410256,0.055555556,0,135,7.604336073818154E-5,1.5099278E-4,1.5491867E-4,99,0.24583334,1,0,201,0,0,-0.190277784
137471172,d_gatto,10,1221,563,973,22,0,39.1181687434,30-39,558,5,23,28,51,51,23,28,10,3.3502641203,3958.8583805983,0.0617955591,0.0631372549,0.21746881,0,135,2.3822885577380238E-4,6.0397113E-4,5.938549E-4,505,0.4079123,9,0,200,0,0,-0.19044349
10151752,ceverest,10,26,20,78,0,1,20.9402845018,20-29,523,5,1,2,3,3,1,2,11,4.1771637546,0.6033938261,0.0056043085,0,0,0,135,4.8588054145079814E-5,5.0330927E-5,5.1639556E-5,353,0.1904762,0,0,1,0,0,-0.1904762
96799205,Eastportorganic,10,13182,868,1996,17,270,49.9540921551,40-49,756,8,36,47,83,83,36,47,8,2.9232019504,33061.8263434732,0.0941603899,0.0177784308,0.057957392,0,135,2.9364846838959445E-4,9.311221E-4,9.553318E-4,343,0.24846981,51,0,200,0,0,-0.190512418
366307876,Peaceameat,10,3598,119,487,4,4,28.5475723617,20-29,500,7,10,20,30,30,10,20,9,3.2637139374,2551.9556252269,0.0419637124,0.0540229885,0.18571429,0,135,1.2168138266383319E-4,2.768201E-4,2.8401756E-4,505,0.37666667,1,1,198,1,0.0050505051,-0.19095238
216732503,caw_kaikit,10,5048,210,163,6,2,47.0277327722,40-49,644,7,15,6,21,21,15,6,10,3.7184071516,856.0765056124,0.0367022999,0.0619047619,0.12745099,0,135,2.1885441213646514E-4,4.0264742E-4,3.8729666E-4,257,0.31848854,31,1,200,1,0.005,-0.19103755
33565866,smrtchng,10,1898,154,422,1,25,45.0706193805,40-49,629,5,16,25,41,41,16,25,9,3.2035757822,5372.1641333836,0.0459327989,0.0152439024,0.04137931,0,135,1.4449063303224657E-4,4.2781286E-4,4.3893623E-4,99,0.23250648,41,2,201,2,0.0099502488,-0.19112717
156040251,kelseymech,10,531,165,163,6,1,38.8546457848,30-39,566,4,7,5,12,12,7,5,10,3.8667208452,1060.8071359763,0.0152970205,0.0757575758,0.25,0,135,1.4939488342576113E-4,2.0132371E-4,2.0655822E-4,71,0.44152048,5,0,200,0,0,-0.19152048
607531851,vansopinion8ted,10,12705,313,306,11,105,37.6611022949,30-39,665,8,43,23,66,66,43,23,9,3.2234863876,13896.3551694881,0.1192741236,0.0195804196,0.05909864,0,135,2.0586366691238944E-4,0.0011072804,0.0011360702,99,0.25085792,35,0,221,0,0,-0.19175928
381136617,GatewayCaveMan,10,630,172,1752,0,0,23.7823634456,20-29,580,5,10,43,53,53,10,43,9,2.9256399837,11204.1900470012,0.0749357554,0.0293904209,0.06921373,0,135,1.033325669633648E-4,2.768201E-4,2.8401756E-4,353,0.261151,29,0,200,0,0,-0.19193727
73651314,dwalshmedia,10,22347,1059,2004,50,5,43.9473982889,40-49,768,9,11,9,20,20,11,9,11,3.7391304348,3408.0828105357,0.0374695498,0.0394736842,0.07720588,0,135,1.731047390121907E-4,3.0198556E-4,3.0983734E-4,71,0.2691952,7,0,200,0,0,-0.19198932
86110985,BZMWillemsen,10,3783,178,291,6,19,56.2916076288,50-59,641,6,5,5,10,10,5,5,10,3.7452255181,267.5083306463,0.0113735683,0.0555555556,0.125,0,135,7.229426208438379E-5,1.5099278E-4,1.5491867E-4,505,0.317029,3,0,200,0,0,-0.192029
331272785,WhseMark,10,2447,224,366,7,7,46.6808075544,40-49,616,6,5,7,12,12,5,7,9,3.6960585128,987.6069897138,0.0112878395,0.0151515152,0.041666668,0,135,9.312543642353352E-5,1.5099278E-4,1.5491867E-4,257,0.23376623,24,1,202,1,0.004950495,-0.192099562
1158739338,Fillthehill13,10,1665,628,1981,6,12,49.5240681075,40-49,647,6,22,37,59,59,22,37,9,2.9687119057,15787.8579771675,0.0579774318,0.0222092344,0.07134146,0,135,1.4838781046125905E-4,5.7880563E-4,5.938549E-4,505,0.26346955,71,1,205,1,0.0048780488,-0.19212809
80474440,Frankie0331,10,14196,880,605,36,1163,51.6690687439,50-59,734,8,40,36,76,76,40,36,9,2.9227956115,24621.9601293043,0.1821397261,0.0266666667,0.100340135,0,135,3.2875839834979457E-4,0.001031784,0.0010586109,99,0.2925095,48,1,212,1,0.0047169811,-0.192169365
173137904,vancouver_rt,10,658817,5845,0,226,0,41.5176094738,40-49,870,12,7,0,7,7,7,0,0,0,0,0.0224345954,0.0476190476,0.071428575,0,48,1.1060776637877542E-4,2.0132371E-4,0,71,0.26373628,0,0,205,0,0,-0.192307705
935732234,_Tracey_S,10,2782,151,387,0,98,47.2248922226,40-49,694,7,32,69,101,101,32,69,9,2.8033319789,35627.2781016877,0.1438993822,0.0206930693,0.06298905,0,135,2.3491909404907402E-4,8.304603E-4,8.5205265E-4,99,0.25546384,255,1,313,1,0.0031948882,-0.19247479
23014499,cyclingzealot,10,1138,230,86,28,1,43.8455839806,40-49,560,5,11,1,12,12,11,1,11,4.7415684681,259.7173631469,0.029905043,0.0606060606,0.10606061,0,135,1.4377141860134245E-4,3.0198556E-4,3.0983734E-4,283,0.2987013,14,1,200,1,0.005,-0.19264069
900667856,OkanaganD_anon,10,3600,735,1535,6,619,42.9848350724,40-49,682,7,34,49,83,83,34,49,9,2.9910605445,17947.7406384972,0.1079796399,0.0226270937,0.093877554,0,135,2.2286637260782445E-4,8.807912E-4,9.036922E-4,99,0.2866933,14,1,202,1,0.004950495,-0.192815746
495905313,HarpersCanada1,10,980,62,6,1,7,21.4514281702,20-29,599,4,8,0,8,8,8,0,0,0,0,0.0158138641,0.0535714286,0.10714286,0,79,8.970050578055326E-5,2.2648917E-4,0,99,0.3,14,2,199,2,0.0100502513,-0.19285714
962044404,46nd2,10,7049,384,596,9,416,59.0816607515,50-59,740,7,32,12,44,44,32,12,10,3.3250711093,7510.669712691,0.1409909537,0.0306553911,0.08235294,0,135,1.9591164413832932E-4,8.304603E-4,8.5205265E-4,99,0.27529138,131,0,231,0,0,-0.19293844
321545042,august_mk,10,6640,362,1048,9,136,50.1577759455,50-59,732,7,16,14,30,30,16,14,10,3.2503047542,5585.2196653363,0.0606200378,0.0275862069,0.12745099,0,135,2.2223302637804204E-4,4.2781286E-4,4.3893623E-4,257,0.32049504,55,1,201,1,0.0049751244,-0.19304405
385195352,CryingWolfe,10,2010,201,451,4,195,41.6825919356,40-49,648,6,7,15,22,22,7,15,9,3.3437626981,810.4503809266,0.0210430716,0.0411255411,0.104166664,0,135,9.698810716469028E-5,2.0132371E-4,2.0655822E-4,71,0.29747474,4,0,199,0,0,-0.193308076
860654623,Johnwboyko,10,958,276,682,1,8,52.2825664132,50-59,616,5,24,56,80,80,24,56,10,2.8594067452,35070.336026041,0.0942059547,0.0102848101,0.028822055,0,135,2.4326203831752637E-4,6.291366E-4,6.4549444E-4,99,0.22229174,39,0,203,0,0,-0.193469685
550534777,DustinJMGriffin,10,504,95,71,0,1,38.9381085998,30-39,564,4,12,6,18,18,12,6,10,3.8248679399,819.6453788571,0.0389803601,0.0392156863,0.1590909,0,135,9.595444554139587E-5,3.27151E-4,3.3565713E-4,505,0.35263157,13,4,199,4,0.0201005025,-0.19354067
890753468,DebbySimms,10,879,90,318,0,593,26.105875457,20-29,463,5,5,17,22,22,5,17,11,3.6420154409,179.2917218056,0.0533842661,0.1082251082,0.21929824,0,135,1.1276298764109911E-4,1.5099278E-4,1.5491867E-4,353,0.41289592,0,2,200,2,0.01,-0.19359768
180093728,mallorydaley,10,2612,220,648,4,187,41.0335545904,40-49,661,6,18,24,42,42,18,24,10,3.3522958147,4287.5725648517,0.07470505,0.0447154472,0.17378917,0,135,1.9738937140427486E-4,4.781438E-4,4.905758E-4,257,0.3675488,90,1,200,1,0.005,-0.19375963
193013796,JMACL3AN,10,2188,437,621,19,29,42.5771765742,40-49,663,6,11,15,26,26,11,15,10,3.5140186916,3266.2793414081,0.0211922932,0.0369230769,0.15,0,135,1.2590261158325263E-4,3.0198556E-4,3.0983734E-4,343,0.34384385,24,0,200,0,0,-0.19384385
271117979,arun_smith,10,11332,603,983,13,19,56.6629788164,50-59,738,8,35,35,70,70,35,35,9,3.104022755,35683.9710257947,0.1078992821,0.0155279503,0.062121212,0,135,3.0339040187032175E-4,9.0595667E-4,9.29512E-4,267,0.2561441,129,0,201,0,0,-0.194022888
227763857,KimberleeTaylor,10,9812,147,407,0,6,43.7565849077,40-49,709,7,6,7,13,13,6,7,10,3.6513612353,1168.8906741906,0.0178779338,0.0256410256,0.1904762,0,135,1.148838603110239E-4,1.7615824E-4,1.8073844E-4,257,0.3847561,22,1,202,1,0.004950495,-0.1942799
397019549,GensofHope,10,874,735,873,6,34,44.7204301914,40-49,619,5,2,4,6,6,2,4,11,3.9752133279,421.6931766761,0.0168044433,0,0,0,135,5.173160932728258E-5,7.549639E-5,7.7459335E-5,353,0.19444445,21,0,200,0,0,-0.19444445
1177213375,WildErinRose,10,149,29,107,1,0,28.8214337619,20-29,324,4,3,5,8,8,3,5,11,3.935392117,48.6961668745,0.0307781658,0.0535714286,0.3,0,135,6.025554850021583E-5,1.00661855E-4,1.0327911E-4,353,0.4945055,4,2,187,2,0.0106951872,-0.1945055
713387070,ToryBluest,10,1322,96,689,2,1,18.0626913353,10-19,621,6,5,14,19,19,5,14,10,3.4498171475,1302.2695195697,0.049384335,0.0760233918,0.116959065,0,135,9.290008603586696E-5,1.5099278E-4,1.5491867E-4,353,0.3116368,4,0,199,0,0,-0.194677735
36128402,RomaAhi,10,1970,553,1148,12,12,44.537161495,40-49,605,6,20,29,49,49,20,29,9,3.1869158879,6711.5266293641,0.0754454081,0.0454931973,0.11593172,0,135,2.693830948408914E-4,5.2847475E-4,5.4221536E-4,505,0.31067887,13,0,200,0,0,-0.19474715
155792555,patimbeau,10,1859,383,336,13,4,32.1709928628,30-39,626,5,26,19,45,45,26,19,10,3.4465664364,2299.0698804296,0.0915199994,0.05,0.2044335,0,135,2.3697333037329046E-4,6.794675E-4,6.97134E-4,257,0.39925665,2,4,200,4,0.02,-0.19482315
283332808,PACE_ag,10,10001,407,547,10,122,33.9978009169,30-39,680,7,11,11,22,22,11,11,9,3.6103210077,2238.8794308441,0.0210787826,0.0432900433,0.14285715,0,135,1.4653691665849508E-4,3.0198556E-4,3.0983734E-4,505,0.3380823,10,0,200,0,0,-0.19522515
379511927,ILoveCanada1987,10,14220,421,1052,7,1023,32.4858206351,30-39,728,8,25,34,59,59,25,34,9,3.0670459163,18554.7613505918,0.0675235907,0.0140268849,0.049786627,0,135,1.6287037469559347E-4,6.54302E-4,6.7131425E-4,505,0.24505228,0,0,200,0,0,-0.195265653
10711672,cmkl,10,3782,638,779,47,73,53.8905223685,50-59,677,6,26,35,61,61,26,35,10,3.2702153596,18545.425374264,0.0572611835,0.0161202186,0.05168409,0,135,3.258550946551255E-4,6.794675E-4,6.97134E-4,257,0.24699011,17,2,200,2,0.01,-0.19530602
292357569,Adam_Dee_Em,10,3805,666,1651,35,149,45.0609757178,40-49,657,7,18,38,56,56,18,38,10,2.9772450223,16521.4204228052,0.0512735897,0.0097402597,0.029014844,0,135,1.6482464556843605E-4,4.781438E-4,4.905758E-4,99,0.22443861,2,4,199,4,0.0201005025,-0.195423766
94900143,NatalieLanovill,10,23772,538,738,30,1490,45.4758589296,40-49,744,8,13,14,27,27,13,14,10,3.4331572531,4968.1615673712,0.0294914044,0.0128205128,0.04411765,0,135,1.5095941481691117E-4,3.5231648E-4,3.6147688E-4,71,0.23975636,51,0,201,0,0,-0.19563871
16149936,duncancameron,10,2615,458,709,11,110,46.4952072823,40-49,649,6,43,19,62,62,43,19,10,3.2576188541,10078.4417726402,0.1253599826,0.0351665785,0.07277527,0,135,4.372054897718681E-4,0.0011072804,0.0011360702,257,0.26850566,46,5,200,5,0.025,-0.19573039
370815539,EcoRational,10,793,145,132,8,119,42.041302091,40-49,594,5,11,5,16,16,11,5,10,3.9898415278,764.6664596254,0.0335830074,0.0541666667,0.1474359,0,135,1.0358212166778846E-4,3.0198556E-4,3.0983734E-4,283,0.34330484,12,0,200,0,0,-0.19586894
160027610,LakeBass,10,318,261,55,6,12,50.2950043474,50-59,735,7,74,3,77,77,74,3,10,3.9439252336,7548.6395037038,0.1859833342,0.0295625427,0.048648648,0,135,2.980028249614423E-4,0.0018874097,0.001859024,99,0.24456841,147,15,362,15,0.0414364641,-0.195919762
400836180,PatrickS71,10,5008,246,204,9,19,45.7138968583,40-49,651,7,29,25,54,54,29,25,10,3.3376676148,4184.9932963589,0.1019613373,0.0524109015,0.18168168,0,135,2.3939034289448564E-4,7.549639E-4,7.745933E-4,257,0.37775493,16,1,200,1,0.005,-0.19607325
277263155,ElectionCDA,10,24483,6785,7375,81,0,40.5326925749,40-49,732,8,42,1,43,43,42,1,11,4.3778951646,4718.7539742303,0.136137141,0.0188261351,0.029900333,0,135,3.241746516124064E-4,0.0010821149,0.0011102505,99,0.22599591,43,1,201,1,0.0049751244,-0.196095577
466765912,GrittyGorg,10,5305,319,500,8,100,48.4753624884,40-49,707,6,17,23,40,40,17,23,10,3.333197887,6374.9368454945,0.036449231,0.0192307692,0.09486166,0,135,1.4170763697108168E-4,4.5297833E-4,4.64756E-4,505,0.29134664,22,1,200,1,0.005,-0.19648498
254228285,anatta60,10,1812,93,778,1,64,34.1697114074,30-39,467,5,5,11,16,16,5,11,10,3.3380739537,812.5756262539,0.0309587013,0.0416666667,0.13636364,0,135,7.907658046824139E-5,1.5099278E-4,1.5491867E-4,99,0.33289006,0,0,201,0,0,-0.19652642
634874281,KaraArdan,10,955,83,186,0,107,42.6979624317,40-49,594,5,12,23,35,35,12,23,9,3.1491263714,2583.7432817493,0.0399539317,0.0176470588,0.05253623,0,135,1.0787394520083853E-4,3.27151E-4,3.3565713E-4,99,0.24926943,29,0,200,0,0,-0.1967332
497084291,savingthepeace,10,2532,113,138,1,7,45.3222712404,40-49,619,6,11,19,30,30,11,19,9,3.1861032101,3329.6106255206,0.0468682279,0.0229885057,0.06842105,0,135,9.105732062791116E-5,3.0198556E-4,3.0983734E-4,71,0.2651822,19,0,200,0,0,-0.19676115
15782873,pcasey,10,2714,242,509,10,10,39.4736281366,30-39,691,6,27,22,49,49,27,22,10,3.2836245429,5883.2839386474,0.0781880515,0.0425170068,0.14109848,0,135,1.767614637393278E-4,7.0463296E-4,7.2295376E-4,257,0.3378933,9,1,200,1,0.005,-0.19679482
327740140,la_cornish,10,3192,430,526,12,35,40.6823333022,40-49,661,6,21,9,30,30,21,9,10,3.80658269,2012.8737190941,0.0448352922,0.0367816092,0.092391305,0,135,2.0524154466063769E-4,5.536402E-4,5.680351E-4,71,0.28921568,7,0,200,0,0,-0.196824375
104476989,frgetit,10,2253,196,553,2,7,43.9779808325,40-49,630,6,20,41,61,61,20,41,10,2.9926859,15819.0665588907,0.0915399058,0.0120218579,0.032850243,0,135,1.8024373889948933E-4,5.2847475E-4,5.4221536E-4,505,0.23033772,19,9,203,9,0.0443349754,-0.197487477
603719194,Colin_m_Brown,10,2558,375,715,8,769,47.1767729134,40-49,650,6,23,20,43,43,23,20,9,3.2145469321,7548.75116117,0.0843399929,0.0603543743,0.17096774,0,135,2.1590077873717963E-4,6.0397113E-4,6.196747E-4,505,0.36853626,32,1,200,1,0.005,-0.19756852
106790430,__CCE,10,17819,1230,1796,28,34,51.2347292153,50-59,732,8,33,31,64,64,33,31,10,3.1479073547,22843.5595817493,0.1083314067,0.0305059524,0.072704084,0,135,3.1690602636329825E-4,8.556257E-4,8.5205265E-4,505,0.27048334,28,0,205,0,0,-0.197779256
74227540,johnnyfriesen,10,10597,978,1107,41,2,49.4526762489,40-49,748,7,28,16,44,44,28,16,10,3.419341731,5520.88218149,0.081678035,0.0528541226,0.14393939,0,135,2.172284828778054E-4,7.297984E-4,7.2295376E-4,505,0.34175727,22,0,201,0,0,-0.19781788
15215453,ReynoldR,10,1262,104,344,0,12,33.0373065452,30-39,578,5,5,8,13,13,5,8,10,3.5692807802,320.339378172,0.0242660097,0.0769230769,0.21111111,0,135,1.0592839358303633E-4,1.5099278E-4,1.5491867E-4,257,0.4091312,3,1,199,1,0.0050251256,-0.19802009
288372843,goinkforward,10,1373,72,173,0,34,37.8461134199,30-39,551,5,7,3,10,10,7,3,10,3.7391304348,364.4706085345,0.0480432105,0.0333333333,0.083333336,0,135,8.355592673982894E-5,2.0132371E-4,2.0655822E-4,353,0.28138527,3,1,199,1,0.0050251256,-0.198051934
264364455,davidfinnis4NDP,10,594,771,1626,38,3,43.1562554197,40-49,595,5,40,46,86,86,40,46,9,2.9837464445,24054.3268645345,0.1526210772,0.0393980848,0.111748636,0,135,3.5287783799639355E-4,0.001031784,0.0010586109,71,0.3098217,7,0,200,0,0,-0.198073064
16312570,mbeckrubin,10,9988,750,886,28,12,46.0754479685,40-49,700,7,22,17,39,39,22,17,10,3.4693214141,2767.5901682841,0.0672504058,0.0748987854,0.18226601,0,135,3.349259245074724E-4,5.7880563E-4,5.938549E-4,505,0.3805221,12,1,200,1,0.005,-0.19825609
421226526,MelansonSa,10,809,469,748,5,2,39.8403368771,30-39,621,5,57,44,101,101,57,44,9,3.2039821211,18789.6461103708,0.2021595916,0.0492079208,0.15196079,0,135,4.793330249727008E-4,0.0014595968,0.0014975471,257,0.35022342,25,7,200,7,0.035,-0.19826263
785739980,Dianora_1,10,4613,530,914,17,47,50.7849822306,50-59,622,5,6,12,18,18,6,12,10,3.3713937424,3932.3414807031,0.0199120339,0.0065359477,0.030303031,0,135,8.347141003892385E-5,1.7615824E-4,1.8073844E-4,283,0.22857143,2,0,201,0,0,-0.198268399
437055633,TylerPaquette19,10,227,73,82,0,3,30.9120322417,30-39,502,4,5,4,9,9,5,4,10,3.7602600569,101.3867939774,0.0220594523,0.125,0.30952382,0,135,7.261488962148524E-5,1.5099278E-4,1.5491867E-4,505,0.50789475,12,0,200,0,0,-0.19837093
273280868,RobinVan,10,4226,378,494,11,20,39.067235921,30-39,673,7,17,11,28,28,17,11,9,3.3360422592,3000.3427143657,0.0602265536,0.0396825397,0.10952381,0,135,2.098030520125596E-4,4.5297833E-4,4.64756E-4,71,0.3079254,7,2,200,2,0.01,-0.19840159
21039946,christofow,10,3524,237,175,4,8,42.6463060473,40-49,658,6,7,2,9,9,7,2,11,4.2478667208,136.3273488381,0.0165295081,0.0833333333,0.1904762,0,135,8.303105080651049E-5,2.0132371E-4,2.0655822E-4,257,0.3888889,6,1,200,1,0.005,-0.1984127
493389719,mmecorrie,10,701,34,124,2,1,43.4577865367,40-49,548,5,6,9,15,15,6,9,9,3.472978464,1575.2365059282,0.0342255656,0.0285714286,0.06818182,0,135,6.354379959880862E-5,1.7615824E-4,1.8073844E-4,267,0.2667984,9,3,200,3,0.015,-0.19861658
107296416,amanda0852,10,12351,945,1951,60,749,44.7672052417,40-49,681,8,20,30,50,50,20,30,9,2.9955302722,23838.4903017162,0.0704850005,0.0118367347,0.04637097,0,135,1.5762998131062827E-4,5.2847475E-4,5.4221536E-4,99,0.24507788,1,0,198,0,0,-0.19870691
281276278,canadian_stew,10,2486,102,226,0,65,38.9703801408,30-39,625,6,11,13,24,24,11,13,10,3.4315318976,3848.5712734715,0.031744988,0.018115942,0.047368422,0,135,1.0998911891835983E-4,3.0198556E-4,3.0983734E-4,99,0.24615385,22,0,200,0,0,-0.198785428
263222957,buttsaima,10,3100,217,582,2,39,41.4447994497,40-49,606,6,5,9,14,14,5,9,10,3.4843559529,804.9942396452,0.0133661763,0.0384615385,0.10909091,0,135,6.47362101182319E-5,1.5099278E-4,1.5491867E-4,353,0.30793652,5,0,200,0,0,-0.19884561
31254552,aysha_marie,10,2644,216,545,3,144,35.5322835904,30-39,600,6,2,11,13,13,2,11,10,3.7602600569,6408.5571323902,0.0053290103,0.0769230769,0.2,0,135,7.393544865981357E-5,7.549639E-5,7.7459335E-5,353,0.39915967,3,0,201,0,0,-0.19915967
28191911,jjfantauzzi,10,9702,1589,1804,80,371,55.1672244445,50-59,742,7,29,44,73,73,29,44,9,2.985778139,31720.0460599216,0.0894452291,0.0197869102,0.060816325,0,135,4.0399428317703127E-4,7.549639E-4,7.745933E-4,257,0.26005435,107,13,216,13,0.0601851852,-0.199238025
16831607,aaronwebber,10,2708,313,165,13,2,34.1221809467,30-39,593,6,16,8,24,24,16,8,10,3.8711905729,1048.5201470941,0.0455274955,0.0688405797,0.18128654,0,135,1.3823258529749996E-4,4.2781286E-4,4.3893623E-4,257,0.3806818,30,0,200,0,0,-0.19939526
164324862,flemingjude,10,32529,462,1281,22,8959,41.015995368,40-49,716,9,16,11,27,27,16,11,9,3.4412840309,7810.7751164203,0.0652324434,0.0242165242,0.06666667,0,135,1.7571966844842524E-4,4.2781286E-4,4.3893623E-4,99,0.26623377,13,0,207,0,0,-0.1995671
411965102,ashmartyn,10,2028,1154,243,4,9,50.5961575398,50-59,611,6,9,10,19,19,9,10,10,3.6046322633,1228.5683556728,0.0324950741,0.067251462,0.12916666,0,135,1.9602615835391591E-4,2.5165462E-4,2.5819778E-4,505,0.32875264,12,0,200,0,0,-0.19958598
19143783,DanielJBeals,10,3932,975,995,76,218,48.2392346043,40-49,679,6,46,32,78,78,46,32,10,3.2507110931,19455.5823459853,0.1610954712,0.0447885448,0.11584997,0,135,4.68544208699215E-4,0.0011827768,0.0012135296,257,0.31551427,6,2,200,2,0.01,-0.1996643
262522708,NoEasyBrushOff,10,8844,323,387,12,20,46.8557555901,40-49,691,7,21,23,44,44,21,23,8,3.1206826493,10192.9821520648,0.0603864129,0.0253699789,0.115384616,0,135,1.9935182563831207E-4,5.536402E-4,5.680351E-4,99,0.31518987,36,0,203,0,0,-0.199805254
472286193,ChrisKirouac,10,52880,488,819,10,11425,56.9173203255,50-59,748,9,46,60,106,106,46,60,9,2.8321820398,27746.2225481974,0.1735898291,0.022821204,0.09020979,0,135,2.5630871319623933E-4,0.0011827768,0.0012135296,99,0.29004976,91,0,223,0,0,-0.19983997
193986339,kingskam,10,11197,859,281,8,444,36.2670216641,30-39,751,7,23,22,45,45,23,22,10,3.143437627,10806.4156162507,0.1073890368,0.0141414141,0.06307692,0,135,1.7708909973378998E-4,6.0397113E-4,6.196747E-4,353,0.26298702,10,0,199,0,0,-0.1999101
190386166,miz_keight,10,356,141,143,1,305,41.3348191596,40-49,538,4,1,1,2,2,1,1,11,4.6095083299,40.7115989519,5.936512526053621E-4,0,0,0,135,5.01614109539121E-5,5.0330927E-5,5.1639556E-5,99,0.2,0,0,200,0,0,-0.2
15881932,offsprog,10,7298,338,433,15,43,42.7419745693,40-49,703,7,3,2,5,5,3,2,11,4.2462413653,3075.5145271802,0.0089920371,0,0,0,135,1.2821718030125005E-4,1.00661855E-4,1.0327911E-4,283,0.2,2,0,199,0,0,-0.2
395292058,OConnorWRDSB,10,4442,343,468,10,244,48.7623548589,40-49,711,7,2,3,5,5,2,3,11,4.1901665989,77.9868111206,0.0012919535,0,0,0,135,5.911102844956324E-5,7.549639E-5,7.7459335E-5,257,0.2,6,0,200,0,0,-0.2
145677570,IoannaBD,10,3566,54,195,0,17,29.4403385633,20-29,567,6,1,1,2,2,1,1,11,4.4770418529,13.7156537317,0.0046989067,0,0,0,135,4.939201657807553E-5,5.0330927E-5,5.1639556E-5,267,0.2,0,1,200,1,0.005,-0.2
1277092860,simoncott,10,79,25,241,1,20,30.7236705773,30-39,311,3,1,2,3,3,1,2,11,4.4884193417,33.998995256,6.363373305072877E-4,0,0,0,135,4.889964379825264E-5,5.0330927E-5,5.1639556E-5,257,0.2,2,0,99,0,0,-0.2
1157726496,newgenparty,10,28,64,40,0,9,26.4950036125,20-29,320,1,2,0,2,2,2,0,0,0,0,0.0019461418,0,0,0,72,1.1935649640801285E-4,7.549639E-5,0,267,0.2,5,0,33,0,0,-0.2
50212797,oxy28,10,1333,38,14,0,2,32.6085483778,30-39,608,6,2,0,2,2,2,0,0,0,0,0.0038820038,0,0,0,20,5.725650638846476E-5,7.549639E-5,0,99,0.2,9,0,200,0,0,-0.2
245212504,mikelondoncan,10,622,331,348,11,2611,49.8237850801,40-49,747,7,29,18,47,47,29,18,10,3.2718407152,8823.2375493934,0.0973795774,0.025439408,0.05832148,0,135,3.371277238047577E-4,7.549639E-4,7.2295376E-4,257,0.25846833,68,0,200,0,0,-0.20014685
503827583,Relayer76,10,1390,134,165,2,11,44.8760453484,40-49,663,5,29,15,44,44,29,15,10,3.2563998375,7355.3028345492,0.1014511535,0.0317124736,0.08712121,0,135,2.0382279210455481E-4,7.549639E-4,7.745933E-4,99,0.2875,52,2,200,2,0.01,-0.20037879
18464551,germstv,10,6264,336,428,8,2202,47.8179767899,40-49,694,7,40,54,94,94,40,54,9,2.8394961398,19729.1123430551,0.158371035,0.0208190345,0.0986532,0,135,2.500194639686692E-4,0.001031784,0.0010586109,99,0.29929265,65,0,207,0,0,-0.20063945
543895677,NootkaRose1,10,1019,107,195,1,6,38.9288542779,30-39,600,5,12,12,24,24,12,12,9,3.301097115,2190.7148022142,0.0355709202,0.0398550725,0.15416667,0,135,1.4105049823322102E-4,3.27151E-4,3.3565713E-4,257,0.35488215,32,2,200,2,0.01,-0.20071548
408143683,DylanFinlay,10,206,112,247,0,26,40.1586583415,40-49,499,4,5,6,11,11,5,6,11,3.724095896,4494.2763251479,0.0064485549,0.0454545455,0.1904762,0,135,6.697333919355555E-5,1.5099278E-4,1.5491867E-4,505,0.39130434,64,0,199,0,0,-0.20082814
533635897,stefanjpguy,10,2280,98,244,0,4,36.6913016617,30-39,545,6,12,23,35,35,12,23,9,3.1088988216,6206.7918398879,0.0441958156,0.0201680672,0.072463766,0,135,1.5883316756922208E-4,3.27151E-4,3.3565713E-4,257,0.27369368,12,0,199,0,0,-0.201229914
22636784,climbrandon,10,12142,1040,1737,46,231,60.5055062362,60-69,733,7,25,38,63,63,25,38,9,3.1060544494,18947.7596367146,0.0663947356,0.031233999,0.09178744,0,135,3.8616663912251236E-4,6.54302E-4,6.7131425E-4,505,0.29315135,22,0,200,0,0,-0.20136391
387431860,TomK0tt,10,6634,383,204,8,445,60.6467978953,60-69,737,7,20,12,32,32,20,12,9,3.4043071922,5900.4586531756,0.0832783261,0.0161290323,0.07368421,0,135,1.3838705652114642E-4,5.2847475E-4,5.4221536E-4,353,0.27524894,76,0,200,0,0,-0.20156473
431504592,Russell_Barth,10,16262,294,338,7,440,19.7085571482,10-19,710,8,21,12,33,33,21,12,10,3.5457131247,5618.8990487675,0.0449702513,0.0359848485,0.11067194,0,135,1.4144715849948478E-4,5.536402E-4,5.680351E-4,505,0.31254902,47,0,227,0,0,-0.20187708
331241281,IBEW_M_Wayland,10,1434,300,579,8,8,43.5955639521,40-49,615,6,16,28,44,44,16,28,10,3.1873222267,11293.0855294468,0.0639709067,0.0237843552,0.08068783,0,135,1.350591365069321E-4,4.2781286E-4,4.3893623E-4,257,0.28276333,18,3,198,3,0.0151515152,-0.2020755
310400113,Moe_Fugger_72,10,9653,602,679,15,512,55.6029035515,50-59,739,8,8,10,18,18,8,10,10,3.6095083299,1326.1814786876,0.0181088568,0.0326797386,0.16666667,0,135,8.619220792366692E-5,2.2648917E-4,2.32378E-4,99,0.3690476,44,0,201,0,0,-0.20238093
278325086,vicki_strelioff,10,3577,177,199,10,1,41.8421769934,40-49,616,6,9,5,14,14,9,5,10,3.6444534742,982.8153638852,0.0261796358,0.0604395604,0.21111111,0,135,1.2307633798231858E-4,2.5165462E-4,2.5819778E-4,257,0.41379312,8,13,201,13,0.0646766169,-0.20268201
233356796,DavidMerner,10,132,198,18,13,0,33.3842319236,30-39,558,2,28,1,29,29,28,1,11,4.2039821211,457.9219698015,0.0687654239,0.065270936,0.10714286,0,135,2.494349337810145E-4,7.297984E-4,7.487736E-4,505,0.30989826,8,0,137,0,0,-0.2027554
13075932,Mannzhu,10,3418,514,240,46,15,42.5992097823,40-49,608,6,16,10,26,26,16,10,10,3.5298659082,1430.0479119247,0.0567976844,0.0538461538,0.20955883,0,135,1.6901909623462573E-4,4.2781286E-4,4.3893623E-4,257,0.4125178,10,0,200,0,0,-0.20295897
401614276,IAMAW2323,10,7497,395,387,2,0,38.9916248341,30-39,649,6,9,8,17,17,9,8,10,3.659488013,2150.480927958,0.0137280251,0.0183823529,0.057692308,0,135,1.0801843505859846E-4,2.5165462E-4,2.32378E-4,257,0.26108375,10,0,200,0,0,-0.203391442
143241913,Arifin17,10,779,144,403,2,1,34.0622998252,30-39,545,5,8,19,27,27,8,19,10,3.2450223486,3506.6637692765,0.0388841173,0.0270655271,0.07368421,0,135,1.0729921521000364E-4,2.2648917E-4,2.32378E-4,71,0.27716348,7,0,200,0,0,-0.20347927
303665229,Rod_McCallum,10,26563,830,1994,22,11,55.7281179412,50-59,773,8,31,44,75,75,31,44,8,2.9573344169,27814.698861555,0.1114355991,0.0209009009,0.05172414,0,135,2.218034084454047E-4,8.0529484E-4,8.262329E-4,99,0.25535363,256,0,216,0,0,-0.20362949
249809370,alicebmcgregor,10,17603,336,622,5,184,40.8978547526,40-49,716,8,31,18,49,49,31,18,9,3.1958553434,8968.8306869078,0.1207092902,0.0289115646,0.06794872,0,135,2.302311122267853E-4,8.0529484E-4,8.262329E-4,99,0.2717368,63,0,213,0,0,-0.20378808
17257492,manuelcosta,10,907,327,863,5,12,39.9244238271,30-39,526,4,10,24,34,34,10,24,10,3.4331572531,10534.7042723841,0.0298672651,0.0294117647,0.066951565,0,135,1.6894492523590997E-4,2.768201E-4,2.8401756E-4,283,0.27112675,13,0,200,0,0,-0.204175185
1149274476,ST_Phelan,10,245,108,483,2,0,43.7561131665,40-49,502,4,11,23,34,34,11,23,10,3.3498577814,3077.7976924449,0.0644056812,0.1007130125,0.20502645,0,135,3.019056747474896E-4,3.0198556E-4,3.0983734E-4,353,0.40921408,1,3,200,2,0.01,-0.20418763
290312086,DavidFox_Canada,10,637,112,616,1,105,31.3318790628,30-39,541,5,6,16,22,22,6,16,10,3.333197887,2445.2897343447,0.0129672199,0.0497835498,0.12091503,0,135,1.0922881618699027E-4,1.7615824E-4,1.8073844E-4,257,0.32527664,2,1,198,1,0.0050505051,-0.20436161
49400099,pugs14,10,5356,218,880,5,545,42.1934464776,40-49,632,7,23,43,66,66,23,43,9,3.0272247054,14173.8257859839,0.0783805135,0.0300699301,0.10570825,0,135,1.6954515466113834E-4,6.0397113E-4,6.196747E-4,257,0.31022742,8,1,201,1,0.0049751244,-0.20451917
174416040,jonathoncomfort,10,1750,399,267,22,75,62.3575660827,60-69,664,6,31,27,58,58,31,27,10,3.100365705,16041.6964952286,0.102081362,0.020568663,0.04625347,0,135,2.1239004800677032E-4,8.0529484E-4,7.487736E-4,99,0.25093502,44,2,201,2,0.0099502488,-0.20468155
17869751,peterburbidge,10,1684,76,148,1,46,36.0739828237,30-39,631,6,10,13,23,23,10,13,10,3.4746038196,3904.2915768989,0.0251082434,0.057312253,0.18333334,0,135,1.3063750832311859E-4,2.768201E-4,2.5819778E-4,257,0.38816327,11,2,200,2,0.01,-0.20482993
608283021,cdn_media,10,1196,157,242,0,6,44.5210587772,40-49,645,6,26,26,52,52,26,26,9,3.0995530272,19267.8302587936,0.0764431657,0.0147058824,0.035256412,0,135,1.8241127361650199E-4,6.794675E-4,6.7131425E-4,99,0.24040404,114,0,200,0,0,-0.205147628
272185225,fsorbara,10,4682,297,530,3,15,43.0717423642,40-49,665,7,24,20,44,44,24,20,10,3.2905323039,8911.6433332343,0.0931691265,0.0454545455,0.14942528,0,135,2.84948011644293E-4,6.291366E-4,6.4549444E-4,505,0.35474005,24,1,200,1,0.005,-0.20531477
122176481,JuiceGniposky,10,1712,354,349,4,1,42.7905884862,40-49,655,6,54,38,92,92,54,38,10,3.2824055262,13790.8322174653,0.1859061503,0.0467032967,0.1621469,0,135,4.5813500077686125E-4,0.0013841004,0.0014200878,257,0.36785713,37,1,200,1,0.005,-0.20571023
166638826,tenzinster,10,683,252,696,4,305,47.0990208643,40-49,605,5,18,23,41,41,18,23,9,3.2478667208,14727.6686760713,0.0496318076,0.031097561,0.13166666,0,135,2.0269000873196166E-4,4.781438E-4,4.905758E-4,257,0.33766234,29,1,200,1,0.005,-0.20599568
26612007,torserda,10,3360,384,493,19,35,57.2326381922,50-59,611,6,9,11,20,20,9,11,10,3.7423811459,4408.6316728262,0.0187743965,0.0421052632,0.11904762,0,135,1.485294821868111E-4,2.5165462E-4,2.5819778E-4,283,0.32512316,4,1,200,1,0.005,-0.20607554
524730862,tabithatb,10,601,152,734,1,10,33.7962623317,30-39,557,5,27,53,80,80,27,53,10,3.2698090207,10846.9818950838,0.082570489,0.0541139241,0.16103896,0,135,2.6410190863176606E-4,7.0463296E-4,7.2295376E-4,257,0.3672949,21,6,200,6,0.03,-0.20625594
197891853,calindab,10,208,146,369,1,9,29.487255568,20-29,472,3,15,23,38,38,15,23,10,3.1982933767,6700.3822787807,0.0802448469,0.0504978663,0.11609195,0,135,1.4519393072647493E-4,4.0264742E-4,4.1311645E-4,257,0.32237762,3,3,200,3,0.015,-0.20628567
226022534,Lavender_Blume,10,4740,907,1988,8,119,49.4412281479,40-49,677,7,22,34,56,56,22,34,10,3.043071922,14210.700523762,0.0888181333,0.0246753247,0.07759784,0,135,1.743608516942945E-4,5.7880563E-4,5.938549E-4,99,0.28394467,9,0,200,0,0,-0.20634683
21825027,DanFmTo,10,2223,121,241,8,166,51.0061842478,50-59,658,6,10,3,13,13,10,3,10,3.8370581065,444.0815558433,0.0290403195,0.0064102564,0.018181818,0,135,8.967857112159632E-5,2.768201E-4,2.8401756E-4,99,0.22461538,38,0,201,0,0,-0.206433562
267184794,Orange_Tory,10,3184,196,324,6,40,43.0665312897,40-49,661,6,12,10,22,22,12,10,10,3.5501828525,6081.557127941,0.0468025549,0.038961039,0.0882353,0,135,1.6347271646053511E-4,3.27151E-4,3.3565713E-4,257,0.2946939,13,3,200,3,0.015,-0.2064586
88240141,LeoFugazza,10,6934,519,768,12,212,60.9165695789,60-69,730,7,25,22,47,47,25,22,9,3.365704998,7396.6080698515,0.0824509912,0.0434782609,0.14488636,0,135,2.122266464024297E-4,6.54302E-4,6.7131425E-4,267,0.35188967,37,1,200,1,0.005,-0.20700331
97474079,susannakelley,10,4921,972,1003,31,53,48.9026989072,40-49,705,7,44,18,62,62,44,18,9,3.2568061764,25005.2415051482,0.1317447496,0.0251189847,0.055697277,0,135,5.498870638108676E-4,0.0011324459,0.00116189,505,0.26283872,34,0,200,0,0,-0.207141443
271646800,simonkinglaw,10,15354,526,1014,8,1525,45.1710837155,40-49,743,8,19,14,33,33,19,14,10,3.3734254368,6349.13849701,0.0413237643,0.0255681818,0.08102767,0,135,1.9154816489135352E-4,5.0330925E-4,5.1639555E-4,257,0.2884117,12,0,203,0,0,-0.20738403
472515859,LiberalCanuck,10,64816,2547,1585,66,6151,57.7863497949,50-59,890,9,25,20,45,45,25,20,9,3.1125558716,28127.1119355944,0.0511840274,0.0095959596,0.04985755,0,135,2.4697324114171195E-4,6.54302E-4,6.4549444E-4,505,0.25730202,86,0,201,0,0,-0.20744447
277132286,rightsprung,10,8584,662,859,21,94,50.5659124743,50-59,730,7,31,50,81,81,31,50,9,2.8691588785,36241.0897585212,0.1086928455,0.0091049383,0.030048916,0,135,2.839115710849493E-4,8.0529484E-4,8.262329E-4,505,0.23795545,49,0,207,0,0,-0.207906534
809810088,happyiggy,10,688,142,246,2,228,44.1728468174,40-49,631,5,17,21,38,38,17,21,9,3.2840308818,4446.9675422168,0.04481035,0.027027027,0.11264822,0,135,1.4960810907287822E-4,4.5297833E-4,4.64756E-4,99,0.32077295,29,0,197,0,0,-0.20812473
255917337,annemariebenoit,10,5550,574,1248,10,79,47.6091501656,40-49,604,7,21,32,53,53,21,32,10,2.9618041447,18518.8809230933,0.0773723292,0.0083454282,0.03629032,0,135,1.8690598891899006E-4,5.536402E-4,5.680351E-4,99,0.244587,14,1,200,1,0.005,-0.20829668
1042940202,NeedOfJustice,10,516,28,94,0,22,29.2673751232,20-29,393,5,4,4,8,8,4,4,9,3.5351483137,443.6580164953,0.0263878883,0.0178571429,0.16666667,0,135,7.77522698195554E-5,1.2582731E-4,1.2909889E-4,99,0.375,5,0,201,0,0,-0.20833333
48931430,umuad,10,14653,659,227,26,2030,,,777,8,4,2,6,6,4,2,9,3.9528646892,2541.8493345254,0.0058935783,0,0,0,135,1.5133793571948123E-4,1.2582731E-4,1.2909889E-4,71,0.20833333,16,0,200,0,0,-0.20833333
21263260,pothen,10,9052,375,374,16,28,47.182253179,40-49,748,7,45,25,70,70,45,25,10,3.3319788704,16778.4839882489,0.1691914279,0.0430641822,0.099326596,0,135,4.059844225004298E-4,0.0011576113,0.0011877097,257,0.30771455,35,3,200,3,0.015,-0.208387954
151579206,justinreist,10,1214,334,688,13,57,51.4910131467,50-59,589,5,14,15,29,29,14,15,10,3.3567655425,6394.5300569349,0.0397592791,0.0209359606,0.078947365,0,135,1.6302880695218198E-4,3.7748195E-4,3.8729666E-4,283,0.28745097,2,1,200,1,0.005,-0.208503605
939500785,Humboldt_FLA,10,210,61,122,1,0,38.677423641,30-39,487,4,7,8,15,15,7,8,10,3.505485575,150.0417369214,0.0327710332,0.1285714286,0.37272727,0,135,1.037647561126481E-4,2.0132371E-4,2.0655822E-4,505,0.5813953,26,1,200,1,0.005,-0.20866803
418032965,CPCDouches,10,1212,227,239,1,1,36.2729971574,30-39,612,5,44,21,65,65,44,21,9,3.1812271434,14868.7490281333,0.1120331311,0.0209134615,0.042532466,0,135,2.4527338210694234E-4,0.0011324459,0.00116189,99,0.2512736,5,3,200,3,0.015,-0.208741134
211700224,NSMoggsy,10,1789,182,318,6,14,42.8992037949,40-49,631,6,14,11,25,25,14,11,10,3.5680617635,3890.2808977347,0.0327443012,0.03,0.15714286,0,135,1.0803224075724113E-4,3.7748195E-4,3.8729666E-4,343,0.3661616,16,0,200,0,0,-0.20901874
15682499,marcy_catherine,10,2002,121,390,0,11,24.6984765749,20-29,594,6,8,15,23,23,8,15,10,3.354733848,2483.1105602601,0.0184076835,0.0355731225,0.121323526,0,135,1.6136071717876994E-4,2.2648917E-4,2.32378E-4,505,0.33040294,0,0,198,0,0,-0.209079414
110099532,hsmelday,10,96,173,1132,0,34,21.7876623334,20-29,330,4,7,36,43,43,7,36,9,3.1414059325,2327.684671164,0.0244851611,0.0858250277,0.17619048,0,135,7.905197523437141E-5,2.0132371E-4,2.0655822E-4,257,0.38545558,2,0,104,0,0,-0.2092651
409401081,Progressivista,10,508,402,740,12,6,27.4700041175,20-29,577,5,38,30,68,68,38,30,9,3.261682243,13114.7243815411,0.1136084419,0.0406057946,0.120567374,0,135,3.095023545885693E-4,9.814531E-4,0.0010069713,257,0.32996824,5,1,200,1,0.005,-0.209400866
587138551,GwynAdam,10,9574,338,327,8,1286,36.9998928336,30-39,650,8,30,25,55,55,30,25,9,2.974806989,11900.5794974577,0.1103490423,0.0185185185,0.11264368,0,135,1.8980003483034098E-4,7.8012934E-4,8.0041314E-4,99,0.32270467,18,1,207,1,0.0048309179,-0.21006099
21460797,adamq112,10,10285,487,696,20,155,55.3807668533,50-59,739,7,45,20,65,65,45,20,9,3.3681430313,8657.7909632078,0.1418299867,0.05,0.1322279,0,135,4.012245123419778E-4,0.0011576113,0.0011877097,505,0.3424545,92,5,203,5,0.0246305419,-0.2102266
260000449,isaacmacd,10,1032,160,454,0,5,38.7573170766,30-39,614,5,7,6,13,13,7,6,10,3.4969524584,610.2230617235,0.0481883379,0.0384615385,0.16071428,0,135,8.082225404850849E-5,2.0132371E-4,2.0655822E-4,353,0.37105262,16,0,199,0,0,-0.21033834
264828297,SistaMax112,10,285,82,315,3,4,31.3401093122,30-39,425,4,12,10,22,22,12,10,10,3.6976838683,3711.6721926423,0.0249332332,0.0346320346,0.13736264,0,135,1.1400483128794868E-4,3.27151E-4,3.3565713E-4,257,0.3477891,11,0,200,0,0,-0.21042646
32359120,bicyclestc,10,4315,1293,1070,67,339,45.6934198476,40-49,695,6,14,15,29,29,14,15,10,3.3421373425,4085.2506716468,0.0320126478,0.0098522167,0.036764707,0,135,1.533842264683754E-4,3.7748195E-4,3.8729666E-4,283,0.24778369,4,0,200,0,0,-0.211018983
541201580,Fortitude_1,10,6539,524,907,27,60,40.902932126,40-49,717,7,7,15,22,22,7,15,8,3.326290126,6418.5233073028,0.0134738645,0.012987013,0.04761905,0,135,9.929667604897743E-5,2.0132371E-4,2.0655822E-4,303,0.25900117,4,0,200,0,0,-0.21138212
8447542,Forian,10,18137,4615,811,93,21,61.0924975872,60-69,749,7,28,15,43,43,28,15,9,3.3587972369,11946.6164061636,0.097098727,0.0332225914,0.0855615,0,135,4.4089675330796486E-4,7.297984E-4,7.2295376E-4,267,0.2969491,48,2,200,2,0.01,-0.2113876
395691956,_A_Singh,10,2048,280,486,15,2,43.0178754654,40-49,638,6,35,25,60,60,35,25,10,3.3388866315,6933.7808259724,0.1262430071,0.0466101695,0.16531713,0,135,2.9743510443570946E-4,9.0595667E-4,9.29512E-4,505,0.37692747,19,2,200,2,0.01,-0.21161034
223516060,Mister_Twitt,10,2473,72,543,0,9,20.7035990189,20-29,572,6,6,10,16,16,6,10,11,4.0365704998,3249.8570133292,0.0280557466,0.0875,0.12083333,0,135,1.1548323849738451E-4,1.7615824E-4,1.8073844E-4,353,0.332493,9,1,200,1,0.005,-0.21165967
341105081,JDanAiken,10,2983,297,703,8,2,44.4636232987,40-49,639,6,7,6,13,13,7,6,10,3.7208451849,786.1218412953,0.0688557339,0.0576923077,0.19444445,0,135,1.0036138550936903E-4,2.0132371E-4,2.0655822E-4,353,0.40625,21,3,200,3,0.015,-0.21180555
160073664,rjmjanes,10,3898,401,564,21,4,55.8156679742,50-59,642,6,11,13,24,24,11,13,10,3.2173913043,5741.0462421335,0.0489372465,0.0126811594,0.036764707,0,135,1.3987522583810532E-4,3.0198556E-4,3.0983734E-4,99,0.24857143,2,0,197,0,0,-0.211806723
111127530,JakeAReid,10,11534,1162,1098,36,7,57.4073868645,50-59,757,7,27,33,60,60,27,33,9,3.1954490045,18104.019342863,0.0671109018,0.0161016949,0.08015873,0,135,3.17700737438791E-4,7.0463296E-4,7.2295376E-4,343,0.29209623,44,0,201,0,0,-0.2119375
423598205,mspratt,10,3432,214,284,11,3,47.7450974598,40-49,690,6,6,6,12,12,6,6,11,4.1344981715,3568.3642761717,0.0115229681,0.0454545455,0.08888889,0,135,1.0176737125409703E-4,1.7615824E-4,1.8073844E-4,257,0.30107528,9,0,200,0,0,-0.21218639
20025826,mi_mcDonald,10,2070,718,1936,12,284,44.188635392,40-49,629,6,22,34,56,56,22,34,10,3.0698902885,14378.9720791351,0.0746372766,0.0224025974,0.08991597,0,135,2.1610862816862954E-4,5.7880563E-4,5.938549E-4,505,0.3021513,23,0,199,0,0,-0.21223533
1184156005,LPC338,10,89,45,234,0,18,42.2205270424,40-49,562,3,24,48,72,72,24,48,10,2.9967492889,16470.7417697397,0.0627716928,0.0332550861,0.1072695,0,135,1.3540593956436339E-4,6.291366E-4,6.4549444E-4,505,0.3197693,60,0,200,0,0,-0.2124998
244085908,LizzyM_TO,10,6116,354,531,0,698,47.9389378076,40-49,697,7,14,16,30,30,14,16,10,3.1186509549,6516.5462548263,0.0418927953,0.0126436782,0.079166666,0,135,1.6352781706731423E-4,3.7748195E-4,3.8729666E-4,99,0.29189354,30,0,203,0,0,-0.212726874
28405581,LisaMicheleM,10,7561,1624,1700,19,281,,,739,7,18,19,37,37,18,19,9,3.2494920764,14715.1836686712,0.03641482,0.0127627628,0.06842105,0,135,2.655410262104255E-4,4.781438E-4,4.905758E-4,505,0.28125,39,0,198,0,0,-0.21282895
67171013,AstuteCitizen,10,8252,146,175,3,5108,49.451259403,40-49,597,8,6,5,11,11,6,5,10,3.5229581471,518.2007112139,0.0118581447,0.0090909091,0.033333335,0,135,7.427968957442685E-5,1.7615824E-4,1.8073844E-4,257,0.24632353,12,0,205,0,0,-0.212990195
30373506,karalenamclean,10,1709,228,1014,3,7,41.148728641,40-49,545,6,13,43,56,56,13,43,9,2.9402681837,20875.9065988119,0.0723682085,0.0321428571,0.07973422,0,135,1.4457983253198342E-4,3.5231648E-4,3.6147688E-4,257,0.29282954,4,1,200,1,0.005,-0.21309532
24817065,RThompsonSun,10,154,474,616,5,3,43.5219121487,40-49,560,3,16,15,31,31,16,15,10,3.5493701747,4264.5755478313,0.0820975968,0.0376344086,0.1764706,0,135,3.739333041433042E-4,4.2781286E-4,4.3893623E-4,353,0.3898551,5,0,159,0,0,-0.2133845
107236815,ocyl_jloc,10,910,631,361,24,0,40.5029899298,40-49,616,5,50,20,70,70,50,20,10,3.4429093864,11147.2248943292,0.1294269366,0.0467908903,0.11515152,0,135,3.9882050061647897E-4,0.0012834386,0.0013168086,505,0.32883352,8,1,198,1,0.0050505051,-0.213682
70789275,cheapgordo,10,2205,517,1827,7,19,40.4584007411,40-49,541,6,3,7,10,10,3,7,10,3.4916700528,389.997868589,0.0220191932,0.1,0.23214285,0,135,6.751635751276948E-5,1.00661855E-4,1.0327911E-4,71,0.44602272,0,0,200,0,0,-0.21387987
68888806,ninesnowboots,10,12242,713,1977,16,645,,,727,8,6,14,20,20,6,14,10,3.3632669646,3066.452087531,0.0191693267,0.0131578947,0.042857144,0,135,1.015071959881682E-4,1.7615824E-4,1.8073844E-4,71,0.25675675,4,0,200,0,0,-0.213899606
87247412,CanadianPeace,10,649,959,821,38,1,43.6412867162,40-49,688,5,36,19,55,55,36,19,10,3.4420967087,7048.0564001686,0.084933529,0.0225589226,0.045983087,0,135,2.776050782364583E-4,9.311221E-4,9.553318E-4,257,0.2602564,46,15,200,15,0.075,-0.214273313
65917423,deancorda,10,694,28,66,2,6,26.2628129049,20-29,392,5,4,2,6,6,4,2,11,4.6103210077,132.1925206382,0.0084426349,0.0666666667,0.33333334,0,135,7.02489926296932E-5,1.2582731E-4,1.2909889E-4,257,0.54761904,4,2,200,2,0.01,-0.2142857
32855469,trishaclarkin,10,11587,1494,1571,82,367,53.9040928783,50-59,754,8,2,3,5,5,2,3,11,3.9528646892,684.0443929911,0.0065682476,0,0,0,135,8.600302249311846E-5,7.549639E-5,7.7459335E-5,353,0.21428572,15,0,199,0,0,-0.21428572
17300548,ddsnorth,10,171277,4867,150,319,2425,,,891,10,39,16,55,55,39,16,9,3.1487200325,8553.844433676,0.1583489127,0.032996633,0.08305648,0,135,2.805240784905248E-4,0.0010066185,0.0010327911,99,0.29741478,104,0,202,0,0,-0.2143583
94031113,AbadKhanNS,10,15430,961,1274,31,191,50.8732212916,50-59,769,8,27,26,53,53,27,26,10,3.372612759,14975.8334112581,0.0607306798,0.0275761974,0.10873441,0,135,3.049427045540274E-4,7.0463296E-4,6.97134E-4,343,0.3233926,29,0,200,0,0,-0.21465819
257761286,danolsonbc,10,3043,212,401,16,20,28.7642825579,20-29,616,6,3,4,7,7,3,4,9,3.5818772857,262.7631655268,0.0129692857,0.0714285714,0.2,0,135,9.592432817209768E-5,1.00661855E-4,1.0327911E-4,71,0.4147436,1,0,199,0,0,-0.2147436
24421289,cnjazvac,10,9923,416,352,4,192,56.04981021,50-59,699,7,30,20,50,50,30,20,10,3.4928890695,6106.0079632622,0.1108843453,0.0848979592,0.24047619,0,135,3.1755796373140164E-4,7.8012934E-4,8.0041314E-4,257,0.45532727,44,2,200,2,0.01,-0.21485108
311231357,350orbust1,10,4015,490,755,18,164,47.6877702734,40-49,688,6,26,45,71,71,26,45,9,2.9772450223,18802.4376996732,0.0838937127,0.0185110664,0.06818182,0,135,2.2479260240525068E-4,6.794675E-4,6.97134E-4,99,0.28353995,19,0,200,0,0,-0.21535813
17934964,KMason_Wpg,10,4379,437,1254,7,35,55.7071463136,50-59,702,7,7,9,16,16,7,9,10,3.4798862251,1150.5668749419,0.0231603434,0.0541666667,0.18181819,0,135,1.017487193922453E-4,2.0132371E-4,2.0655822E-4,257,0.3972431,18,0,200,0,0,-0.21542491
27447051,querqle,10,2463,96,324,0,95,39.0202213714,30-39,532,6,5,8,13,13,5,8,10,3.3340105648,899.629778848,0.0212546558,0.0192307692,0.06944445,0,135,6.964451258203926E-5,1.5099278E-4,1.5491867E-4,99,0.28520626,4,0,200,0,0,-0.21576181
978426805,TheRobNickerson,10,344,52,392,0,8,30.5443417877,30-39,505,4,3,5,8,8,3,5,10,3.5404307192,76.4622493645,0.0108514662,0.0357142857,0.15,0,135,1.279427921728582E-4,1.00661855E-4,1.0327911E-4,99,0.36578947,8,1,200,1,0.005,-0.21578947
191017430,RyanMLake,10,3483,376,599,18,0,39.9539290242,30-39,650,6,13,20,33,33,13,20,10,3.3567655425,3085.7089554122,0.0397078387,0.0236742424,0.07575758,0,135,2.530139474924751E-4,3.5231648E-4,3.6147688E-4,505,0.29166666,7,2,200,2,0.01,-0.21590908
346949719,Craig_McDowell,10,591,243,449,7,0,38.0671280174,30-39,561,4,30,23,53,53,30,23,10,3.3340105648,4871.2564690409,0.1223002203,0.0769230769,0.24174175,0,135,3.773212167539059E-4,7.8012934E-4,8.0041314E-4,257,0.45776954,6,2,200,2,0.01,-0.21602779
267121768,ernieandbert1,10,5345,507,1745,3,28,43.8135368026,40-49,657,7,6,26,32,32,6,26,10,3.1560341325,5746.244507277,0.0342048447,0.0201612903,0.046153847,0,135,7.060950845684897E-5,1.7615824E-4,1.8073844E-4,257,0.2625509,10,0,200,0,0,-0.216397053
65308877,wherebdangels,10,2288,302,981,16,3708,34.9026377167,30-39,457,5,3,7,10,10,3,7,9,3.4900446973,238.4415874494,0.0083458445,0.0333333333,0.0952381,0,135,7.922392516728299E-5,1.00661855E-4,1.0327911E-4,99,0.3116883,0,0,199,0,0,-0.2164502
263122187,liamswiss,10,846,303,640,20,27,,,581,5,9,9,18,18,9,9,10,3.8309630232,5849.6711176202,0.0115756987,0.0163398693,0.060606062,0,135,1.238332918346352E-4,2.5165462E-4,2.5819778E-4,267,0.27705628,9,0,200,0,0,-0.216450218
603341720,bfaparsons,10,1501,210,409,7,23,55.2254235127,50-59,640,6,18,16,34,34,18,16,10,3.537586347,12061.1296348934,0.0634008909,0.0463458111,0.20714286,0,135,2.625081751925473E-4,4.781438E-4,4.905758E-4,505,0.4236111,14,0,200,0,0,-0.21646824
300070934,ALiberalCase,10,6420,602,723,17,26,54.7210883442,50-59,742,7,33,28,61,61,33,28,10,3.2633075985,18363.7571578516,0.0655103666,0.0286885246,0.07626262,0,135,2.8152845182951436E-4,8.556257E-4,8.7787246E-4,505,0.29291075,31,0,199,0,0,-0.21664813
65254420,supposedly_fun,10,1351,293,610,9,0,44.6071869586,40-49,597,5,24,24,48,48,24,24,10,3.455099553,4417.3959105022,0.0690786937,0.047429078,0.17419355,0,135,4.228109080549221E-4,6.291366E-4,6.4549444E-4,257,0.3911854,51,11,200,11,0.055,-0.21699185
591461998,smosonyi,10,2026,268,502,6,158,44.2270687932,40-49,635,6,20,19,39,39,20,19,10,3.3742381146,10046.7196224053,0.0598832254,0.0249662618,0.09,0,135,1.9804371899468664E-4,5.2847475E-4,5.4221536E-4,353,0.3071185,18,1,200,1,0.005,-0.2171185
311286748,jaystor,10,2489,172,448,3,3,47.6949774463,40-49,668,6,13,13,26,26,13,13,10,3.7578220236,6522.3433139537,0.043288695,0.0369230769,0.06916996,0,135,3.847651737878754E-4,3.5231648E-4,3.6147688E-4,353,0.2866145,29,22,200,22,0.11,-0.21744454
262501181,solutionsonly,10,217,43,225,0,5,25.5027182162,20-29,349,3,3,3,6,6,3,3,8,3.6363266965,1468.4951399541,0.0088001391,0.0333333333,0.33333334,0,135,5.250371214241395E-5,1.00661855E-4,1.0327911E-4,283,0.5508021,9,0,200,0,0,-0.21746876
55142273,jaywattsiii,10,15211,1296,2001,13,108,63.2003467323,60-69,744,8,12,18,30,30,12,18,10,3.372612759,3214.3682055392,0.0313066711,0.0218390805,0.051948052,0,135,1.9381608311030992E-4,3.27151E-4,3.3565713E-4,257,0.26961505,35,0,202,0,0,-0.217666998
23263454,cehenne,10,8748,1604,653,100,2,54.2131475686,50-59,738,7,28,6,34,34,28,6,11,3.5745631857,4804.3379827252,0.0753995522,0.0374331551,0.058064517,0,135,4.577005440589379E-4,7.297984E-4,7.2295376E-4,505,0.27600887,14,4,200,4,0.02,-0.217944353
214324469,tfalcone86,10,9170,374,483,9,0,57.5567771868,50-59,722,7,25,13,38,38,25,13,10,3.5318976026,6347.2190871584,0.0786436682,0.0490753912,0.121839084,0,135,2.0657019740089616E-4,6.54302E-4,6.7131425E-4,505,0.33983904,20,0,205,0,0,-0.217999956
178879310,tweetingLew,10,829,48,97,0,4,31.3192489175,30-39,563,5,2,1,3,3,2,1,12,5.0345388054,15.4421894529,0.0020928786,0,0,0,135,5.278534900575554E-5,7.549639E-5,7.7459335E-5,353,0.21818182,2,1,200,1,0.005,-0.21818182
131171499,MKlwr,10,5395,169,453,9,174,46.2122387331,40-49,646,7,15,20,35,35,15,20,10,3.6265745632,1415.4527097411,0.0535129114,0.0697478992,0.28787878,0,135,2.158984618460459E-4,4.0264742E-4,4.1311645E-4,257,0.50629145,0,2,200,2,0.01,-0.21841267
40152815,tibiamyfibula,10,7108,249,329,6,890,50.6485047781,50-59,695,7,26,8,34,34,26,8,10,3.5444941081,3324.8426560899,0.0695181968,0.0169340463,0.037037037,0,135,1.4509854824822636E-4,6.794675E-4,6.97134E-4,99,0.25555557,28,17,206,14,0.067961165,-0.218518533
519000338,DuffCaledonNDP,10,10,55,156,5,1,24.5053668014,20-29,112,2,5,9,14,14,5,9,10,3.720438846,139.933004728,0.022777538,0.1813186813,0.3939394,0,135,1.1164637914042336E-4,1.5099278E-4,1.5491867E-4,257,0.61247486,0,0,20,0,0,-0.21853546
42198561,TheMarthaChaves,10,1387,522,665,7,250,50.0689091998,50-59,646,6,7,8,15,15,7,8,10,3.3206013816,1373.4622617831,0.0352153882,0.0047619048,0.035714287,0,135,7.711571602438854E-5,2.0132371E-4,2.0655822E-4,505,0.25438598,18,0,200,0,0,-0.218671693
131859786,Sandy1Canada,10,5315,195,489,5,497,47.5716448647,40-49,634,7,14,17,31,31,14,17,9,3.0333197887,5598.6130983932,0.0419185573,0.0225806452,0.078947365,0,135,1.1026857282508185E-4,3.7748195E-4,3.8729666E-4,99,0.29764065,8,1,205,1,0.0048780488,-0.218693285
150779362,Unicycling4life,10,4776,568,1864,9,27,39.5790801821,30-39,637,7,18,44,62,62,18,44,10,2.8443722064,29191.4949939465,0.0841524036,0.019566367,0.053382665,0,135,1.8989335269886982E-4,4.781438E-4,4.905758E-4,99,0.27255502,3,1,196,1,0.0051020408,-0.219172355
195000753,NKumarBritten,10,3866,383,555,10,132,48.6517839834,40-49,671,7,17,8,25,25,17,8,10,3.5379926859,3786.0659703341,0.0514099472,0.055,0.11666667,0,135,2.4136635535766752E-4,4.5297833E-4,4.64756E-4,343,0.33607596,45,3,201,3,0.0149253731,-0.21940929
952184484,Veterans4LPC,10,97,115,375,2,2,35.2401851808,30-39,530,3,20,34,54,54,20,34,10,3.1881349045,7529.2657768476,0.0622195593,0.070580014,0.16782811,0,135,1.8701092605880203E-4,5.2847475E-4,5.4221536E-4,505,0.3873416,17,0,105,0,0,-0.21951349
574279451,Quaker_Diane,10,25267,450,1830,6,958,36.7938828504,30-39,638,8,11,22,33,33,11,22,9,3.1523770825,7584.7332880993,0.0468936049,0.0236742424,0.0634058,0,135,1.0410249838715716E-4,3.0198556E-4,3.0983734E-4,71,0.2831766,16,0,206,0,0,-0.2197708
49140248,MINOTAURSBAND,10,2917,413,509,10,248,45.6312857176,40-49,665,6,3,2,5,5,3,2,11,4.3063795205,140.1232879713,0.0033451224,0.1,0.16666667,0,135,9.917629927786769E-5,1.00661855E-4,1.0327911E-4,257,0.3868421,16,0,200,0,0,-0.22017543
831767154,CycleTOMidtown,10,172,113,168,8,5,38.091332614,30-39,510,3,4,3,7,7,4,3,10,4.032100772,299.2492128318,0.007510365,0.0238095238,0.083333336,0,135,6.326627436103244E-5,1.2582731E-4,1.2909889E-4,257,0.30357143,7,0,177,0,0,-0.220238094
771076922,NeutralEthnic,10,1414,164,452,3,84,40.4928006444,40-49,586,6,9,12,21,21,9,12,10,3.6603006908,4632.7398116786,0.0229509626,0.0071428571,0.0125,0,135,1.0495929424732962E-4,2.5165462E-4,2.5819778E-4,99,0.23282829,3,1,198,1,0.0050505051,-0.22032829
18436624,write_stuff_2,10,701,491,1996,5,1,22.110319985,20-29,528,4,6,21,27,27,6,21,10,3.3462007314,4001.2007074726,0.0534604015,0.0313390313,0.077922076,0,135,1.0596076277715818E-4,1.7615824E-4,1.8073844E-4,353,0.29826352,0,2,200,2,0.01,-0.220341444
63826204,fotoGnique,10,8294,529,1677,22,1736,44.4232073862,40-49,574,7,7,15,22,22,7,15,9,3.4022754978,7716.9172393583,0.0129180282,0.0151515152,0.03267974,0,135,8.848861123656026E-5,2.0132371E-4,2.0655822E-4,267,0.25346938,0,1,200,1,0.005,-0.22078964
296350580,KevinROKeefe,10,599,93,89,3,0,42.1771487323,40-49,407,3,7,5,12,12,7,5,10,3.5530272247,301.8881816479,0.0239769324,0.0681818182,0.16666667,0,135,1.2204077271763633E-4,2.0132371E-4,2.0655822E-4,505,0.38746437,21,5,200,5,0.025,-0.2207977
514845467,JayIMG,10,6352,308,889,8,2,36.8402716976,30-39,709,7,20,20,40,40,20,20,10,3.4246241365,3194.2526642869,0.0554140133,0.041025641,0.14387465,0,135,1.9949950589896663E-4,5.2847475E-4,5.4221536E-4,505,0.3649274,42,0,201,0,0,-0.22105275
56690455,momorycroft,10,559,151,382,3,3,35.2361230438,30-39,521,4,20,10,30,30,20,10,10,3.6147907355,2010.3769590207,0.0643927335,0.1126436782,0.29051384,0,135,2.5473603055633327E-4,5.2847475E-4,5.4221536E-4,257,0.51159286,11,4,200,4,0.02,-0.22107902
43705629,ECJLajoie,10,4276,670,1306,13,392,40.9981994529,40-49,695,6,15,30,45,45,15,30,10,3.0812677773,7222.3790217704,0.0403322841,0.0328282828,0.0789916,0,135,1.9524518382732763E-4,4.0264742E-4,4.1311645E-4,505,0.30014026,14,0,201,0,0,-0.22114866
26273435,HanlansPoint,10,1244,98,282,1,31,47.4874652285,40-49,645,6,9,11,20,20,9,11,10,3.3031288094,1899.9999642527,0.0264843741,0.05,0.1125,0,135,9.780618738227978E-5,2.5165462E-4,2.5819778E-4,505,0.3337766,162,4,201,4,0.0199004975,-0.2212766
141246833,brendajeans,10,1753,171,270,5,34,38.8824744136,30-39,588,6,15,12,27,27,15,12,10,3.4993904917,3311.5298236832,0.056134976,0.0270655271,0.081871346,0,135,1.6601853152719824E-4,4.0264742E-4,4.1311645E-4,257,0.3032844,5,0,200,0,0,-0.221413054
274325886,RedLangara,10,876,245,348,15,1,42.5757019823,40-49,562,5,10,14,24,24,10,14,9,3.3445753759,2546.544959066,0.0289898121,0.0199275362,0.07619048,0,135,1.1373908135549195E-4,2.768201E-4,2.8401756E-4,257,0.2977208,12,1,200,1,0.005,-0.22153032
162606435,vancitydan,10,22518,603,1218,23,283,40.291488634,40-49,761,8,3,3,6,6,3,3,11,4.0369768387,30.8677981065,0.0041526551,0.0666666667,0.1,0,135,9.79617133634775E-5,1.00661855E-4,1.0327911E-4,99,0.32163742,1,0,202,0,0,-0.22163742
91017612,jcat111,10,1922,175,836,0,236,44.8366705453,40-49,551,6,13,45,58,58,13,45,9,3.0243803332,17282.5309704903,0.0351217484,0.020568663,0.055050503,0,135,1.827445312518521E-4,3.5231648E-4,3.6147688E-4,99,0.27672955,23,0,202,0,0,-0.221679047
402042795,Wwilyman,10,2622,117,1037,1,191,27.0548992206,20-29,581,6,5,28,33,33,5,28,10,3.1084924827,3512.9558842992,0.0404411058,0.0369318182,0.07011494,0,135,7.716061958630566E-5,1.5099278E-4,1.5491867E-4,353,0.29183877,0,0,200,0,0,-0.22172383
243244761,JeffParadis,10,3815,492,632,24,100,57.9092660877,50-59,659,6,39,27,66,66,39,27,10,3.2941893539,6022.8532223315,0.139548733,0.0564102564,0.20190275,0,135,4.3634015935874583E-4,0.0010066185,0.0010327911,257,0.42363054,10,1,200,1,0.005,-0.22172779
91404588,MarkCRobins,10,29128,1111,1084,57,59,44.7375466475,40-49,760,9,25,32,57,57,25,32,10,3.0772043885,18583.9041465045,0.0753051018,0.0206766917,0.06153846,0,135,2.527947376138168E-4,6.54302E-4,6.7131425E-4,505,0.28329936,49,0,210,0,0,-0.2217609
239540543,jackooloosie,10,4244,317,303,8,2,43.8076319849,40-49,633,7,9,4,13,13,9,4,11,4.0410402275,592.8354014944,0.0333457496,0.0256410256,0.083333336,0,135,1.224422970105559E-4,2.5165462E-4,2.5819778E-4,99,0.3051948,4,0,200,0,0,-0.221861464
412692285,ocd007,10,2383,1916,2025,17,8,48.3393047701,40-49,665,5,38,56,94,94,38,56,9,2.8122714344,46773.331963477,0.1321956172,0.0078929307,0.030099357,0,135,2.960322477572525E-4,9.814531E-4,0.0010069713,99,0.25221878,17,2,200,2,0.01,-0.222119423
135257089,richardlevangie,10,9260,806,630,47,169,50.8094328765,50-59,741,7,5,2,7,7,5,2,10,3.7785453068,3489.140495891,0.0105820204,0,0,0,135,1.2309289080969906E-4,1.5099278E-4,1.2909889E-4,303,0.22222222,13,0,200,0,0,-0.22222222
17171476,rzypci,10,11278,250,285,5,645,46.8245462345,40-49,714,7,3,3,6,6,3,3,11,4.2677773263,4938.3443326723,0.0026382293,0,0,0,135,1.4807357401652382E-4,1.00661855E-4,1.0327911E-4,257,0.22222222,9,0,200,0,0,-0.22222222
1284971173,46005_CPC_EDA,10,1,2,11,0,0,,,2,0,2,3,5,5,2,3,11,4.3600162536,27.2117582108,0.011301173,0.05,0.33333334,0,135,9.586442175436398E-5,7.549639E-5,7.7459335E-5,353,0.5555556,0,0,1,0,0,-0.22222226
399253284,debbiepalm44,10,12046,377,590,10,42,49.2217389423,40-49,692,8,14,10,24,24,14,10,9,3.236489232,3265.7309224657,0.0592761498,0.018115942,0.08095238,0,135,1.1490892922630905E-4,3.7748195E-4,3.8729666E-4,99,0.30357143,17,5,209,4,0.019138756,-0.22261905
274058279,alexpensato,10,8195,450,2000,6,1984,41.0018912233,40-49,693,7,18,40,58,58,18,40,8,2.9540837058,36928.1136164113,0.0494716904,0.0072595281,0.020512821,0,135,2.2046646639445417E-4,4.781438E-4,4.905758E-4,505,0.24351852,2,0,200,0,0,-0.223005699
16801721,njsh2008,10,7322,192,783,1,44,47.6160779518,40-49,715,7,14,26,40,40,14,26,10,3.0292563998,8446.3361208205,0.0711391482,0.0141025641,0.044159543,0,135,1.760614470014048E-4,3.7748195E-4,3.8729666E-4,505,0.2673969,14,1,203,1,0.0049261084,-0.223237357
306018798,seriousHabit,10,4475,889,1989,20,71,48.9040624617,40-49,740,7,5,13,18,18,5,13,10,3.3551401869,4340.5863744084,0.0181169347,0.0130718954,0.044871796,0,135,8.643606358646652E-5,1.5099278E-4,1.5491867E-4,99,0.26813656,10,0,200,0,0,-0.223264764
22279004,MurfAD,10,56824,395,302,9,13,42.7756354292,40-49,781,9,11,9,20,20,11,9,9,3.4904510362,3893.6798285353,0.0443831409,0.0447368421,0.14285715,0,135,1.4509533190053075E-4,3.0198556E-4,3.0983734E-4,343,0.36627907,8,1,206,1,0.0048543689,-0.22342192
322164578,gabaribeau,10,3426,307,751,6,3,45.3394716435,40-49,635,6,9,11,20,20,9,11,10,3.3437626981,3551.2155272992,0.031124899,0.0105263158,0.060606062,0,135,8.77446131360569E-5,2.5165462E-4,2.5819778E-4,71,0.28403363,5,1,200,1,0.005,-0.223427568
391743192,scum_tv,10,3943,281,240,9,2,45.2925574097,40-49,658,7,36,16,52,52,36,16,10,3.1678179602,12558.4049761219,0.0945617379,0.0207390649,0.049932525,0,135,2.144757911797878E-4,9.311221E-4,9.553318E-4,99,0.27374834,13,0,200,0,0,-0.223815815
439313680,michaelcwheeler,10,3441,974,801,23,348,50.2301778141,50-59,694,6,11,19,30,30,11,19,10,3.6651767574,7702.4177594769,0.0277932374,0.0367816092,0.08152174,0,135,1.1846173737158542E-4,3.0198556E-4,3.0983734E-4,257,0.30539396,22,1,200,1,0.005,-0.22387222
306832808,jonathan_sas,10,3791,411,809,14,173,49.6604722838,40-49,698,7,16,14,30,30,16,14,10,3.3640796424,10429.2747454264,0.0407373013,0.0298850575,0.07359307,0,135,2.7161928701168153E-4,4.2781286E-4,4.3893623E-4,257,0.2975358,65,0,202,0,0,-0.22394273
83180342,shawnwlewis,10,4250,325,336,10,44,45.3904046444,40-49,680,7,30,20,50,50,30,20,10,3.5887850467,7236.0528228569,0.0781875749,0.0473469388,0.11806543,0,135,2.1543844639368336E-4,7.8012934E-4,7.745933E-4,257,0.3422149,18,1,200,1,0.005,-0.22414947
278768935,SkeenaSage,10,553,99,292,1,18,37.125404575,30-39,576,5,15,13,28,28,15,13,9,3.254368143,7533.405538046,0.0514360013,0.0396825397,0.15808824,0,135,1.5444598288879088E-4,4.0264742E-4,3.8729666E-4,99,0.3822923,12,0,199,0,0,-0.22420406
294174645,katheaney,10,806,423,941,11,2,41.9224914021,40-49,634,5,26,36,62,62,26,36,9,3.0759853718,20022.8606027673,0.0955121685,0.0317292438,0.12517782,0,135,2.2699378416690108E-4,6.794675E-4,6.97134E-4,257,0.34970015,13,4,199,4,0.0201005025,-0.22452233
1058370912,FletJan,10,1579,38,48,0,9,47.66713388,40-49,613,5,12,5,17,17,12,5,10,3.7533522958,4600.1357713434,0.0230086378,0.0110294118,0.030303031,0,135,1.0689192565502808E-4,3.27151E-4,3.3565713E-4,99,0.25498575,117,0,299,0,0,-0.224682719
186285606,pettyrivergirl,10,7733,332,301,5,28,51.7292474458,50-59,722,8,31,12,43,43,31,12,10,3.1848841934,6112.2368517642,0.1023483405,0.0404208195,0.100713015,0,135,1.7232839716526787E-4,8.0529484E-4,8.262329E-4,99,0.32575452,49,1,207,1,0.0048309179,-0.225041505
128028442,dohRG,10,19422,946,1091,52,12,48.9336825511,40-49,759,8,7,10,17,17,7,10,10,3.4916700528,2350.398764425,0.0147531409,0.0110294118,0.055555556,0,135,1.0478051106949752E-4,2.0132371E-4,2.0655822E-4,505,0.28062677,4,0,201,0,0,-0.225071214
391997276,Itson_anon,10,3000,363,1074,8,14,45.7487941354,40-49,665,6,23,48,71,71,23,48,9,2.9581470947,17561.7834675691,0.1032273503,0.0146881288,0.048315603,0,135,2.1940764093706966E-4,6.0397113E-4,6.196747E-4,99,0.27440575,15,0,200,0,0,-0.226090147
94732370,SpecBurns,10,886,237,937,3,3,40.1009818041,40-49,570,5,4,10,14,14,4,10,10,3.3023161317,1326.3124191248,0.028986937,0.010989011,0.022222223,0,135,7.067307355277904E-5,1.2582731E-4,1.2909889E-4,99,0.2484127,0,0,200,0,0,-0.226190477
227114507,DemProg,10,1102,68,193,4,1,35.1637080394,30-39,599,5,5,10,15,15,5,10,10,3.5091426249,197.2629882397,0.0224832776,0.1380952381,0.37272727,0,135,1.0194581453377162E-4,1.5099278E-4,1.5491867E-4,505,0.5989899,31,1,200,1,0.005,-0.22626263
100531055,knoxkp,10,15742,2125,2033,111,20,57.8886987338,50-59,765,7,40,48,88,88,40,48,9,2.8915075173,55640.7959814853,0.0990789685,0.0053552769,0.027755102,0,135,3.355503754301182E-4,0.001031784,0.0010586109,99,0.25437972,44,0,202,0,0,-0.226624618
19883894,grizzelda3,10,8475,300,684,4,309,44.4615049108,40-49,719,7,17,26,43,43,17,26,10,3.157659488,6026.6313649901,0.0435391475,0.0132890365,0.04761905,0,135,2.024760846595146E-4,4.5297833E-4,4.64756E-4,99,0.27428338,20,0,200,0,0,-0.22666433
703722876,ThomasHall17,10,1511,143,65,2,0,47.8707444869,40-49,654,6,10,4,14,14,10,4,10,3.745631857,718.4726745746,0.0350254122,0.032967033,0.08181818,0,135,2.3641704946597182E-4,2.768201E-4,2.8401756E-4,267,0.30855855,31,14,201,13,0.0646766169,-0.22674037
366864224,AndrewJReeve,10,2800,258,180,7,241,47.1853939915,40-49,650,6,22,11,33,33,22,11,10,3.5696871191,2870.9507282163,0.0789545724,0.0501893939,0.12923077,0,135,1.5697297747040804E-4,5.7880563E-4,5.938549E-4,505,0.35607845,22,1,200,1,0.005,-0.22684768
553215041,DonCapriccioso,10,4388,771,1768,5,6,44.8905532779,40-49,664,6,5,16,21,21,5,16,9,3.3266964649,1015.2548285975,0.0191246812,0.0333333333,0.075,0,135,8.25079175305417E-5,1.5099278E-4,1.5491867E-4,99,0.30208334,5,0,200,0,0,-0.22708334
28429319,chickification,10,6535,799,1197,26,0,45.5596386806,40-49,688,7,4,7,11,11,4,7,11,3.7891101178,115.7585587333,0.0039718157,0.0454545455,0.07777778,0,135,7.888858338389049E-5,1.2582731E-4,1.2909889E-4,71,0.30492425,4,0,200,0,0,-0.22714647
226717858,ChristoYoung,10,1613,389,373,12,2,42.9672116675,40-49,629,6,43,25,68,68,43,25,10,3.5278342137,6952.801403925,0.1389276765,0.0555311677,0.19848485,0,135,4.8194594956356933E-4,0.0011072804,0.0011360702,257,0.42575613,32,9,200,9,0.045,-0.22727128
21423190,MsMarieB,10,18495,382,256,4,990,49.3501072749,40-49,733,8,4,1,5,5,4,1,11,4.2226737099,464.628522473,0.0125862912,0,0,0,135,9.291509593354949E-5,1.2582731E-4,1.2909889E-4,257,0.22727273,10,0,202,0,0,-0.22727273
268412615,LaurierInst,10,389,339,94,30,0,44.3273283442,40-49,548,2,15,4,19,19,15,4,10,3.885412434,5298.6297608242,0.0325497268,0.0116959064,0.029166667,0,135,2.7279000540490094E-4,4.0264742E-4,3.8729666E-4,267,0.25757575,4,0,200,0,0,-0.228409083
1058502702,CAnneRogers,10,1117,71,231,3,429,45.1631576669,40-49,584,5,8,14,22,22,8,14,9,3.179195449,1644.856110794,0.036142318,0.0238095238,0.115384616,0,135,1.3682794156842564E-4,2.2648917E-4,2.32378E-4,505,0.34392014,24,0,200,0,0,-0.228535524
787861291,Tamsen_Creative,10,2480,76,1181,0,45,40.1552210028,40-49,468,5,0,6,6,6,0,6,10,3.5580828595,0,0,0.0333333333,0.06666667,0,439,4.8603352068158225E-5,0,2.5819778E-5,71,0.2952381,2,0,201,0,0,-0.22857143
621924412,AviGoldberg,10,5601,335,323,13,204,50.5780638996,50-59,724,7,7,7,14,14,7,7,9,3.6546119464,1653.5733259646,0.0102644181,0.0164835165,0.11904762,0,135,1.0190248690666367E-4,2.0132371E-4,2.0655822E-4,267,0.34761906,19,0,202,0,0,-0.22857144
1250328126,just_usOkanagan,10,190,60,635,0,0,35.7596042558,30-39,445,4,3,19,22,22,3,19,9,3.2320195043,786.2344041671,0.0093394955,0.0367965368,0.06725146,0,135,5.365089393379928E-5,1.00661855E-4,1.0327911E-4,71,0.29607844,2,0,200,0,0,-0.22882698
594212211,lilyliveredlib,10,410,70,79,1,3,40.9994273903,40-49,549,4,10,11,21,21,10,11,10,3.40877692,416.317998085,0.0357120306,0.0857142857,0.3021978,0,135,1.0229615272952221E-4,2.768201E-4,2.8401756E-4,505,0.53109246,10,1,200,1,0.005,-0.22889466
519750654,ianpottawa,10,682,81,50,4,16,42.2215482708,40-49,542,5,18,4,22,22,18,4,10,3.5794392523,1637.8060850603,0.0452488238,0.0930735931,0.1631579,0,135,2.5577446125534746E-4,4.781438E-4,4.905758E-4,505,0.3922294,35,2,199,2,0.0100502513,-0.2290715
70377745,dalegkirby,10,4702,4718,2348,95,0,60.8347873758,60-69,761,6,44,31,75,75,44,31,9,3.2702153596,21717.3195126032,0.1354420745,0.0376576577,0.10866527,0,135,4.909614631395449E-4,0.0011324459,0.0011360702,257,0.3379866,92,0,200,0,0,-0.22932133
250306808,NearFutureComm,10,1271,139,620,2,21,26.8121236993,20-29,556,5,3,13,16,16,3,13,10,3.6899634295,251.802548385,0.0212090008,0.0541666667,0.12820514,0,135,1.4987651237770966E-4,1.00661855E-4,1.0327911E-4,353,0.3577031,3,7,200,6,0.03,-0.22949796
122961376,GladstoneCFRE,10,4018,512,646,27,12,59.0081553492,50-59,638,7,21,14,35,35,21,14,10,3.4339699309,1633.223450252,0.073731008,0.0663865546,0.18833333,0,135,2.877995864791577E-4,5.536402E-4,5.680351E-4,505,0.418018,24,9,199,7,0.0351758794,-0.22968467
56382876,finklejoe,10,4421,447,624,12,3,46.7403196579,40-49,660,6,9,11,20,20,9,11,11,3.7655424624,6454.7931785241,0.0267395897,0.0289473684,0.19090909,0,135,1.4579203563374504E-4,2.5165462E-4,2.5819778E-4,353,0.42067736,16,2,200,2,0.01,-0.22976827
22100885,MatthewFCarroll,10,242,343,243,10,1,38.1420166665,30-39,557,4,26,8,34,34,26,8,10,3.6720845185,8682.7766971449,0.0521138363,0.0249554367,0.05026455,0,135,2.339157800860564E-4,6.794675E-4,6.7131425E-4,71,0.28004807,14,0,200,0,0,-0.22978352
14690573,romeoinottawa,10,25312,1295,914,48,291,60.2686627228,60-69,755,8,27,11,38,38,27,11,10,3.5782202357,10647.9295546572,0.0894642589,0.0113798009,0.03133903,0,135,6.036934618230773E-4,7.0463296E-4,7.2295376E-4,505,0.2615694,112,1,201,1,0.0049751244,-0.23023037
173465009,joeyarchibald,10,3731,637,1997,7,9,56.2883115802,50-59,682,6,15,28,43,43,15,28,10,3.1930109711,11902.4956401154,0.046194642,0.0188261351,0.047311828,0,135,1.4245868317654773E-4,4.0264742E-4,4.1311645E-4,343,0.2776079,19,0,200,0,0,-0.230296072
836907222,VireshRaghubeer,10,620,41,176,0,1,27.5119252008,20-29,492,5,4,7,11,11,4,7,9,3.5660300691,70.071766241,0.0168580582,0.1454545455,0.2777778,0,135,1.3811444250032599E-4,1.2582731E-4,1.2909889E-4,257,0.50830567,12,0,200,0,0,-0.23052787
1222620624,CanadianProg,10,446,27,133,0,16,26.2277917262,20-29,375,4,2,2,4,4,2,2,10,3.5294595693,28.3912887298,0.0075211223,0.1666666667,0.33333334,0,135,5.5472484711559966E-5,7.549639E-5,7.7459335E-5,99,0.5640114,4,0,201,0,0,-0.23067806
56515814,JamesAldersley,10,5080,149,220,3,585,48.269805297,40-49,686,7,3,3,6,6,3,3,10,4.1665989435,61.9815385785,0.007062122,0,0,0,135,6.825442221008094E-5,1.00661855E-4,1.0327911E-4,257,0.23076923,18,0,200,0,0,-0.23076923
595774618,BannockHammock,10,806,104,111,1,126,40.7329951553,40-49,608,4,6,8,14,14,6,8,10,3.6269809021,101.5222458954,0.0244964078,0.021978022,0.10714286,0,135,9.045684635608425E-5,1.7615824E-4,1.8073844E-4,99,0.33809525,10,0,201,0,0,-0.23095239
18722095,richardfromm,10,2143,88,348,0,8,30.08996201,30-39,609,6,7,20,27,27,7,20,10,3.3429500203,1815.5782251529,0.0674125979,0.066951567,0.16666667,0,135,1.645813646972566E-4,2.0132371E-4,2.0655822E-4,353,0.39762405,12,0,199,0,0,-0.23095738
23399192,nealjennings,10,72866,1656,1273,84,1052,56.8408941712,50-59,795,9,19,8,27,27,19,8,10,3.5952864689,1903.9066418878,0.0415900405,0.0156695157,0.030952381,0,135,2.3951704890818449E-4,5.0330925E-4,5.1639555E-4,71,0.26196077,42,0,201,0,0,-0.231008389
274743250,LauraMorie,10,841,240,574,1,15,41.09068688,40-49,493,5,9,20,29,29,9,20,10,3.1385615603,6893.3105370325,0.0507778242,0.0123152709,0.033333335,0,135,1.0370880928026383E-4,2.5165462E-4,2.5819778E-4,99,0.26450035,12,2,200,2,0.01,-0.231167015
493488747,L_MacAulayMP,10,614,727,409,23,1,44.7775977607,40-49,642,4,21,10,31,31,21,10,10,3.523364486,9923.0973136239,0.0694734732,0.0494623656,0.125,0,135,3.508972938402378E-4,5.536402E-4,5.680351E-4,505,0.35641629,34,5,200,5,0.025,-0.23141629
415141537,NoLongerMeSelf,10,9791,299,577,12,103,35.8051452678,30-39,730,8,21,34,55,55,21,34,10,3.0499796831,14160.2396645963,0.0612556218,0.0134680135,0.032926828,0,135,2.3677073241885072E-4,5.536402E-4,5.680351E-4,99,0.2645731,1,3,200,3,0.015,-0.231646272
342281222,cjlanarchist,10,1951,181,626,2,105,34.0993134283,30-39,560,6,9,13,22,22,9,13,10,3.5274278748,2036.5161208651,0.0214328978,0.0303030303,0.0875,0,135,1.0936132547503193E-4,2.5165462E-4,2.5819778E-4,257,0.3193989,2,0,200,0,0,-0.2318989
395484715,BarryLoewen1,10,3209,256,501,15,12,42.8724775589,40-49,651,6,7,17,24,24,7,17,9,3.1869158879,1476.2896226178,0.0273157082,0.0307971014,0.08455882,0,135,9.861491038219097E-5,2.0132371E-4,2.0655822E-4,99,0.31668332,13,1,201,1,0.0049751244,-0.2321245
254388885,FireClef,10,884,318,736,2,87,22.7766664199,20-29,555,5,0,2,2,2,0,2,11,5.0422420796,0,0,0,0,0,215,4.553966086114525E-5,0,2.5819778E-5,99,0.23214285,0,2,200,2,0.01,-0.23214285
168504027,RandySRoberts,10,2161,270,912,5,75,55.7214621808,50-59,649,6,1,2,3,3,1,2,10,3.9345794393,7.6390777762,0.0046144079,0,0,0,135,5.2067636063267745E-5,5.0330927E-5,5.1639556E-5,257,0.23214285,15,0,201,0,0,-0.23214285
622525029,TheKnerdKingTM,10,23425,660,913,18,4,44.1867917492,40-49,774,9,18,14,32,32,18,14,10,3.3624542869,4696.0811320256,0.0561688225,0.0171370968,0.07105263,0,135,1.9804423678755962E-4,4.781438E-4,4.905758E-4,257,0.3035519,47,0,1,0,0,-0.23249927
271183691,unionjason,10,1030,158,254,1,2,43.3242953307,40-49,594,5,12,15,27,27,12,15,9,3.483949614,5009.8172033989,0.0372205672,0.0341880342,0.13235295,0,135,1.1133622797650969E-4,3.27151E-4,3.3565713E-4,257,0.36486486,31,0,200,0,0,-0.23251191
389475975,FeffTheChef,10,7754,248,546,3,174,33.0142862706,30-39,693,7,7,11,18,18,7,11,9,3.4676960585,1277.9252144916,0.025551578,0.0294117647,0.071428575,0,135,1.0162491954928913E-4,2.0132371E-4,2.0655822E-4,99,0.3039867,6,0,200,0,0,-0.232558125
613822232,BeesEyeView,10,771,307,526,2,68,43.084351138,40-49,592,5,31,45,76,76,31,45,10,2.964242178,17874.7244249406,0.0968753267,0.0164912281,0.07474747,0,135,2.178079496650018E-4,8.0529484E-4,8.262329E-4,99,0.30740258,25,0,200,0,0,-0.23265511
389052680,miki_lou,10,5153,197,62,4,576,46.5685720737,40-49,659,6,21,8,29,29,21,8,10,3.6903697684,2573.5223619531,0.0800276716,0.039408867,0.074074075,0,135,2.00929973446051E-4,5.536402E-4,5.680351E-4,99,0.30677965,30,0,201,0,0,-0.232705575
422365641,Wanuskewin_FLA,10,838,314,541,7,5,42.0600356935,40-49,587,5,26,36,62,62,26,36,9,3.1462819992,6010.1665847346,0.0786598343,0.0415124273,0.17867868,0,135,2.4465530043985684E-4,6.794675E-4,6.97134E-4,505,0.41162464,55,6,200,6,0.03,-0.23294596
95934473,FrustratdFarmer,10,138,29,20,3,3,20.9477207116,20-29,418,3,2,1,3,3,2,1,12,4.6249492076,0,0.0242590949,0.5,0.6666667,0,135,5.987115237318379E-5,7.549639E-5,7.7459335E-5,353,0.9,1,0,138,0,0,-0.2333333
92783808,ben_burnett,10,547,93,460,6,3,28.3551976905,20-29,469,4,3,0,3,3,3,0,0,0,0,0.0146106081,0,0,0,17,5.0437083015298484E-5,1.00661855E-4,0,99,0.23333333,7,3,199,3,0.0150753769,-0.23333333
119149614,curiousceramics,10,2954,154,372,8,3,50.4943252142,50-59,598,6,9,15,24,24,9,15,10,3.6566436408,980.5873884885,0.0263231754,0.0561594203,0.22857143,0,135,1.8439811566571383E-4,2.5165462E-4,2.5819778E-4,257,0.46190476,6,1,199,1,0.0050251256,-0.23333333
377139026,angelocsn,10,7178,252,290,4,19,50.1358567534,50-59,700,7,3,5,8,8,3,5,9,3.6188541243,144.8461132066,0.0066775209,0.0714285714,0.3,0,135,7.201869808440697E-5,1.00661855E-4,1.0327911E-4,267,0.53333336,3,0,201,0,0,-0.23333336
21671326,NatStechyson,10,2724,631,300,38,0,47.854733011,40-49,677,6,17,4,21,21,17,4,11,4.1637545713,1539.6069814192,0.0573643826,0.0119047619,0.019607844,0,135,5.506536083894122E-4,4.5297833E-4,4.64756E-4,353,0.25346938,11,2,200,2,0.01,-0.233861536
1077759668,thehillcat,10,252,103,410,2,1,33.5029998579,30-39,389,4,17,24,41,41,17,24,9,3.3230394149,2929.3667745473,0.0639319603,0.0634146341,0.24923077,0,135,1.4003837607224007E-4,4.5297833E-4,4.64756E-4,257,0.48310316,6,1,200,1,0.005,-0.23387239
293056684,JsrSmith,10,421,217,386,1,3,44.3946516327,40-49,573,4,32,26,58,58,32,26,10,3.4282811865,4864.5431125031,0.1072912421,0.057168784,0.16002215,0,135,3.3887680556211414E-4,8.304603E-4,8.262329E-4,257,0.39401057,56,7,200,7,0.035,-0.23398842
250282374,susanicoleberry,10,1694,257,426,10,12,46.2459594549,40-49,653,5,15,18,33,33,15,18,9,3.2226737099,3061.1673417425,0.0726204697,0.0170454545,0.08479532,0,135,1.929645987630908E-4,4.0264742E-4,4.1311645E-4,99,0.31886536,16,1,200,1,0.005,-0.23407004
624500661,V_of_tReason,10,886,63,72,1,44,44.1164489367,40-49,610,5,14,6,20,20,14,6,10,3.9500203169,1578.885430424,0.0335662582,0.0263157895,0.05882353,0,135,1.0137372541618985E-4,3.7748195E-4,3.8729666E-4,99,0.29327732,25,1,200,1,0.005,-0.23445379
523219348,Rocknrollfoolz,10,3974,279,508,6,487,44.1989878804,40-49,654,7,21,34,55,55,21,34,9,2.9890288501,10839.9557087183,0.083632933,0.0252525253,0.092857145,0,135,1.9964640808515827E-4,5.536402E-4,5.680351E-4,99,0.32732674,43,1,197,1,0.0050761421,-0.234469595
41870206,Momforchoice,10,6506,766,656,44,8,54.6827980084,50-59,715,7,11,12,23,23,11,12,10,3.4104022755,3988.8282394472,0.0319808428,0.0316205534,0.1,0,135,2.3200496133548893E-4,3.0198556E-4,3.0983734E-4,99,0.33459964,4,0,199,0,0,-0.23459964
93649345,_nuotio_,10,3272,1189,2001,40,75,46.1665505751,40-49,668,7,8,8,16,16,8,8,10,3.8724095896,1396.6788590744,0.0139028624,0.0541666667,0.1474359,0,135,1.194319524528949E-4,2.2648917E-4,2.32378E-4,343,0.3820513,5,6,200,6,0.03,-0.2346154
842768190,MarnaNightingal,10,4237,111,281,1,13,44.3463544889,40-49,643,7,2,2,4,4,2,2,11,4.2295814709,29.7681549871,0.0035703397,0.0833333333,0.33333334,0,135,5.154124330943574E-5,7.549639E-5,7.7459335E-5,257,0.5681818,1,0,200,0,0,-0.23484846
93212217,roysmolinski,10,248,67,211,1,74,23.0113596883,20-29,466,3,5,8,13,13,5,8,10,3.4741974807,696.6701200838,0.0178519037,0.0320512821,0.11111111,0,135,6.125186625963274E-5,1.5099278E-4,1.5491867E-4,99,0.3460145,1,1,198,1,0.0050505051,-0.23490339
229682182,c_kenn,10,3370,252,278,3,59,44.2370581211,40-49,654,6,17,28,45,45,17,28,9,3.0898008939,7064.7252929823,0.0559616433,0.0126262626,0.046798028,0,135,1.3659652205893523E-4,4.5297833E-4,4.64756E-4,99,0.28181818,22,0,202,0,0,-0.235020152
16132289,jneilson42,10,2086,303,210,24,5,44.4027975051,40-49,595,5,6,1,7,7,6,1,12,4.8878504673,299.957358433,0.0160943703,0.0476190476,0.1,0,135,9.855297031252113E-5,1.7615824E-4,1.5491867E-4,353,0.33516484,2,0,200,0,0,-0.23516484
1187507545,SmithChadley,10,70,78,355,2,3,40.6482136206,40-49,442,3,4,5,9,9,4,5,10,3.7899227956,482.9467668048,0.0080940142,0.0138888889,0.1,0,135,5.9551322199954033E-5,1.2582731E-4,1.2909889E-4,71,0.33516484,13,0,79,0,0,-0.23516484
396745864,GailRhyno,10,2834,182,320,4,595,38.5233366663,30-39,656,6,14,13,27,27,14,13,9,3.2157659488,4038.2798936889,0.0400745212,0.0199430199,0.104166664,0,135,1.3233120768242786E-4,3.7748195E-4,3.8729666E-4,99,0.33942413,5,4,200,4,0.02,-0.235257466
254814925,Fnolet,10,4375,210,484,6,13,38.1437208856,30-39,652,6,11,17,28,28,11,17,10,3.4075579033,540.1699199548,0.0373551982,0.0806878307,0.3529412,0,135,2.0855425948286795E-4,3.0198556E-4,3.0983734E-4,257,0.58837533,23,0,200,0,0,-0.23543413
493463871,feralfrank,10,647,38,117,0,7,21.8821895874,20-29,552,4,4,14,18,18,4,14,10,3.4827305973,1053.5626387659,0.0119561935,0.0359477124,0.082417585,0,135,8.214670765407631E-5,1.2582731E-4,1.2909889E-4,99,0.3179232,3,0,200,0,0,-0.235505615
262280216,OntarioCStores,10,1925,498,831,6,8,44.4305588824,40-49,640,5,9,18,27,27,9,18,10,3.3299471759,5745.6481863685,0.0751350729,0.047008547,0.12368421,0,135,1.5274895815720255E-4,2.5165462E-4,2.5819778E-4,353,0.35921568,10,0,199,0,0,-0.23553147
267529750,APsalmanD,10,1706,282,358,4,29,47.447385356,40-49,632,6,37,47,84,84,37,47,9,2.9670865502,18044.9782489688,0.1119407363,0.0141996558,0.071365245,0,135,2.1878291142582795E-4,9.562876E-4,9.811516E-4,99,0.30704647,97,1,232,1,0.0043103448,-0.235681225
56739067,ShinyGlow,10,1152,70,126,0,158,38.1363345027,30-39,561,5,3,5,8,8,3,5,9,3.5741568468,125.2838012441,0.0094316289,0,0,0,135,5.323740680057107E-5,1.00661855E-4,1.0327911E-4,99,0.23626374,6,0,200,0,0,-0.23626374
416434193,NFSSmith,10,16904,659,1977,12,3961,39.157000957,30-39,708,8,27,35,62,62,27,35,9,3.0158472166,18555.5245958313,0.0859333528,0.0126916975,0.034848485,0,135,2.230210864163772E-4,7.0463296E-4,7.2295376E-4,99,0.2715484,11,1,201,1,0.0049751244,-0.236699915
273012474,jasonthistle,10,2486,366,1026,6,8,47.2832340349,40-49,682,6,9,13,22,22,9,13,10,3.3994311256,3509.1718035483,0.020341085,0.0173160173,0.06666667,0,135,8.88222443245945E-5,2.5165462E-4,2.5819778E-4,71,0.3036338,11,0,200,0,0,-0.23696713
222995401,pearcen44,10,2346,57,145,0,72,41.4440111688,40-49,582,6,13,12,25,25,13,12,9,3.3429500203,6528.724284154,0.0380107563,0.0133333333,0.042857144,0,135,1.2154030109635254E-4,3.5231648E-4,3.6147688E-4,99,0.27983195,36,2,200,2,0.01,-0.236974806
16272618,iclysdale,10,552,301,314,20,4,51.5990255459,50-59,591,4,9,10,19,19,9,10,10,3.7322226737,1814.381533052,0.0194491525,0.0380116959,0.15454546,0,135,1.7337885679532798E-4,2.5165462E-4,2.5819778E-4,257,0.3915344,8,0,200,0,0,-0.23698894
224400947,pinkolefty,10,3463,250,413,5,95,47.6989197388,40-49,696,7,17,21,38,38,17,21,9,3.2060138155,5106.8807923742,0.0392994153,0.0170697013,0.04100529,0,135,1.3814160644698835E-4,4.5297833E-4,4.64756E-4,99,0.27853882,36,1,200,1,0.005,-0.23753353
438556331,rastalam,10,726,122,318,2,5,40.8984616751,40-49,565,4,11,20,31,31,11,20,9,3.1279967493,8417.2167592759,0.0436007142,0.0193548387,0.086842105,0,135,1.1010348046836157E-4,3.0198556E-4,3.0983734E-4,99,0.32456142,20,0,200,0,0,-0.237719315
347878358,j_kneen,10,1730,227,60,12,11,42.0365237021,40-49,662,6,17,4,21,21,17,4,11,3.9687119057,874.263638741,0.0409979216,0.0357142857,0.080882356,0,135,2.0445267297312234E-4,4.5297833E-4,4.64756E-4,257,0.31904763,10,1,200,1,0.005,-0.238165274
442407662,jetsshadow49,10,2329,97,450,1,38,42.6386525553,40-49,561,6,7,20,27,27,7,20,10,3.2880942706,8174.4160206418,0.02284347,0.0299145299,0.064935066,0,135,1.1585799943944578E-4,2.0132371E-4,2.0655822E-4,283,0.30317637,14,0,199,0,0,-0.238241304
595832255,RP_67,10,3378,320,912,1,6,34.0393747291,30-39,503,6,9,16,25,25,9,16,10,3.3242584315,3393.5435252868,0.0305026815,0.025,0.080882356,0,135,9.896548925527937E-5,2.5165462E-4,2.5819778E-4,99,0.31914893,2,1,199,1,0.0050251256,-0.238266574
371062289,ShawnNason1,10,6741,202,236,5,218,43.3947617949,40-49,696,7,5,7,12,12,5,7,11,3.7354733848,803.3188777998,0.0596382445,0.0606060606,0.23214285,0,135,1.0970229757062062E-4,1.5099278E-4,1.5491867E-4,353,0.47058824,11,0,200,0,0,-0.23844539
160432735,Sonny_Resist,10,2887,153,137,11,8,38.1779453281,30-39,650,6,3,3,6,6,3,3,10,3.7606663958,153.6416082352,0.0189489966,0.0666666667,0.15,0,135,6.0300103330744E-5,1.00661855E-4,1.0327911E-4,343,0.3888889,5,0,200,0,0,-0.2388889
206457337,pdeppisch,10,3918,237,361,2,70,43.6681925803,40-49,670,7,12,19,31,31,12,19,9,3.1332791548,2915.5496280665,0.0547013525,0.0215053763,0.10818713,0,135,1.3059785606330887E-4,3.27151E-4,3.3565713E-4,99,0.34796807,12,0,201,0,0,-0.23978094
187140926,daniela_aum,10,46104,1388,2001,47,3928,55.6112888602,50-59,753,9,22,19,41,41,22,19,10,3.3360422592,7227.777168426,0.0633845641,0.0268292683,0.06653226,0,135,3.4128745126938955E-4,5.7880563E-4,5.938549E-4,99,0.30640504,10,0,205,0,0,-0.23987278
46213096,dgordonwaters,10,1702,161,443,4,31,38.3644539985,30-39,656,6,18,25,43,43,18,25,9,3.0308817554,6233.472451902,0.0767445068,0.0127353267,0.046296295,0,135,1.4416919542145916E-4,4.781438E-4,4.905758E-4,99,0.2862262,23,0,201,0,0,-0.239929905
624022720,BeautifulRed7,10,2946,173,200,3,274,46.8894994686,40-49,678,6,25,17,42,42,25,17,10,3.2332385209,5985.4232387243,0.1151606093,0.0429732869,0.12561576,0,135,1.9045424929845238E-4,6.54302E-4,6.7131425E-4,99,0.36582017,53,0,203,0,0,-0.24020441
221579366,NSValley,10,3759,149,301,4,3,44.2114159339,40-49,634,7,24,15,39,39,24,15,10,3.1637545713,5831.3421758348,0.0704359623,0.0303643725,0.125,0,135,1.8553007071288872E-4,6.291366E-4,6.4549444E-4,99,0.36554307,29,1,206,1,0.0048543689,-0.24054307
52657832,erik_zennstrom,10,471,53,136,0,892,33.1162888026,30-39,508,5,4,4,8,8,4,4,10,3.6574563186,38.1974146163,0.0176243649,0.0357142857,0.15,0,135,5.621141757200825E-5,1.2582731E-4,1.2909889E-4,99,0.3909091,3,0,199,0,0,-0.2409091
94020511,dcourtens,10,2937,307,804,4,0,36.0487563383,30-39,530,6,4,7,11,11,4,7,10,3.494514425,341.6952228535,0.0192966901,0.0363636364,0.14285715,0,135,8.902377201986122E-5,1.2582731E-4,1.2909889E-4,257,0.384127,8,0,200,0,0,-0.24126985
633057774,BeaverCanuck,10,85,11,35,0,5,21.219250479,20-29,377,2,3,4,7,7,3,4,10,3.6704591629,2653.9693892567,0.0056508411,0.0238095238,0.083333336,0,135,7.421644288420873E-5,1.00661855E-4,1.0327911E-4,257,0.32575756,3,0,88,0,0,-0.242424224
281661071,iyer_a,10,1386,190,682,2,4,46.538943956,40-49,580,5,6,23,29,29,6,23,10,3.2600568874,3348.8839787001,0.0171152507,0.0197044335,0.049407113,0,135,7.495085911878801E-5,1.7615824E-4,1.8073844E-4,353,0.2923077,4,1,200,1,0.005,-0.242900587
6038862,draymaker,10,1887,525,875,9,20,42.170339424,40-49,662,5,17,13,30,30,17,13,10,3.6692401463,14407.0755490162,0.0479156698,0.016091954,0.057894737,0,135,4.35613554422834E-4,4.5297833E-4,4.64756E-4,505,0.30107528,12,0,200,0,0,-0.243180543
19918228,groovystiles,10,1569,499,611,10,7,44.940543003,40-49,657,6,32,25,57,57,32,25,9,3.247460382,14502.8975182159,0.1252008939,0.0307017544,0.09581646,0,135,3.840514861467986E-4,8.304603E-4,8.5205265E-4,257,0.33905426,39,3,200,3,0.015,-0.2432378
370168544,DominicTerry,10,5142,291,359,5,9,46.4759519143,40-49,689,6,7,5,12,12,7,5,11,3.7350670459,197.783132862,0.0542288128,0.0757575758,0.16666667,0,135,1.0636377783476155E-4,2.0132371E-4,2.0655822E-4,353,0.410148,7,0,200,0,0,-0.24348133
130341846,MichaelVStewart,10,3191,489,1999,5,6,28.3163095508,20-29,535,6,4,11,15,15,4,11,10,3.5282405526,509.4681375678,0.04073448,0.0571428571,0.14393939,0,135,5.646314826951256E-5,1.2582731E-4,1.2909889E-4,353,0.38746437,1,0,200,0,0,-0.24352498
216790519,BlueShoes55,10,21885,552,589,28,978,40.7535860426,40-49,757,8,15,7,22,22,15,7,10,3.7001219017,792.0358166758,0.049954605,0.0411255411,0.065789476,0,135,2.1131167662768994E-4,4.0264742E-4,4.1311645E-4,99,0.30946815,9,0,200,0,0,-0.243678674
51545098,mariebernatchez,10,4070,611,590,31,8,49.9071524648,40-49,680,6,6,7,13,13,6,7,9,3.6139780577,4984.2586763227,0.0140366775,0.0512820513,0.33333334,0,135,8.699976691162643E-5,1.7615824E-4,1.8073844E-4,267,0.5777778,11,0,200,0,0,-0.24444446
94669804,KeenanAylwin,10,981,202,597,2,492,53.590730012,50-59,590,5,10,15,25,25,10,15,10,3.2608695652,3600.7256834062,0.0423734849,0.0216666667,0.066176474,0,135,9.84671623754109E-5,2.768201E-4,2.8401756E-4,505,0.3108108,17,12,200,12,0.06,-0.244634326
14871120,indigosky9,10,1526,76,188,1,2,20.4183649103,20-29,424,6,6,4,10,10,6,4,9,3.6160097521,515.9148107524,0.0134597156,0.0222222222,0.0952381,0,135,7.862491543886517E-5,1.7615824E-4,1.8073844E-4,99,0.34,0,1,199,1,0.0050251256,-0.2447619
132993708,DavidJGagnon,10,7036,475,1966,8,319,43.3539491923,40-49,668,7,10,32,42,42,10,32,9,3.1113368549,9376.8902970423,0.0442289351,0.0092915215,0.020499108,0,135,2.206356751191683E-4,2.768201E-4,2.8401756E-4,505,0.26529503,12,1,202,1,0.004950495,-0.244795922
483577756,daphlipside,10,4590,184,211,4,275,30.2941068949,30-39,680,7,28,7,35,35,28,7,9,3.4055262089,3832.7419278447,0.0902188584,0.0134453782,0.027093597,0,135,2.0529115198843355E-4,7.297984E-4,7.487736E-4,99,0.27220482,10,2,199,2,0.0100502513,-0.245111223
366565098,ravenkitteh33,10,4680,1124,2000,30,44,34.2665081431,30-39,702,7,30,42,72,72,30,42,7,2.8732222674,289007.566045611,0.0850586282,0.0150625978,0.062626265,0,135,2.586754422138848E-4,7.8012934E-4,8.0041314E-4,99,0.30808082,4,0,198,0,0,-0.245454555
34073187,hhpouliot,10,410,115,201,0,71,40.2513992932,40-49,571,4,12,8,20,20,12,8,10,3.8541243397,968.7337291049,0.0495032505,0.0763157895,0.21428572,0,135,1.3263663968919186E-4,3.27151E-4,3.3565713E-4,257,0.460034,25,3,200,3,0.015,-0.24574828
16795670,salwind,10,664,25,234,0,81,29.8594938538,20-29,334,5,3,3,6,6,3,3,10,3.8338073954,31.7946241635,0.0071377556,0.0333333333,0.16666667,0,135,5.34220489573608E-5,1.00661855E-4,1.0327911E-4,71,0.4125,6,0,202,0,0,-0.24583333
156280432,OppoGuy,10,960,230,458,6,0,41.0896751893,40-49,612,4,27,38,65,65,27,38,9,3.3019097928,10534.5238750973,0.0746126261,0.0288461538,0.11673414,0,135,4.007132789555016E-4,7.0463296E-4,7.2295376E-4,257,0.36264285,28,2,200,2,0.01,-0.24590871
14241069,klashton27,10,12762,901,393,57,7,56.5942915033,50-59,752,7,10,1,11,11,10,1,11,4.4656643641,662.2156521375,0.0211918559,0.0272727273,0.044444446,0,135,1.992473439556927E-4,2.768201E-4,2.8401756E-4,257,0.2904762,11,0,200,0,0,-0.246031754
89704537,bonezmtl,10,2642,177,426,3,21,46.6496878522,40-49,675,6,25,30,55,55,25,30,9,3.0117838277,11618.7520956902,0.0733147253,0.0104377104,0.05632184,0,135,1.9536832428461095E-4,6.54302E-4,6.7131425E-4,99,0.3024158,59,0,207,0,0,-0.24609396
494252830,bates_gail,10,1325,113,202,2,4,40.4887057146,40-49,586,6,13,15,28,28,13,15,9,3.3535148314,7047.6838646188,0.0337529876,0.0211640212,0.09583333,0,135,1.3188707960461868E-4,3.5231648E-4,3.6147688E-4,99,0.34200603,8,1,202,1,0.004950495,-0.2461727
369212454,Ottawa_Steve,10,6242,269,446,1,67,42.7822841859,40-49,653,6,6,9,15,15,6,9,10,3.6537992686,1924.3365372953,0.0341089669,0.0428571429,0.13333334,0,135,8.069781710070291E-5,1.7615824E-4,1.8073844E-4,353,0.37962964,7,3,199,3,0.0150753769,-0.2462963
362725025,pembina_media,10,248,369,601,16,2,44.6829683527,40-49,574,4,23,16,39,39,23,16,10,3.3998374644,8476.9348604341,0.0816742077,0.0276653171,0.071428575,0,135,2.468742912910727E-4,6.0397113E-4,6.196747E-4,71,0.31780782,8,1,200,1,0.005,-0.246379245
37085947,Sethpt,10,2150,227,194,4,32,43.8618687005,40-49,648,5,6,4,10,10,6,4,11,4.1235270215,144.4858794053,0.0173638943,0.0666666667,0.23809524,0,135,1.3896979449443318E-4,1.7615824E-4,1.8073844E-4,343,0.4848485,6,0,199,0,0,-0.24675326
214946558,LibConcordia,10,112,156,47,5,0,41.7051578767,40-49,519,4,18,14,32,32,18,14,10,3.4782608696,9748.2231874989,0.0476156606,0.0635080645,0.2099567,0,135,2.8751594261259373E-4,4.781438E-4,4.905758E-4,505,0.45697117,21,1,187,1,0.0053475936,-0.24701447
188379252,MattSchein,10,2893,521,2001,9,61,42.702804128,40-49,630,6,15,32,47,47,15,32,10,3.1621292158,10744.602134915,0.0559542222,0.026827012,0.06306306,0,135,1.9464011441228812E-4,4.0264742E-4,4.1311645E-4,257,0.3103147,24,1,200,1,0.005,-0.24725164
532841420,stkenzie,10,3961,93,150,3,209,40.4235960572,40-49,581,7,6,4,10,10,6,4,9,3.6456724909,263.7481950079,0.0220662056,0.0111111111,0.06666667,0,135,7.616505704922389E-5,1.7615824E-4,1.8073844E-4,99,0.31422925,11,0,185,0,0,-0.24756258
540194655,krafty747,10,873,138,1021,2,125,26.4062107872,20-29,500,5,9,15,24,24,9,15,9,3.20073141,2384.4913433018,0.0230470146,0.0235507246,0.073529415,0,135,8.309160794310029E-5,2.5165462E-4,2.5819778E-4,99,0.32115385,3,0,200,0,0,-0.247624435
19495609,Fansen,10,12257,450,165,11,60,54.2657083809,50-59,752,8,43,13,56,56,43,13,9,3.3295408371,8205.7960440644,0.1218194208,0.0201298701,0.049154334,0,135,2.82103476793923E-4,0.0011072804,0.0011360702,99,0.2969567,115,0,200,0,0,-0.247802366
366095123,JulieCWC,10,611,208,373,6,0,40.7133962326,40-49,512,4,14,16,30,30,14,16,10,3.519707436,3335.3869127293,0.0563182256,0.0620689655,0.1868421,0,135,3.690852715153866E-4,3.7748195E-4,3.8729666E-4,353,0.43498966,14,3,200,3,0.015,-0.24814756
542898267,MassBucketry,10,15787,525,1398,26,1190,40.7053145926,40-49,731,7,11,13,24,24,11,13,10,3.4104022755,2830.2796195087,0.036772387,0.0217391304,0.040935673,0,135,1.1777538504174866E-4,3.0198556E-4,3.0983734E-4,99,0.2891348,7,0,200,0,0,-0.248199127
17546540,nickcott,10,7165,383,1445,17,40,47.4630905691,40-49,733,7,8,19,27,27,8,19,10,3.304754165,1443.4076030321,0.0188559688,0.0341880342,0.08809524,0,135,1.669287645871527E-4,2.2648917E-4,2.32378E-4,505,0.33640736,4,0,201,0,0,-0.24831212
334475094,3bas1,10,2117,264,644,4,26,34.9901428683,30-39,627,6,10,17,27,27,10,17,8,3.2137342544,4488.2492113998,0.0328021772,0.0356125356,0.1,0,135,1.0631357730985617E-4,2.768201E-4,2.8401756E-4,99,0.34848484,4,0,196,0,0,-0.24848484
272583709,EnzodellaRocca,10,2579,518,1403,13,57,42.4464565386,40-49,585,6,4,9,13,13,4,9,10,3.6192604632,585.02089471,0.0121484243,0.0448717949,0.11818182,0,135,6.921439199953506E-5,1.2582731E-4,1.2909889E-4,505,0.36666667,12,1,200,1,0.005,-0.24848485
283258239,LukewSavage,10,5733,549,1986,7,115,47.2361493565,40-49,685,6,18,30,48,48,18,30,10,3.2230800488,15388.698565526,0.054916502,0.0341312057,0.08095238,0,135,2.1358814792598536E-4,4.781438E-4,4.905758E-4,257,0.32963625,22,11,200,11,0.055,-0.24868387
1094058062,bc7rocks,10,354,14,9,0,45,44.803022416,40-49,598,5,7,5,12,12,7,5,10,3.4108086144,598.092102535,0.0324830694,0.0227272727,0.06666667,0,135,6.830048842681828E-5,2.0132371E-4,2.0655822E-4,99,0.31578946,78,0,203,0,0,-0.24912279
478115584,MattieLemieux,10,584,42,186,1,9,24.3957681927,20-29,462,4,4,3,7,7,4,3,10,3.9345794393,34.4190058217,0.0143187819,0.0476190476,0.06666667,0,135,7.024666148920589E-5,1.2582731E-4,1.2909889E-4,505,0.3164251,5,2,200,2,0.01,-0.24975843
308606319,zambo57,10,84,245,60,6,7,40.7783239598,40-49,557,2,3,1,4,4,3,1,1,1,2,7.593090382224469E-4,0,0,0,178,1.057516340852866E-4,1.00661855E-4,5.1639556E-5,71,0.25,24,0,100,0,0,-0.25
18881147,JonnKmech,10,1448,222,244,18,3,41.7677809772,40-49,580,5,3,2,5,5,3,2,11,4.4583502641,36.3703101481,0.0043886322,0,0,0,135,6.137152229227996E-5,1.00661855E-4,1.0327911E-4,353,0.25,0,0,199,0,0,-0.25
313503716,JamesLoganpdx,10,13164,631,787,26,6,36.5520203091,30-39,718,8,3,3,6,6,3,3,10,3.8520926453,346.8187204663,0.0059610928,0,0,0,135,6.827077054352614E-5,1.00661855E-4,1.0327911E-4,99,0.25,1,0,198,0,0,-0.25
125848560,stevem20,10,7903,528,179,30,340,40.6551522358,40-49,732,7,2,1,3,3,2,1,12,5.2458350264,15.7721615369,0.0015828839,0,0,0,135,8.823139047763924E-5,7.549639E-5,7.7459335E-5,283,0.25,2,0,200,0,0,-0.25
14467651,patzaph,10,10242,378,382,20,43,47.8394219812,40-49,739,7,2,0,2,2,2,0,0,0,0,0.006665415,0,0,0,74,5.2347543175348286E-5,7.549639E-5,0,505,0.25,5,0,200,0,0,-0.25
27279477,stacemcf,10,503,196,528,4,15,33.1566735857,30-39,509,4,1,1,2,2,1,1,11,4.5347419748,7.1011220198,0.0035168619,0,0,0,135,5.267096408277813E-5,5.0330927E-5,5.1639556E-5,505,0.25,3,0,200,0,0,-0.25
116667710,eltaria,10,6729,67,59,6,6,23.4520760882,20-29,610,5,2,1,3,3,2,1,10,3.935392117,169.357657784,0.0073560164,0,0,0,135,5.401149005111516E-5,7.549639E-5,7.7459335E-5,99,0.25,0,0,200,0,0,-0.25
33351678,Chrazzie,10,608,166,163,10,56,43.2839551667,40-49,502,4,2,1,3,3,2,1,11,4.641609102,41.4573438431,0.0015181142,0,0,0,135,6.028956058194048E-5,7.549639E-5,7.7459335E-5,257,0.25,2,0,200,0,0,-0.25
564212349,ElliotAustinH,10,1124,38,67,1,0,34.068912418,30-39,549,5,0,2,2,2,0,2,11,4.1267262388,0,0,0,0,0,800,4.4780486537007367E-5,0,2.5819778E-5,505,0.25,2,2,199,2,0.0100502513,-0.25
99802405,Dan_ONeail,10,10788,518,778,20,58,48.0067359405,40-49,737,7,36,15,51,51,36,15,9,3.1670052824,16657.7518764786,0.1338711329,0.0141176471,0.037537538,0,135,2.84752318778341E-4,9.311221E-4,9.553318E-4,99,0.2882883,15,2,200,2,0.01,-0.250750762
454114632,smell3roses,10,6113,177,363,4,16,35.2921382426,30-39,644,7,27,30,57,57,27,30,9,2.9520520114,16573.6437643428,0.0828824287,0.0109649123,0.043650795,0,135,2.0959327265042732E-4,7.0463296E-4,7.2295376E-4,505,0.2944032,31,2,214,2,0.0093457944,-0.250752405
115886031,2010redmittens,10,2646,251,364,5,97,33.0799685055,30-39,647,6,38,41,79,79,38,41,9,2.8919138562,24998.2323928754,0.1376530378,0.017689062,0.07440476,0,135,2.3005049733743242E-4,9.814531E-4,9.811516E-4,99,0.32542017,11,0,199,0,0,-0.25101541
186273990,miltonlaura,10,8149,387,228,18,5,56.3618137576,50-59,699,7,4,1,5,5,4,1,11,4.6623323852,23.5522821578,0.0107514412,0.1,0.15,0,135,7.501379720011946E-5,1.2582731E-4,1.2909889E-4,505,0.4010989,10,0,201,0,0,-0.2510989
237404095,dardsa,10,1447,25,231,0,20,27.6692733765,20-29,442,5,1,3,4,4,1,3,10,3.8789110118,37.0299150071,0.0016104229,0.0833333333,0.33333334,0,135,4.7678199958129156E-5,5.0330927E-5,5.1639556E-5,257,0.58455884,3,1,200,1,0.005,-0.2512255
254342818,KellmMurph,10,1055,218,353,11,5,44.5594729061,40-49,593,5,11,7,18,18,11,7,11,3.7618854124,1225.4680625355,0.0283256415,0.0359477124,0.12179487,0,135,9.376858713614534E-5,3.0198556E-4,3.0983734E-4,343,0.3731527,14,0,200,0,0,-0.25135783
791995963,philYama,10,1787,1200,1095,17,183,48.7167336769,40-49,656,6,38,37,75,75,38,37,9,2.9130434783,33273.5604506934,0.1176432516,0.0075675676,0.049932525,0,135,2.621631083503252E-4,9.814531E-4,0.0010069713,99,0.3015048,16,0,200,0,0,-0.251572275
279623396,moeyd64,10,2924,154,467,1,42,39.9733369115,30-39,595,7,23,20,43,43,23,20,9,3.0540430719,14568.6931193938,0.0597052479,0.015503876,0.044334974,0,135,2.309525785568888E-4,6.0397113E-4,6.196747E-4,257,0.29630896,11,3,207,3,0.0144927536,-0.251973986
273703828,MilesKrauter,10,2212,203,545,6,9,41.0621506741,40-49,651,6,9,9,18,18,9,9,10,3.4941080861,1144.9454977036,0.0413542328,0.045751634,0.12179487,0,135,1.2728329317177078E-4,2.5165462E-4,2.5819778E-4,257,0.37406015,27,0,200,0,0,-0.25226528
17911191,derekmcb,10,3763,590,303,36,50,43.8423855966,40-49,701,6,8,3,11,11,8,3,10,3.756196668,832.6362274488,0.0138302425,0.0272727273,0.044444446,0,135,1.341511982462597E-4,2.2648917E-4,2.32378E-4,353,0.29679143,4,0,200,0,0,-0.252346984
143188147,NickyP1979,10,2182,138,793,0,24,38.57186495,30-39,587,6,8,17,25,25,8,17,10,3.2271434376,2655.7199856262,0.0357062771,0.0233333333,0.068627454,0,135,1.1888438297526975E-4,2.2648917E-4,2.32378E-4,99,0.32115677,17,3,201,3,0.0149253731,-0.252529316
479174961,RayleenK,10,13704,338,443,8,2713,37.3702842414,30-39,713,8,14,17,31,31,14,17,10,3.1950426656,4617.7328989329,0.0385004865,0.011827957,0.06535948,0,135,1.1931096581209192E-4,3.7748195E-4,3.8729666E-4,99,0.3180272,9,0,201,0,0,-0.25266772
292413983,danminkin,10,2692,271,698,5,80,44.9556857014,40-49,670,6,16,13,29,29,16,13,10,3.4823242584,3174.4967414384,0.045684091,0.0381773399,0.110526316,0,135,1.4234716548796025E-4,4.2781286E-4,4.1311645E-4,257,0.3638625,10,1,200,1,0.005,-0.253336184
524754019,MaryPChipman,10,3035,361,578,3,3044,46.0445760287,40-49,656,6,23,30,53,53,23,30,9,2.8850060951,13281.8816351897,0.0879581196,0.0148766328,0.064367816,0,135,1.945427399187001E-4,6.0397113E-4,6.196747E-4,99,0.3178428,68,6,207,5,0.0241545894,-0.253474984
444262205,BravoFourTwenty,10,7103,369,674,0,730,46.3599743796,40-49,735,7,31,28,59,59,31,28,9,3.053636733,9588.0836086491,0.0856892491,0.0295149036,0.11031746,0,135,2.278032403769364E-4,8.0529484E-4,8.262329E-4,99,0.36415884,46,1,203,1,0.0049261084,-0.25384138
287040067,davejrider,10,170,58,347,0,19,32.4052502923,30-39,442,3,5,14,19,19,5,14,10,3.4299065421,739.4173877906,0.0172981891,0.0263157895,0.06593407,0,135,5.9057766879494586E-5,1.5099278E-4,1.5491867E-4,505,0.31986216,5,0,173,0,0,-0.25392809
297239016,a_w_young,10,9832,686,1844,17,437,58.1037090682,50-59,744,7,21,16,37,37,21,16,9,3.2714343763,9357.7181399993,0.0506090931,0.0142642643,0.03325123,0,135,2.4748837004844623E-4,5.536402E-4,5.680351E-4,99,0.28735223,21,0,200,0,0,-0.254101
200883695,WScott_Steele,10,20423,1438,2000,47,807,56.345807179,50-59,742,8,20,18,38,38,20,18,9,3.2535554653,8402.9968503952,0.0482256763,0.0149359886,0.047692306,0,135,3.055565790281384E-4,5.2847475E-4,5.4221536E-4,505,0.3019608,37,0,201,0,0,-0.254268494
705490496,kenlister1,10,332,33,89,0,4,36.9518139847,30-39,498,4,4,7,11,11,4,7,10,3.6160097521,83.7607911059,0.0140349585,0.0454545455,0.16666667,0,135,9.110676340042895E-5,1.2582731E-4,1.2909889E-4,505,0.42105263,11,1,200,1,0.005,-0.25438596
96918349,memaxmarz,10,4787,143,395,6,1231,39.0717695951,30-39,652,6,4,4,8,8,4,4,10,3.6765542462,1636.1417917502,0.0102524259,0.0178571429,0.06666667,0,135,9.169192441275386E-5,1.2582731E-4,1.2909889E-4,71,0.32105264,1,1,199,1,0.0050251256,-0.25438597
190240891,amdrobinson,10,7020,724,1295,14,65,61.2164756492,60-69,699,6,6,8,14,14,6,8,10,3.6046322633,516.4469609435,0.0133747017,0.0604395604,0.13636364,0,135,7.739805913289625E-5,1.7615824E-4,1.8073844E-4,505,0.3908046,6,0,200,0,0,-0.25444096
17235459,NutkinNB,10,11305,837,1001,37,5,49.4848220307,40-49,710,7,8,12,20,20,8,12,10,3.3937423811,2388.4331466421,0.0241527895,0.0184210526,0.07692308,0,135,9.930713877578065E-5,2.2648917E-4,2.32378E-4,257,0.33141026,3,3,200,3,0.015,-0.25448718
27434069,trev_harrison,10,4933,628,594,20,0,45.5583715631,40-49,711,7,26,7,33,33,26,7,10,3.917513206,1187.2649479443,0.0854778367,0.0700757576,0.14550264,0,135,4.866064371067483E-4,6.794675E-4,6.7131425E-4,505,0.4003594,11,2,199,2,0.0100502513,-0.25485676
859029968,patricklpc,10,2993,480,1000,7,45,47.0433089606,40-49,591,6,11,22,33,33,11,22,10,3.318976026,3184.8880332478,0.0438292685,0.0255681818,0.07905138,0,135,1.3343827560787668E-4,3.0198556E-4,3.0983734E-4,99,0.3339506,6,0,205,0,0,-0.25489922
258562269,SpYeDeR,10,2458,552,2000,7,374,36.5273015869,30-39,597,6,3,17,20,20,3,17,9,3.4026818367,1759.4402368823,0.0119800813,0.0631578947,0.12867647,0,135,1.0557346547185597E-4,1.00661855E-4,1.0327911E-4,99,0.38444445,5,0,200,0,0,-0.25576798
299506138,ThatJBrown,10,6115,351,1148,4,139,46.5229693602,40-49,713,7,6,7,13,13,6,7,11,3.6826493295,575.8581551033,0.0161944062,0.0320512821,0.08181818,0,135,1.5468059216155225E-4,1.7615824E-4,1.8073844E-4,283,0.33760685,3,2,200,1,0.005,-0.25578867
10206822,neilbakshi,10,8318,882,1125,40,1013,49.2140285948,40-49,705,7,6,9,15,15,6,9,9,3.5075172694,7618.7831482679,0.0178236511,0.0095238095,0.055555556,0,135,1.253190964194543E-4,1.7615824E-4,1.8073844E-4,148,0.3115942,10,0,201,0,0,-0.256038644
97175858,MarleneRivier,10,444,226,111,19,0,56.8464492345,50-59,563,3,17,5,22,22,17,5,9,3.5900040634,1567.8580522245,0.0617315872,0.0649350649,0.1503268,0,135,1.390632460358615E-4,4.5297833E-4,4.64756E-4,257,0.40650406,33,0,200,0,0,-0.25617726
248412992,firstcircle12,10,1776,269,336,3,240,46.9893277989,40-49,661,5,20,18,38,38,20,18,9,3.0369768387,12114.7750735764,0.0683883303,0.0120910384,0.07105263,0,135,2.0890515878720304E-4,5.2847475E-4,5.4221536E-4,99,0.32726076,86,1,209,1,0.004784689,-0.25620813
63371371,adamharris09,10,3088,344,555,14,20,42.799321264,40-49,628,6,3,2,5,5,3,2,11,4.3019097928,30.7521252954,0.0048399349,0,0,0,135,6.114998096653483E-5,1.00661855E-4,1.0327911E-4,343,0.25641027,3,0,200,0,0,-0.25641027
37961352,retxab03,10,9654,140,377,2,475,39.2369416532,30-39,665,7,10,5,15,15,10,5,9,3.6623323852,596.0737722423,0.0370214001,0.0380952381,0.09090909,0,135,1.0887472532943962E-4,2.768201E-4,2.8401756E-4,99,0.34756097,3,1,200,1,0.005,-0.25665188
242975599,jeanoudy,10,4698,299,682,4,28,43.4090228885,40-49,694,7,18,27,45,45,18,27,10,3.1186509549,7755.0760586821,0.0518940573,0.0202020202,0.06896552,0,135,2.4476979618367166E-4,4.781438E-4,4.905758E-4,99,0.32566988,28,0,198,0,0,-0.25670436
80027957,TweetJewels,10,2664,257,393,16,25,47.0284300127,40-49,579,6,18,15,33,33,18,15,9,3.3063795205,4767.6772675614,0.0640725056,0.0369318182,0.19005848,0,135,1.5982295327107127E-4,4.781438E-4,4.905758E-4,257,0.44680852,13,2,200,2,0.01,-0.25675004
473449200,g_e13,10,4750,169,533,6,131,40.6040228277,40-49,622,7,16,46,62,62,16,46,8,2.9272653393,13684.6646567142,0.0371501446,0.0116340561,0.028214617,0,135,1.8291407118499123E-4,4.2781286E-4,4.3893623E-4,99,0.28507078,14,1,205,1,0.0048780488,-0.256856163
94125725,kellypatrickxox,10,11956,393,775,11,51,47.3405552739,40-49,702,7,21,23,44,44,21,23,9,3.1832588379,11722.8356215503,0.0600374738,0.0142706131,0.044827588,0,135,2.7995992720090127E-4,5.536402E-4,5.680351E-4,505,0.3017177,59,0,200,0,0,-0.256890112
79263310,itsluncht1me,10,7016,407,653,11,106,43.2398607968,40-49,681,7,2,8,10,10,2,8,10,3.4384396587,310.3978019147,0.0106125477,0.0333333333,0.06666667,0,135,7.973565450583735E-5,7.549639E-5,7.7459335E-5,99,0.3235887,11,0,200,0,0,-0.25692203
15964090,TakeoverMonkey,10,3089,114,100,4,16,28.8862687863,20-29,590,6,2,1,3,3,2,1,11,4.5810646079,31.6519185618,0.0124269043,0.1666666667,0.16666667,0,135,6.0192384655731965E-5,7.549639E-5,7.7459335E-5,99,0.42380953,4,3,200,3,0.015,-0.25714286
435707754,Mikoshoes17,10,12779,388,787,4,375,37.4013851166,30-39,695,8,33,48,81,81,33,48,9,2.9674928891,28205.2401951526,0.0840735458,0.012345679,0.032792207,0,135,2.635782475145261E-4,8.556257E-4,8.7787246E-4,99,0.28996968,29,0,207,0,0,-0.257177473
51448005,MikeMcD76,10,28543,648,1304,40,28,45.0786759952,40-49,759,8,29,21,50,50,29,21,9,3.1787891101,11789.6889181325,0.084306131,0.0175510204,0.041835357,0,135,2.625204482817132E-4,7.549639E-4,7.745933E-4,99,0.29943502,71,0,204,0,0,-0.257599663
393056809,nerdpoligirl,10,1598,94,146,2,2,24.6965205622,20-29,523,6,18,8,26,26,18,8,10,3.4770418529,1590.7490008751,0.0656538925,0.0692307692,0.18947369,0,135,1.8824749453060963E-4,4.781438E-4,4.905758E-4,257,0.44724175,0,13,200,12,0.06,-0.25776806
559903099,wayneglenwood,10,268,144,189,8,14,36.614746722,30-39,739,8,9,13,22,22,9,13,9,3.3340105648,2612.0533585431,0.028548243,0.0108225108,0.044871796,0,135,1.0183626067923557E-4,2.5165462E-4,2.5819778E-4,99,0.30322582,11,0,201,0,0,-0.258354024
155631208,kylejhutton,10,4493,168,145,9,0,46.1225676785,40-49,664,6,17,6,23,23,17,6,10,3.5006095083,2192.2114663022,0.0548664329,0.0355731225,0.113970585,0,135,1.8575986001487328E-4,4.5297833E-4,4.64756E-4,505,0.37239057,81,0,201,0,0,-0.258419985
261857919,JacksonUTE,10,9182,306,634,3,0,45.7122704789,40-49,697,7,19,25,44,44,19,25,10,3.0971149939,10704.0640330475,0.06546724,0.0237843552,0.092307694,0,135,2.1760864604561695E-4,5.0330925E-4,5.1639555E-4,257,0.35085964,29,2,200,2,0.01,-0.258551946
494454468,MuffysMusings,10,1368,171,314,0,230,42.3148568285,40-49,658,5,32,38,70,70,32,38,9,2.9565217391,17830.1879207738,0.0824407528,0.0155279503,0.05041628,0,135,2.4328462722016773E-4,8.304603E-4,8.5205265E-4,99,0.3091992,32,2,200,2,0.01,-0.25878292
78596808,wellsdavid,10,104,138,319,2,1,29.5996929599,20-29,456,3,5,10,15,15,5,10,9,3.7472572125,3090.8798282565,0.0091261517,0.0571428571,0.22222222,0,135,1.1576106272541317E-4,1.5099278E-4,1.5491867E-4,343,0.4815271,4,0,111,0,0,-0.25930488
72182988,Mayssia,10,47576,1083,1984,29,1040,44.3421850398,40-49,767,9,4,13,17,17,4,13,9,3.3437626981,1350.4790413426,0.0076980453,0.0147058824,0.03846154,0,135,8.025403719879295E-5,1.2582731E-4,1.2909889E-4,257,0.29781422,11,0,199,0,0,-0.25935268
909289290,Planet350,10,696,313,778,4,198,46.2685843792,40-49,557,5,11,17,28,28,11,17,9,3.2633075985,6719.5933281454,0.0308733898,0.0145502646,0.04047619,0,135,1.1947595890738954E-4,3.0198556E-4,3.0983734E-4,99,0.30056325,12,0,199,0,0,-0.26008706
573076951,thom_roland,10,16278,609,874,16,2405,41.4119338518,40-49,771,8,8,14,22,22,8,14,10,3.4217797643,4163.9517830191,0.0215265806,0.0324675325,0.080882356,0,135,1.0298142873082686E-4,2.2648917E-4,2.32378E-4,99,0.34107745,42,0,198,0,0,-0.260195094
515638983,MacIntyreCheryl,10,1239,108,115,2,285,41.9420795721,40-49,594,5,29,9,38,38,29,9,10,3.3157253149,3779.9284876355,0.1034058025,0.0376955903,0.077419356,0,135,1.5382149849574642E-4,7.549639E-4,7.745933E-4,99,0.33782697,15,1,200,1,0.005,-0.260407614
198722685,MBolero,10,3158,110,278,1,1774,41.6986727686,40-49,603,6,7,8,15,15,7,8,10,3.4112149533,919.9943485119,0.0228479634,0.0428571429,0.09090909,0,135,1.4514056137902525E-4,2.0132371E-4,2.0655822E-4,99,0.35141242,7,1,199,1,0.0050251256,-0.26050333
315296719,lechefwayne,10,6986,104,108,3,99,44.2026709683,40-49,690,7,6,1,7,7,6,1,12,4.6038195855,63.4683488396,0.0190117952,0.0238095238,0.033333335,0,135,8.800885882584094E-5,1.7615824E-4,1.8073844E-4,99,0.29411766,36,0,225,0,0,-0.260784325
1249867202,NakotaCreative,10,114,43,217,0,166,28.7357977398,20-29,342,4,4,6,10,10,4,6,10,3.7501015847,368.8228802183,0.0172028728,0.0333333333,0.1,0,135,6.76589531675786E-5,1.2582731E-4,1.2909889E-4,99,0.3611111,3,0,146,0,0,-0.2611111
1048447759,Tenaciousceeee,10,4,1,18,0,0,34.98955094,30-39,429,4,2,5,7,7,2,5,10,3.5619666802,631.8153484564,0.0140624332,0.0714285714,0.13333334,0,135,5.6369375095576556E-5,7.549639E-5,7.7459335E-5,99,0.39462367,24,69,210,67,0.319047619,-0.26129033
192922494,toronto_red,10,3132,86,142,0,13,35.8488474279,30-39,599,6,4,4,8,8,4,4,10,3.5713124746,340.7312624893,0.0070641755,0.0178571429,0.06666667,0,135,6.788265517191482E-5,1.2582731E-4,1.2909889E-4,343,0.32806325,11,0,200,0,0,-0.26139658
20753028,JohnCollison,10,33666,824,57,38,7,43.8559858904,40-49,782,9,21,1,22,22,21,1,11,4.2880942706,203.9221156119,0.0925570357,0.0303030303,0.05,0,135,1.9476964998556552E-4,5.536402E-4,5.680351E-4,353,0.3116836,36,0,202,0,0,-0.2616836
781055977,sasquatchdene,10,290,32,235,0,3,33.8686881917,30-39,411,5,3,9,12,12,3,9,10,3.5908167412,286.6758347761,0.0054082336,0.0227272727,0.06944445,0,135,6.819059427949963E-5,1.00661855E-4,1.0327911E-4,99,0.3314394,5,0,195,0,0,-0.26199495
579490823,yorkuliberals,10,218,183,492,5,0,25.8731891273,20-29,461,3,8,7,15,15,8,7,10,3.7163754571,885.9102945736,0.0243504225,0.0666666667,0.18181819,0,135,1.2702766553916476E-4,2.2648917E-4,2.32378E-4,505,0.44391677,3,6,200,6,0.03,-0.26209858
73128904,caperspark,10,17746,583,1100,29,4,36.8947602264,30-39,761,8,5,3,8,8,5,3,10,3.7773262901,2415.7936647103,0.0138272554,0.0178571429,0.033333335,0,135,6.762175091373535E-5,1.5099278E-4,1.5491867E-4,99,0.29583332,2,0,199,0,0,-0.262499985
437673995,lorabruncke,10,29816,690,789,20,9501,44.5246300209,40-49,762,9,30,26,56,56,30,26,9,3.1661926046,15320.8683039524,0.0973321815,0.0194805195,0.05792683,0,135,2.258892437745586E-4,7.8012934E-4,8.0041314E-4,99,0.3204396,17,0,211,0,0,-0.26251277
67254536,WhatTheTWEEEET,10,4888,515,1472,24,69,43.7679225106,40-49,628,6,3,10,13,13,3,10,9,3.2775294596,168.8242904747,0.0131985773,0.0384615385,0.07777778,0,135,7.137072850920514E-5,1.00661855E-4,1.0327911E-4,257,0.34030196,0,0,200,0,0,-0.26252418
160356798,finnheather,10,306,219,414,5,0,34.1281016394,30-39,494,4,24,15,39,39,24,15,10,3.6135717188,2637.9110635004,0.0802492454,0.0877192982,0.2413793,0,135,3.165738410195178E-4,6.291366E-4,6.4549444E-4,257,0.5039474,14,11,199,10,0.0502512563,-0.2625681
17076793,wjordan,10,13925,556,700,27,1331,54.0132586554,50-59,738,8,22,24,46,46,22,24,9,3.1097114994,9021.1790241806,0.0794355992,0.0115942029,0.054131053,0,135,2.118623179278659E-4,5.7880563E-4,5.938549E-4,99,0.31678322,9,1,200,1,0.005,-0.262652167
494609110,RougeMenace,10,3340,207,244,5,405,47.3135595905,40-49,673,6,12,9,21,21,12,9,10,3.2100772044,5162.3675580263,0.0578152437,0.0142857143,0.054945055,0,135,1.1296917086443558E-4,3.27151E-4,3.3565713E-4,99,0.31764707,62,0,202,0,0,-0.262702015
270889290,1charlesjohnson,10,496,48,156,1,13,27.071033782,20-29,360,4,4,11,15,15,4,11,10,3.2734660707,529.6625123666,0.0156066986,0.0285714286,0.054545455,0,135,6.791238339707136E-5,1.2582731E-4,1.2909889E-4,99,0.31756756,1,2,200,2,0.01,-0.263022105
15970856,TotallyTolen,10,1111,174,354,9,1,29.0237687357,20-29,556,5,14,15,29,29,14,15,10,3.4900446973,4165.6239636516,0.0411294868,0.0406403941,0.09881423,0,135,1.4478934741729406E-4,3.7748195E-4,3.8729666E-4,257,0.36189258,4,3,200,3,0.015,-0.26307835
66140247,jeffgalbraith,10,650,59,127,3,79,27.9629047885,20-29,594,5,2,1,3,3,2,1,11,4.4867939862,13.8396600855,0.0057248099,0.1666666667,0.16666667,0,135,6.541187114185215E-5,7.549639E-5,7.7459335E-5,257,0.43014705,2,0,200,0,0,-0.26348038
27272767,dennisflood54,10,1009,88,172,0,40,36.2945968327,30-39,604,5,4,6,10,10,4,6,9,3.8187728566,204.8385794858,0.015149785,0.0777777778,0.2857143,0,135,6.454711585422582E-5,1.2582731E-4,1.2909889E-4,343,0.5494506,4,0,200,0,0,-0.2637363
22303151,robertlavigne,10,11033,271,502,5,16,49.2696483862,40-49,728,8,30,13,43,43,30,13,10,3.3421373425,10498.2476636932,0.0738987774,0.0166112957,0.035650622,0,135,3.3960757654687303E-4,7.8012934E-4,8.0041314E-4,505,0.29960024,49,0,202,0,0,-0.263949618
234140065,lucky774,10,1472,108,281,1,38,30.7254390778,30-39,501,5,4,7,11,11,4,7,9,3.6115400244,317.3259987489,0.0145551127,0.0090909091,0.035714287,0,135,9.831952807224186E-5,1.2582731E-4,1.2909889E-4,71,0.3,3,1,200,1,0.005,-0.264285713
271006415,ingriddecorator,10,5276,74,537,0,14,22.037057394,20-29,497,7,8,21,29,29,8,21,10,3.2251117432,3187.7904145871,0.0214418536,0.0209359606,0.033333335,0,135,9.965834957443618E-5,2.2648917E-4,2.32378E-4,99,0.2978034,2,1,200,1,0.005,-0.264470065
49403072,brit_newsman,10,72303,2939,3125,131,10,55.3278759799,50-59,840,10,36,35,71,71,36,35,9,2.9878098334,16855.7030842872,0.099918421,0.0136820926,0.08250356,0,135,2.896594134276717E-4,9.311221E-4,9.553318E-4,99,0.34723336,65,0,203,0,0,-0.2647298
178401121,theultimateaven,10,16960,633,2001,9,1,32.1064718404,30-39,625,8,7,2,9,9,7,2,10,3.8898821617,473.6371247439,0.0188981937,0.0138888889,0.035714287,0,135,8.767701599636053E-5,2.0132371E-4,2.0655822E-4,343,0.3004926,1,0,198,0,0,-0.264778313
872639550,billg1963,10,4357,585,1015,4,77,52.6044950628,50-59,659,7,4,9,13,13,4,9,10,3.3120682649,2817.8523548986,0.0262866883,0.0064102564,0.013888889,0,135,7.598813643336887E-5,1.2582731E-4,1.2909889E-4,99,0.2792208,6,0,200,0,0,-0.265331911
421482494,TorontoPost,10,17293,40378,2506,11,49,42.6871724849,40-49,763,8,9,9,18,18,9,9,10,3.4469727753,3302.4815377089,0.0225542765,0.0032679739,0.013888889,0,135,1.1411714646872328E-4,2.5165462E-4,2.5819778E-4,99,0.2792208,19,0,202,0,0,-0.265331911
242808527,Zorpheous,10,5020,251,450,7,277,50.7798177184,50-59,726,7,23,31,54,54,23,31,9,3.1084924827,19397.12564385,0.0764986493,0.0171208945,0.056818184,0,135,2.644044269044486E-4,6.0397113E-4,6.196747E-4,99,0.3221782,21,1,199,1,0.0050251256,-0.265360016
395853126,petjamwil,10,6309,377,758,5,128,43.6033604533,40-49,688,7,15,26,41,41,15,26,9,2.9492076392,9102.3247130055,0.0701720265,0.0219512195,0.08153846,0,135,1.4426666316797777E-4,4.0264742E-4,4.1311645E-4,99,0.34696606,12,1,201,1,0.0049751244,-0.2654276
275210802,67Capt_Canuck,10,15528,375,390,9,39,42.5906101948,40-49,731,8,30,19,49,49,30,19,10,3.1056481105,15514.0530931289,0.1326914233,0.0165816327,0.053977273,0,135,3.2966005997482514E-4,7.8012934E-4,8.0041314E-4,267,0.31948245,59,1,204,1,0.0049019608,-0.265505177
858827341,NextGenTrudeau,10,125,23,156,1,1,25.5339698189,20-29,422,4,5,13,18,18,5,13,10,3.39780577,472.2790364969,0.0122538423,0.0392156863,0.093406595,0,135,9.426539591415081E-5,1.5099278E-4,1.5491867E-4,505,0.36,5,4,168,3,0.0178571429,-0.266593405
14560819,amymyoung,10,44319,737,594,112,41,54.1532016304,50-59,775,9,3,3,6,6,3,3,10,3.8911011784,53.6973785118,0.0079250299,0.0333333333,0.33333334,0,135,6.213639989472136E-5,1.00661855E-4,1.0327911E-4,257,0.6,7,0,201,0,0,-0.26666666
20476018,4zim,10,10793,845,553,34,137,51.10655461,50-59,699,7,5,3,8,8,5,3,11,4.3514831369,465.4710653054,0.0198844189,0.0178571429,0.1,0,135,1.3019352133194457E-4,1.5099278E-4,1.5491867E-4,353,0.36666667,4,1,200,1,0.005,-0.26666667
318568724,FredOliver245,10,4907,73,61,0,74,16.897913174,10-19,561,7,3,3,6,6,3,3,10,3.9500203169,170.276120609,0.0061537523,0.0333333333,0.1,0,135,7.258026823402371E-5,1.00661855E-4,1.0327911E-4,257,0.36666667,0,0,200,0,0,-0.26666667
513354952,1nfinitezer0,10,313,256,1339,5,15,34.6169071823,30-39,491,4,0,3,3,3,0,3,11,4.6699147381,0,0,0,0,0,366,4.4780486537007367E-5,0,2.5819778E-5,283,0.26666668,1,0,200,0,0,-0.26666668
503693698,reddogcw,10,5896,143,383,2,5188,45.3032563061,40-49,648,7,7,8,15,15,7,8,10,3.5709061357,2713.4021896102,0.017322471,0.019047619,0.045454547,0,135,8.638685618809717E-5,2.0132371E-4,2.0655822E-4,99,0.3123077,15,0,203,0,0,-0.266853153
119711865,dexterchaos,10,2503,185,441,2,796,47.4612988274,40-49,651,6,15,24,39,39,15,24,9,3.0511986997,3506.1887116732,0.043657553,0.0209176788,0.07666667,0,135,1.582919237356544E-4,4.0264742E-4,4.1311645E-4,99,0.34394753,21,1,201,1,0.0049751244,-0.26728086
517905077,Gibsons_Rare,10,253,19,34,0,14,31.8976771126,30-39,457,4,2,2,4,4,2,2,10,4.086143844,51.6554935927,0.0028168914,0,0,0,135,4.828203442393243E-5,7.549639E-5,7.7459335E-5,71,0.26785713,10,2,202,2,0.0099009901,-0.26785713
22277694,steveouthouse,10,2060,921,313,27,8,41.2030715536,40-49,628,5,29,8,37,37,29,8,10,4.0520113775,6890.8799202178,0.1011904064,0.0337837838,0.07096774,0,135,6.695822336393884E-4,7.549639E-4,7.745933E-4,353,0.3389234,25,0,200,0,0,-0.26795566
305330589,gelagaffe,10,1082,166,223,2,213,44.3606971045,40-49,615,6,24,30,54,54,24,30,10,2.9723689557,6755.3742407379,0.0921434031,0.0199161426,0.11149425,0,135,1.8599060932126388E-4,6.291366E-4,6.4549444E-4,99,0.37949955,209,4,200,4,0.02,-0.2680053
381013583,YukonTeddy,10,230,114,327,3,3,29.4073605097,20-29,438,4,6,9,15,15,6,9,10,3.4664770419,2177.3569720878,0.0797967222,0.0333333333,0.14444445,0,135,1.2039218034560926E-4,1.7615824E-4,1.8073844E-4,353,0.41254902,0,0,199,0,0,-0.26810457
95539607,ottawa_jen,10,2179,156,777,3,22,42.7112371744,40-49,618,6,12,17,29,29,12,17,10,3.4851686306,2542.1731036994,0.0363407072,0.0578817734,0.11956522,0,135,2.0753548837144524E-4,3.27151E-4,3.3565713E-4,257,0.38772893,24,5,201,5,0.0248756219,-0.26816371
16861429,canadian_stix,10,1350,129,552,0,14,20.5209013648,20-29,424,5,2,5,7,7,2,5,10,3.6184477855,81.7028600171,0.0043980595,0.0238095238,0.1,0,135,5.8064899315446634E-5,7.549639E-5,7.7459335E-5,99,0.36923078,0,0,200,0,0,-0.26923078
152498426,TheLeftPopulist,10,4435,230,467,7,5,51.6224581176,50-59,708,6,21,35,56,56,21,35,9,3.0004063389,13713.2560162225,0.0450484985,0.011038961,0.03228228,0,135,2.1086782716526098E-4,5.536402E-4,5.680351E-4,99,0.30167508,12,2,204,2,0.0098039216,-0.2693928
317755864,LarryDiIanni,10,9230,1343,918,40,11,54.967750627,50-59,765,7,13,8,21,21,13,8,10,3.6635514019,9622.3958678693,0.0317028387,0.0214285714,0.0625,0,135,1.0747407742706133E-4,3.5231648E-4,3.6147688E-4,505,0.33205783,50,0,200,0,0,-0.26955783
97820008,TaleFinn,10,6160,994,1714,7,1625,44.3582455127,40-49,618,7,16,23,39,39,16,23,10,3.1930109711,6041.925573845,0.0421160798,0.0209176788,0.083333336,0,135,2.0758118389505682E-4,4.2781286E-4,4.3893623E-4,99,0.353973,8,0,205,0,0,-0.270639664
177416004,nojgr,10,5605,104,388,2,51,43.2579397063,40-49,594,7,17,16,33,33,17,16,10,3.0828931329,5794.9556620267,0.0735435351,0.0160984848,0.0513834,0,135,1.3014060840474179E-4,4.5297833E-4,4.64756E-4,99,0.32245386,16,3,201,3,0.0149253731,-0.27107046
1276460149,CladinaDawes,10,1,2,50,0,0,17.092575493,10-19,48,2,0,3,3,3,0,3,10,3.8521527214,0,0,0.1666666667,0.16666667,0,158,4.4780486537007367E-5,0,2.5819778E-5,283,0.43809524,1,0,19,0,0,-0.27142857
112327585,lifeinanorthern,10,3950,111,333,0,35,38.4560407897,30-39,535,6,19,39,58,58,19,39,9,3.0186915888,6566.0594403769,0.069144202,0.0226860254,0.058139537,0,135,1.9104581206686762E-4,5.0330925E-4,5.1639555E-4,99,0.3305417,0,5,198,5,0.0252525253,-0.272402163
21625747,RedAloud,10,10169,577,842,23,83,53.4814268082,50-59,738,7,29,19,48,48,29,19,10,3.466070703,8953.2058412355,0.0939043512,0.039893617,0.125,0,135,3.152942101384842E-4,7.549639E-4,7.745933E-4,257,0.3975364,104,0,201,0,0,-0.2725364
230220287,Coteter,10,6008,217,298,10,1843,46.641993125,40-49,671,7,31,29,60,60,31,29,10,3.0077204388,13099.0658138848,0.0921226339,0.0141242938,0.08387097,0,135,2.2258480800374332E-4,8.0529484E-4,8.262329E-4,99,0.35645932,23,4,201,4,0.0199004975,-0.27258835
534827153,usernamehere,10,829,343,279,2,39,44.5112222834,40-49,592,5,2,5,7,7,2,5,9,3.8191791954,317.5575349759,0.0025564748,0,0,0,135,5.982451938423053E-5,7.549639E-5,7.7459335E-5,71,0.27272728,13,1,201,1,0.0049751244,-0.27272728
246637413,fermangogo,10,499,27,106,0,6,25.630856559,20-29,479,4,1,3,4,4,1,3,10,3.6481105242,208.0159322309,3.672052307997992E-4,0,0,0,135,4.6426260340864236E-5,5.0330927E-5,5.1639556E-5,505,0.27272728,0,0,199,0,0,-0.27272728
1242064148,InKorrrect,10,0,5,35,0,0,25.5288069222,20-29,407,2,1,4,5,5,1,4,9,3.7996749289,2460.3239247312,3.033261553497888E-4,0,0,0,135,5.5027316895881816E-5,5.0330927E-5,5.1639556E-5,99,0.27272728,5,5,50,5,0.1,-0.27272728
253382876,OccupyCoscienza,10,11727,615,969,14,1365,47.8975036571,40-49,748,8,11,20,31,31,11,20,9,3.1292157659,7739.742183256,0.0455887025,0.0204301075,0.078947365,0,135,1.9311943699221128E-4,3.0198556E-4,3.0983734E-4,99,0.35172158,20,0,200,0,0,-0.272774215
267358228,northernsooner,10,10276,393,1720,4,206,48.181917244,40-49,708,7,6,14,20,20,6,14,9,3.3100365705,3783.7706446829,0.018296132,0.0157894737,0.03809524,0,135,9.381174170269676E-5,1.7615824E-4,1.5491867E-4,99,0.31094658,18,0,201,0,0,-0.27285134
263831999,amneetbali,10,2716,340,140,3,100,41.5292524667,40-49,699,6,4,4,8,8,4,4,10,3.8094270622,84.067007057,0.0155603617,0.0892857143,0.33333334,0,135,1.35547761261836E-4,1.2582731E-4,1.2909889E-4,257,0.60645163,16,1,200,1,0.005,-0.27311829
65254904,KiavashNajafi,10,114,98,273,1,0,41.4397167619,40-49,507,3,24,15,39,39,24,15,10,3.4737911418,4040.5771474677,0.0675423914,0.0580296896,0.125,0,135,3.1713265311310746E-4,6.291366E-4,6.4549444E-4,257,0.39857596,60,7,166,7,0.0421686747,-0.27357596
467212067,markcheck99,10,2969,668,2000,6,62,37.816370527,30-39,592,6,17,40,57,57,17,40,9,3.0552620886,16766.9415956447,0.0513317423,0.0103383459,0.031097561,0,135,2.352332733638716E-4,4.5297833E-4,4.64756E-4,99,0.30508736,0,0,200,0,0,-0.273989799
295707178,BCaramento,10,8957,371,350,8,98,46.0599482084,40-49,736,7,13,13,26,26,13,13,9,3.2320195043,3931.298449567,0.0389526081,0.0107692308,0.04945055,0,135,1.1869667306173746E-4,3.5231648E-4,3.6147688E-4,99,0.32346722,26,0,201,0,0,-0.27401667
516583662,Jkhourystfx,10,2015,135,346,5,2,42.036800662,40-49,548,6,8,12,20,20,8,12,11,3.8772856562,8753.3211646387,0.0141703098,0.0342105263,0.0952381,0,135,1.372438722799168E-4,2.2648917E-4,2.32378E-4,343,0.3692899,8,1,200,1,0.005,-0.2740518
298034083,gariovich,10,4150,171,190,7,44,46.8813178583,40-49,711,7,12,15,27,27,12,15,10,3.20438846,2393.8555964563,0.0500697377,0.037037037,0.12091503,0,135,1.2070047236764029E-4,3.27151E-4,3.3565713E-4,99,0.3951782,38,0,200,0,0,-0.27426317
35425956,areviaki,10,1000,92,382,0,10,28.2705066878,20-29,533,5,3,8,11,11,3,8,9,3.5505891914,7551.9187339127,0.0027637722,0.0181818182,0.041666668,0,135,7.357575254687373E-5,1.00661855E-4,1.0327911E-4,99,0.31602564,2,1,200,1,0.005,-0.274358972
870165780,MarieJazvac,10,13,8,76,0,0,14.1202465551,10-19,18,0,2,1,3,3,2,1,11,4.4924827306,0,0.0101550913,0.1666666667,0.5,0,135,5.005354573177374E-5,7.549639E-5,7.7459335E-5,257,0.775,0,0,14,0,0,-0.275
28421045,bow_en_arrow,10,5288,334,1019,8,116,39.246907445,30-39,700,7,16,21,37,37,16,21,9,3.2165786266,5184.6985291563,0.0430703806,0.0105105105,0.035384614,0,135,1.6535954685809482E-4,4.2781286E-4,4.3893623E-4,505,0.31052223,5,2,200,2,0.01,-0.275137616
76977981,craddo,10,7595,1778,1790,70,567,61.2346693216,60-69,737,7,10,6,16,16,10,6,11,3.7935798456,1191.6436744963,0.0152841663,0.0166666667,0.053030305,0,135,1.226074619505962E-4,2.768201E-4,2.8401756E-4,353,0.32845744,15,0,200,0,0,-0.275427135
245660950,MeToddScott,10,4476,208,354,6,30,44.69646525,40-49,690,7,4,8,12,12,4,8,10,3.3823648923,616.1472020013,0.0276795332,0.0151515152,0.05357143,0,135,7.153616518905426E-5,1.2582731E-4,1.2909889E-4,99,0.32900432,13,0,200,0,0,-0.27543289
203559806,lucmenard,10,4547,133,93,2,19,29.1787435678,20-29,630,7,10,2,12,12,10,2,10,4.1239333604,492.5132805094,0.0298455405,0.0227272727,0.055555556,0,135,1.0771092169981953E-4,2.768201E-4,2.8401756E-4,267,0.33103448,3,0,200,0,0,-0.275478924
307884494,kitconlib,10,502,175,252,5,0,45.1259426908,40-49,592,5,14,10,24,24,14,10,10,3.3665176757,5585.9378711248,0.0423955873,0.0489130435,0.1904762,0,135,1.534082666060261E-4,3.7748195E-4,3.8729666E-4,505,0.46606335,74,0,200,0,0,-0.27558715
258151703,BarbaraCee,10,582,54,171,1,7,40.4005250232,40-49,559,4,4,5,9,9,4,5,10,3.688338074,296.7822682646,0.0064336896,0,0,0,135,6.207569250191492E-5,1.2582731E-4,1.2909889E-4,283,0.27564102,12,1,200,1,0.005,-0.27564102
1149028724,RoariBC,10,35,57,184,0,0,17.654164154,10-19,152,2,12,18,30,30,12,18,10,3.4331572531,3849.8616707047,0.0461915588,0.0804597701,0.29210526,0,135,1.809962301671608E-4,3.27151E-4,3.3565713E-4,257,0.56782264,4,0,36,0,0,-0.27571738
197672377,chris_p_cream,10,1791,58,128,1,1,35.228356967,30-39,656,6,4,11,15,15,4,11,9,3.1926046323,1327.3730867029,0.0265318602,0.0285714286,0.07272727,0,135,8.011464376184005E-5,1.2582731E-4,1.2909889E-4,99,0.34848484,4,2,200,2,0.01,-0.27575757
161797179,ScottAWolfe,10,5083,1131,2000,43,41,46.1487117284,40-49,678,7,10,21,31,31,10,21,10,3.3807395368,6406.824515752,0.0257115631,0.0290322581,0.06666667,0,135,1.723094959331848E-4,2.768201E-4,2.8401756E-4,257,0.3425876,6,0,200,0,0,-0.27592093
176398351,Wascally7Wabbit,10,15960,310,453,4,223,33.7766159102,30-39,680,8,11,10,21,21,11,10,10,3.3340105648,2621.8622935795,0.0330376351,0.019047619,0.09848485,0,135,2.2082079926862908E-4,3.0198556E-4,3.0983734E-4,505,0.37461695,6,0,200,0,0,-0.2761321
237103462,Mike_EH_52,10,36280,451,261,15,1,39.1752175985,30-39,744,8,11,5,16,16,11,5,10,4.0044697278,2301.8232845682,0.035928677,0.0375,0.06043956,0,135,1.6694457312926847E-4,3.0198556E-4,2.8401756E-4,343,0.33668077,10,0,199,0,0,-0.27624121
22065687,rayformayor,10,4394,173,336,0,723,39.2536896143,30-39,633,6,6,5,11,11,6,5,10,3.6854937017,1010.9974698844,0.0199264125,0.0090909091,0.023809524,0,135,7.265940708632499E-5,1.7615824E-4,1.8073844E-4,505,0.30128205,13,0,200,0,0,-0.277472526
242506891,tuxforpm,10,4532,91,89,4,1,38.2545878799,30-39,722,6,6,0,6,6,6,0,0,0,0,0.0143970115,0.0666666667,0.13333334,0,58,1.1242397491965304E-4,1.7615824E-4,0,99,0.41092438,19,1,200,1,0.005,-0.27759104
244299485,greenmarcel,10,2105,80,58,0,26,27.0760765394,20-29,600,6,8,2,10,10,8,2,10,3.7769199512,126.1115442596,0.0213238378,0.0444444444,0.055555556,0,135,1.0859714721576935E-4,2.2648917E-4,2.32378E-4,99,0.33333334,1,2,200,2,0.01,-0.277777784
497952624,IamACanRadical,10,3203,255,110,8,338,48.1355687341,40-49,703,6,4,0,4,4,4,0,0,0,0,0.0048994127,0,0,0,84,5.6287706175350914E-5,1.2582731E-4,0,99,0.2777778,3,0,199,0,0,-0.2777778
226512656,stop1984,10,41218,596,376,11,678,40.8804956761,40-49,751,9,4,2,6,6,4,2,10,3.9837464445,83.165692948,0.0078112504,0,0,0,135,6.200648957368956E-5,1.2582731E-4,1.2909889E-4,99,0.2777778,1,0,201,0,0,-0.2777778
16561725,Indefatigabl_,10,11869,603,732,22,326,47.897189982,40-49,732,7,16,14,30,30,16,14,10,3.2011377489,5967.5499459608,0.0434394657,0.0068965517,0.041666668,0,135,1.9964414642583745E-4,4.2781286E-4,4.3893623E-4,99,0.31947115,10,0,198,0,0,-0.277804482
49989431,NOtoGMOs,10,13157,2608,1738,173,144,53.9457550356,50-59,722,8,7,8,15,15,7,8,9,3.5245835026,1453.4124616497,0.0231784474,0.0142857143,0.055555556,0,135,1.2014749909226182E-4,2.0132371E-4,2.0655822E-4,267,0.33412698,11,1,203,1,0.0049261084,-0.278571424
273038120,WinnipegFatArse,10,8802,555,948,16,154,,,735,7,25,24,49,49,25,24,10,3.2559934986,12393.6949800547,0.0658778565,0.0097789116,0.022048363,0,135,2.6836163927296367E-4,6.54302E-4,6.7131425E-4,505,0.30103925,13,0,200,0,0,-0.278990887
196340725,ott_pol,10,1744,154,874,4,56,37.9356363145,30-39,611,6,2,6,8,8,2,6,10,3.7773262901,59.9503783341,0.0061084035,0.0892857143,0.16666667,0,135,7.040744979896159E-5,7.549639E-5,7.7459335E-5,505,0.44594595,1,0,200,0,0,-0.27927928
154136730,JDignum,10,11923,261,376,7,7448,43.9207482062,40-49,663,8,11,9,20,20,11,9,9,3.2998780983,1013.0674303063,0.033359153,0.0236842105,0.07692308,0,135,1.4738792377125062E-4,3.0198556E-4,3.0983734E-4,257,0.35639882,9,0,202,0,0,-0.27947574
71358586,MartinGratton,10,200,14,84,0,2,23.3466910443,20-29,388,5,0,4,4,4,0,4,10,3.8460601137,0,0,0.1666666667,0.25,0,769,4.4780486537007367E-5,0,2.5819778E-5,353,0.52964425,11,0,201,0,0,-0.27964425
69856537,caroldunk,10,4994,336,657,8,48,47.5471473206,40-49,639,7,13,23,36,36,13,23,10,3.2218610321,4915.2445665171,0.0286975812,0.0182539683,0.040640395,0,135,1.8181093162787372E-4,3.5231648E-4,3.6147688E-4,99,0.32053378,15,2,200,2,0.01,-0.279893385
15959069,jamesbow,10,10242,860,446,61,10,49.0839117003,40-49,738,7,17,8,25,25,17,8,10,3.6233238521,3901.5857151547,0.0294402438,0.02,0.066176474,0,135,2.5505858412125853E-4,4.5297833E-4,4.3893623E-4,257,0.34724742,14,0,200,0,0,-0.281070946
24598043,CorComm,10,3857,369,300,9,25,57.0323314853,50-59,695,6,21,1,22,22,21,1,11,4.3994311256,455.7084821771,0.0591609817,0.0324675325,0.057142857,0,135,3.728297884161908E-4,5.536402E-4,5.680351E-4,505,0.33877194,72,0,201,0,0,-0.281629083
285734431,ajssinc,10,3594,236,195,11,21,46.2823503514,40-49,639,6,9,4,13,13,9,4,10,3.577001219,1235.2172770169,0.0273812692,0.0320512821,0.054545455,0,135,1.0970616126354192E-4,2.5165462E-4,2.5819778E-4,71,0.33633634,13,1,201,1,0.0049751244,-0.281790885
1290020496,Kool_aid_Kon,10,2,0,39,0,0,10,10-19,1,0,0,2,2,2,0,2,10,4.1888708367,0,0,0,0,0,653,4.6361206780343715E-5,0,2.5819778E-5,99,0.2820513,0,0,5,0,0,-0.2820513
442832919,LeblancMiguel,10,3178,106,380,2,8,45.3729994594,40-49,602,6,5,9,14,14,5,9,9,3.8545306786,1323.2645389488,0.0153514268,0.0604395604,0.18888889,0,135,1.0214439473598057E-4,1.5099278E-4,1.5491867E-4,267,0.4709653,15,0,200,0,0,-0.28207641
22333382,schizoidman,10,7361,535,1573,22,7,44.2907146613,40-49,704,7,8,14,22,22,8,14,10,3.501828525,5874.4953853658,0.013387635,0.0151515152,0.0375,0,135,1.798347431400627E-4,2.2648917E-4,2.32378E-4,505,0.3196186,4,0,200,0,0,-0.2821186
26181736,cherylfougere,10,4826,562,837,22,2,44.032320737,40-49,684,6,18,16,34,34,18,16,10,3.455099553,5840.3984322507,0.0577281323,0.0436720143,0.14229248,0,135,4.529015816426106E-4,4.781438E-4,4.905758E-4,505,0.4256579,5,1,200,1,0.005,-0.28336542
123279913,WrightRyan,10,13689,275,146,16,28,54.4010103912,50-59,743,8,12,3,15,15,12,3,10,3.60585128,615.6956701851,0.0414342305,0.0428571429,0.121212125,0,135,1.381850445723015E-4,3.27151E-4,3.3565713E-4,505,0.40469417,31,2,204,2,0.0098039216,-0.283482045
112755355,_capps,10,3595,193,242,6,204,45.1329220047,40-49,654,6,8,5,13,13,8,5,10,3.7029662739,922.453362391,0.0165914799,0.0448717949,0.16666667,0,135,1.5913156934990153E-4,2.2648917E-4,2.32378E-4,283,0.45021337,53,5,200,5,0.025,-0.2835467
22574670,hot_sushi,10,836,146,512,1,6,,,552,4,4,10,14,14,4,10,10,3.6229175132,377.6974265234,0.0090967918,0.0494505495,0.11363637,0,135,7.884941462973292E-5,1.2582731E-4,1.2909889E-4,257,0.3974359,0,0,200,0,0,-0.28379953
408257459,jackshope,10,1006,62,162,1,47,34.9603038601,30-39,577,5,3,6,9,9,3,6,10,3.6936204795,99.3130194166,0.0048141977,0,0,0,135,6.543884068344153E-5,1.00661855E-4,1.0327911E-4,71,0.28421053,21,0,200,0,0,-0.28421053
26286207,clsmale,10,1622,106,221,2,88,43.8326645981,40-49,616,5,3,5,8,8,3,5,10,3.8098334011,5458.2243466537,0.0084312802,0.0178571429,0.1,0,135,7.18864816301732E-5,1.00661855E-4,1.0327911E-4,267,0.3846154,1,0,200,0,0,-0.2846154
395810455,Falconlady7,10,26702,1126,941,23,1651,37.8869336027,30-39,761,9,11,4,15,15,11,4,9,3.3571718813,632.6036111894,0.0447160019,0.0333333333,0.10909091,0,135,9.551716007610714E-5,3.0198556E-4,3.0983734E-4,99,0.39384615,4,0,200,0,0,-0.28475524
265041082,TrickNig,10,2570,184,589,0,8,35.2004409242,30-39,616,6,4,15,19,19,4,15,10,3.372612759,858.4346543269,0.007627881,0.0263157895,0.057142857,0,135,7.434207464814314E-5,1.2582731E-4,1.2909889E-4,99,0.34191918,2,1,199,1,0.0050251256,-0.284776323
461633566,PeteSchwarzhoff,10,999,109,285,2,2,40.1441446644,40-49,585,5,5,18,23,23,5,18,10,3.2726533929,1064.6665486438,0.023962572,0.0276679842,0.062091503,0,135,1.3369827538470017E-4,1.5099278E-4,1.5491867E-4,505,0.3468813,9,0,200,0,0,-0.284789797
553315935,AlCatJDP,10,946,71,188,1,205,25.4392699796,20-29,563,5,3,6,9,9,3,6,10,3.6172287688,5132.7106752978,0.0040113515,0.0138888889,0.033333335,0,135,7.878010208324064E-5,1.00661855E-4,1.0327911E-4,505,0.31868133,4,0,200,0,0,-0.285347995
15397836,ShireenJ,10,27556,1023,771,65,449,47.8074838703,40-49,750,8,10,9,19,19,10,9,10,3.6513612353,1912.9574091005,0.0188635011,0.0029239766,0.004761905,0,135,2.512491303328712E-4,2.768201E-4,2.8401756E-4,257,0.29016912,19,0,202,0,0,-0.285407215
30865662,sjkelly1,10,355,119,192,1,5,30.8774847106,30-39,571,5,5,3,8,8,5,3,10,4.1491263714,214.8172889218,0.017621635,0.0714285714,0.2,0,135,1.327948809047974E-4,1.5099278E-4,1.5491867E-4,353,0.48544973,1,0,199,0,0,-0.28544973
939998528,TheNationalEric,10,769,60,105,1,31,40.4534412693,40-49,610,5,6,2,8,8,6,2,11,4.1665989435,260.2778046127,0.0183136421,0.0357142857,0.071428575,0,135,8.966697589055204E-5,1.7615824E-4,1.8073844E-4,505,0.35714287,23,0,200,0,0,-0.285714295
608835608,joan_rollins,10,798,45,107,1,59,42.5966783529,40-49,573,6,3,3,6,6,3,3,9,3.7436001625,898.8941473572,0.0135644421,0,0,0,135,5.9991269830456964E-5,1.00661855E-4,1.0327911E-4,283,0.2857143,4,0,203,0,0,-0.2857143
93663580,APOVMentarch,10,23193,1203,1632,74,60,37.8472120185,30-39,766,8,26,25,51,51,26,25,9,3.1767574157,23261.4538944802,0.0624961412,0.0101960784,0.041330647,0,135,3.274639858401494E-4,6.794675E-4,6.97134E-4,99,0.32721713,11,0,200,0,0,-0.285886483
175925311,dougalgodfrey,10,21011,338,765,19,24,43.6526473053,40-49,770,8,3,6,9,9,3,6,10,3.6050386022,636.2441052446,0.0228299989,0.0277777778,0.13333334,0,135,8.333580953540106E-5,1.00661855E-4,1.0327911E-4,353,0.4199134,0,0,200,0,0,-0.28658006
63795844,Shawn_J_Martin,10,1153,77,186,0,42,34.7969206942,30-39,547,5,5,5,10,10,5,5,10,3.6932141406,1127.7271581118,0.0203991893,0.0111111111,0.04761905,0,135,9.132978202808077E-5,1.5099278E-4,1.5491867E-4,267,0.3344086,14,2,200,2,0.01,-0.28678955
192302852,AnnSwayze,10,14,51,287,0,20,19.3747043564,10-19,131,2,3,14,17,17,3,14,10,3.5071109305,767.9015406694,0.0200391346,0.0404411765,0.058333334,0,135,7.631603019112512E-5,1.00661855E-4,1.0327911E-4,99,0.3455767,0,0,15,0,0,-0.287243366
28578004,Sabrina_B2011,10,451,60,199,1,20,29.3216038389,20-29,470,4,4,8,12,12,4,8,10,3.5944737911,1455.3513685107,0.0121913376,0.0151515152,0.035714287,0,135,6.305492711707701E-5,1.2582731E-4,1.2909889E-4,257,0.3229885,4,0,197,0,0,-0.287274213
31226332,Professorsan,10,10921,955,1193,49,5,53.3613772462,50-59,757,8,29,22,51,51,29,22,9,3.0796424218,14158.2413590377,0.0818045224,0.0164705882,0.045519203,0,135,2.3006189777743374E-4,7.549639E-4,7.487736E-4,99,0.33327454,94,2,207,2,0.0096618357,-0.287755337
275038599,AppalledBC,10,7903,264,521,27,17,45.8079534761,40-49,691,7,14,7,21,21,14,7,10,3.4575375863,2590.1019544315,0.0367512101,0.030952381,0.06535948,0,135,1.5307362716086625E-4,3.7748195E-4,3.8729666E-4,99,0.3531321,21,1,200,1,0.005,-0.28777262
13350372,jedgar,10,19174,18473,229,176,43,66.7005979378,60-69,782,7,6,0,6,6,6,0,0,0,0,0.0105734722,0.0333333333,0.06666667,0,86,1.0684920708774411E-4,1.7615824E-4,0,505,0.35454544,4,0,200,0,0,-0.28787877
246823640,1girlonthehill,10,819,144,279,3,4,29.2849033492,20-29,551,5,12,15,27,27,12,15,10,3.6241365299,892.0461894547,0.0351611261,0.0584045584,0.2124183,0,135,1.5705699185047665E-4,3.27151E-4,3.3565713E-4,257,0.50072074,8,3,200,3,0.015,-0.28830244
264267429,JerryPrag,10,5536,146,62,9,2,49.9250468739,40-49,676,7,7,3,10,10,7,3,11,4.168630638,710.0708341371,0.0165630375,0.0333333333,0.06944445,0,135,1.7636013602376953E-4,2.0132371E-4,2.0655822E-4,505,0.3583043,93,0,200,0,0,-0.28885985
1170723684,edtanas65,10,510,17,18,0,0,40.7274038558,40-49,531,4,5,1,6,6,5,1,12,5.3758634701,7.7963557947,0.0173332012,0.0333333333,0.06666667,0,135,5.533129636531451E-5,1.5099278E-4,1.5491867E-4,99,0.35555556,13,0,200,0,0,-0.28888889
180443064,Heading_West,10,6452,194,353,11,113,46.3201295062,40-49,714,7,12,10,22,22,12,10,10,3.5436814303,8209.075909842,0.0150519333,0.0043290043,0.006535948,0,135,1.7050840908691984E-4,3.27151E-4,3.3565713E-4,505,0.296003,8,0,200,0,0,-0.289467052
94352593,GameBreakersCan,10,5238,115,260,1,512,42.8580234936,40-49,577,6,1,7,8,8,1,7,10,3.5867533523,45.7811245933,0.0043347955,0,0,0,135,5.408727822725234E-5,5.0330927E-5,5.1639556E-5,71,0.28947368,9,0,201,0,0,-0.28947368
51099638,James_W_J_Crown,10,652,115,315,1,4,19.5667397122,10-19,482,5,14,17,31,31,14,17,9,3.3193823649,2694.0996841206,0.0496272164,0.047311828,0.20175439,0,135,1.5383428877495617E-4,3.7748195E-4,3.8729666E-4,257,0.4913928,3,5,200,5,0.025,-0.28963841
62139614,JDarwin,10,2225,102,464,2,640,34.1282650481,30-39,536,6,3,6,9,9,3,6,10,3.5355546526,282.1613198053,0.0143372191,0.0555555556,0.083333336,0,135,8.54820800754223E-5,1.00661855E-4,1.0327911E-4,505,0.37310606,4,1,205,1,0.0048780488,-0.289772724
306494846,popoffculture,10,4813,189,350,4,3,47.4233175926,40-49,692,7,16,5,21,21,16,5,10,3.6875253962,1061.560035129,0.0553374876,0.0238095238,0.045751635,0,135,2.370908828012885E-4,4.2781286E-4,4.3893623E-4,505,0.33557424,30,16,200,16,0.08,-0.289822605
240988612,MisturrPants,10,2338,293,669,4,693,42.0698518598,40-49,652,6,14,23,37,37,14,23,9,3.1767574157,6802.7637431582,0.0317898436,0.012012012,0.037549406,0,135,1.1235836114169225E-4,3.7748195E-4,3.8729666E-4,99,0.32769975,0,0,201,0,0,-0.290150344
273758664,LALegault,10,12394,512,583,18,72,40.8500274634,40-49,704,7,17,14,31,31,17,14,10,3.2799674929,13796.5504541684,0.0564933348,0.0107526882,0.04901961,0,135,2.804444082921497E-4,4.5297833E-4,4.64756E-4,257,0.33963963,12,0,200,0,0,-0.29062002
161475722,akaKaiser,10,2219,150,327,1,10,26.7653204274,20-29,602,6,1,4,5,5,1,4,10,3.5461194636,73.8868299055,0.0143493568,0,0,0,135,7.35134068438375E-5,5.0330927E-5,5.1639556E-5,353,0.2908497,8,1,200,1,0.005,-0.2908497
321968555,MahassenF,10,2879,87,350,0,20,20.9988320141,20-29,569,6,3,14,17,17,3,14,10,3.2194229988,2089.0653055813,0.0117675011,0.0257352941,0.06043956,0,135,9.094166423249143E-5,1.00661855E-4,1.0327911E-4,99,0.3514014,4,0,200,0,0,-0.29096184
524791202,Stacey0891,10,240,56,84,0,4,22.5101518236,20-29,462,4,2,2,4,4,2,2,11,3.8862251117,15.1814944543,0.0043671874,0,0,0,135,5.39908881398768E-5,7.549639E-5,7.7459335E-5,71,0.29166666,2,3,200,2,0.01,-0.29166666
37208886,MusingsFrom_TO,10,6274,214,712,5,773,37.4227124524,30-39,643,6,1,2,3,3,1,2,11,4.4705404307,11.8985167396,7.379156635332952E-4,0,0,0,135,5.125094007037459E-5,5.0330927E-5,5.1639556E-5,106,0.29166666,0,0,199,0,0,-0.29166666
122422343,DavidPatersonca,10,4024,160,106,5,26,45.881825754,40-49,720,7,33,5,38,38,33,5,10,3.5814709468,2725.3941793768,0.0891597124,0.0227596017,0.041666668,0,135,2.0304183454784074E-4,8.556257E-4,8.7787246E-4,99,0.33333334,145,0,207,0,0,-0.291666672
574132457,GwynethMPrice,10,2826,85,223,1,350,26.3184609124,20-29,606,6,10,15,25,25,10,15,10,3.2511174319,3002.0019549126,0.0402716273,0.01,0.052380953,0,135,1.2239838316852142E-4,2.768201E-4,2.8401756E-4,257,0.34424603,5,5,200,5,0.025,-0.291865077
193156404,Prospero37,10,20714,172,109,8,41,36.8292573529,30-39,709,8,19,2,21,21,19,2,10,3.6720845185,1071.4704148798,0.0622891362,0.0452380952,0.10233918,0,135,1.2374705550018505E-4,5.0330925E-4,5.1639555E-4,99,0.39423078,20,0,208,0,0,-0.2918916
83304354,JackCanada1,10,4224,794,1963,39,1928,38.0475607603,30-39,571,6,2,6,8,8,2,6,9,3.7541649736,3183.9707447265,0.0039518149,0.0178571429,0.033333335,0,135,6.959903722121656E-5,7.549639E-5,7.7459335E-5,257,0.32523617,1,0,200,0,0,-0.291902835
72884615,timhowl,10,537,181,92,2,1,28.6453769096,20-29,547,4,20,5,25,25,20,5,10,3.7947988623,690.0325006934,0.0521543369,0.0983333333,0.22857143,0,135,3.134650902213542E-4,5.2847475E-4,5.4221536E-4,257,0.520765,13,20,200,19,0.095,-0.29219357
268137967,marktmaclean,10,4606,307,656,11,156,46.1286340638,40-49,678,7,7,8,15,15,7,8,10,3.2344575376,3583.3274562778,0.0338657908,0.0238095238,0.11111111,0,135,7.796953390123073E-5,2.0132371E-4,2.0655822E-4,71,0.40374333,4,0,199,0,0,-0.29263222
107534282,anti_rogue,10,3220,306,258,10,11,46.4085411966,40-49,664,6,22,3,25,25,22,3,9,3.6834620073,2096.3992406116,0.0658419341,0.0216666667,0.041501977,0,135,1.7628261406198777E-4,5.7880563E-4,5.938549E-4,99,0.3342447,25,1,200,1,0.005,-0.292742723
26774435,MtnGoat1,10,5370,348,964,11,1714,42.2839071101,40-49,628,7,6,13,19,19,6,13,10,3.4205607477,4229.6555511404,0.0058778599,0.0087719298,0.032051284,0,135,1.5807006580892389E-4,1.7615824E-4,1.8073844E-4,99,0.32490215,4,2,200,2,0.01,-0.292850866
247528533,H2OWise,10,4167,162,152,8,213,40.8742510096,40-49,651,7,7,4,11,11,7,4,10,3.7553839902,502.1103252647,0.0162959541,0.0090909091,0.035714287,0,135,9.541087140605014E-5,2.0132371E-4,2.0655822E-4,71,0.32936507,12,1,200,1,0.005,-0.293650783
270091796,cwstewart9,10,8582,344,935,12,84,32.5513794101,30-39,670,7,13,21,34,34,13,21,10,3.2312068265,6283.5497483849,0.0403685907,0.0196078431,0.044615384,0,135,1.9264836668265325E-4,3.5231648E-4,3.6147688E-4,99,0.33841333,3,1,199,1,0.0050251256,-0.293797946
32257133,G_McLachlan,10,553,209,420,11,58,43.7784507776,40-49,553,5,7,10,17,17,7,10,10,3.5294595693,2874.7487569379,0.0314248604,0.0882352941,0.21153846,0,135,1.1796661521968705E-4,2.0132371E-4,2.0655822E-4,71,0.5062057,7,7,200,7,0.035,-0.29466724
275793678,Pentoth,10,843,90,252,0,38,22.3480075281,20-29,540,5,0,2,2,2,0,2,10,4.1490658002,0,0,0,0,0,698,6.477136612809232E-5,0,2.5819778E-5,505,0.2948718,2,0,200,0,0,-0.2948718
141702501,kevdsmith,10,1619,282,1022,5,32,52.1956566518,50-59,595,5,7,11,18,18,7,11,10,3.3616416091,1425.853996245,0.0257134852,0.0098039216,0.021978023,0,135,1.4058059271023266E-4,2.0132371E-4,2.0655822E-4,99,0.3169399,13,1,200,1,0.005,-0.294961877
510942432,mrsinisterlefty,10,6168,206,136,9,10,37.937147249,30-39,709,7,22,4,26,26,22,4,10,4.0922389273,1091.1361419388,0.0488483179,0.0307692308,0.05253623,0,135,2.4375390671905128E-4,5.7880563E-4,5.680351E-4,257,0.3475485,52,1,200,1,0.005,-0.29501227
270927838,laumicant,10,419,146,420,2,1,28.1534261228,20-29,486,4,4,4,8,8,4,4,10,3.9158878505,182.0274091807,0.0102931673,0.0357142857,0.2,0,135,7.2840462182993E-5,1.2582731E-4,1.2909889E-4,505,0.49502134,1,0,200,0,0,-0.29502134
221303153,logik36,10,5014,144,297,5,636,36.8386758177,30-39,698,7,3,4,7,7,3,4,10,4.0776107273,480.1081761242,0.0032181575,0.0476190476,0.16666667,0,135,6.98278520700103E-5,1.00661855E-4,1.0327911E-4,505,0.46190476,4,1,201,1,0.0049751244,-0.29523809
178824088,Fitter660,10,736,40,161,2,7,17.3294859927,10-19,309,5,2,4,6,6,2,4,9,3.9097927672,195.9292896346,0.0092591355,0,0,0,135,5.949591905771517E-5,7.549639E-5,7.7459335E-5,257,0.2952381,0,0,199,0,0,-0.2952381
24717531,sandra_harris,10,6058,484,261,9,318,47.7481282427,40-49,701,7,31,20,51,51,31,20,10,3.2950020317,5476.044774393,0.0971580034,0.0345098039,0.0975976,0,135,2.1489715729630128E-4,8.0529484E-4,8.262329E-4,99,0.3929307,47,0,200,0,0,-0.2953331
206340892,rrrwong,10,3871,478,477,28,73,43.740946651,40-49,656,6,7,10,17,17,7,10,10,3.4823242584,3731.8211543853,0.032056052,0.0110294118,0.044444446,0,135,1.7259534298611645E-4,2.0132371E-4,2.0655822E-4,71,0.33990148,7,1,200,1,0.005,-0.295457034
195419614,nickthemack,10,1429,65,158,1,328,28.5589735938,20-29,523,6,10,3,13,13,10,3,11,4.3787078423,2753.8377729669,0.0303457846,0.0320512821,0.06363636,0,135,8.84924610294801E-5,2.768201E-4,2.8401756E-4,99,0.35918003,6,0,202,0,0,-0.29554367
107886768,barb_hill,10,34196,588,906,22,3310,45.4159966092,40-49,768,9,18,15,33,33,18,15,9,3.1702559935,10126.8028792086,0.0526432734,0.0132575758,0.05,0,135,2.525843419178017E-4,4.781438E-4,4.905758E-4,99,0.34561127,51,0,202,0,0,-0.29561127
220778300,cupedoll_500,10,25507,850,880,47,269,40.9639252092,40-49,772,9,28,21,49,49,28,21,9,3.0719219829,13581.0529759598,0.0805495528,0.0085034014,0.03678161,0,135,2.740291865357947E-4,7.297984E-4,7.487736E-4,99,0.33272758,19,3,202,3,0.0148514851,-0.29594597
14819714,seanmhair,10,16145,485,744,37,1736,44.1184011276,40-49,713,7,13,21,34,34,13,21,9,3.2356765542,5822.052500438,0.0231782244,0.0106951872,0.041501977,0,135,3.1178918600227747E-4,3.5231648E-4,3.6147688E-4,99,0.33754578,9,1,204,1,0.0049019608,-0.296043803
446682479,PatDeRocH,10,270,108,443,2,0,42.5215626065,40-49,540,4,6,5,11,11,6,5,10,3.8000812678,375.0068216392,0.0120743475,0.0454545455,0.055555556,0,135,7.780176816857693E-5,1.7615824E-4,1.5491867E-4,505,0.35218704,14,1,201,1,0.0049751244,-0.296631484
43162451,gavanp,10,1633,227,149,9,3,43.47591539,40-49,588,6,4,5,9,9,4,5,11,3.8561560341,1703.2194563198,0.0110682138,0.0555555556,0.11904762,0,135,1.1331583232161412E-4,1.2582731E-4,1.0327911E-4,353,0.41578948,14,0,200,0,0,-0.29674186
178794231,jonnyenviro,10,2996,138,583,0,16,25.2173236751,20-29,577,6,4,4,8,8,4,4,10,3.7614790735,264.8826161944,0.0085540933,0.0178571429,0.033333335,0,135,8.092495415327165E-5,1.2582731E-4,1.2909889E-4,99,0.33076924,0,1,200,1,0.005,-0.297435905
211130293,nlguy65,10,1405,132,679,4,44,33.2394898009,30-39,573,6,5,10,15,15,5,10,9,3.4953271028,1038.3865224406,0.0155539187,0.0285714286,0.09090909,0,135,8.612257345159711E-5,1.5099278E-4,1.5491867E-4,343,0.39058822,3,1,199,1,0.0050251256,-0.29967913
54169562,Blaiserboy,10,12983,2077,1953,5,0,51.4724435885,50-59,734,7,23,22,45,45,23,22,9,2.9691182446,10595.724244633,0.0813898987,0.0090909091,0.04743083,0,135,2.2981908042767204E-4,6.0397113E-4,6.196747E-4,99,0.34723443,171,1,231,1,0.0043290043,-0.2998036
776556378,GregGinYYC,10,320,35,63,3,6,42.4261814202,40-49,546,4,1,2,3,3,1,2,11,4.3165379927,2.6767475776,0.0017243947,0,0,0,135,5.299043332792726E-5,5.0330927E-5,5.1639556E-5,353,0.3,6,0,200,0,0,-0.3
404472305,randy_caine,10,551,61,114,0,9,26.278996385,20-29,528,5,2,3,5,5,2,3,10,3.9589597725,60.7715432613,0.0027810692,0,0,0,135,5.145644062078954E-5,7.549639E-5,7.7459335E-5,257,0.3,4,0,200,0,0,-0.3
15395708,ryanbaldwin,10,10486,569,282,34,63,46.2179295451,40-49,727,7,1,2,3,3,1,2,11,4.2730597318,0.6857098264,0.0014512098,0,0,0,135,5.637974640122858E-5,5.0330927E-5,5.1639556E-5,257,0.3,2,0,200,0,0,-0.3
89812685,ea_p,10,3932,450,643,16,11,60.1258936818,60-69,670,6,16,14,30,30,16,14,10,3.4262494921,3547.1845406823,0.0516186527,0.0264367816,0.08809524,0,135,2.0350773915686713E-4,4.2781286E-4,4.3893623E-4,257,0.3885841,33,6,201,6,0.0298507463,-0.30048886
1186454012,TrueGrit_,10,323,29,130,0,2,45.6031130984,40-49,524,4,8,10,18,18,8,10,10,3.3498577814,3524.3190781916,0.0388401994,0.0555555556,0.12637363,0,135,1.4269264666597666E-4,2.2648917E-4,2.32378E-4,505,0.42728716,44,0,200,0,0,-0.30091353
340965023,liberalanon,10,2519,347,644,15,2,41.9799563868,40-49,698,6,8,12,20,20,8,12,10,3.7127184072,6716.2307051008,0.0088200942,0.0157894737,0.057692308,0,135,1.9831158974054728E-4,2.2648917E-4,2.32378E-4,505,0.358756,1,1,198,1,0.0050505051,-0.301063692
14103001,nofx1337,10,709,203,1075,5,156,23.3728559229,20-29,493,4,1,2,3,3,1,2,10,4.3494514425,4.890432095,0.001705941,0.1666666667,0.16666667,0,135,5.00564022920962E-5,5.0330927E-5,5.1639556E-5,99,0.4679487,1,0,199,0,0,-0.30128203
14483082,ntozubod,10,6716,165,1303,4,8,22.442067303,20-29,485,7,4,12,16,16,4,12,10,3.698902885,609.6609787087,0.0062120055,0.0041666667,0.010989011,0,135,6.932561758136213E-5,1.2582731E-4,1.2909889E-4,505,0.31259426,0,0,200,0,0,-0.301605249
63198527,sandstonelass,10,16644,452,266,22,53,49.1969301801,40-49,755,8,13,5,18,18,13,5,10,3.8431531898,817.220977236,0.036247093,0.0424836601,0.06985294,0,135,1.8790431744774162E-4,3.5231648E-4,3.3565713E-4,257,0.3715278,16,0,203,0,0,-0.30167486
1078538047,katemcinturff,10,428,167,367,6,4,47.280782494,40-49,591,4,12,3,15,15,12,3,10,3.7273466071,2012.4682498101,0.0355857304,0.0571428571,0.13636364,0,135,1.350802489225333E-4,3.27151E-4,3.3565713E-4,257,0.43850806,31,0,200,0,0,-0.30214442
75436573,MoreTo_Discover,10,3990,232,435,3,2616,44.6628136121,40-49,639,6,15,18,33,33,15,18,10,3.1296221048,6316.456211448,0.0481920941,0.009469697,0.028571429,0,135,1.7152065388314138E-4,4.0264742E-4,3.8729666E-4,99,0.33110368,11,0,209,0,0,-0.302532251
297787306,evilscientistca,10,2513,219,381,4,130,46.1910890958,40-49,689,6,15,17,32,32,15,17,10,3.2072328322,15519.5810672372,0.0338858183,0.0100806452,0.06985294,0,135,1.9842707628224524E-4,4.0264742E-4,4.1311645E-4,99,0.37244898,21,1,204,1,0.0049019608,-0.30259604
24696861,grreengirl,10,1062,137,386,2,16,24.8431342937,20-29,534,5,6,6,12,12,6,6,10,3.8061763511,429.9828573968,0.0161153002,0.0681818182,0.09090909,0,135,1.632904051114884E-4,1.7615824E-4,1.8073844E-4,353,0.3935135,2,3,199,3,0.0150753769,-0.30260441
20697134,briannemett,10,7196,443,680,11,1158,49.7823212376,40-49,721,8,16,16,32,32,16,16,9,3.2137342544,7050.4717970384,0.0366383772,0.0100806452,0.036842104,0,135,2.5303865537064894E-4,4.2781286E-4,4.1311645E-4,257,0.3394958,20,0,201,0,0,-0.302653696
515732918,LinneaEldred,10,932,76,135,2,12,41.0571837309,40-49,482,5,1,7,8,8,1,7,11,4.0268183665,21.1698599422,0.0024195653,0.1428571429,0.33333334,0,135,6.145797760111869E-5,5.0330927E-5,5.1639556E-5,353,0.6363636,2,1,200,1,0.005,-0.30303026
275164696,yvonne4tn,10,1390,188,344,1,40,28.178033063,20-29,561,5,25,15,40,40,25,15,10,3.4437220642,5373.1491726424,0.0704637711,0.0269230769,0.059475806,0,135,2.389114180206604E-4,6.54302E-4,6.7131425E-4,99,0.3631288,3,4,200,3,0.015,-0.303652994
22147325,joshstuart,10,5193,1469,1317,87,103,56.1227925772,50-59,686,7,14,20,34,34,14,20,10,3.3616416091,6032.7973574198,0.0452656043,0.0169340463,0.058441557,0,135,3.0742740575675706E-4,3.7748195E-4,3.8729666E-4,257,0.36254463,10,1,200,1,0.005,-0.304103073
15726214,dmac53,10,916,92,508,0,20,27.9990324631,20-29,528,5,0,7,7,7,0,7,10,3.6774979691,0,0,0.0476190476,0.0952381,0,344,5.766097907329967E-5,0,2.5819778E-5,257,0.3994709,3,0,200,0,0,-0.3042328
208467742,PhilSoubliere,10,2170,150,313,1,0,38.4621959902,30-39,553,5,7,10,17,17,7,10,10,3.3518894758,2557.3276820926,0.0281846909,0.0330882353,0.11818182,0,135,1.1494873086043063E-4,2.0132371E-4,2.0655822E-4,283,0.42243186,3,1,200,1,0.005,-0.30425004
224935028,jaglister,10,5764,328,386,6,31,45.2062045167,40-49,704,7,15,17,32,32,15,17,9,3.1487200325,4933.6652952456,0.0511449422,0.0141129032,0.07720588,0,135,1.6551461665067672E-4,4.0264742E-4,4.1311645E-4,99,0.38181818,111,0,200,0,0,-0.3046123
216554278,kosmovinylHAF,10,38,29,35,1,0,24.2740429206,20-29,89,1,3,0,3,3,3,0,0,0,0,0.011014125,0.3333333333,0.5,0,24,1.1397761251963253E-4,1.00661855E-4,0,257,0.8047619,4,0,40,0,0,-0.3047619
629007862,PhDerping,10,609,83,127,2,3,39.9844890442,30-39,502,4,2,2,4,4,2,2,11,4.4278748476,37.1049483318,0.0044333186,0.0833333333,0.16666667,0,135,6.622286499939124E-5,7.549639E-5,7.7459335E-5,99,0.47142857,3,2,200,2,0.01,-0.3047619
121291378,smithlkk,10,4817,97,427,0,448,39.7499681812,30-39,573,7,0,4,4,4,0,4,10,4.0211210398,0,0,0,0,0,338,5.556670175316308E-5,0,2.5819778E-5,257,0.30476192,2,0,197,0,0,-0.30476192
180715429,CritReviews,10,3875,105,478,1,54,41.0437938908,40-49,625,6,0,2,2,2,0,2,11,4.3387489846,0,0,0,0,0,731,5.102484312353722E-5,0,2.5819778E-5,99,0.30514705,3,1,200,1,0.005,-0.30514705
67341240,ValGervais,10,247,64,236,1,2,42.4583258336,40-49,420,4,6,10,16,16,6,10,10,3.4392523364,6354.6092252453,0.0215800744,0.0166666667,0.045454547,0,135,7.252119680406032E-5,1.7615824E-4,1.8073844E-4,505,0.35080644,6,1,200,1,0.005,-0.305351893
198756416,venividitweety,10,9095,588,558,25,170,56.1580971752,50-59,727,7,18,11,29,29,18,11,10,3.2852498984,5113.9612101685,0.0505930744,0.0209359606,0.057312254,0,135,1.9802317708472655E-4,4.781438E-4,4.905758E-4,99,0.3627907,7,0,200,0,0,-0.305478446
359980797,CaregiversTakeA,10,626,130,158,2,1,37.2456996416,30-39,559,5,2,1,3,3,2,1,12,5.1288094271,9.2680757408,0.006198179,0.1666666667,0.16666667,0,135,8.565174439088686E-5,7.549639E-5,7.7459335E-5,99,0.4722222,12,1,199,1,0.0050251256,-0.30555553
192659552,AnnaAnthro,10,17440,632,1282,39,38,42.421023696,40-49,680,8,10,12,22,22,10,12,11,3.7180008127,2176.038183517,0.0226014221,0.0238095238,0.036842104,0,135,2.192631322305013E-4,2.768201E-4,2.8401756E-4,267,0.34395605,6,0,201,0,0,-0.307113946
236130596,HerstoriesCafe,10,1068,217,206,6,9,37.5994797918,30-39,550,5,4,3,7,7,4,3,10,3.8147094677,2762.6294731733,0.0089956742,0,0,0,135,7.763884157219165E-5,1.2582731E-4,1.2909889E-4,267,0.30769232,3,0,200,0,0,-0.30769232
25886969,TwalRa,10,20869,1199,592,28,58,53.6558570012,50-59,780,8,10,8,18,18,10,8,10,3.4282811865,5082.333298173,0.0288123217,0.0163398693,0.07272727,0,135,1.3947542226207078E-4,2.768201E-4,2.8401756E-4,99,0.3805704,21,0,202,0,0,-0.30784313
408867671,BCummings945,10,1136,93,515,1,14,40.3798686347,40-49,571,6,5,9,14,14,5,9,10,3.5087362861,482.6286196354,0.0101360237,0.010989011,0.027777778,0,135,9.916578017497877E-5,1.5099278E-4,1.5491867E-4,99,0.33579236,3,3,201,3,0.0149253731,-0.308014582
5837592,dilip_andrade,10,7160,309,239,9,22,42.0056625437,40-49,642,6,4,2,6,6,4,2,11,3.9756196668,92.041480532,0.0212780496,0.0333333333,0.16666667,0,135,2.577057430978078E-4,1.2582731E-4,1.2909889E-4,505,0.47578347,0,0,200,0,0,-0.3091168
105358446,Heer_preet,10,928,99,199,0,10,21.8368517848,20-29,460,5,2,3,5,5,2,3,11,4.0564811052,30.7152086714,0.0019501815,0,0,0,135,5.60834955445222E-5,7.549639E-5,7.7459335E-5,99,0.30952382,1,0,199,0,0,-0.30952382
458909421,AlanWHKan,10,1925,83,103,0,84,46.5603656521,40-49,597,6,2,1,3,3,2,1,11,4.0837058106,34.0918530696,0.0220008686,0,0,0,135,6.88280313584518E-5,7.549639E-5,7.7459335E-5,505,0.30952382,4,0,199,0,0,-0.30952382
50664739,HayeseLaw,10,1614,482,182,46,1,48.0144429422,40-49,614,5,2,2,4,4,2,2,11,4.7911418123,46.9977601326,0.0030301773,0,0,0,135,5.918083738294546E-5,7.549639E-5,7.7459335E-5,267,0.30952382,0,0,200,0,0,-0.30952382
50383438,jenniibeez,10,5570,180,267,6,2,37.9304650968,30-39,664,6,2,2,4,4,2,2,12,5.3884599756,2516.4613030113,5.872381939068803E-4,0,0,0,135,9.682408375759195E-5,7.549639E-5,7.7459335E-5,106,0.30952382,7,0,200,0,0,-0.30952382
415063003,BestShaneEver,10,927,62,213,1,70,27.5038645539,20-29,550,5,2,6,8,8,2,6,10,3.4449410809,116.411846054,0.0074901961,0,0,0,135,9.302787635525933E-5,7.549639E-5,7.7459335E-5,99,0.31034482,0,0,200,0,0,-0.31034482
375634441,CamF57,10,1135,140,203,4,17,40.2180120302,40-49,652,5,29,12,41,41,29,12,10,3.4258431532,3086.4532171917,0.0941978647,0.0317073171,0.06031746,0,135,1.970061974384901E-4,7.549639E-4,7.745933E-4,99,0.37132224,7,4,200,4,0.02,-0.31100478
22420494,incomplete2009,10,4914,369,864,10,14,41.9668616765,40-49,670,6,13,22,35,35,13,22,10,3.1288094271,7586.2808130051,0.0487557281,0.0075630252,0.019762846,0,135,2.0196745218583107E-4,3.5231648E-4,3.6147688E-4,99,0.33138818,11,1,199,1,0.0050251256,-0.311625334
2183601,dougsymington,10,22795,2239,1121,130,4180,52.7847785255,50-59,729,7,21,15,36,36,21,15,9,3.164973588,9630.3725339545,0.0745564765,0.0158730159,0.08095238,0,135,2.3720990906718996E-4,5.536402E-4,5.680351E-4,99,0.39366516,8,1,199,1,0.0050251256,-0.31271278
26648462,DouglasCS,10,1736,261,287,9,19,45.7563891025,40-49,641,5,9,8,17,17,9,8,10,3.5046728972,1832.3900522748,0.0215660804,0.0330882353,0.12727273,0,135,1.3829485180951148E-4,2.5165462E-4,2.5819778E-4,505,0.4403409,4,1,200,1,0.005,-0.31306817
632160153,BruceMHicks,10,2273,325,109,12,0,43.2065436997,40-49,661,6,18,2,20,20,18,2,11,4.0544494108,2974.0795313621,0.0395851541,0.0315789474,0.049707603,0,135,4.187904541834068E-4,4.781438E-4,4.905758E-4,267,0.36278194,2,2,200,2,0.01,-0.313074337
28009693,jonbeharry,10,1207,86,444,2,3,28.6743698479,20-29,560,5,1,5,6,6,1,5,10,3.9041040228,10.7338251648,0.002691935,0.1,0.1,0,135,5.7430226933839495E-5,5.0330927E-5,5.1639556E-5,257,0.41330644,1,1,200,1,0.005,-0.31330644
754052142,DickieAnginson,10,1199,70,210,1,42,44.0117232782,40-49,609,5,8,9,17,17,8,9,10,3.5729378302,1120.5361762036,0.0236195869,0.0036764706,0.010989011,0,135,1.235331346359902E-4,2.2648917E-4,2.32378E-4,343,0.32469454,44,64,199,63,0.3165829146,-0.313705529
217606140,youwishme2,10,17024,7207,7692,52,34,38.0138719412,30-39,735,9,4,11,15,15,4,11,10,3.3104429094,1864.4173449665,0.0200903529,0.0238095238,0.08181818,0,135,1.4013858989242624E-4,1.2582731E-4,1.2909889E-4,99,0.39565217,2,1,201,1,0.0049751244,-0.31383399
19295032,Duplisea,10,522,64,125,2,249,34.7618883096,30-39,446,5,3,3,6,6,3,3,10,3.9886225112,2496.2351244595,0.0052059861,0,0,0,135,1.69416536910323E-4,1.00661855E-4,1.0327911E-4,99,0.31385282,1,0,199,0,0,-0.31385282
284619179,VeryEthnic,10,1268,979,965,28,140,45.6514653692,40-49,657,5,14,11,25,25,14,11,10,3.4571312475,6665.6946916519,0.0205656696,0.0016666667,0.00952381,0,135,1.949023495466761E-4,3.7748195E-4,3.8729666E-4,99,0.32354996,9,0,200,0,0,-0.31402615
74888261,LiamTheSaint,10,2570,168,196,4,44,44.1026870425,40-49,671,6,6,1,7,7,6,1,10,3.9845591223,400.0890835138,0.0215930935,0.0714285714,0.16666667,0,135,1.2542404099251275E-4,1.7615824E-4,1.8073844E-4,505,0.48084676,12,0,200,0,0,-0.31418009
55699327,sarahrimmington,10,2798,409,601,11,32,58.1989073323,50-59,591,6,7,8,15,15,7,8,9,3.5574969525,380.1114057912,0.0278804784,0.0523809524,0.17777778,0,135,1.0999580770158353E-4,2.0132371E-4,2.0655822E-4,257,0.49231306,0,1,200,1,0.005,-0.31453528
48415266,partialtomusic,10,3610,191,295,14,8,45.3205216193,40-49,684,6,3,8,11,11,3,8,10,3.6741162129,3113.5076602427,0.0191027235,0.0636363636,0.08181818,0,135,1.0530694177432656E-4,1.00661855E-4,1.0327911E-4,257,0.39658925,9,0,200,0,0,-0.31477107
268672435,clepsydre,10,11282,1396,1364,27,26,46.5115480318,40-49,757,8,12,11,23,23,12,11,10,3.2527427875,9492.7209116479,0.0360677093,0.0039525692,0.030303031,0,135,1.6703762563288608E-4,3.27151E-4,3.3565713E-4,99,0.34761906,9,0,202,0,0,-0.317316029
321663386,GenestJourdain,10,273,299,49,28,0,40.8126502781,40-49,560,4,19,2,21,21,19,2,11,4.7566030069,254.2111001715,0.0759551043,0.1142857143,0.21052632,0,135,3.497563548510024E-4,5.0330925E-4,5.1639555E-4,257,0.5279035,36,6,200,5,0.025,-0.31737718
16535205,d5e5,10,5627,607,486,18,267,47.3386984525,40-49,689,7,6,4,10,10,6,4,10,3.5404307192,945.3384228516,0.0127182048,0.0222222222,0.1,0,135,9.876356151601167E-5,1.7615824E-4,1.8073844E-4,99,0.41774893,9,0,199,0,0,-0.31774893
270891869,PeterHfx,10,408,129,443,2,62,34.7867923098,30-39,554,4,8,17,25,25,8,17,9,3.3518894758,2825.4678153789,0.0158703822,0.0033333333,0.013071896,0,135,1.424258959441589E-4,2.2648917E-4,2.32378E-4,343,0.33102587,5,0,200,0,0,-0.317953974
543394473,crvallotton,10,2904,503,1411,8,45,50.0344166709,50-59,693,7,9,21,30,30,9,21,9,3.064607883,2032.4329450582,0.028671437,0.0402298851,0.10869565,0,135,1.096394051007155E-4,2.5165462E-4,2.5819778E-4,99,0.42685476,37,0,201,0,0,-0.31815911
556880621,lilypad3516,10,969,64,120,0,25,21.9820844514,20-29,474,5,3,2,5,5,3,2,11,4.1544087769,2505.5188621695,0.01199298,0,0,0,135,5.697448445625195E-5,1.00661855E-4,1.0327911E-4,99,0.3181818,1,1,200,1,0.005,-0.3181818
132950661,gmohamed111,10,8232,690,2002,14,1438,50.8553196886,50-59,663,7,4,4,8,8,4,4,11,3.7350670459,744.3811467866,0.0060656889,0.0178571429,0.017857144,0,135,1.1298622789189193E-4,1.2582731E-4,1.2909889E-4,71,0.33686867,9,0,201,0,0,-0.319011526
105485447,habbe79,10,8362,197,507,0,58,27.55799542,20-29,622,7,2,6,8,8,2,6,10,3.4067452255,80.7786491475,0.0064289283,0,0,0,135,5.3770945474676254E-5,7.549639E-5,7.7459335E-5,99,0.31904763,1,0,197,0,0,-0.31904763
284853577,TrashManPalmer,10,2323,120,250,0,3,31.6939985633,30-39,619,6,2,1,3,3,2,1,11,4.5790329134,23.6101922375,0.0032501227,0,0,0,135,7.299331319693118E-5,7.549639E-5,7.7459335E-5,283,0.31944445,12,0,199,0,0,-0.31944445
413246876,aj_smartideas,10,977,55,158,0,122,23.7930447666,20-29,463,5,2,2,4,4,2,2,10,3.6525802519,29.4892525073,0.0138149471,0.0833333333,0.16666667,0,135,5.7614815710187724E-5,7.549639E-5,7.7459335E-5,99,0.4862069,2,0,200,0,0,-0.31954023
273704144,creepsx5,10,957,45,175,0,124,23.3182249361,20-29,567,5,4,4,8,8,4,4,11,3.964242178,192.4090564859,0.0088761977,0.0178571429,0.04761905,0,135,6.29359716881019E-5,1.2582731E-4,1.2909889E-4,99,0.36742425,2,2,194,1,0.0051546392,-0.3198052
305360589,EvanPivnick,10,1284,123,348,3,7,35.9035963827,30-39,561,5,3,8,11,11,3,8,10,3.7931735067,175.8285630813,0.0087120413,0.0272727273,0.06944445,0,135,6.978868145867561E-5,1.00661855E-4,1.0327911E-4,505,0.389372,5,1,200,1,0.005,-0.31992755
65535533,carolaik,10,26077,1367,461,128,29,50.4208732006,50-59,793,9,24,7,31,31,24,7,10,3.4924827306,5223.7202021932,0.0540283289,0.0107526882,0.03,0,135,3.0538121976572306E-4,6.291366E-4,6.196747E-4,99,0.3499658,54,0,200,0,0,-0.3199658
471078603,msthorpe43,10,1832,128,240,3,0,42.0013362876,40-49,677,6,13,11,24,24,13,11,10,3.3027224705,1766.0837565224,0.0337744387,0.0217391304,0.046783626,0,135,1.789318650002756E-4,3.5231648E-4,3.6147688E-4,99,0.3675304,14,0,200,0,0,-0.320746774
237052663,holtom2000,10,2721,76,147,1,16,31.814438919,30-39,624,6,4,4,8,8,4,4,11,3.8390898009,13.2105111079,0.0440842805,0.0714285714,0.25,0,135,6.13473964023051E-5,1.2582731E-4,1.2909889E-4,353,0.5714286,3,0,200,0,0,-0.3214286
19801933,ThomasMilne,10,5990,246,475,2,84,40.449948495,40-49,687,7,14,20,34,34,14,20,9,3.1458756603,9055.1497282305,0.0312729899,0.0035650624,0.015789473,0,135,1.6451499284833284E-4,3.7748195E-4,3.8729666E-4,99,0.33744133,8,0,200,0,0,-0.321651857
23797435,RobTrewartha,10,2342,293,581,2,4,40.5595436853,40-49,652,5,11,7,18,18,11,7,11,3.7622917513,893.9122065631,0.0246608263,0.0490196078,0.12878788,0,135,1.7249061075812048E-4,3.0198556E-4,3.0983734E-4,505,0.45058823,4,0,200,0,0,-0.32180035
748080476,GTAAdvocate,10,1655,646,1531,11,4,43.5970331479,40-49,626,5,4,4,8,8,4,4,10,3.6261682243,136.0284731037,0.010111695,0,0,0,135,5.215564841798475E-5,1.2582731E-4,1.2909889E-4,99,0.32222223,0,0,200,0,0,-0.32222223
34159192,elquintron,10,675,106,500,2,16,24.6677820996,20-29,418,5,4,7,11,11,4,7,8,3.3421373425,3272.687992978,0.0164448413,0.0090909091,0.023809524,0,135,6.350124097460201E-5,1.2582731E-4,1.2909889E-4,99,0.3467023,0,1,200,1,0.005,-0.322892776
458789217,Desiree_McGraw,10,665,232,423,3,1,41.0658387833,40-49,552,5,10,4,14,14,10,4,10,3.8464039009,805.05408107,0.0281200947,0.0384615385,0.07692308,0,135,2.1238761055046652E-4,2.768201E-4,2.8401756E-4,505,0.4,9,0,200,0,0,-0.32307692
201407405,deepak_minhas,10,30491,587,1031,12,278,37.5295402415,30-39,712,8,2,3,5,5,2,3,10,4.3409183259,327.9593048971,0.0029026252,0,0,0,135,1.638577685420462E-4,7.549639E-5,7.7459335E-5,303,0.32352942,2,0,201,0,0,-0.32352942
27655434,BrandanRowe,10,140,38,114,1,11,31.0804061221,30-39,317,3,3,2,5,5,3,2,10,3.9329540837,80.99963003,0.0045287513,0.1,0.16666667,0,135,1.1042914116322211E-4,1.00661855E-4,1.0327911E-4,505,0.4903226,3,27,158,24,0.1518987342,-0.32365593
16969753,Pheartattack,10,1426,67,109,1,201,38.1410408078,30-39,571,6,7,13,20,20,7,13,10,3.3246647704,1878.2040778944,0.0194402903,0.0105263158,0.051282052,0,135,1.1017499358989281E-4,2.0132371E-4,2.0655822E-4,99,0.375,15,6,197,6,0.0304568528,-0.323717948
426888980,drknssonthedge,10,2351,138,498,0,103,27.3231906522,20-29,468,5,3,5,8,8,3,5,10,3.6672084518,76.3594293362,0.0064295541,0.0357142857,0.15,0,135,6.93140021903941E-5,1.00661855E-4,1.0327911E-4,99,0.4738562,0,0,200,0,0,-0.3238562
138313976,FatherTheo,10,5792,1450,1739,26,5,41.4739455203,40-49,661,6,6,6,12,12,6,6,10,3.3140999594,2548.3391509135,0.029966055,0,0,0,135,8.08464395744577E-5,1.7615824E-4,1.8073844E-4,99,0.32417583,3,0,200,0,0,-0.32417583
546424088,FredFord46,10,4629,157,484,0,6,40.3975460622,40-49,624,7,5,7,12,12,5,7,9,3.3494514425,3673.7122540586,0.033296716,0.0075757576,0.013888889,0,135,8.942555729368718E-5,1.5099278E-4,1.5491867E-4,257,0.3380682,6,0,200,0,0,-0.324179311
111715724,lawrencecanuck,10,8466,126,1081,0,4,25.2693703672,20-29,526,7,2,8,10,10,2,8,10,3.4311255587,811.8375868943,0.0210679364,0.0111111111,0.027777778,0,135,6.955298766005884E-5,7.549639E-5,7.7459335E-5,353,0.35227272,1,0,201,0,0,-0.324494942
21547158,ThePhotowagon,10,3618,269,253,12,292,47.0240082548,40-49,652,6,10,10,20,20,10,10,10,3.3892726534,7407.5074323425,0.0154772975,0.0105263158,0.025641026,0,135,1.3604539303221767E-4,2.768201E-4,2.5819778E-4,99,0.35064012,43,1,200,1,0.005,-0.324999094
266965724,katiesmith1963,10,1130,59,331,0,25,28.4822890935,20-29,569,5,5,13,18,18,5,13,10,3.2986590817,1320.409736573,0.0130502216,0.0130718954,0.032051284,0,135,9.82309882288948E-5,1.5099278E-4,1.5491867E-4,257,0.35739437,2,0,200,0,0,-0.325343086
43171180,qualitypunk,10,7460,447,686,13,3608,49.2051714251,40-49,671,6,6,7,13,13,6,7,11,3.7537586347,1239.2225999428,0.0313783027,0.0192307692,0.055555556,0,135,9.465411764937306E-5,1.7615824E-4,1.8073844E-4,505,0.3815331,7,0,200,0,0,-0.325977544
169236244,drstoopid,10,361,12,65,0,3,33.3091590163,30-39,510,4,2,2,4,4,2,2,9,3.7582283625,210.2562075334,0.0086030145,0,0,0,135,5.493152628345022E-5,7.549639E-5,7.7459335E-5,99,0.32692307,2,3,200,3,0.015,-0.32692307
16751415,jamesphieffer,10,4424,720,1962,29,14,40.7467971585,40-49,625,6,4,10,14,14,4,10,11,3.6326696465,257.0395561216,0.0426666461,0.0494505495,0.15555556,0,135,1.113717645208416E-4,1.2582731E-4,1.2909889E-4,353,0.48255813,2,1,199,1,0.0050251256,-0.32700257
511399796,hellis6,10,488,153,492,1,7,31.2870794745,30-39,521,5,1,4,5,5,1,4,10,3.6968711906,310.1718505085,0.0060798098,0,0,0,135,6.848566268734194E-5,5.0330927E-5,5.1639556E-5,99,0.3276923,3,0,200,0,0,-0.3276923
811236194,stratdemwatch,10,891,107,205,2,12,41.5447118389,40-49,562,5,12,13,25,25,12,13,9,3.2238927265,2350.662777154,0.0583331749,0.0183333333,0.12179487,0,135,1.358510712589843E-4,3.27151E-4,3.3565713E-4,99,0.4500675,42,0,200,0,0,-0.32827263
260827091,harmanfreelance,10,2533,318,992,9,5,43.2269788362,40-49,613,6,3,5,8,8,3,5,10,3.7013409183,243.354849256,0.0068737655,0.0535714286,0.0952381,0,135,9.063458085316095E-5,1.00661855E-4,1.0327911E-4,505,0.42411423,2,10,200,10,0.05,-0.32887613
103594620,uswjamie,10,607,119,170,2,25,24.688176552,20-29,493,4,3,5,8,8,3,5,10,3.7253149126,45.8948775973,0.0127811327,0.0357142857,0.2,0,135,8.581151004047627E-5,1.00661855E-4,1.0327911E-4,257,0.5294118,0,1,200,1,0.005,-0.3294118
26776939,mertonwa,10,320,64,133,0,3,31.2463578336,30-39,402,3,4,4,8,8,4,4,10,3.6424217798,61.7085494431,0.0132591271,0.1071428571,0.35,0,135,6.657012343162654E-5,1.2582731E-4,1.2909889E-4,257,0.67948717,6,0,200,0,0,-0.32948717
403804341,TaushaMichaud,10,120,72,403,1,0,16.5109541068,10-19,222,3,2,3,5,5,2,3,11,4.2291751321,5.9424977234,0.0038908658,0.05,0.16666667,0,135,6.182947233851763E-5,7.549639E-5,7.7459335E-5,353,0.49761903,0,0,120,0,0,-0.33095236
15608428,Paulbhaven,10,15294,518,954,14,328,42.4011318794,40-49,686,7,2,3,5,5,2,3,11,3.7533522958,103.3097783028,0.0067062632,0,0,0,135,6.452466160695358E-5,7.549639E-5,7.7459335E-5,99,0.3323077,15,1,200,1,0.005,-0.3323077
131175096,billmilliken,10,10420,1000,1383,34,411,50.4124748804,50-59,720,8,11,6,17,17,11,6,10,3.9366111337,6734.5003800775,0.0289815964,0.0110294118,0.01923077,0,135,2.743478963408278E-4,3.0198556E-4,3.0983734E-4,267,0.352459,27,1,203,1,0.0049261084,-0.33322823
436158344,SA_Ball,10,106,29,179,0,0,13.2918299397,10-19,254,3,1,2,3,3,1,2,13,6.0730816078,2462,2.6808524730492474E-4,0,0,0,139,1.0912479197109002E-4,5.0330927E-5,5.1639556E-5,353,0.33333334,0,0,115,0,0,-0.33333334
403372214,RiverdaleBoy,10,1349,45,59,0,31,41.4975465617,40-49,615,5,2,0,2,2,2,0,0,0,0,0.0037727647,0,0,0,102,5.064847961160404E-5,7.549639E-5,0,257,0.33333334,15,0,200,0,0,-0.33333334
199354634,MovingBoxesca,10,15234,810,642,23,174,55.7186678304,50-59,734,7,1,2,3,3,1,2,11,4.5286468915,1.619559587,0.0013592462,0,0,0,135,5.4864947830897145E-5,5.0330927E-5,5.1639556E-5,353,0.33333334,31,0,212,0,0,-0.33333334
73197511,Jess_TFA,10,6885,375,167,22,1,50.4276277638,50-59,696,6,5,0,5,5,5,0,0,0,0,0.0180362836,0,0,0,63,9.259801539157543E-5,1.5099278E-4,0,257,0.33333334,10,0,200,0,0,-0.33333334
33269047,Scruffy19,10,2462,104,148,0,20,38.3835014219,30-39,594,6,4,4,8,8,4,4,9,3.4465664364,327.0191010934,0.0179466801,0,0,0,135,7.280026634806564E-5,1.2582731E-4,1.2909889E-4,99,0.33333334,14,0,200,0,0,-0.33333334
392538004,sonjay_1,10,7211,50,106,1,824,21.9739002993,20-29,507,7,2,1,3,3,2,1,10,4.1109305161,37.7572861085,0.002958814,0,0,0,135,4.785463542257256E-5,7.549639E-5,7.7459335E-5,99,0.33333334,6,0,193,0,0,-0.33333334
126571380,AlexDolbec,10,8531,363,1997,5,177,45.6835498134,40-49,655,6,0,2,2,2,0,2,11,4.2282696994,0,0,0,0,0,498,4.790338355077782E-5,0,2.5819778E-5,106,0.33333334,3,0,202,0,0,-0.33333334
292123879,BennViel,10,1664,90,264,1,153,37.2976588313,30-39,600,5,1,1,2,2,1,1,11,4.2608695652,13.9456453725,0.0013482027,0,0,0,135,5.2236307912470375E-5,5.0330927E-5,5.1639556E-5,267,0.33333334,0,0,200,0,0,-0.33333334
109299182,jhodson79,10,5710,627,665,22,55,49.6258731547,40-49,677,7,4,5,9,9,4,5,11,3.8573750508,3484.611404945,0.0108640401,0,0,0,135,7.006067560199914E-5,1.2582731E-4,1.2909889E-4,99,0.33333334,10,0,201,0,0,-0.33333334
18491472,DWKeoughan,10,11839,500,1245,19,7,60.0582781201,60-69,738,8,2,2,4,4,2,2,11,4.3177570093,64.0706931192,0.0027243198,0,0,0,135,5.378369787780637E-5,7.549639E-5,7.7459335E-5,71,0.33333334,0,0,201,0,0,-0.33333334
185815993,coatesdavid,10,324,372,278,27,0,36.0436878212,30-39,540,2,1,1,2,2,1,1,11,4.3787078423,477.4542364513,0.0037124709,0,0,0,135,5.000827508008745E-5,5.0330927E-5,5.1639556E-5,303,0.33333334,0,0,200,0,0,-0.33333334
40536415,Lancecote,10,3786,82,231,0,54,41.1473287414,40-49,646,6,2,0,2,2,2,0,0,0,0,0.0066107913,0,0,0,98,5.009564877268508E-5,7.549639E-5,0,99,0.33333334,7,0,200,0,0,-0.33333334
423891063,melissajanedube,10,667,151,252,1,148,31.4264376452,30-39,527,4,2,2,4,4,2,2,12,5.483949614,504.6445163951,8.209969750881968E-4,0,0,0,135,1.288312954122692E-4,7.549639E-5,7.7459335E-5,343,0.33333334,1,0,200,0,0,-0.33333334
1098266563,Bigcitylib2,10,825,123,119,8,3,54.1543316828,50-59,638,5,14,2,16,16,14,2,10,3.6485168631,4226.9047043173,0.0239336887,0.0166666667,0.027472528,0,135,2.2278715667091526E-4,3.7748195E-4,3.0983734E-4,99,0.3609831,68,0,200,0,0,-0.333510572
152625640,MayRaap1,10,4478,204,260,1,365,36.8639586224,30-39,671,7,9,11,20,20,9,11,10,3.1893539212,3456.9426419876,0.0334034635,0.0105263158,0.060606062,0,135,1.1089505128775855E-4,2.5165462E-4,2.5819778E-4,99,0.39423078,4,0,201,0,0,-0.333624718
57103588,henryca3,10,1977,505,487,15,57,43.7287879986,40-49,638,6,16,11,27,27,16,11,10,3.4059325477,3406.9370615647,0.0479587172,0.0256410256,0.08169935,0,135,2.610742379121372E-4,4.2781286E-4,4.3893623E-4,257,0.41591752,8,1,200,1,0.005,-0.33421817
335439371,KeepItReaL57,10,632,44,174,0,11,13.684257086,10-19,532,5,1,2,3,3,1,2,11,4.4002438033,17.0380013768,0.0028365851,0,0,0,135,4.8380909205958136E-5,5.0330927E-5,5.1639556E-5,99,0.3345588,0,0,200,0,0,-0.3345588
247478131,heron09,10,4407,60,179,1,244,35.2310246004,30-39,524,7,6,8,14,14,6,8,9,3.4741974807,725.0475252979,0.0208159435,0.0164835165,0.03787879,0,135,1.1512679192545255E-4,1.7615824E-4,1.8073844E-4,257,0.37283653,9,4,222,4,0.018018018,-0.33495774
44708852,TVVH,10,8955,256,370,9,326,45.387287025,40-49,683,7,11,9,20,20,11,9,10,3.2629012597,3470.5207672435,0.0500121469,0.0078947368,0.025641026,0,135,1.8901333327608685E-4,3.0198556E-4,3.0983734E-4,267,0.3612858,19,0,201,0,0,-0.335644774
315943388,arsenic101,10,7309,738,915,9,216,40.4352860756,40-49,674,6,17,18,35,35,17,18,9,3.1942299878,9231.2913682325,0.0354827715,0.0109243697,0.062091503,0,135,2.047524611552031E-4,4.5297833E-4,4.64756E-4,267,0.39801803,6,3,200,3,0.015,-0.335926527
56556297,VirtualFellow,10,5479,663,376,27,746,56.0892151996,50-59,685,7,15,7,22,22,15,7,10,3.7537586347,1749.3982489659,0.0447204532,0.0194805195,0.071428575,0,135,2.1978755522840892E-4,4.0264742E-4,4.1311645E-4,505,0.40750527,14,3,201,3,0.0149253731,-0.336076695
272141036,dbmeaford,10,2090,60,109,1,2,38.9195069725,30-39,655,5,7,3,10,10,7,3,10,4.0459162942,2850.7494004493,0.0109238411,0,0,0,135,1.0460889358171571E-4,2.0132371E-4,1.8073844E-4,99,0.33613446,15,1,200,1,0.005,-0.33613446
20594175,mdrohan,10,681,396,118,24,1,47.0850040843,40-49,615,3,5,2,7,7,5,2,11,4.2657456319,75.4064029197,0.013710153,0.0476190476,0.15,0,135,2.589677749226389E-4,1.5099278E-4,1.5491867E-4,257,0.486166,15,0,200,0,0,-0.336166
215501705,Matthew_Barlow,10,45051,966,765,43,43,50.6182049199,50-59,806,9,29,27,56,56,29,27,9,3.0479479886,14052.750663388,0.0724704062,0.0055194805,0.03325123,0,135,2.598383624879752E-4,7.549639E-4,7.745933E-4,99,0.37078652,92,0,201,0,0,-0.33753529
280047851,ykvmc,10,1046,67,298,1,3,25.9219558315,20-29,552,5,0,7,7,7,0,7,10,3.6226645004,0,0,0.0714285714,0.11904762,0,806,7.917997050063998E-5,0,2.5819778E-5,257,0.45705783,2,1,200,1,0.005,-0.33801021
16636799,hfxgirl,10,11889,635,335,33,70,47.3786457316,40-49,740,7,5,0,5,5,5,0,0,0,0,0.0217143112,0,0,0,60,6.0592880266960905E-5,1.5099278E-4,0,343,0.3392857,1,0,200,0,0,-0.3392857
553601544,Logigron,10,71,28,276,0,112,13.2590185118,10-19,68,3,2,4,6,6,2,4,10,3.8504672897,15.1580023646,0.0038012204,0.0333333333,0.16666667,0,135,5.883369805967391E-5,7.549639E-5,7.7459335E-5,505,0.5061538,0,0,89,0,0,-0.33948713
737364186,DontDoDinosaurs,10,660,106,325,2,283,37.7780670596,30-39,511,4,4,6,10,10,4,6,10,3.8098334011,265.3098496779,0.0068794762,0.0444444444,0.08928572,0,135,6.195904747580434E-5,1.2582731E-4,1.2909889E-4,353,0.42894736,9,0,200,0,0,-0.33966164
235783992,_ilpo_,10,17680,1269,1970,60,1022,41.1608069241,40-49,743,8,11,10,21,21,11,10,9,3.4888256806,7117.210406695,0.0257470142,0.0095238095,0.032967035,0,135,1.924543823075427E-4,3.0198556E-4,3.0983734E-4,505,0.3734007,20,0,204,0,0,-0.340433665
490776451,bmichniak,10,596,159,464,1,10,27.4637022632,20-29,514,4,6,8,14,14,6,8,10,3.3628606258,2481.5855200098,0.0270755888,0.010989011,0.041666668,0,135,9.4312442759446E-5,1.7615824E-4,1.8073844E-4,99,0.38283208,1,0,200,0,0,-0.341165412
1138077696,MightyGreen1,10,1055,152,310,0,227,44.3009304955,40-49,567,6,8,16,24,24,8,16,9,3.1068671272,2200.4835582138,0.0221797293,0.0344202899,0.125,0,135,9.127706055233843E-5,2.2648917E-4,2.32378E-4,99,0.466457,38,0,203,0,0,-0.341457
149852919,offroadartist,10,335,116,506,2,5,21.2591849544,20-29,448,4,3,13,16,16,3,13,10,3.4733848029,656.6117224826,0.0080900369,0.0083333333,0.025641026,0,135,7.595997128293864E-5,1.00661855E-4,1.0327911E-4,505,0.36742756,0,0,200,0,0,-0.341786534
1126806397,Queen8Bees,10,400,12,14,0,40,43.2110086046,40-49,592,5,8,8,16,16,8,8,10,3.3396993092,534.6857967888,0.0282257065,0.0166666667,0.08888889,0,135,7.122427108158914E-5,2.2648917E-4,2.32378E-4,99,0.43083003,55,0,205,0,0,-0.34194114
53698190,_drewski,10,42096,1021,1130,83,96,49.5750289982,40-49,770,9,19,14,33,33,19,14,10,3.4733848029,11112.0494464721,0.0410803516,0.0123106061,0.04112554,0,135,4.8289504593602956E-4,5.0330925E-4,5.1639555E-4,505,0.38309312,26,1,202,1,0.004950495,-0.34196758
415126004,Rolfe_,10,1818,84,430,0,0,29.652809524,20-29,596,6,1,3,4,4,1,3,11,4.6330759854,13.8295981852,0.0012678971,0,0,0,135,7.512028672496914E-5,5.0330927E-5,5.1639556E-5,71,0.342246,6,2,199,2,0.0100502513,-0.342246
239489739,SirLoinn,10,15592,103,90,4,7737,37.2378453381,30-39,701,8,5,0,5,5,5,0,0,0,0,0.0147673003,0,0,0,34,8.951657890471662E-5,1.5099278E-4,0,505,0.34285715,26,0,250,0,0,-0.34285715
443804372,mrwclarkson,10,9927,843,1065,11,39,47.6491971227,40-49,716,7,7,7,14,14,7,7,10,3.2950020317,1585.4598173421,0.0397769464,0.010989011,0.071428575,0,135,9.87893496886271E-5,2.0132371E-4,2.0655822E-4,99,0.41443852,8,0,202,0,0,-0.343009945
956281,ingridrkonopka,10,3494,159,394,7,87,42.7503642181,40-49,685,6,5,8,13,13,5,8,10,3.5127996749,1437.7609445146,0.0241599693,0.0448717949,0.125,0,135,1.0071960218379318E-4,1.5099278E-4,1.5491867E-4,505,0.4688172,12,2,200,2,0.01,-0.3438172
55649216,EatThatQuestion,10,992,304,168,13,77,28.1127224491,20-29,525,5,4,3,7,7,4,3,9,3.6761479074,324.3128647211,0.0201135227,0.0238095238,0.16666667,0,135,6.364598128099607E-5,1.2582731E-4,1.2909889E-4,99,0.51111114,0,0,200,0,0,-0.34444447
140186605,Canada_1867,10,117,106,219,4,0,22.175018001,20-29,495,1,8,10,18,18,8,10,10,3.3222267371,5274.7078025639,0.0224018492,0.0032679739,0.011111111,0,135,1.2829841814826699E-4,2.2648917E-4,2.32378E-4,99,0.35560054,0,2,117,2,0.0170940171,-0.344489429
21767372,FriendlyLawyer,10,3802,222,325,14,4,41.6038512321,40-49,627,6,9,9,18,18,9,9,10,3.5071109305,3573.7005962299,0.0312911562,0.0294117647,0.11363637,0,135,1.3499390764531516E-4,2.5165462E-4,2.5819778E-4,505,0.45816463,11,0,200,0,0,-0.34452826
487981280,notacons,10,645,13,111,0,16,24.6420193741,20-29,367,4,1,5,6,6,1,5,10,3.5371800081,80.8890349979,0.0034694602,0.0666666667,0.1,0,135,6.012078339232711E-5,5.0330927E-5,5.1639556E-5,283,0.44474155,6,0,199,0,0,-0.34474155
287655600,Juscored,10,1430,124,752,1,44,23.0257298973,20-29,405,6,3,9,12,12,3,9,10,3.3624542869,574.9801741699,0.0137584906,0.0151515152,0.027777778,0,135,6.863740573376276E-5,1.00661855E-4,1.0327911E-4,505,0.37264672,1,3,200,3,0.015,-0.344868942
31159339,Stephistan,10,157,78,381,0,21,20.8904748848,20-29,323,2,4,4,8,8,4,4,10,3.734660707,364.4676924324,0.0117597914,0.0178571429,0.033333335,0,135,9.003882069306592E-5,1.2582731E-4,1.2909889E-4,505,0.37849462,1,0,157,0,0,-0.345161285
39234426,gsmardli,10,108,28,96,0,94,40.2981785025,40-49,482,4,3,3,6,6,3,3,10,4.0255993499,144.9916121507,0.0034711372,0,0,0,135,5.929256147316878E-5,1.00661855E-4,1.0327911E-4,283,0.34545454,9,1,200,1,0.005,-0.34545454
57568642,WayneFougere,10,3043,156,523,4,4,41.168474751,40-49,665,6,1,6,7,7,1,6,10,3.7245022349,69.3784977912,0.0020539171,0.0476190476,0.1,0,135,7.570624297740347E-5,5.0330927E-5,5.1639556E-5,71,0.44551283,2,0,200,0,0,-0.34551283
214613340,KathrynB_FSJ,10,14072,428,434,37,89,38.5396269115,30-39,739,8,4,4,8,8,4,4,10,4.1763510768,1005.5375345955,0.0034326377,0.0357142857,0.1,0,135,1.1177538630648499E-4,1.2582731E-4,1.2909889E-4,99,0.44871795,8,0,200,0,0,-0.34871795
19957201,Killandra,10,14944,3034,3351,90,556,42.0639541236,40-49,683,6,7,7,14,14,7,7,10,3.7188134905,3068.0496788585,0.0138822276,0,0,0,135,1.7142191788401012E-4,2.0132371E-4,2.0655822E-4,505,0.35177046,7,8,200,8,0.04,-0.35177046
269643383,nicpwall,10,990,134,521,1,9,34.4094453909,30-39,520,5,4,7,11,11,4,7,10,3.5505891914,608.4310345981,0.0094565609,0.0272727273,0.055555556,0,135,8.118925530441491E-5,1.2582731E-4,1.2909889E-4,505,0.40808415,2,3,200,3,0.015,-0.352528594
391553226,EricClevinger,10,220,18,53,0,4,31.7184712923,30-39,414,4,2,2,4,4,2,2,10,3.5347419748,227.2449647707,0.0123048289,0,0,0,135,5.320870374534159E-5,7.549639E-5,7.7459335E-5,353,0.3525641,2,0,199,0,0,-0.3525641
274074495,teampalerider,10,3978,81,109,1,1,31.0699598428,30-39,611,6,5,3,8,8,5,3,10,3.580658269,437.2483001706,0.0169936443,0.0178571429,0.1,0,135,7.427751272000233E-5,1.5099278E-4,1.5491867E-4,257,0.4526316,3,7,200,7,0.035,-0.3526316
805996554,gsdenton,10,412,105,286,2,112,37.6998596942,30-39,522,3,3,10,13,13,3,10,10,3.6692401463,570.8133632366,0.0059249281,0.0512820513,0.14444445,0,135,7.918023409005826E-5,1.00661855E-4,1.0327911E-4,257,0.4985755,3,0,200,0,0,-0.35413105
218987872,canonkevy,10,7030,373,1247,8,351,46.2879698851,40-49,688,7,4,7,11,11,4,7,9,3.7387240959,360.7626935162,0.0076882755,0.0181818182,0.071428575,0,135,1.269850265958822E-4,1.2582731E-4,1.2909889E-4,343,0.4260204,19,0,200,0,0,-0.354591825
275078381,TOprogressive,10,1972,243,611,8,15,36.3652794285,30-39,624,6,5,11,16,16,5,11,10,3.5383990248,3507.8449747276,0.012596427,0.0041666667,0.007575758,0,135,9.389801037388594E-5,1.5099278E-4,1.5491867E-4,505,0.36237144,2,1,199,1,0.0050251256,-0.354795682
254714696,MediatedJustice,10,1635,196,433,17,3,42.3330194385,40-49,617,6,5,5,10,10,5,5,11,3.885412434,1069.0686572206,0.0090647718,0.0111111111,0.013888889,0,135,1.3420290831651612E-4,1.5099278E-4,1.5491867E-4,257,0.36879432,6,0,200,0,0,-0.354905431
564037933,DArcy_McGee_,10,1328,61,112,3,12,35.306674972,30-39,467,5,3,2,5,5,3,2,11,4.0361641609,72.7888908748,0.0030773234,0,0,0,135,1.2167914491872716E-4,1.00661855E-4,1.0327911E-4,343,0.35632184,1,2,200,2,0.01,-0.35632184
545144439,sarah_jordison,10,400,78,208,0,75,37.9824574936,30-39,467,4,5,4,9,9,5,4,10,3.8805363673,557.3796870912,0.013120282,0.0277777778,0.06666667,0,135,8.364588436004088E-5,1.5099278E-4,1.5491867E-4,257,0.42333335,14,1,200,1,0.005,-0.35666668
20059077,postshaggy,10,15133,338,486,19,4,43.9132799375,40-49,711,7,2,2,4,4,2,2,11,4.5188947582,2616.7518806394,0.0011141862,0,0,0,135,1.2070653595976372E-4,7.549639E-5,7.7459335E-5,505,0.35714287,3,0,200,0,0,-0.35714287
194490269,arcticyaks,10,2642,24,47,0,119,34.5852066472,30-39,513,5,0,2,2,2,0,2,10,3.9285134037,0,0,0,0,0,510,5.3867110428161445E-5,0,2.5819778E-5,283,0.35714287,7,2,200,2,0.01,-0.35714287
89018343,ygjb,10,938,360,410,20,7,,,610,5,0,2,2,2,0,2,10,4.5808285946,0,0,0,0,0,537,5.067037150417671E-5,0,2.5819778E-5,71,0.35714287,3,0,200,0,0,-0.35714287
239993455,taylornoakes,10,5180,270,373,10,9,46.8901991964,40-49,675,6,5,1,6,6,5,1,11,4.6017878911,87.1989800503,0.0120952305,0.0333333333,0.06666667,0,135,8.330404343847313E-5,1.5099278E-4,1.5491867E-4,267,0.4239766,8,3,204,3,0.0147058824,-0.35730993
501454405,metacanada,10,67,32,61,1,6,33.2922720092,30-39,411,3,3,3,6,6,3,3,10,4.0418529053,611.6708482494,0.0169985996,0,0,0,135,6.426827331856196E-5,1.00661855E-4,1.0327911E-4,267,0.35897437,3,1,90,1,0.0111111111,-0.35897437
305850379,DonnaChevrier,10,750,73,219,0,29,21.9491528975,20-29,462,5,0,2,2,2,0,2,10,3.6380991064,0,0,0,0,0,660,5.745755126109798E-5,0,2.5819778E-5,505,0.35897437,0,0,200,0,0,-0.35897437
17025223,debrah6,10,6280,5205,5205,85,2,41.205730339,40-49,644,6,6,5,11,11,6,5,10,3.7846403901,2156.8004715689,0.0131384862,0,0,0,135,1.1148220074918025E-4,1.7615824E-4,1.8073844E-4,257,0.36050725,0,0,200,0,0,-0.36050725
16751014,daroco,10,684,164,1149,0,4,19.7132662009,10-19,613,5,3,8,11,11,3,8,10,3.5713124746,267.7155020598,0.0350816226,0.0454545455,0.11111111,0,135,6.172432956940052E-5,1.00661855E-4,1.0327911E-4,353,0.47206095,1,1,200,1,0.005,-0.36094984
17180475,JyotiM,10,1099,267,1754,2,54,38.6435299008,30-39,473,5,2,10,12,12,2,10,10,3.4067452255,611.1552969277,0.0131820594,0,0,0,135,6.0229371679750144E-5,7.549639E-5,7.7459335E-5,505,0.36363637,1,0,200,0,0,-0.36363637
609603108,RobPaulX,10,3346,87,296,0,954,43.743790845,40-49,649,7,1,5,6,6,1,5,10,3.9613978058,41.7431885944,0.0011606992,0,0,0,135,6.406013151587261E-5,5.0330927E-5,5.1639556E-5,99,0.36413044,12,0,201,0,0,-0.36413044
1230330985,StephaneGroulx,10,15,11,102,0,0,53.3676645039,50-59,63,1,2,3,5,5,2,3,10,3.6432344575,135.4837310648,0.0071942146,0.05,0.083333336,0,135,6.109817274677499E-5,7.549639E-5,7.7459335E-5,99,0.44761905,0,1,22,1,0.0454545455,-0.364285714
51822882,hep0010,10,1198,2056,1985,54,11,45.6346255725,40-49,578,5,5,10,15,15,5,10,9,3.3518894758,5932.3082868592,0.0153234762,0.0142857143,0.06666667,0,135,1.2710112978702313E-4,1.5099278E-4,1.5491867E-4,99,0.43109244,0,0,201,0,0,-0.36442577
608395920,teesock,10,2314,120,332,1,438,38.4738638908,30-39,600,6,5,5,10,10,5,5,10,3.7098740349,696.6025160826,0.0145087425,0.0111111111,0.05,0,135,9.853651028600077E-5,1.5099278E-4,1.5491867E-4,267,0.41502464,4,0,198,0,0,-0.36502464
126325261,the_problematic,10,10077,287,268,13,21,42.6768527797,40-49,711,7,7,5,12,12,7,5,10,3.5193010971,900.2427476325,0.0142661732,0.0075757576,0.017857144,0,135,1.0318003279310136E-4,2.0132371E-4,2.0655822E-4,257,0.38333333,4,0,200,0,0,-0.365476186
53060913,DaschkoCo,10,1176,66,221,0,105,32.3143979725,30-39,589,5,4,7,11,11,4,7,10,3.6574563186,383.0975877383,0.0057879154,0,0,0,135,7.554373493003814E-5,1.2582731E-4,1.2909889E-4,505,0.36578947,9,0,198,0,0,-0.36578947
293488070,jannovision,10,2448,164,519,3,493,41.3721179483,40-49,594,5,3,6,9,9,3,6,10,3.4465664364,295.130224584,0.0080194116,0.0138888889,0.033333335,0,135,8.619640283732377E-5,1.00661855E-4,1.0327911E-4,257,0.39953542,19,0,200,0,0,-0.366202085
264451340,onahunttoday,10,52185,695,807,19,59506,54.5290110285,50-59,725,9,2,0,2,2,2,0,0,0,0,0.0099987263,0,0,0,118,5.649169254741309E-5,7.549639E-5,0,303,0.36666667,4,0,201,0,0,-0.36666667
283292134,tuesdaymudds,10,1502,44,81,0,8,31.1832926036,30-39,454,6,1,1,2,2,1,1,10,4.2551808208,9.4887123769,0.00201833,0,0,0,135,5.1441156510850135E-5,5.0330927E-5,5.1639556E-5,505,0.36666667,0,0,201,0,0,-0.36666667
243346390,garrattguy,10,1186,42,125,0,4,34.8511336283,30-39,542,6,2,2,4,4,2,2,10,3.8151158066,5.4755763734,0.0074341267,0.0833333333,0.16666667,0,135,5.451580419495961E-5,7.549639E-5,7.7459335E-5,505,0.53571427,3,2,200,2,0.01,-0.3690476
372189219,garthworld,10,4677,406,1139,0,3791,40.8374591442,40-49,607,7,5,12,17,17,5,12,10,3.2998780983,732.0827540768,0.0122557542,0.0183823529,0.053030305,0,135,7.933287748687403E-5,1.5099278E-4,1.5491867E-4,99,0.4227451,1,0,201,0,0,-0.369714795
17956672,csteffensen,10,687,48,301,2,795,24.6359149545,20-29,530,4,4,7,11,11,4,7,10,3.512393336,273.843969288,0.0159261844,0.0272727273,0.071428575,0,135,7.717523667521975E-5,1.2582731E-4,1.2909889E-4,257,0.4412581,0,3,200,3,0.015,-0.369829525
113387174,abtthecause,10,5561,1519,1972,62,1,59.4322491057,50-59,674,7,6,9,15,15,6,9,10,3.4437220642,1871.7840369324,0.0182872054,0.0095238095,0.033333335,0,135,1.2315710091380033E-4,1.7615824E-4,1.8073844E-4,99,0.40367347,8,1,199,1,0.0050251256,-0.370340135
16832788,Koschany,10,741,429,132,24,1,43.1134987719,40-49,581,5,4,1,5,5,4,1,1,1,5.8003568499,0.012281315,0.1,0.16666667,0,10,3.0605254274966364E-4,1.2582731E-4,1.2909889E-4,343,0.5375,8,0,200,0,0,-0.37083333
283199001,SharperPM,10,589,111,96,2,2,24.2875433599,20-29,586,4,6,1,7,7,6,1,12,4.8216172288,63.3206147594,0.0129247476,0.0238095238,0.023809524,0,135,8.86342602769261E-5,1.7615824E-4,1.8073844E-4,505,0.3952381,2,0,200,0,0,-0.371428576
51184630,mlinto,10,1126,118,545,2,2,29.6439130504,20-29,512,5,2,8,10,10,2,8,10,3.3120682649,259.5855768961,0.0096873102,0.0111111111,0.035714287,0,135,7.37906159301162E-5,7.549639E-5,7.7459335E-5,99,0.40789473,5,0,200,0,0,-0.372180443
189619402,EugeneHaslam,10,4955,1090,324,50,5,45.870062076,40-49,691,7,7,1,8,8,7,1,12,5.4709467696,144.3324562315,0.017853548,0,0,0,135,1.7938486755095134E-4,2.0132371E-4,2.0655822E-4,343,0.37237236,7,0,200,0,0,-0.37237236
259606419,StigNasty,10,7274,103,191,1,50,41.0891969493,40-49,684,6,8,2,10,10,8,2,10,3.9666802113,264.6411859007,0.0278184506,0.0111111111,0.027777778,0,135,1.0469996195878626E-4,2.2648917E-4,2.32378E-4,99,0.4002463,8,1,200,1,0.005,-0.372468522
312379410,MattMcLean1919,10,435,107,278,1,0,23.7752248204,20-29,557,4,7,5,12,12,7,5,10,3.8980089395,5134.1543611392,0.0171835298,0.0303030303,0.125,0,135,1.3339886756987514E-4,2.0132371E-4,2.0655822E-4,257,0.4981884,1,0,200,0,0,-0.3731884
217254311,cathylenair,10,238,27,88,2,92,23.2097914173,20-29,404,3,0,2,2,2,0,2,11,4.5926076361,0,0,0,0,0,536,4.839308717829337E-5,0,2.5819778E-5,505,0.375,3,0,200,0,0,-0.375
19568866,SheikYurbouti,10,40512,324,279,39,1,46.4424353748,40-49,785,8,2,1,3,3,2,1,10,4.79926859,2451.3239247312,9.66555637913817E-4,0,0,0,135,6.373106688304122E-5,7.549639E-5,7.7459335E-5,99,0.375,9,21,202,21,0.103960396,-0.375
71611873,sez_i,10,2589,131,233,6,200,41.2013728651,40-49,533,6,8,5,13,13,8,5,9,3.5473384803,983.1386813529,0.0267028062,0.0064102564,0.035714287,0,135,1.1176377141559852E-4,2.2648917E-4,2.32378E-4,99,0.41101056,12,3,200,3,0.015,-0.375296273
273792908,martantomkat,10,2860,129,488,3,45,44.0219360843,40-49,654,6,3,7,10,10,3,7,10,3.7110930516,113.9853621469,0.0276535598,0.0222222222,0.041666668,0,135,1.282506178674232E-4,1.00661855E-4,1.0327911E-4,353,0.4176065,1,2,200,2,0.01,-0.375939832
196218449,tprcrdr,10,7857,274,610,4,34,43.7578431757,40-49,700,7,6,7,13,13,6,7,9,3.3140999594,568.8617620446,0.0394667368,0.0256410256,0.10714286,0,135,7.449682956695953E-5,1.7615824E-4,1.8073844E-4,99,0.48333332,8,0,200,0,0,-0.37619046
14258863,Justance,10,5253,184,214,0,870,40.4826655961,40-49,644,6,4,1,5,5,4,1,10,4.1036164161,60.002898479,0.0127107212,0,0,0,135,6.535885245709097E-5,1.2582731E-4,1.2909889E-4,505,0.37619048,5,0,201,0,0,-0.37619048
493730203,Big_Guy_Ty,10,4153,119,43,2,4,33.321038964,30-39,713,6,10,0,10,10,10,0,0,0,0,0.0310329243,0.0111111111,0.022222223,0,96,1.1839425773380502E-4,2.768201E-4,0,99,0.39900428,5,0,200,0,0,-0.376782057
85999942,pmc85,10,3718,223,642,1,259,35.5737991693,30-39,643,6,0,6,6,6,0,6,9,3.6238830219,0,0,0,0,0,283,7.229382047225548E-5,0,2.5819778E-5,257,0.37815127,0,0,200,0,0,-0.37815127
1095333092,JordanNReid,10,5,24,181,0,0,16.6229289464,10-19,60,2,3,12,15,15,3,12,10,3.681023974,364.1609621464,0.0103148276,0.0714285714,0.20454545,0,135,1.2952568906481624E-4,1.00661855E-4,1.0327911E-4,257,0.582748,1,0,5,0,0,-0.37820255
272573393,BevJD24,10,2146,61,60,4,7,19.4858508114,10-19,518,6,3,2,5,5,3,2,11,4.1735067046,16.2318823711,0.0123522239,0.05,0.083333336,0,135,6.399183557329512E-5,1.00661855E-4,1.0327911E-4,505,0.46153846,1,1,200,1,0.005,-0.378205124
565131608,Cromsdottir,10,1511,197,652,4,469,35.0206132725,30-39,498,5,2,5,7,7,2,5,10,3.781389679,53.9659725676,0.0042253358,0.0238095238,0.05,0,135,6.415477109569071E-5,7.549639E-5,7.7459335E-5,99,0.42894736,2,0,199,0,0,-0.37894736
158532249,atomiccentre,10,2041,267,442,8,52,44.2536453516,40-49,610,6,3,4,7,7,3,4,10,3.6940268184,120.6399357331,0.0111799643,0,0,0,135,9.316731375909023E-5,1.00661855E-4,1.0327911E-4,99,0.38,10,0,199,0,0,-0.38
140899011,ShorterNet,10,591,41,109,0,0,34.58851713,30-39,480,4,5,10,15,15,5,10,10,3.4063388866,758.1463884136,0.0139801265,0.0142857143,0.045454547,0,135,1.0610740272601857E-4,1.5099278E-4,1.5491867E-4,99,0.42635885,12,6,200,6,0.03,-0.380904303
1164511201,EgmontNDP,10,98,27,47,3,0,30.2775148756,30-39,199,3,4,2,6,6,4,2,11,4.2876879317,212.5065276435,0.0153874084,0,0,0,135,5.723407492594904E-5,1.2582731E-4,1.2909889E-4,257,0.38181818,5,1,127,1,0.0078740157,-0.38181818
52435593,scott451,10,8995,274,394,3,1073,43.5017813709,40-49,676,7,18,12,30,30,18,12,8,3.2665583096,7933.4641108927,0.0454214745,0.0091954023,0.02631579,0,135,2.0379535728006087E-4,4.781438E-4,4.905758E-4,99,0.4082397,27,1,200,1,0.005,-0.38192391
188983641,KatieBrist,10,27660,232,1067,6,525,34.6196007346,30-39,729,8,4,3,7,7,4,3,11,3.8634701341,256.5970945467,0.0066228139,0.0476190476,0.06666667,0,135,1.1042616265785733E-4,1.2582731E-4,1.2909889E-4,505,0.44915825,7,3,203,3,0.0147783251,-0.38249158
165286708,catscortex,10,17937,454,304,17,121,44.6856436362,40-49,761,8,10,8,18,18,10,8,10,3.354733848,2700.0307399511,0.0273901289,0.0065359477,0.022222223,0,135,3.0209904437571454E-4,2.768201E-4,2.8401756E-4,505,0.40483093,6,0,200,0,0,-0.382608707
246393685,TYoungWrite,10,2428,271,661,4,12,35.3625471236,30-39,575,5,1,3,4,4,1,3,10,3.7533522958,34.4602706239,0.0013211781,0,0,0,135,9.968728998802316E-5,5.0330927E-5,5.1639556E-5,505,0.3839406,2,0,200,0,0,-0.3839406
239032386,M2thaCo,10,3137,57,261,0,291,22.7605800607,20-29,398,5,0,2,2,2,0,2,10,3.9740048741,0,0,0,0,0,807,5.034065667458013E-5,0,2.5819778E-5,505,0.3846154,0,1,200,1,0.005,-0.3846154
21448068,hannahbethbell,10,12238,1106,896,42,1432,57.4530014265,50-59,762,8,3,0,3,3,3,0,0,0,0,0.0078167678,0,0,0,87,8.144128313810582E-5,1.00661855E-4,0,267,0.3859649,3,1,200,1,0.005,-0.3859649
279644970,MgS_2011,10,272,22,82,0,1,22.3683243166,20-29,455,3,3,5,8,8,3,5,10,3.7261275904,5007.0476964902,0.0046652207,0,0,0,135,8.635806547356087E-5,1.00661855E-4,1.0327911E-4,99,0.38615385,9,1,200,1,0.005,-0.38615385
23633041,bevincate,10,3599,276,450,2,17,49.9940532371,40-49,630,6,8,8,16,16,8,8,10,3.5639983746,1509.2265362245,0.0224615735,0.0166666667,0.06666667,0,135,1.376244583385802E-4,2.2648917E-4,2.32378E-4,257,0.45296168,11,1,200,1,0.005,-0.38629501
16730316,KendallAdelaide,10,701,114,270,0,0,25.1985094191,20-29,564,4,7,8,15,15,7,8,10,3.6176351077,6635.4260992859,0.0166578272,0,0,0,135,1.367503329459474E-4,2.0132371E-4,2.0655822E-4,505,0.38648948,5,0,200,0,0,-0.38648948
14884259,masonsherry,10,1414,395,543,34,16,48.6815728096,40-49,639,5,7,5,12,12,7,5,10,3.8764729785,1698.1708939645,0.0192753875,0.0075757576,0.027777778,0,135,7.813340437685252E-5,2.0132371E-4,2.0655822E-4,257,0.41579315,25,0,200,0,0,-0.388015372
517159398,Crimethought,10,4,21,0,0,15,31.1984222593,30-39,535,5,3,0,3,3,3,0,0,0,0,0.010172726,0,0,0,25,6.329772751199695E-5,1.00661855E-4,0,99,0.3888889,8,0,3,0,0,-0.3888889
316910129,hashonomy_gus,10,213287,2483,0,139,0,48.0280261767,40-49,793,10,4,0,4,4,4,0,0,0,0,0.0065605144,0,0,0,33,7.15361602070769E-5,1.2582731E-4,0,71,0.3888889,8,0,201,0,0,-0.3888889
919226346,OttawapiskatBot,10,73,2,21,0,0,13.9481264984,10-19,22,3,2,5,7,7,2,5,10,3.752539618,213.3797954674,0.0036237917,0,0,0,135,5.65966892173306E-5,7.549639E-5,7.7459335E-5,99,0.3888889,0,0,77,0,0,-0.3888889
5748362,Senturion,10,10214,631,775,31,197,54.0183461108,50-59,748,7,3,1,4,4,3,1,11,5.0008126778,15.3911843377,0.010097543,0,0,0,135,6.538418947001583E-5,1.00661855E-4,1.0327911E-4,353,0.3888889,1,0,200,0,0,-0.3888889
244534330,Wayne_Comeau,10,493,44,340,1,51,38.4864896305,30-39,535,5,2,5,7,7,2,5,10,3.7350670459,242.1137429107,0.003666949,0,0,0,135,7.657954322487489E-5,7.549639E-5,7.7459335E-5,343,0.38916257,5,2,200,2,0.01,-0.38916257
233303806,aquiottawa,10,2147,31,109,0,17,29.1376394847,20-29,458,5,1,4,5,5,1,4,10,3.6932141406,33.6928004154,0.0028166567,0,0,0,135,6.457456782847143E-5,5.0330927E-5,5.1639556E-5,71,0.39181286,5,0,200,0,0,-0.39181286
27525925,judithjoy,10,885,205,627,1,54,31.6613265581,30-39,539,5,0,3,3,3,0,3,11,4.2944760357,0,0,0,0,0,430,4.4780486537007367E-5,0,2.5819778E-5,257,0.39285713,1,0,200,0,0,-0.39285713
20387713,maybo__oker,10,3801,95,379,4,13,41.9100343035,40-49,619,6,2,4,6,6,2,4,10,3.9528646892,246.9305582985,0.0079779958,0,0,0,135,5.773468369101087E-5,7.549639E-5,7.7459335E-5,99,0.39384615,4,0,200,0,0,-0.39384615
267924719,s_a_t_i_n_k_a,10,2062,106,156,0,3,22.6134329678,20-29,606,6,0,3,3,3,0,3,10,4.2108042242,0,0,0,0,0,172,6.437825303121288E-5,0,2.5819778E-5,99,0.395,3,0,200,0,0,-0.395
81871292,davidmossey,10,1633,300,1999,4,11,28.9736952873,20-29,524,6,0,4,4,4,0,4,10,3.9987814785,0,0,0,0,0,650,4.4780486537007367E-5,0,2.5819778E-5,343,0.4,3,0,200,0,0,-0.4
15443546,RickZaleski,10,7036,1012,1511,21,0,35.9108625769,30-39,570,5,2,1,3,3,2,1,1,1,28.0097695391,0.0053678235,0,0,0,89,5.6615237402784754E-5,7.549639E-5,7.7459335E-5,71,0.4,0,0,200,0,0,-0.4
148752523,moviereviewsbyd,10,4491,73,74,4,172,40.4144609914,40-49,617,7,1,2,3,3,1,2,11,4.236489232,8.881105317,0.0015106073,0,0,0,135,6.254493076115392E-5,5.0330927E-5,5.1639556E-5,257,0.4,6,4,200,3,0.015,-0.4
433690691,dashriprock87,10,888,59,111,0,6,25.3780120253,20-29,606,5,3,1,4,4,3,1,11,4.2202356766,21.3284736499,0.0069778623,0,0,0,135,5.075713307697882E-5,1.00661855E-4,1.0327911E-4,257,0.4,2,0,200,0,0,-0.4
19492704,Andrew_MTL,10,3439,100,140,2,7,41.1112590993,40-49,654,6,1,1,2,2,1,1,12,5.0524177164,4.3182702213,8.269485399798066E-4,0,0,0,135,4.6713925543511025E-5,5.0330927E-5,5.1639556E-5,267,0.4,2,0,199,0,0,-0.4
26245743,LVRoberts,10,35629,1070,1977,47,368,40.4642618114,40-49,749,9,6,8,14,14,6,8,10,3.7610727347,2807.2386866826,0.019182888,0.0164835165,0.036363635,0,135,1.2111632654371709E-4,1.7615824E-4,1.8073844E-4,257,0.43636364,1,0,201,0,0,-0.400000005
41013703,LyndaDW,10,3552,645,1989,22,76,39.016525727,30-39,597,6,1,6,7,7,1,6,10,3.7891101178,4960.6652795149,0.0022305025,0,0,0,135,1.4709142481743754E-4,5.0330927E-5,5.1639556E-5,257,0.4009324,0,1,198,1,0.0050505051,-0.4009324
255332775,alip450,10,3277,182,739,1,281,45.4504507868,40-49,667,7,1,7,8,8,1,7,10,3.5814709468,151.8882260967,0.005274272,0.0714285714,0.0952381,0,135,5.182208695264831E-5,5.0330927E-5,5.1639556E-5,267,0.49667773,10,0,201,0,0,-0.40143963
208672074,McKayInc,10,411,24,112,0,0,32.0903731699,30-39,537,4,2,0,2,2,2,0,0,0,0,0.0081873571,0,0,0,90,6.467849063915386E-5,7.549639E-5,0,505,0.40151516,27,0,200,0,0,-0.40151516
498230889,TimSanchez2,10,3449,76,343,1,21,41.0511004525,40-49,610,6,4,8,12,12,4,8,10,3.5761885412,510.8596944547,0.0104997372,0.0151515152,0.033333335,0,135,1.2637938255313406E-4,1.2582731E-4,1.2909889E-4,505,0.43563512,10,2,200,2,0.01,-0.402301785
16178972,countryrose763,10,6399,223,428,4,366,54.882384856,50-59,710,7,7,9,16,16,7,9,9,3.2108898822,6962.7254014514,0.023685931,0,0,0,135,9.918235888013131E-5,2.0132371E-4,2.0655822E-4,99,0.40350878,18,0,204,0,0,-0.40350878
552119609,legant66,10,9266,263,367,5,1,38.7428871638,30-39,678,8,3,0,3,3,3,0,0,0,0,0.0072184611,0,0,0,14,7.831116804097498E-5,1.00661855E-4,0,505,0.40384614,41,0,225,0,0,-0.40384614
364402840,CdnEnginerd,10,2118,171,519,1,204,51.3855310201,50-59,592,6,1,1,2,2,1,1,11,4.5347419748,12.0583131807,9.608652081880118E-4,0,0,0,135,6.582870336302546E-5,5.0330927E-5,5.1639556E-5,257,0.40789473,0,0,200,0,0,-0.40789473
449955557,brynnbeard,10,4325,119,328,2,601,50.5034307461,50-59,657,7,2,2,4,4,2,2,10,4.2218610321,396.5353864863,0.0027133262,0,0,0,135,6.426045325249627E-5,7.549639E-5,7.7459335E-5,505,0.4090909,25,0,202,0,0,-0.4090909
25241610,misterdevans,10,30518,203,308,11,9,45.3609217943,40-49,771,8,9,7,16,16,9,7,10,3.5835026412,1443.5674963649,0.0258531625,0.0166666667,0.06666667,0,135,1.700069522628914E-4,2.5165462E-4,2.5819778E-4,505,0.4764151,27,1,203,1,0.0049261084,-0.40974843
43815505,LiamLahey,10,27945,1537,887,84,39,,,765,8,8,7,15,15,8,7,10,3.5392117026,2540.5846819614,0.0141620352,0,0,0,135,1.7958307154997512E-4,2.2648917E-4,2.32378E-4,505,0.40998217,8,0,200,0,0,-0.40998217
84407151,ballantynedj,10,7741,691,573,50,46,47.5187058432,40-49,730,7,4,4,8,8,4,4,10,3.8427468509,1284.5622191484,0.004505214,0.0178571429,0.033333335,0,135,1.0072763102725351E-4,1.2582731E-4,1.2909889E-4,505,0.44367817,3,0,200,0,0,-0.410344835
46851659,beanjammin,10,1442,126,152,3,6,26.1991817406,20-29,588,5,3,1,4,4,3,1,11,4.7184071516,58.1312862079,0.0077684722,0,0,0,135,5.404502749805496E-5,1.00661855E-4,1.0327911E-4,505,0.41111112,1,0,200,0,0,-0.41111112
306944225,vukmanx,10,1704,72,213,3,2,36.77362331,30-39,581,6,2,4,6,6,2,4,10,3.8955709061,74.7643470357,0.0033954014,0,0,0,135,6.960569156142067E-5,7.549639E-5,7.7459335E-5,257,0.4117647,31,0,200,0,0,-0.4117647
269511391,ERICatEXECUCOR,10,1373,285,302,1,0,46.8961050437,40-49,654,6,2,4,6,6,2,4,10,3.6680211296,85.4305001338,0.0102641079,0.0333333333,0.1,0,135,9.569023239395061E-5,7.549639E-5,7.7459335E-5,99,0.51310486,42,3,200,3,0.015,-0.41310486
7727422,brashley46,10,8561,244,300,10,48,41.2374981314,40-49,608,7,6,6,12,12,6,6,10,3.5501828525,1267.1348887892,0.0226621257,0.0151515152,0.04761905,0,135,1.0152936009594545E-4,1.7615824E-4,1.8073844E-4,257,0.46153846,1,0,202,0,0,-0.41391941
57431906,MrGenier,10,4070,448,529,35,10,35.0293412498,30-39,579,6,6,5,11,11,6,5,10,3.9195449004,679.3680530369,0.0106475614,0.0272727273,0.055555556,0,135,3.7679909309410017E-4,1.7615824E-4,1.8073844E-4,505,0.4706573,4,0,198,0,0,-0.415101744
136598338,DyPeaks,10,3480,177,205,2,38,34.790741974,30-39,626,6,4,3,7,7,4,3,11,3.9483949614,86.56519968,0.022043836,0.0238095238,0.05,0,135,9.253437484835208E-5,1.2582731E-4,1.2909889E-4,505,0.46536797,8,7,200,6,0.03,-0.41536797
527170087,Lena__Rose,10,620,47,167,0,25,23.7469139114,20-29,445,5,1,2,3,3,1,2,11,4.5188947582,2.4496335736,0.0010441846,0,0,0,135,6.480847151972055E-5,5.0330927E-5,5.1639556E-5,99,0.41666666,0,0,200,0,0,-0.41666666
44366939,geckospots,10,2827,71,155,2,19,40.9319231623,40-49,640,6,2,2,4,4,2,2,11,4.4355952865,7103.9718084574,0.0015257617,0,0,0,135,6.891229464300549E-5,7.549639E-5,7.7459335E-5,106,0.41666666,39,1,199,1,0.0050251256,-0.41666666
229067990,KasTwits,10,1446,34,60,0,1,28.8900686218,20-29,574,5,2,2,4,4,2,2,1,1,2,5.382408138703652E-4,0,0,397,685,1.0141933259075513E-4,7.549639E-5,7.7459335E-5,414,0.41666666,0,0,200,0,0,-0.41666666
1103795653,dkslogcarving,10,117,6,16,0,6,14.0588760157,10-19,47,3,1,2,3,3,1,2,11,3.8053636733,3.2143712541,0.0241051796,0,0,0,135,4.9481557891212485E-5,5.0330927E-5,5.1639556E-5,353,0.41666666,0,4,157,4,0.025477707,-0.41666666
363666493,Darrahteitel,10,232,66,72,2,2,33.9002226406,30-39,476,3,3,4,7,7,3,4,10,3.7261275904,123.0654744505,0.0069941937,0.0476190476,0.1,0,135,8.611684957977403E-5,1.00661855E-4,1.0327911E-4,257,0.5183333,4,1,200,1,0.005,-0.4183333
19549528,culturejunky,10,1679,518,976,16,17,41.4707717523,40-49,623,5,3,2,5,5,3,2,11,4.3254774482,223.4391802813,0.0039451113,0,0,0,135,5.772706270403931E-5,1.00661855E-4,1.0327911E-4,267,0.4199134,0,0,200,0,0,-0.4199134
150419399,aballinga,10,2851,464,805,16,8,46.5955788822,40-49,631,6,5,5,10,10,5,5,9,3.8013002844,325.2536270394,0.0110962807,0.0111111111,0.013888889,0,135,1.315293335027093E-4,1.5099278E-4,1.5491867E-4,505,0.43492064,5,0,200,0,0,-0.421031751
109608296,Beverly_Akerman,10,13704,1899,1679,98,422,66.0960928161,60-69,751,8,6,5,11,11,6,5,10,3.5509955303,1098.5271669867,0.0225319119,0,0,0,135,1.3320588166374482E-4,1.7615824E-4,1.8073844E-4,505,0.42117646,12,0,200,0,0,-0.42117646
61248597,rikkismeltzer,10,3207,85,25,2,122,23.1044544767,20-29,534,6,2,0,2,2,2,0,0,0,0,0.0047755819,0,0,0,107,7.277699223695472E-5,7.549639E-5,0,505,0.42222223,1,0,200,0,0,-0.42222223
519571848,Blissful_hell,10,1509,121,162,2,3,27.0508091765,20-29,609,6,2,0,2,2,2,0,0,0,0,0.004785083,0,0,0,115,5.868367900377784E-5,7.549639E-5,0,99,0.4227941,2,0,200,0,0,-0.4227941
1132300357,Ibrahber,10,934,41,132,0,3,39.6572946641,30-39,607,5,2,1,3,3,2,1,10,4.1072734661,8.5142651894,0.0049410218,0,0,0,135,5.523886504851264E-5,7.549639E-5,7.7459335E-5,343,0.42885375,5,0,200,0,0,-0.42885375
244680936,thefamousmrX,10,2742,86,425,2,14,31.4696006383,30-39,596,6,2,1,3,3,2,1,11,3.9142624949,126.6518755924,0.0211132144,0,0,0,135,4.9293576793887016E-5,7.549639E-5,7.7459335E-5,505,0.43055555,0,0,199,0,0,-0.43055555
277580021,pureozone,10,72,13,218,0,6,18.0024103914,10-19,33,3,0,2,2,2,0,2,2,1.5,0,0,0,0,0,285,4.4780486537007367E-5,0,2.5819778E-5,71,0.43333334,1,0,77,0,0,-0.43333334
116294029,johncolincraig,10,1364,416,1045,13,65,47.8841618595,40-49,601,6,2,3,5,5,2,3,10,3.6005688744,31.5986290372,0.0171640132,0.05,0.16666667,0,135,8.961194459539177E-5,7.549639E-5,7.7459335E-5,353,0.6009852,1,0,200,0,0,-0.43431853
1075087957,YaWhatHeSaid,10,286,18,69,0,0,39.7181005404,30-39,475,4,3,6,9,9,3,6,10,3.6363266965,405.5538861349,0.0093351164,0.0138888889,0.023809524,0,135,7.273940371364342E-5,1.00661855E-4,1.0327911E-4,99,0.45866936,12,0,200,0,0,-0.434859836
64846289,ptboscienceguy,10,361,64,132,0,2,53.251696074,50-59,502,4,2,2,4,4,2,2,10,3.9524583503,31.2026389693,0.0032654192,0,0,0,135,5.925786714009379E-5,7.549639E-5,7.7459335E-5,257,0.44152048,5,1,200,1,0.005,-0.44152048
276586569,riseupforcanada,10,1268,43,63,1,75,27.3452111224,20-29,566,5,3,0,3,3,3,0,0,0,0,0.0085074632,0,0,0,46,7.858336133435597E-5,1.00661855E-4,0,257,0.44746378,2,1,200,1,0.005,-0.44746378
225438673,peaceterry,10,363,37,154,0,0,26.5747335921,20-29,404,4,6,4,10,10,6,4,10,3.533929297,612.1573716407,0.0148828532,0.0222222222,0.071428575,0,135,7.856982322897865E-5,1.7615824E-4,1.8073844E-4,257,0.51956815,6,0,200,0,0,-0.448139575
100689906,Chan_ing,10,12740,189,141,8,1,44.813418309,40-49,739,8,3,1,4,4,3,1,11,4.6103210077,98.3507420678,0.0260187677,0,0,0,135,8.695176381149584E-5,1.00661855E-4,1.0327911E-4,283,0.45054945,5,0,202,0,0,-0.45054945
178097164,auntbeulah,10,7899,106,122,6,26,41.2746062797,40-49,619,7,3,2,5,5,3,2,10,4.1629418935,96.1671543927,0.0066582882,0,0,0,135,7.761429055637068E-5,1.00661855E-4,1.0327911E-4,99,0.45166665,2,0,200,0,0,-0.45166665
59114494,BoredomCorner,10,7887,122,92,4,638,42.9938394911,40-49,683,7,3,0,3,3,3,0,0,0,0,0.0048863054,0,0,0,36,9.174076127267942E-5,1.00661855E-4,0,99,0.45416668,2,0,200,0,0,-0.45416668
221613684,Soylent81,10,405,14,74,0,69,20.259453202,20-29,537,4,3,2,5,5,3,2,10,3.9142624949,34.7970048077,0.0081962612,0,0,0,135,5.601185586577928E-5,1.00661855E-4,1.0327911E-4,99,0.45454547,1,0,200,0,0,-0.45454547
1022240827,ZubieZorn,10,487,11,118,0,0,35.980751933,30-39,471,5,0,2,2,2,0,2,11,4.2278635256,0,0,0,0,0,601,4.4780486537007367E-5,0,2.5819778E-5,505,0.45454547,1,0,200,0,0,-0.45454547
15446865,luvtosmock,10,12167,227,466,27,444,46.0298663984,40-49,711,8,4,3,7,7,4,3,11,4.1552214547,121.1949458957,0.0107695023,0.0238095238,0.033333335,0,135,1.985312790553397E-4,1.2582731E-4,1.2909889E-4,505,0.48910257,3,1,200,1,0.005,-0.455769235
33959429,cmarcoux,10,742,69,549,0,10,27.9407866832,20-29,483,5,2,8,10,10,2,8,10,3.4835432751,1853.1568629656,0.0062890616,0.0111111111,0.017857144,0,135,6.171364250266E-5,7.549639E-5,7.7459335E-5,99,0.4756894,3,1,200,1,0.005,-0.457832256
283590835,tek_heretik,10,1796,110,111,0,0,24.5727773356,20-29,626,6,5,5,10,10,5,5,9,3.4181227143,1051.0283468217,0.0317662835,0,0,0,135,9.645616512044804E-5,1.5099278E-4,1.5491867E-4,99,0.45789474,3,0,200,0,0,-0.45789474
17556793,dougdela,10,4262,96,80,3,10,42.5126722724,40-49,698,7,5,1,6,6,5,1,11,4.6172287688,63.2736402678,0.0132309969,0,0,0,135,1.0954130889504316E-4,1.5099278E-4,1.5491867E-4,505,0.46022728,15,1,200,1,0.005,-0.46022728
21510079,8skylark,10,3812,406,857,9,68,43.6311698004,40-49,641,7,2,2,4,4,2,2,10,3.634295002,13.2183218509,0.0074997577,0,0,0,135,8.515409995176238E-5,7.549639E-5,7.7459335E-5,99,0.46059114,4,0,201,0,0,-0.46059114
80292014,gliverpool9966,10,22180,438,546,10,72,44.5784550966,40-49,744,8,2,0,2,2,2,0,0,0,0,0.00413354,0,0,0,78,7.433876980588307E-5,7.549639E-5,0,106,0.46153846,8,2,201,2,0.0099502488,-0.46153846
174036746,theEARLofSWIRL,10,1592,264,638,16,1644,36.2438862539,30-39,533,5,2,4,6,6,2,4,10,3.652173913,173.2484310861,0.0065767952,0,0,0,135,1.0147102881638967E-4,7.549639E-5,7.7459335E-5,505,0.46346155,2,1,200,1,0.005,-0.46346155
247404995,michelineless,10,1389,76,251,7,4,25.6013855861,20-29,381,6,2,5,7,7,2,5,10,3.7858594067,15.9700097818,0.00548026,0.0238095238,0.1,0,135,5.5415459360372776E-5,7.549639E-5,7.7459335E-5,257,0.5640394,0,2,200,2,0.01,-0.4640394
100300239,JonWiseman,10,23564,430,327,2,307,56.8678703194,50-59,763,8,2,2,4,4,2,2,11,4.2206420154,48.892371759,0.0025909541,0,0,0,135,5.1198429434679196E-5,7.549639E-5,7.7459335E-5,505,0.4642857,10,0,201,0,0,-0.4642857
15641725,Deb_Prothero,10,2992,181,796,8,87,33.1381982467,30-39,449,5,3,6,9,9,3,6,10,3.4681023974,460.0537415711,0.0119346558,0,0,0,135,1.6896336486647932E-4,1.00661855E-4,1.0327911E-4,99,0.4659864,3,0,200,0,0,-0.4659864
312874303,RPrance,10,280,75,237,0,21,31.8932576762,30-39,503,4,1,2,3,3,1,2,10,3.8017066233,0.3036989327,0.0080697697,0,0,0,135,5.321850887225625E-5,5.0330927E-5,5.1639556E-5,99,0.46666667,11,0,200,0,0,-0.46666667
193714026,LeasideBuzz,10,10724,1093,1995,28,108,31.0632646459,30-39,679,7,0,2,2,2,0,2,10,3.9626320065,0,0,0,0,0,772,7.5406549513933E-5,0,2.5819778E-5,505,0.46703297,0,0,200,0,0,-0.46703297
316842662,Sallie_Lama,10,4,133,381,1,88,41.1046042032,40-49,605,5,2,2,4,4,2,2,10,3.5026412028,41.7398501005,0.0065287723,0,0,0,135,8.177800637242601E-5,7.549639E-5,7.7459335E-5,343,0.4679487,4,0,33,0,0,-0.4679487
24727570,leighhanssen,10,5455,551,543,24,156,44.2148712663,40-49,680,6,6,5,11,11,6,5,10,3.5428687525,2078.3036507911,0.0153761055,0,0,0,135,1.7064144038780302E-4,1.7615824E-4,1.8073844E-4,99,0.4704017,6,0,200,0,0,-0.4704017
92620044,kiranrhines,10,1554,171,189,14,1,35.4144921324,30-39,507,6,2,1,3,3,2,1,12,5.4148720033,25.7808036878,0.0039204899,0,0,0,135,2.316986616379611E-4,7.549639E-5,7.7459335E-5,343,0.47064394,4,3,200,3,0.015,-0.47064394
23764854,AlysonFair,10,3641,556,515,22,5,46.25316068,40-49,617,6,9,5,14,14,9,5,10,4.0012190167,3418.7342079167,0.0263339997,0.021978022,0.054545455,0,135,5.052542872575658E-4,2.5165462E-4,2.5819778E-4,353,0.5254054,10,1,200,1,0.005,-0.470859945
484399810,DaveJHL,10,6,8,96,0,2,12.1265715677,10-19,8,1,1,3,4,4,1,3,10,4.0089394555,3.9282488485,0.0016691527,0.0833333333,0.16666667,0,135,5.278267107099271E-5,5.0330927E-5,5.1639556E-5,257,0.64021164,0,1,9,1,0.1111111111,-0.47354497
315422740,emiliehigginson,10,204,18,83,0,4,12.8994027935,10-19,139,4,1,2,3,3,1,2,10,3.8049573344,81.2342004335,0.0068719943,0,0,0,135,5.168302232725848E-5,5.0330927E-5,5.1639556E-5,283,0.47435898,0,3,199,3,0.0150753769,-0.47435898
35302544,DaveWhitton,10,1186,171,710,1,5,25.2506944911,20-29,489,4,0,3,3,3,0,3,10,3.7489845654,0,0,0,0,0,369,6.894310802114915E-5,0,2.5819778E-5,99,0.47504455,1,0,199,0,0,-0.47504455
255696084,k_menard,10,472,113,946,3,1,19.3189892194,10-19,232,5,1,6,7,7,1,6,10,3.9256399837,2512.5968284155,0.0032526147,0.0238095238,0.033333335,0,135,7.500450883071182E-5,5.0330927E-5,5.1639556E-5,353,0.50898993,0,1,199,1,0.0050251256,-0.475656595
374170691,EricMarkDo,10,3225,447,360,19,191,53.8913844548,50-59,696,6,3,1,4,4,3,1,11,4.6716781796,12.7911440872,0.0121247618,0,0,0,135,1.6998144074889445E-4,1.00661855E-4,1.0327911E-4,99,0.47632575,6,0,200,0,0,-0.47632575
593946790,Jclar672Jmc,10,210,34,199,0,2,16.6131938017,10-19,108,3,1,3,4,4,1,3,9,3.6513612353,30.4946066454,0.002982492,0,0,0,135,4.6289777447431015E-5,5.0330927E-5,5.1639556E-5,343,0.47712418,1,0,200,0,0,-0.47712418
59995883,mysafehomeca,10,1430,42,109,1,140,22.8240235258,20-29,438,5,0,2,2,2,0,2,10,3.9354183591,0,0,0,0,0,692,5.638455240451964E-5,0,2.5819778E-5,99,0.4779412,0,1,198,1,0.0050505051,-0.4779412
159845237,wypbell,10,121,61,201,0,0,18.8203429392,10-19,401,3,3,2,5,5,3,2,11,4.1816334823,89.319011514,0.0067352746,0,0,0,135,6.422983815457917E-5,1.00661855E-4,1.0327911E-4,257,0.47916666,0,0,119,0,0,-0.47916666
22166737,DrMJW,10,353,51,249,3,11,23.9703339495,20-29,333,4,2,2,4,4,2,2,10,3.8033319789,116.4488625756,0.0180419461,0,0,0,135,6.4787573281212E-5,7.549639E-5,7.7459335E-5,99,0.47956988,1,0,200,0,0,-0.47956988
394838420,LLevsen,10,1480,66,189,3,3,38.7291366385,30-39,619,6,1,3,4,4,1,3,11,4.1491263714,11.8044413813,0.0117588288,0,0,0,135,5.920836059684782E-5,5.0330927E-5,5.1639556E-5,257,0.48181817,8,0,200,0,0,-0.48181817
575574447,sylviaray5,10,91,19,71,0,6,18.2272270932,10-19,335,3,2,2,4,4,2,2,10,4.2531491264,182.1698089255,0.0046950467,0,0,0,135,4.870197150345055E-5,7.549639E-5,7.7459335E-5,99,0.48333332,4,1,94,1,0.0106382979,-0.48333332
34573800,reddit_gowest,10,1609,91,170,1,2,23.9232763475,20-29,619,5,1,2,3,3,1,2,11,3.9077610727,20.0795071338,0.0033217335,0,0,0,135,9.038891961922446E-5,5.0330927E-5,5.1639556E-5,71,0.48390806,0,5,200,5,0.025,-0.48390806
16658420,ianangus,10,296,77,418,1,8,21.9873524587,20-29,481,4,1,2,3,3,1,2,11,4.3766761479,11.2992754588,0.0024599261,0,0,0,135,7.674335379130044E-5,5.0330927E-5,5.1639556E-5,505,0.4876923,0,1,200,1,0.005,-0.4876923
15827727,wrikent3500,10,236252,1378,2001,15,21352,51.0025907792,50-59,700,11,4,2,6,6,4,2,10,4.2413652987,157.7305397105,0.0172113861,0,0,0,135,8.067569007030168E-5,1.2582731E-4,1.2909889E-4,71,0.48897058,4,0,204,0,0,-0.48897058
14988819,ratsamy,10,10031,458,309,23,15,48.204308331,40-49,683,7,3,1,4,4,3,1,11,4.4555058919,48.8241547057,0.0024463013,0,0,0,135,6.581185647123467E-5,1.00661855E-4,1.0327911E-4,99,0.49166667,3,0,201,0,0,-0.49166667
176548558,calmecam,10,1333,30,71,0,20,27.5663302404,20-29,526,5,2,0,2,2,2,0,0,0,0,0.0022081917,0,0,0,35,5.598209415982681E-5,7.549639E-5,0,267,0.4952381,8,0,200,0,0,-0.4952381
291626846,AnnieClaireBO,10,2712,461,861,24,15,45.8133060801,40-49,659,6,3,3,6,6,3,3,10,3.8541243397,370.4971487413,0.003735262,0.0333333333,0.06666667,0,135,2.1165141851150424E-4,1.00661855E-4,1.0327911E-4,505,0.56534094,15,3,200,3,0.015,-0.49867427
313584539,SNWTodd,10,1081,133,310,2,52,32.472890579,30-39,594,5,2,2,4,4,2,2,11,4.0235676554,75.4346759993,0.0041048665,0,0,0,135,5.648579152568922E-5,7.549639E-5,7.7459335E-5,353,0.5,0,0,200,0,0,-0.5
554872086,RunForTheEarth,10,83,256,336,5,2,36.879647956,30-39,446,3,2,1,3,3,2,1,11,4.4327509143,12.9720672426,0.0018303215,0,0,0,135,4.785366834423614E-5,7.549639E-5,7.7459335E-5,283,0.5,1,0,175,0,0,-0.5
1033285939,duckpondmedia,10,252,40,180,0,7,30.1569401195,30-39,383,5,2,1,3,3,2,1,11,3.8590004063,31.0472103972,0.0066524624,0,0,0,135,5.4474886818034684E-5,7.549639E-5,7.7459335E-5,505,0.5,3,1,200,1,0.005,-0.5
414186251,Cow_Palace,10,77,84,515,0,0,28.8648916143,20-29,393,3,1,2,3,3,1,2,11,4.4701340918,15.6845835153,5.938315318500779E-4,0,0,0,135,4.7758066005273844E-5,5.0330927E-5,5.1639556E-5,505,0.5,1,0,112,0,0,-0.5
1149139530,Steve_o_Reno,10,190,40,89,0,79,41.0001012284,40-49,505,4,1,2,3,3,1,2,10,4.0016253555,25.1090951748,0.0034765439,0,0,0,135,4.760600506570529E-5,5.0330927E-5,5.1639556E-5,343,0.5,2,0,200,0,0,-0.5
215108502,GGeorgieGirl,10,3921,208,273,13,4,34.6344681808,30-39,659,6,7,6,13,13,7,6,10,3.6046322633,1297.7274618204,0.0109459886,0.0064102564,0.04761905,0,135,1.528045623139866E-4,2.0132371E-4,2.0655822E-4,99,0.54781145,4,0,200,0,0,-0.5001924
249221943,bbbrobin,10,1221,100,121,3,0,35.8404843832,30-39,577,5,5,6,11,11,5,6,9,3.4282811865,1153.307289445,0.0099503297,0,0,0,135,9.076641060669988E-5,1.5099278E-4,1.5491867E-4,505,0.50292397,5,0,200,0,0,-0.50292397
1301486268,4thebirdiez,10,10,2,114,0,0,22.6780844369,20-29,90,3,0,4,4,4,0,4,11,4.015434606,0,0,0,0,0,858,4.4780486537007367E-5,0,2.5819778E-5,353,0.5046253,0,0,27,0,0,-0.5046253
607874997,enuff_is_enough,10,226,19,125,0,0,12.9916482201,10-19,127,4,3,1,4,4,3,1,11,4.3888663145,55.3909702718,0.0050898345,0,0,0,135,5.78434005091395E-5,1.00661855E-4,1.0327911E-4,283,0.5090909,0,1,200,1,0.005,-0.5090909
426707296,MattInJacques,10,2553,139,259,2,1287,37.7556044623,30-39,574,6,3,2,5,5,3,2,10,3.5335229581,464.5963171711,0.013207861,0,0,0,135,5.779645912159371E-5,1.00661855E-4,1.0327911E-4,99,0.510989,1,0,200,0,0,-0.510989
25121600,random_noise,10,1056,130,226,4,0,35.7998399987,30-39,541,4,3,3,6,6,3,3,10,3.6940268184,349.3210255585,0.0092376264,0,0,0,135,1.5949894538220318E-4,1.00661855E-4,1.0327911E-4,505,0.5124777,0,0,200,0,0,-0.5124777
19253829,nmucklow,10,443,84,175,3,1,32.3002799621,30-39,499,4,2,2,4,4,2,2,11,4.1109305161,24.0696721985,0.0042138283,0.0833333333,0.16666667,0,135,5.062336500684136E-5,7.549639E-5,7.7459335E-5,505,0.6805556,0,0,199,0,0,-0.51388893
67516139,ACNACanada,10,903,358,569,9,7,28.684939049,20-29,572,5,2,2,4,4,2,2,11,4.2555871597,32.5781695207,0.0071995344,0,0,0,135,1.003990383863659E-4,7.549639E-5,7.7459335E-5,505,0.51426023,3,0,199,0,0,-0.51426023
321045843,atremblay1,10,1246,55,14,1,3,33.884205399,30-39,671,5,4,0,4,4,4,0,0,0,0,0.0100972647,0,0,0,101,8.408064321911994E-5,1.2582731E-4,0,257,0.51666665,1,1,200,1,0.005,-0.51666665
18588982,relliotmeyer,10,910,123,182,3,0,29.7538344697,20-29,580,6,2,2,4,4,2,2,11,4.1495327103,136.4078795829,0.0025694815,0,0,0,135,5.82500756032248E-5,7.549639E-5,7.7459335E-5,267,0.51785713,2,1,200,1,0.005,-0.51785713
313310001,MattLyte,10,557,86,189,1,46,26.7520904528,20-29,477,5,2,3,5,5,2,3,10,3.5042665583,33.1234084411,0.0134468157,0,0,0,135,5.809014538927524E-5,7.549639E-5,7.7459335E-5,99,0.5181818,1,0,200,0,0,-0.5181818
54766840,MALeclerc_,10,586,228,514,4,0,37.5370761775,30-39,565,3,1,1,2,2,1,1,11,4.5522145469,4.0711143161,3.4500892193804056E-4,0,0,0,135,5.016466750424932E-5,5.0330927E-5,5.1639556E-5,353,0.5183824,0,0,200,0,0,-0.5183824
17394041,SDBSmith,10,393,19,128,0,11,21.6826995451,20-29,193,4,1,2,3,3,1,2,10,4.0040633889,11.4255760786,0.0010711214,0,0,0,135,5.3483119723601444E-5,5.0330927E-5,5.1639556E-5,257,0.5204678,3,3,201,3,0.0149253731,-0.5204678
156447298,Wendelovermats,10,1604,56,271,0,16,24.8030285295,20-29,534,4,1,2,3,3,1,2,9,3.7667614791,4.2921351208,0.0014908186,0,0,0,135,4.872426036140957E-5,5.0330927E-5,5.1639556E-5,257,0.52380955,2,0,200,0,0,-0.52380955
15823471,KenCox,10,1504,129,33,9,9,32.3320173818,30-39,664,5,2,0,2,2,2,0,0,0,0,0.0043105444,0,0,0,95,6.050239148591744E-5,7.549639E-5,0,505,0.52380955,2,0,200,0,0,-0.52380955
90552383,Jeffsariot,10,1709,66,225,0,1,33.9864666489,30-39,523,5,2,1,3,3,2,1,11,4.3624542869,49.8059471049,0.0066596723,0,0,0,135,6.40526743977623E-5,7.549639E-5,7.7459335E-5,343,0.5277778,0,1,200,1,0.005,-0.5277778
269437734,maxvillejim,10,584,49,116,1,2,24.1906341196,20-29,458,4,0,2,2,2,0,2,11,4.4727863526,0,0,0,0,0,817,4.63462263885734E-5,0,2.5819778E-5,148,0.5285714,1,0,200,0,0,-0.5285714
495058610,macleodmarkd,10,2554,275,216,7,14,42.707532328,40-49,693,6,5,2,7,7,5,2,10,3.7391304348,113.9585438468,0.0085813405,0,0,0,135,5.866338139985475E-5,1.5099278E-4,1.5491867E-4,505,0.53267974,4,0,200,0,0,-0.53267974
1109797962,RonMcKinnon3,10,28,4,152,0,1,14.9414911194,10-19,27,2,1,3,4,4,1,3,10,3.5574969525,64.3247211103,0.008504538,0,0,0,135,4.7321570694625844E-5,5.0330927E-5,5.1639556E-5,505,0.53988606,0,0,40,0,0,-0.53988606
1135401164,DEG_1,10,352,8,41,0,0,37.2123206171,30-39,512,4,1,2,3,3,1,2,11,3.9987809833,3.30909566,0.0078667616,0,0,0,135,4.7155515793881623E-5,5.0330927E-5,5.1639556E-5,71,0.54545456,11,2,200,2,0.01,-0.54545456
405695721,Jenellsaphid,10,3839,90,266,4,20,28.4294592928,20-29,597,6,1,1,2,2,1,1,10,4.0983340106,4.891000354,0.0052308887,0,0,0,135,4.995319073491694E-5,5.0330927E-5,5.1639556E-5,99,0.55,1,0,199,0,0,-0.55
900494527,DrDDOM,10,13,4,25,0,1,14.6555225743,10-19,75,2,1,2,3,3,1,2,10,3.79926859,15.4774421991,0.0029648656,0,0,0,135,4.646118971401038E-5,5.0330927E-5,5.1639556E-5,257,0.55,0,0,25,0,0,-0.55
30381942,Liam_Toronto,10,1914,197,315,7,42,37.2046060315,30-39,545,5,1,1,2,2,1,1,11,4.5347419748,12.5758958049,0.0073980322,0,0,0,135,5.685110818358313E-5,5.0330927E-5,5.1639556E-5,257,0.5625,0,1,200,1,0.005,-0.5625
1160587963,BlvlMoore,10,198,22,61,0,1,33.9500787528,30-39,483,3,2,0,2,2,2,0,0,0,0,0.0088527578,0,0,0,38,4.996899812518858E-5,7.549639E-5,0,99,0.57272726,17,0,200,0,0,-0.57272726
14718629,NoamGoldUtting,10,1185,43,111,1,1,16.034313484,10-19,469,4,2,2,4,4,2,2,10,4.3571718813,18.5998212584,0.0036221587,0,0,0,135,1.2505834753984127E-4,7.549639E-5,7.7459335E-5,257,0.58157897,2,7,198,7,0.0353535354,-0.58157897
399238624,FireMcGuinty,10,29,22,190,0,0,17.7660810424,10-19,152,2,3,1,4,4,3,1,11,3.971149939,13.3144750251,0.0120472742,0,0,0,135,5.636751216370427E-5,1.00661855E-4,1.0327911E-4,353,0.58235294,1,0,30,0,0,-0.58235294
70500181,kristenleal,10,7518,299,296,12,139,59.5924449878,50-59,718,6,1,2,3,3,1,2,12,4.7541649736,0.7197802198,0.0010478949,0,0,0,135,7.368437722831566E-5,5.0330927E-5,5.1639556E-5,353,0.60714287,2,0,199,0,0,-0.60714287
235907534,coalitionmtl,10,1053,232,714,1,49,25.0610917062,20-29,533,5,1,2,3,3,1,2,10,3.9418935392,19.9456388336,0.0032526147,0,0,0,135,6.119276681341064E-5,5.0330927E-5,5.1639556E-5,267,0.6111111,1,0,200,0,0,-0.6111111
706036914,lbastura,10,149,6,116,0,6,35.8001405383,30-39,507,4,0,2,2,2,0,2,11,4.827376117,0,0,0,0,0,831,6.369871111938029E-5,0,2.5819778E-5,353,0.61333334,17,0,200,0,0,-0.61333334
756913038,lgfc2,10,1093,23,14,0,84,26.3747119243,20-29,529,4,2,0,2,2,2,0,0,0,0,0.0019714731,0,0,0,7,6.685215211545008E-5,7.549639E-5,0,505,0.61538464,11,6,200,6,0.03,-0.61538464
1090069562,ellewist,10,1875,128,345,0,105,35.776874828,30-39,465,6,1,2,3,3,1,2,11,4.2547744819,2.6758551643,0.0028726201,0,0,0,135,5.6951062240813304E-5,5.0330927E-5,5.1639556E-5,353,0.6363636,4,0,201,0,0,-0.6363636
807441157,caireanne,10,82,35,95,0,167,30.095400683,30-39,454,5,2,2,4,4,2,2,10,3.8008939456,4.1584196661,0.0073635265,0,0,0,135,7.365616656717802E-5,7.549639E-5,7.7459335E-5,99,0.66374266,1,0,111,0,0,-0.66374266
291142267,CDM4Sarnia,10,2415,48,35,3,618,24.0609325951,20-29,401,6,2,1,3,3,2,1,11,3.8090207233,20.7504407429,0.0291628199,0,0,0,135,6.0199615493815546E-5,7.549639E-5,7.7459335E-5,353,0.6666667,0,0,196,0,0,-0.6666667
