id,label,size,statuses_count,followers_count,friends_count,listed_count,favourites_count,klout_score,klout_score_bucket,kred_influence,kred_outreach,indegree,outdegree,degree,weighted degree,weighted indegree,weighted outdegree,eccentricity,closnesscentrality,betweenesscentrality,eigencentrality,newClusteringCoefficient,clustering,componentnumber,strongcompnum,pageranks,authority,hub,modularity_class,interaction_count,temp_term_score,num_tweets,term_score_distinct_tweets,final_term_score
10229,RobCottingham,10,19240,5760,3068,517,591,66.9563016247,60-69,770,7,77,89,166,166,77,89,6,2.377986966,3328.8654314775,0.1295020171,0.1035779482,0.2778079,0,59,5.300129712117752E-4,5.284374E-4,5.348474E-4,182,11,0,200,0,0
415583,Axell,10,9205,2342,955,62,269,67.2913465189,60-69,686,5,2,2,4,4,2,2,6,3.1538461538,471.5,1.7990370091669125E-4,0.0833333333,0.16666667,42,307,0.0011967809,2.0324514E-5,2.0571053E-5,197,1,0,200,0,0
805084,JordonCooper,10,23807,2324,754,115,1655,55.9219115121,50-59,774,8,38,31,69,69,38,31,7,2.7121650978,750.9370129908,0.0465946716,0.1165814152,0.29374057,0,59,2.743269977467165E-4,2.642187E-4,2.674237E-4,25,78,0,202,0,0
1771481,mmeija,10,1937,123,316,8,1,28.6749076079,20-29,440,6,1,4,5,5,1,4,7,3.1097031137,7.4636253718,2.2887075842316563E-4,0.1,0.25,0,59,5.918003881060458E-5,1.3549677E-5,1.3714035E-5,147,0,0,199,0,0
2183601,dougsymington,10,22834,2234,1123,130,4282,52.7847785255,50-59,729,7,33,30,63,63,33,30,6,2.5673425054,2722.9689724317,0.0497629415,0.0742447517,0.3857143,0,59,2.3307310464338335E-4,2.303445E-4,2.3313859E-4,77,7,1,199,1,0.0050251256
3567831,sleslie,10,26410,1837,436,226,1271,54.4065863925,50-59,769,8,8,5,13,13,8,5,7,3.301230992,53.5005135838,0.0023137794,0.0512820513,0.18055555,0,59,9.341181932559288E-5,6.0973543E-5,6.171316E-5,182,5,0,200,0,0
5262391,ctoverdrive,10,22866,1815,1365,102,577,56.1155236418,50-59,755,8,15,19,34,34,15,19,7,2.9105720492,546.2104542822,0.0096244491,0.0704099822,0.2228261,0,59,1.3241229115772618E-4,1.0839741E-4,1.0971228E-4,175,12,0,201,0,0
5661632,Nelson_Camara,10,759,87,131,2,0,36.2204923273,30-39,497,5,1,1,2,2,1,1,0,0,0,8.095914281419891E-5,0,0,135,306,3.177448371356425E-4,1.3549677E-5,1.3714035E-5,130,9,0,200,0,0
5748362,Senturion,10,10214,631,775,31,197,54.0183461108,50-59,748,7,6,10,16,16,6,10,6,2.7443881245,67.3714127019,0.0027881275,0.1416666667,0.30128205,0,59,7.431542444204725E-5,4.742387E-5,4.799912E-5,175,12,0,200,0,0
6038862,draymaker,10,1895,523,875,9,20,42.170339424,40-49,662,5,35,53,88,88,35,53,7,2.6125995655,403.6710714742,0.0686496574,0.1199059561,0.32142857,0,59,4.548601442939678E-4,2.4389417E-4,2.4685264E-4,175,8,0,200,0,0
6167332,oliveridley,10,11885,939,837,54,46,59.6492763514,50-59,741,7,65,70,135,135,65,70,6,2.320782042,5748.1989596176,0.0998196368,0.080983969,0.23919372,0,59,3.599012693815314E-4,4.4713932E-4,4.5256317E-4,77,39,1,200,1,0.005
6237632,ink_slinger,10,26697,1589,186,124,45,44.5534897923,40-49,735,7,10,16,26,26,10,16,7,2.7994207096,207.169691933,0.0145324388,0.1723076923,0.35064936,0,59,1.516095790152298E-4,7.452322E-5,7.542719E-5,175,3,0,200,0,0
6424072,kerfluffer,10,12519,290,272,12,106,,,732,8,10,6,16,16,10,6,7,2.9015206372,6.1742559432,0.0272637332,0.2166666667,0.51282054,0,59,1.361803790180546E-4,7.452322E-5,7.542719E-5,175,3,0,200,0,0
6894272,thekyleguy,10,13757,1413,1275,72,1773,46.8805022448,40-49,730,7,42,62,104,104,42,62,6,2.3845039826,4208.793965184,0.0400354281,0.0783233757,0.24393584,0,59,2.1962326260083082E-4,2.9131805E-4,2.9485175E-4,25,37,0,200,0,0
7075582,trasie,10,11634,1139,675,72,129,50.0658787157,50-59,701,7,33,40,73,73,33,40,6,2.4996379435,1756.2355125087,0.056597018,0.1105403349,0.32202113,0,59,2.2135208117487654E-4,2.303445E-4,2.3313859E-4,175,6,13,201,13,0.0646766169
7417792,WernerPatels,10,26849,763,457,47,0,48.8561742337,40-49,740,8,38,36,74,74,38,36,7,2.7784214337,546.9673200781,0.0340194684,0.0973713439,0.18323638,0,59,2.5782452135023217E-4,2.642187E-4,2.674237E-4,175,8,0,201,0,0
7491592,NailaJ,10,129431,2753,1274,180,923,55.8302590213,50-59,844,10,15,16,31,31,15,16,6,2.8439536568,479.7945890848,0.0265541684,0.147311828,0.33666667,0,59,1.9572185188180218E-4,1.0839741E-4,1.0971228E-4,175,13,0,203,0,0
7727422,brashley46,10,8612,245,300,10,48,41.2374981314,40-49,608,7,15,30,45,45,15,30,6,2.528602462,92.262755185,0.0283763126,0.1868686869,0.51336896,0,59,1.060665384966802E-4,1.0839741E-4,1.0971228E-4,25,1,0,201,0,0
7950242,sergioragone,10,39732,3892,889,113,573,64.4612318331,60-69,787,8,10,3,13,13,10,3,4,2.2307692308,1054.6666666667,8.439797387354388E-4,0.0384615385,0.08181818,42,307,0.0036135496,7.452322E-5,4.1142106E-5,197,47,0,201,0,0
8329682,CapnAllegra,10,28212,979,602,41,75,54.149353949,50-59,781,8,3,3,6,6,3,3,8,3.6368573497,13.7547456354,0.0010006129,0,0,0,59,8.097554204140104E-5,2.7099353E-5,2.742807E-5,175,3,0,201,0,0
8384152,iMenna29,10,21120,1014,869,12,227,56.0484225312,50-59,754,8,0,0,0,0,0,0,0,0,0,0,0,0,73,167,4.766339181938244E-5,0,0,65,2,0,199,0,0
8642882,Sanlin,10,59434,1041,1666,49,447,41.8135364716,40-49,736,9,6,17,23,23,6,17,6,2.9087617668,466.921239542,0.0060112386,0.0652173913,0.10526316,0,59,9.492631919910852E-5,4.742387E-5,4.799912E-5,77,0,0,200,0,0
10711672,cmkl,10,3828,643,802,47,83,53.8905223685,50-59,677,6,67,112,179,179,67,112,6,2.368211441,3934.2514160939,0.1022445796,0.0777101249,0.23309678,0,59,3.8551741601560314E-4,4.60689E-4,4.6627718E-4,182,17,2,200,2,0.01
11267302,ajproc,10,87820,2396,1698,131,845,59.7218870682,50-59,796,10,16,12,28,28,16,12,7,2.9304851557,706.2634591164,0.009133553,0.0740740741,0.21315789,0,59,1.2926342618912266E-4,1.1517225E-4,1.16569296E-4,175,21,0,201,0,0
11275512,nicsticks,10,2778,51,28,2,1,24.7779454204,20-29,552,5,0,0,0,0,0,0,0,0,0,0,0,0,132,300,4.766339181938244E-5,0,0,124,0,0,195,0,0
11314672,kshaidle,10,42363,11184,12306,389,52,71.2121311386,70-79,787,9,75,81,156,156,75,81,6,2.3895727734,10908.4505134066,0.052862011,0.0385442514,0.2282445,0,59,3.9511652621176203E-4,5.148877E-4,5.211333E-4,175,54,2,200,2,0.01
11435092,weinreporter,10,14387,4233,3193,293,104,65.7187413149,60-69,710,6,0,0,0,0,0,0,0,0,0,0,0,0,104,232,4.766339181938244E-5,0,0,93,1,0,200,0,0
11582802,JonSThompson,10,498,260,296,15,31,43.288435468,40-49,612,4,16,13,29,29,16,13,7,2.9123823316,190.5224303069,0.0149815792,0.1022167488,0.26666668,0,59,1.2556493761562015E-4,1.1517225E-4,1.16569296E-4,77,24,0,198,0,0
12046772,JProssa,10,14813,1247,933,29,175,45.509516029,40-49,718,7,37,47,84,84,37,47,6,2.4312092686,2217.5208450695,0.0568074925,0.0797475617,0.26378447,0,59,3.020547797001014E-4,2.5744384E-4,2.6056665E-4,175,12,0,200,0,0
12562482,simplysanj,10,3274,76,76,0,28,22.4039649238,20-29,534,5,0,1,1,1,0,1,7,3.4802750633,0,0,0,0,0,197,4.766339181938244E-5,0,6.8570175E-6,25,1,0,200,0,0
12843532,colly_mitch,10,2448,497,1516,14,78,41.5717260774,40-49,620,5,20,59,79,79,20,59,6,2.4561911658,368.6886726006,0.0364019854,0.1251217137,0.32144946,0,59,1.0839808551841119E-4,1.422716E-4,1.4399737E-4,77,0,0,200,0,0
12864252,idillun,10,13498,683,1429,33,47,45.3755511737,40-49,700,7,7,14,21,21,7,14,7,2.7939898624,4.9233434853,0.006139272,0.1619047619,0.5824176,0,59,7.237564787106017E-5,5.4198706E-5,5.485614E-5,175,2,0,199,0,0
12993222,CityNews,10,41185,52266,1636,1280,24,69.6932524949,60-69,944,8,147,32,179,179,147,32,6,2.6669080377,42354.2632094908,0.1231767058,0.0652815266,0.09625168,0,59,0.0012902746,0.0010026761,9.1884035E-4,175,231,0,200,0,0
13075932,Mannzhu,10,3408,516,235,46,13,42.5992097823,40-49,608,6,46,31,77,77,46,31,6,2.5275162925,341.0184451263,0.0862260631,0.1057758031,0.39411765,0,59,2.783511761759089E-4,3.1841738E-4,3.222798E-4,25,12,0,199,0,0
13179482,Tigerlily007,10,2516,243,331,3,126,45.6540744553,40-49,637,6,10,25,35,35,10,25,6,2.6375814627,1756.2821020256,0.0127508354,0.1285714286,0.365,0,59,8.02819023733118E-5,7.452322E-5,7.542719E-5,77,21,0,201,0,0
13229652,ikonvodka,10,1789,1570,1873,40,4,36.4568575093,30-39,564,5,3,2,5,5,3,2,7,3.2784214337,207.1665554685,0.0077390328,0.05,0.16666667,0,59,1.6421939242729366E-4,2.7099353E-5,2.742807E-5,175,0,0,200,0,0
13230662,DianneKnight,10,394,1268,1948,2,6,29.6361403349,20-29,536,4,3,9,12,12,3,9,6,2.7679217958,1.9299786222,0.010583367,0.3181818182,0.5,0,59,6.556677941154664E-5,2.7099353E-5,2.742807E-5,77,0,0,200,0,0
13236872,TPHogan,10,2919,2134,2228,68,8,60.6521326477,60-69,699,6,50,69,119,119,50,69,7,2.5814627082,2760.4509293998,0.0444857163,0.0878792195,0.27055103,0,59,3.637190638031567E-4,3.4551675E-4,3.497079E-4,175,22,3,200,3,0.015
13282022,bluebeard,10,1678,292,858,3,54,45.5941825309,40-49,610,5,4,13,17,17,4,13,7,2.8660391021,38.8762102939,0.004417689,0.0919117647,0.21794872,0,59,6.277556347697588E-5,3.3874192E-5,3.4285087E-5,175,1,0,200,0,0
13384192,Tim_Ell,10,2573,660,1271,16,304,66.1526643903,60-69,662,6,70,144,214,214,70,144,6,2.2172338885,4869.2106739659,0.0949189338,0.0994032732,0.2540801,0,59,3.7402469804405716E-4,4.8101353E-4,4.8684824E-4,182,34,2,200,2,0.01
13896552,globalnewsto,10,20988,11732,1078,459,0,63.4678880491,60-69,793,6,73,11,84,84,73,11,7,2.8095582911,3693.5590198232,0.075544074,0.082616179,0.1314035,0,59,7.118819822457E-4,5.0133804E-4,5.0056225E-4,175,73,0,200,0,0
13952632,calix,10,4492,391,284,23,8,62.3120034183,60-69,638,5,44,36,80,80,44,36,6,2.5249818972,744.3170478253,0.0647989035,0.1360759494,0.32601798,0,59,2.5417617930048895E-4,3.0486772E-4,3.085658E-4,182,33,0,200,0,0
14065963,kevinharding,10,26003,1214,1960,34,777,60.1949666915,60-69,779,8,90,145,235,235,90,145,6,2.2451122375,9723.8819297645,0.1274097117,0.0745771959,0.21256468,0,59,4.2607762170197416E-4,6.165103E-4,6.2398857E-4,182,85,0,201,0,0
14070067,MosesIngram,10,530,2,56,0,0,15.6708586376,10-19,142,3,0,15,15,15,0,15,7,3.0152008686,0,0,0.3904761905,0.5809524,0,364,4.766339181938244E-5,0,6.8570175E-6,25,0,0,200,0,0
14092606,robertsnell,10,19370,1713,733,64,29,57.8672247311,50-59,763,8,7,5,12,12,7,5,7,3.2002172339,605.2228951148,0.0076494177,0.0454545455,0.21428572,0,59,2.0478273178429473E-4,5.4198706E-5,5.485614E-5,147,4,0,201,0,0
14103847,garychisholm,10,1141,165,268,6,8,36.6554307053,30-39,560,5,8,20,28,28,8,20,7,2.6998551774,600.6177778652,0.0128299493,0.1626984127,0.3904762,0,59,9.320861667859295E-5,6.0973543E-5,6.171316E-5,25,9,1,200,1,0.005
14108832,planta,10,12232,597,1296,25,233,58.5017988528,50-59,726,7,14,42,56,56,14,42,7,2.6556842867,433.1605113344,0.0314078641,0.1441558442,0.35147992,0,59,1.7397123866177907E-4,1.0162257E-4,1.02855265E-4,175,6,0,200,0,0
14171837,edwardtoronto,10,4548,494,1108,26,33,45.4267758607,40-49,641,6,21,62,83,83,21,62,6,2.5152063722,398.4527169014,0.0384625496,0.1667646195,0.3432836,0,59,1.3847396359417934E-4,1.4904643E-4,1.5085438E-4,175,23,0,200,0,0
14180138,forestethics,10,2012,5776,1912,346,14,56.2766228748,50-59,766,6,112,16,128,128,112,16,6,2.8320057929,9069.3618074551,0.085037119,0.0550565945,0.10745891,0,59,6.391403533480949E-4,7.655567E-4,7.6798594E-4,77,113,0,200,0,0
14199772,joeyjack,10,14099,680,739,26,42,58.2207853974,50-59,753,7,25,23,48,48,25,23,6,2.51955105,7974.9472718622,0.0323377529,0.052748227,0.2179803,0,59,2.3715906828658155E-4,1.761458E-4,1.7828245E-4,182,9,1,199,1,0.0050251256
14241069,klashton27,10,12762,901,393,57,7,56.5942915033,50-59,752,7,11,10,21,21,11,10,7,2.9333816075,80.2669754858,0.0194960633,0.1476190476,0.28431374,0,59,2.2332580354892975E-4,8.129806E-5,8.228421E-5,175,10,0,200,0,0
14258863,Justance,10,5372,186,223,0,978,40.4826655961,40-49,644,6,3,7,10,10,3,7,7,2.9015206372,0.6532966289,0.0079493001,0.2444444444,0.5,0,59,6.103875684691665E-5,2.7099353E-5,2.742807E-5,175,2,0,200,0,0
14259750,RyanMMM,10,1169,457,1994,7,4,39.4966898267,30-39,623,5,42,164,206,206,42,164,6,2.2215785663,6239.057980657,0.0767718996,0.1249112006,0.24714285,0,59,3.433374360869336E-4,2.9131805E-4,2.9485175E-4,175,8,4,200,3,0.015
14261329,Scooterissima,10,30370,499,1082,20,113,41.23295631,40-49,640,9,48,84,132,132,48,84,6,2.4217958001,3607.7226568346,0.0529319598,0.0746588018,0.23220974,0,59,2.2146882104201376E-4,3.3196708E-4,3.3599386E-4,182,0,0,200,0,0
14262783,kweenshaker,10,1997,43,128,0,338,32.2243293928,30-39,619,5,0,3,3,3,0,3,7,3.3496199783,0,0,0.1666666667,0.16666667,0,684,4.766339181938244E-5,0,6.8570175E-6,175,3,0,200,0,0
14281632,ChrisTomalty,10,8513,420,206,5,122,62.2987714867,60-69,678,6,15,11,26,26,15,11,7,2.9055032585,1210.5077627717,0.0137744279,0.0923076923,0.29411766,0,59,1.2020149026020934E-4,1.0839741E-4,1.0971228E-4,175,24,0,200,0,0
14303077,kishcom,10,4986,1907,421,34,20,44.7926483079,40-49,723,6,1,0,1,1,1,0,0,0,0,9.013879974086967E-4,0,0,0,57,4.998923433827396E-5,1.3549677E-5,0,175,4,0,200,0,0
14304664,c_9,10,40689,1215,368,79,1,54.183020368,50-59,788,9,60,17,77,77,60,17,6,2.7574221579,3535.1774920373,0.087227435,0.1196172249,0.24182692,0,59,3.563074621552293E-4,4.1326514E-4,4.1827807E-4,175,63,0,201,0,0
14390356,carlena,10,7724,882,686,33,268,53.3213213668,50-59,729,7,73,37,110,110,73,37,6,2.622737147,817.9387143875,0.1243021399,0.1531276063,0.36126703,0,59,4.8353739348546624E-4,5.0133804E-4,5.074193E-4,175,26,1,200,1,0.005
14446092,nietha,10,3393,202,403,5,67,41.0947326402,40-49,632,5,2,15,17,17,2,15,7,2.8649529327,6.9792621561,0.0018640936,0.1397058824,0.20952381,0,59,5.152159617800872E-5,2.0324514E-5,2.0571053E-5,77,0,0,200,0,0
14470102,anthonymarco,10,24275,1870,1487,114,15,57.6143259812,50-59,772,7,86,80,166,166,86,80,6,2.3750905141,9344.4413742371,0.1082830918,0.0623220153,0.21967655,0,59,5.684043261911981E-4,5.8941095E-4,5.9656054E-4,182,93,0,200,0,0
14485907,tamtar,10,7602,161,167,7,287,60.6321296613,60-69,705,6,2,2,4,4,2,2,8,3.9286748733,3.0817460317,3.091634834609252E-4,0,0,0,59,8.079893022594355E-5,2.0324514E-5,2.0571053E-5,182,5,0,200,0,0
14558543,headtale,10,1159,624,1629,21,8,58.3145234725,50-59,633,5,45,86,131,131,45,86,7,2.4873280232,2514.073585935,0.0529398615,0.09377569,0.29468846,0,59,2.3716269019851048E-4,3.1164257E-4,3.154228E-4,25,48,1,199,1,0.0050251256
14560937,oneguycoding,10,2330,50,131,3,125,29.6031456493,20-29,530,5,2,3,5,5,2,3,7,3.1002896452,0.4235653828,0.0033683165,0.2,0.41666666,0,59,5.936703473744953E-5,2.0324514E-5,2.0571053E-5,175,0,1,200,1,0.005
14627265,freebalance,10,29628,1044,725,57,80,54.2174766777,50-59,737,8,2,1,3,3,2,1,7,3.5434467777,0.3571428571,6.323809764469337E-4,0.1666666667,0.16666667,0,59,5.0742070075449115E-5,2.0324514E-5,2.0571053E-5,175,3,0,201,0,0
14660147,Bendihossan,10,41942,846,965,49,490,50.0098605949,50-59,786,9,1,1,2,2,1,1,8,3.8808834178,0,2.2887075842316563E-4,0,0,0,59,5.918003881060458E-5,1.3549677E-5,1.3714035E-5,182,2,0,201,0,0
14690573,romeoinottawa,10,25028,1268,873,47,260,60.2686627228,60-69,755,8,53,34,87,87,53,34,6,2.6386676322,757.8873040278,0.1004320331,0.1017107725,0.29717514,0,59,5.602511101668255E-4,3.6584126E-4,3.7027895E-4,175,79,0,202,0,0
14705603,680News,10,33347,46341,234,1561,6,69.6425748328,60-69,929,7,134,9,143,143,134,9,7,3.1281679942,7553.4406209899,0.105063554,0.0657933616,0.088860676,0,59,0.0010756624,9.146032E-4,8.571272E-4,175,150,0,202,0,0
14718629,NoamGoldUtting,10,1163,42,111,1,1,16.034313484,10-19,469,4,10,24,34,34,10,24,7,2.5800144823,5.4602557248,0.0318158877,0.2745098039,0.6737892,0,59,1.3780739925623456E-4,7.452322E-5,7.542719E-5,25,2,7,198,7,0.0353535354
14795481,alexbungle35,10,2035,65,200,4,5,38.7991299808,30-39,579,6,1,7,8,8,1,7,7,2.7766111513,0,0.0072676982,0.2857142857,0.54761904,0,59,5.409653606626543E-5,1.3549677E-5,1.3714035E-5,25,1,0,200,0,0
14890735,DonFelipe,10,354,17,50,0,7,18.5784069155,10-19,322,3,0,1,1,1,0,1,7,4.3571428571,0,0,0,0,42,454,4.766339181938244E-5,0,6.8570175E-6,197,0,0,198,0,0
14900584,jplett,10,5775,492,596,12,35,60.0671861623,60-69,695,7,40,52,92,92,40,52,6,2.452570601,5270.5440942667,0.0433408112,0.0630673674,0.2739343,0,59,2.011884429940985E-4,2.7776835E-4,2.811377E-4,182,54,0,199,0,0
14969693,klimaz,10,2453,64,45,2,40,27.2199036137,20-29,564,6,4,4,8,8,4,4,7,3.2509051412,6.4396348605,0.0047101061,0.125,0.46666667,0,59,6.098345705150649E-5,3.3874192E-5,3.4285087E-5,147,0,0,199,0,0
15013005,nigelbeale,10,3711,945,1059,51,36,51.4604038539,50-59,653,6,6,34,40,40,6,34,7,2.631788559,18.026776236,0.0173362675,0.2480769231,0.465873,0,59,9.743704279595052E-5,4.742387E-5,4.799912E-5,175,10,0,201,0,0
15031337,Geoff_Sharpe,10,9325,1844,1984,80,113,67.7501788895,60-69,761,7,107,132,239,239,107,132,6,2.3251267198,15460.0124535797,0.1122781902,0.0704440772,0.18525451,0,59,5.619127731116803E-4,7.316825E-4,7.405579E-4,175,79,0,200,0,0
15142813,BFSingh,10,11232,1880,982,119,40,64.337621702,60-69,749,7,39,19,58,58,39,19,7,2.7472845764,1009.0669869155,0.0459898847,0.0635208711,0.19329268,0,59,2.643909170126388E-4,2.7099354E-4,2.742807E-4,175,16,0,200,0,0
15152494,cheriak,10,1160,272,537,6,26,42.1567935276,40-49,558,5,7,18,25,25,7,18,6,2.5901520637,38.2541420083,0.0176429327,0.1583333333,0.44117647,0,59,7.610076191687491E-5,5.4198706E-5,5.485614E-5,77,2,0,200,0,0
15178939,cindiforeman,10,1458,616,1523,41,98,43.6923609717,40-49,642,5,32,72,104,104,32,72,6,2.4478638668,1505.2943739806,0.0371071714,0.0850448096,0.24054053,0,59,1.652209738473447E-4,2.2356966E-4,2.2628158E-4,182,20,0,202,0,0
15179114,jkehoe3,10,1776,460,1598,24,1,45.7837099385,40-49,494,5,34,90,124,124,34,90,6,2.3595220854,861.3384537162,0.050548111,0.1318515605,0.33321893,0,59,1.6375660869010958E-4,2.3711934E-4,2.3999561E-4,182,1,0,200,0,0
15206059,janfromthebruce,10,3109,301,586,7,40,44.894271974,40-49,616,6,73,140,213,213,73,140,6,2.2664735699,5223.3423961859,0.1147747098,0.0974178404,0.31605875,0,59,3.1838140496560485E-4,5.0133804E-4,5.074193E-4,25,42,1,200,1,0.005
15215453,ReynoldR,10,1264,107,344,0,12,33.0373065452,30-39,578,5,23,38,61,61,23,38,6,2.4377262853,986.8985042092,0.0453972481,0.1841530055,0.40731293,0,59,1.3219201859477847E-4,1.6259612E-4,1.6456842E-4,25,2,1,199,1,0.0050251256
15223577,Johnny222,10,1705,231,294,3,26,40.937518047,40-49,599,5,39,54,93,93,39,54,6,2.5076031861,939.6797726747,0.0558243876,0.1110331931,0.33630952,0,59,2.2410249944768414E-4,2.7099354E-4,2.742807E-4,182,21,1,200,1,0.005
15228888,page_1215,10,3026,1015,1477,40,37,61.4100033401,60-69,668,6,65,83,148,148,65,83,6,2.367487328,2265.9076616031,0.0794977277,0.0915149844,0.32340425,0,59,3.657691541341284E-4,4.4713932E-4,4.5256317E-4,182,25,0,198,0,0
15235516,Leenes,10,232,85,369,0,14,49.2469538388,40-49,361,4,20,79,99,99,20,79,6,2.2910934106,527.6127781378,0.0199922229,0.1230674088,0.2609568,0,59,1.0169083021737174E-4,1.422716E-4,1.4399737E-4,77,1,1,200,1,0.005
15254148,mode23,10,21543,804,733,25,1,51.5736796839,50-59,754,8,91,122,213,213,91,122,6,2.3055756698,5843.8217182217,0.1042957582,0.0759146071,0.29413086,0,59,2.869238427729692E-4,6.2328513E-4,6.308456E-4,77,49,7,199,5,0.0251256281
15275729,pblaauw,10,11034,306,604,15,0,43.0195784874,40-49,691,7,1,6,7,7,1,6,7,2.9384503983,0.2212430999,0.0064515096,0.2142857143,0.4,0,59,5.695780909507137E-5,1.3549677E-5,1.3714035E-5,182,0,1,201,1,0.0049751244
15331235,claudlemire,10,23790,1163,1627,20,1689,54.2426620811,50-59,765,8,80,93,173,173,80,93,6,2.414916727,4533.5886666152,0.0609906948,0.0776650087,0.22024524,0,59,4.0147774678629526E-4,5.487619E-4,5.5541843E-4,175,84,2,200,2,0.01
15333188,Real_Dr_Roy,10,35663,1565,2001,74,97,47.2216755891,40-49,740,9,77,87,164,164,77,87,6,2.5068790731,4481.379000375,0.0646824639,0.0713003142,0.21541184,0,59,4.5949092881931433E-4,5.284374E-4,5.348474E-4,175,10,0,201,0,0
15395708,ryanbaldwin,10,10486,569,282,34,63,46.2179295451,40-49,727,7,2,2,4,4,2,2,7,3.3044895004,9.4468551074,0.0018113843,0.0833333333,0.16666667,0,59,5.7153077582842236E-5,2.0324514E-5,2.0571053E-5,77,2,0,200,0,0
15419003,lexinc,10,1136,74,295,3,51,42.3998625657,40-49,548,5,13,43,56,56,13,43,6,2.4659666908,199.6092299249,0.0147531752,0.1181818182,0.27353266,0,59,9.133423623809926E-5,9.484774E-5,9.599824E-5,77,14,0,200,0,0
15458655,CathHughes,10,118,169,222,2,8,45.8342745006,40-49,432,3,0,1,1,1,0,1,7,3.4379297865,0,0,0,0,0,634,4.766339181938244E-5,0,6.8570175E-6,25,0,0,120,0,0
15487023,kyall,10,7562,297,233,6,10,43.3657657195,40-49,695,6,39,29,68,68,39,29,6,2.7277335264,691.4362286453,0.0629645005,0.1496927129,0.40039214,0,59,2.1063222982985427E-4,2.7099354E-4,2.742807E-4,25,33,1,200,1,0.005
15526230,mujtaba2k8,10,6530,1304,1895,28,46,52.9354424108,50-59,699,8,3,4,7,7,3,4,7,3.2776973208,336.3606521283,0.0017639791,0,0,0,59,6.768974481344851E-5,2.7099353E-5,2.742807E-5,175,2,0,200,0,0
15590725,hillsarah,10,2710,553,492,12,9,44.2199367673,40-49,665,6,44,63,107,107,44,63,6,2.4847936278,1727.0754083607,0.0628040399,0.1255510492,0.35780886,0,59,2.536087480731423E-4,3.0486772E-4,3.085658E-4,147,22,2,200,2,0.01
15612072,gregsdouglas,10,4817,988,1274,17,6,59.1302450661,50-59,669,6,23,61,84,84,23,61,6,2.4076755974,1646.3634599163,0.0248295638,0.1176133104,0.32734004,0,59,1.5634274720178072E-4,1.6259612E-4,1.6456842E-4,175,6,0,200,0,0
15616657,jpturcotte,10,7842,410,1952,6,0,40.0362581494,40-49,614,7,7,27,34,34,7,27,6,2.5506879073,169.0840441167,0.0154865907,0.1506238859,0.32539684,0,59,7.216243620522234E-5,5.4198706E-5,5.485614E-5,77,1,0,200,0,0
15616667,MyPetGloat,10,26121,1150,646,63,38,56.4475603035,50-59,783,8,119,64,183,183,119,64,6,2.3620564808,2067.2014219836,0.1225412929,0.0919053624,0.26804864,0,59,3.34821490355064E-4,8.129806E-4,8.159851E-4,77,163,0,201,0,0
15625485,opendna,10,10182,710,2001,36,1711,,,741,8,5,11,16,16,5,11,7,3.0206372194,207.4330670607,0.0026257327,0.0458333333,0.10606061,0,59,8.848320421070825E-5,4.064903E-5,4.1142106E-5,182,6,0,199,0,0
15636921,LloydHLawrence,10,213,9,6,0,1,14.7471614865,10-19,230,4,0,0,0,0,0,0,0,0,0,0,0,0,97,222,4.766339181938244E-5,0,0,88,0,1,185,1,0.0054054054
15664624,realpaid,10,18,2,9,0,0,17.013925624,10-19,72,2,0,4,4,4,0,4,7,2.8678972132,0,0,0.25,0.41666666,0,581,4.766339181938244E-5,0,6.8570175E-6,175,1,0,24,0,0
15782873,pcasey,10,2733,242,523,10,14,39.4736281366,30-39,691,6,47,85,132,132,47,85,6,2.4210716872,561.0346549894,0.0834880965,0.1420888272,0.33779848,0,59,2.472301907648429E-4,3.2519223E-4,3.2913685E-4,25,10,1,200,1,0.005
15816745,NBToryGal,10,5650,218,407,12,9,39.0976008362,30-39,628,6,29,41,70,70,29,41,7,2.6477190442,254.5446108694,0.0224723141,0.1037267081,0.35169083,0,59,1.614646613571184E-4,2.0324514E-4,2.0571053E-4,175,0,2,200,2,0.01
15827727,wrikent3500,10,238906,1403,2001,15,21486,51.0025907792,50-59,700,11,7,12,19,19,7,12,7,2.9131064446,20.8985971551,0.0121958674,0.2251461988,0.34640524,0,59,8.577571336418715E-5,5.4198706E-5,5.485614E-5,175,1,0,201,0,0
15830174,Emile_BC,10,17645,1510,1265,62,24,68.5437679819,60-69,764,8,77,67,144,144,77,67,6,2.5637219406,12827.6820081199,0.0935469923,0.0603632479,0.19596864,0,59,5.521301158355782E-4,5.284374E-4,5.348474E-4,175,128,0,201,0,0
15877389,DaynaBramston,10,1717,439,1270,9,9,42.420421306,40-49,612,6,22,54,76,76,22,54,6,2.471397538,814.5212892724,0.0303601766,0.1112280702,0.28822055,0,59,1.317699577214029E-4,1.5582128E-4,1.577114E-4,182,8,0,200,0,0
15959069,jamesbow,10,10339,860,450,61,10,49.0839117003,40-49,738,7,47,27,74,74,47,27,6,2.6904417089,283.5962495242,0.0717849628,0.091447612,0.33630952,0,59,2.752389661139728E-4,3.2519223E-4,3.222798E-4,175,16,0,199,0,0
15970302,hardcorps80204,10,38020,790,825,58,263,46.2980501098,40-49,752,9,2,2,4,4,2,2,7,3.179217958,2.4522492032,0.0017600783,0,0,0,59,5.756381903970572E-5,2.0324514E-5,2.0571053E-5,77,0,0,200,0,0
16060443,RoyceKoop,10,2014,377,472,15,14,47.253438798,40-49,618,5,34,51,85,85,34,51,7,2.4373642288,1326.4205505752,0.0649135051,0.1326330532,0.32331732,0,59,2.417958888637487E-4,2.3711934E-4,2.3999561E-4,175,27,2,200,2,0.01
16073380,Robert_L_Lewis,10,296,105,176,5,0,43.9901297188,40-49,383,3,5,10,15,15,5,10,7,3.0141202028,2.9074902172,0.0094442874,0.2095238095,0.4848485,0,59,8.876463664655879E-5,4.064903E-5,4.1142106E-5,175,0,0,200,0,0
16074963,jellys,10,773,98,101,1,16,41.0169426915,40-49,576,5,24,32,56,56,24,32,7,2.7049239681,154.5612447446,0.0209409353,0.1,0.2801282,0,59,1.276826417699127E-4,1.6937095E-4,1.7142543E-4,182,33,0,200,0,0
16075594,TicknerSafety,10,6556,198,116,3,14,47.474083749,40-49,696,7,8,8,16,16,8,8,7,3.2045619117,48.5497463047,0.0075652021,0.1916666667,0.26190478,0,59,7.501171431618696E-5,6.0973543E-5,6.171316E-5,175,45,0,200,0,0
16084787,RussNeverSleeps,10,1240,169,941,3,104,28.4966670546,20-29,549,5,3,10,13,13,3,10,7,2.9869659667,14.6435568296,0.0027123559,0.1538461538,0.29090908,0,59,6.17498752343475E-5,2.7099353E-5,2.742807E-5,175,1,1,200,1,0.005
16092905,nsleach,10,2372,464,942,11,1,43.4284567181,40-49,615,6,6,19,25,25,6,19,7,2.8055756698,95.9330302566,0.007202552,0.1283333333,0.3508772,0,59,7.437865254751998E-5,4.742387E-5,4.799912E-5,175,4,0,200,0,0
16116004,JPGallant,10,8333,371,398,13,32,56.7321433048,50-59,730,7,14,13,27,27,14,13,6,2.8330919623,536.0176371619,0.0271879507,0.1196581197,0.44852942,0,59,1.7744878223998687E-4,1.0162257E-4,1.02855265E-4,175,39,0,200,0,0
16124644,AaronGenest,10,6431,463,368,25,130,56.2019656577,50-59,720,7,25,14,39,39,25,14,7,2.8149891383,317.4326622136,0.0266683081,0.1349527665,0.46438748,0,59,1.68469374754649E-4,1.761458E-4,1.7828245E-4,25,65,0,200,0,0
16125720,heeeraldo,10,17863,644,423,52,415,55.3741466501,50-59,743,7,7,4,11,11,7,4,7,3.3406951484,31.3727799963,0.0050151109,0.0818181818,0.3809524,0,59,1.054523469896608E-4,5.4198706E-5,5.485614E-5,182,6,1,201,1,0.0049751244
16135612,leftcoastrant,10,5630,271,438,10,99,52.0959638817,50-59,706,7,60,80,140,140,60,80,6,2.3330919623,1621.7078008907,0.0572347446,0.1221479959,0.27099422,0,59,2.3390521456396763E-4,4.1326514E-4,4.1827807E-4,182,340,0,255,0,0
16180318,brentgranby,10,10953,1511,878,66,275,65.0243995061,60-69,740,7,93,84,177,177,93,84,6,2.3877624909,3496.4095545135,0.131008375,0.1154982024,0.27723312,0,59,6.440372526826496E-4,6.3683477E-4,6.445596E-4,182,41,0,199,0,0
16195210,markiglo,10,152,52,113,6,10,27.4575210956,20-29,395,3,1,1,2,2,1,1,8,3.8740043447,0,1.2977722658618618E-4,0,0,0,59,5.8358798694899036E-5,1.3549677E-5,1.3714035E-5,147,2,0,152,0,0
16208964,cheena1,10,15528,480,388,15,434,59.2691001995,50-59,739,8,109,97,206,206,109,97,6,2.3301955105,1583.8782014516,0.1259393931,0.1042386929,0.32542107,0,59,3.078692051909355E-4,7.452322E-4,7.542719E-4,77,30,2,200,2,0.01
16216473,Kevin_Wright,10,879,284,362,11,12,39.0933873671,30-39,556,5,64,88,152,152,64,88,6,2.3406951484,1266.0085656678,0.0952462075,0.1118856745,0.37666667,0,59,2.8504922455063693E-4,4.403645E-4,4.4570613E-4,25,24,2,200,2,0.01
16217176,mareMtl,10,6351,174,138,16,22,35.2105100481,30-39,682,6,1,2,3,3,1,2,7,2.9507959479,2763,8.095914281419891E-5,0,0,0,555,1.380466301787866E-4,1.3549677E-5,1.3714035E-5,25,0,1,200,1,0.005
16229679,katiegibbs,10,3166,1285,1704,63,3,51.5796678916,50-59,699,6,50,65,115,115,50,65,6,2.4482259232,10892.4147931073,0.0683040363,0.0669717773,0.21838687,0,59,4.680702738367736E-4,3.4551675E-4,3.497079E-4,77,39,0,200,0,0
16231046,cmor21,10,1590,775,1910,23,1,42.6930887726,40-49,621,5,5,7,12,12,5,7,7,3.0173787111,30.7033242281,0.0027920775,0.0909090909,0.18055555,0,59,7.453773446759547E-5,4.064903E-5,4.1142106E-5,175,1,0,200,0,0
16232438,danielleb_c,10,15384,277,191,12,52,50.0702521233,50-59,744,8,4,2,6,6,4,2,7,3.2994207096,7.2146952521,0.0026756907,0.1,0.15,0,59,6.232895507544186E-5,3.3874192E-5,3.4285087E-5,77,3,0,201,0,0
16239231,tatterededge,10,25099,204,253,6,209,48.8215518592,40-49,732,8,3,4,7,7,3,4,7,3.3964518465,2.0879160637,0.0020018161,0.0714285714,0.3,0,59,7.70146088667388E-5,2.7099353E-5,2.742807E-5,182,23,0,201,0,0
16261900,thibodeau,10,1346,350,452,20,29,59.1891028962,50-59,578,5,51,82,133,133,51,82,7,2.4380883418,282.1026937394,0.1007665646,0.2271018455,0.49498096,0,59,2.887005133292654E-4,3.522916E-4,3.565649E-4,25,2,3,200,3,0.015
16276647,HermanThind,10,4884,459,1192,6,114,46.1407684875,40-49,609,7,65,153,218,218,65,153,6,2.2154236061,5850.9746815418,0.0833936351,0.0943643512,0.257782,0,59,3.771687877925252E-4,4.4713932E-4,4.5256317E-4,175,37,0,204,0,0
16290583,vtoriaaa,10,1257,301,230,5,1,40.4146484394,40-49,584,5,25,25,50,50,25,25,7,2.8265749457,2324.1395338551,0.0302003478,0.1167346939,0.37878788,0,59,2.6839800473098507E-4,1.761458E-4,1.7828245E-4,25,12,0,200,0,0
16324671,GlenkArthur,10,6017,470,622,18,22,52.2867110491,50-59,700,7,25,38,63,63,25,38,6,2.6180304127,536.5523293407,0.0296850199,0.1216077829,0.3159112,0,59,1.5944006856597785E-4,1.761458E-4,1.7828245E-4,182,16,2,199,2,0.0100502513
16330729,phytolipide,10,3642,144,295,7,1,42.6485358358,40-49,643,6,9,21,30,30,9,21,7,2.7183200579,726.0230588888,0.0139140813,0.083908046,0.18774703,0,59,1.3113612753454611E-4,6.7748384E-5,6.8570174E-5,77,2,0,199,0,0
16382539,GlenStromquist,10,2467,156,183,8,75,47.2671768333,40-49,675,6,18,27,45,45,18,27,7,2.7816799421,708.4112801519,0.0157802015,0.1176767677,0.44712645,0,59,1.2600005174482845E-4,1.2872192E-4,1.3028333E-4,175,64,0,199,0,0
16405982,mooseandskwerl,10,31255,5213,4955,113,389,57.8237499901,50-59,776,8,85,94,179,179,85,94,7,2.433743664,7259.4364320111,0.0420980855,0.0539200301,0.23179333,0,59,4.2454153405858876E-4,5.826361E-4,5.897035E-4,175,96,1,204,1,0.0049019608
16425076,notsteveharper,10,6586,1053,1995,23,140,46.2028469115,40-49,697,7,37,68,105,105,37,68,6,2.3678493845,5178.3286534275,0.0638917041,0.052014652,0.1817988,0,59,2.7884924099167005E-4,2.5744384E-4,2.6056665E-4,175,153,0,203,0,0
16426890,Serg_7,10,6563,316,883,4,83,49.8461843374,40-49,714,7,0,2,2,2,0,2,6,3.4285714286,0,0,0.5,1,42,425,4.766339181938244E-5,0,6.8570175E-6,197,7,0,201,0,0
16434993,aaronleewudrick,10,5243,532,517,20,0,53.9818322152,50-59,739,7,49,66,115,115,49,66,6,2.4333816075,1988.1124721883,0.082976804,0.1346300534,0.29698458,0,59,4.4544835598012714E-4,3.387419E-4,3.4285086E-4,175,123,0,201,0,0
16437983,WilliamNorman,10,5968,1019,1737,45,37,47.3936575213,40-49,705,7,70,118,188,188,70,118,6,2.3979000724,5377.50365796,0.0857202301,0.1160826033,0.30133292,0,59,3.885597741782013E-4,4.8101353E-4,4.8684824E-4,175,20,2,200,2,0.01
16449405,craigcantin,10,848,1009,2000,54,0,43.1247367249,40-49,631,5,41,38,79,79,41,38,6,2.5159304852,3406.945009808,0.0715962191,0.0772476469,0.24782293,0,59,3.599664051922817E-4,2.845432E-4,2.8799474E-4,175,5,3,200,3,0.015
16469906,kusovski,10,4888,322,431,12,187,36.7915206845,30-39,676,6,42,54,96,96,42,54,7,2.4580014482,529.031500448,0.0657079755,0.1333333333,0.36523265,0,59,1.9292197447472753E-4,2.9131805E-4,2.9485175E-4,25,8,0,200,0,0
16493164,Kaymee,10,124705,2601,896,129,6625,59.4414934513,50-59,889,10,48,22,70,70,48,22,6,2.8569876901,880.0781990992,0.0289069307,0.0766045549,0.19566737,0,59,2.317832655994888E-4,3.3196708E-4,3.3599386E-4,77,101,0,201,0,0
16540752,chrisalecanada,10,5454,304,244,13,10,46.1366407646,40-49,664,6,13,12,25,25,13,12,7,2.8464880521,95.4676318982,0.018444809,0.1283333333,0.27631578,0,59,1.0739713916720326E-4,9.484774E-5,9.599824E-5,182,16,0,200,0,0
16546939,The_Jedinator,10,890,88,201,1,60,41.229222845,40-49,580,5,1,3,4,4,1,3,7,3.3392469225,0,0.0032224332,0.25,0.8333333,0,59,7.728334711640014E-5,1.3549677E-5,1.3714035E-5,77,2,0,200,0,0
16561725,Indefatigabl_,10,11872,603,732,22,326,47.897189982,40-49,732,7,31,40,71,71,31,40,6,2.377262853,2823.7667075984,0.0515564807,0.083501006,0.3372093,0,59,1.79097794870795E-4,2.1679483E-4,2.1942456E-4,77,8,0,198,0,0
16574552,jmtoriel,10,3164,692,1003,33,19,42.1185029582,40-49,626,6,19,29,48,48,19,29,6,2.5568428675,1497.6435341264,0.0407351701,0.1365248227,0.37142858,0,59,2.456840967308934E-4,1.3549677E-4,1.3714035E-4,182,3,1,199,1,0.0050251256
16580153,BrockWHarrison,10,7064,1748,899,53,3,58.8536455473,50-59,757,7,83,57,140,140,83,57,7,2.5818247647,3212.1939253793,0.0856948939,0.0951695786,0.24807692,0,59,6.093218948831536E-4,5.690864E-4,5.6913245E-4,175,72,2,200,2,0.01
16591660,sasquatchh,10,166,17,156,0,11,18.2613601291,10-19,102,2,4,21,25,25,4,21,6,2.5803765387,0.9498255583,0.0169350853,0.2716666667,0.6357143,0,59,7.405363460442407E-5,3.3874192E-5,3.4285087E-5,25,0,0,161,0,0
16591952,Jon_Tupper,10,13966,1507,634,45,14,61.0420031565,60-69,763,8,34,23,57,57,34,23,7,2.6937002172,404.2151912806,0.0401582493,0.1203007519,0.29492602,0,59,2.4067267847084942E-4,2.3711934E-4,2.3999561E-4,175,19,0,200,0,0
16627700,petermeyeer,10,1034,31,68,1,7,20.0862972944,20-29,466,5,0,1,1,1,0,1,7,4.3571428571,0,0,0,0,42,457,4.766339181938244E-5,0,6.8570175E-6,197,0,0,200,0,0
16727909,earthdroplet,10,311,63,181,0,12,18.0259694988,10-19,272,3,4,6,10,10,4,6,6,2.9898624185,8.0995832498,0.0041703419,0.1666666667,0.5952381,0,59,9.524488226102285E-5,3.3874192E-5,3.4285087E-5,77,1,0,200,0,0
16744001,shafto3,10,108,31,147,0,1,15.3271531957,10-19,71,1,2,5,7,7,2,5,7,2.6759594497,0.1358314182,0.0087015979,0.2142857143,0.65,0,59,5.663946277297581E-5,2.0324514E-5,2.0571053E-5,25,1,0,109,0,0
16747563,rvollo,10,514,109,392,2,0,41.5827178896,40-49,517,5,29,65,94,94,29,65,6,2.5079652426,197.5961476171,0.0300543639,0.1591169069,0.45929444,0,59,1.2960185341071812E-4,2.0324514E-4,2.0571053E-4,182,10,0,202,0,0
16751014,daroco,10,683,164,1149,0,4,19.7132662009,10-19,613,5,4,52,56,56,4,52,6,2.5130340333,54.744840182,0.0031080623,0.2753246753,0.44584206,0,59,5.817597661464268E-5,3.3874192E-5,3.4285087E-5,175,1,1,200,1,0.005
16751415,jamesphieffer,10,4433,719,1964,29,14,40.7467971585,40-49,625,6,11,43,54,54,11,43,7,2.5629978277,181.0643962205,0.0237937849,0.179944095,0.45847178,0,59,1.284367713016338E-4,8.129806E-5,8.228421E-5,175,1,1,199,1,0.0050251256
16753411,bubbles1286,10,427,25,62,0,50,17.8704577794,10-19,374,3,0,3,3,3,0,3,7,3.1740861383,0,0,0.3333333333,0.33333334,0,294,4.766339181938244E-5,0,6.8570175E-6,182,1,2,200,2,0.01
16795670,salwind,10,664,25,234,0,81,29.8594938538,20-29,334,5,4,16,20,20,4,16,7,2.7751629254,3.099705966,0.0041694944,0.2473684211,0.5147059,0,59,5.6123612924975786E-5,3.3874192E-5,3.4285087E-5,175,7,0,201,0,0
16811279,NickLane,10,122,43,239,1,8,23.4480957598,20-29,409,3,3,2,5,5,3,2,7,3.3537291818,0,0.001090035,0.15,1,0,59,5.1431889271254124E-5,2.7099353E-5,2.742807E-5,25,4,0,133,0,0
16826178,jewbrina,10,11714,157,544,0,1466,43.8250321774,40-49,715,7,0,4,4,4,0,4,7,3.5808903366,0,0,0.1666666667,0.25,0,585,4.766339181938244E-5,0,6.8570175E-6,175,8,0,200,0,0
16831607,aaronwebber,10,2708,313,165,13,2,34.1221809467,30-39,593,6,54,39,93,93,54,39,6,2.6926140478,577.9332096095,0.075801047,0.1331229547,0.40004522,0,59,2.9382545846811596E-4,3.726161E-4,3.7713596E-4,147,33,0,200,0,0
16832788,Koschany,10,741,429,132,24,1,43.1134987719,40-49,581,5,17,8,25,25,17,8,7,3.0524981897,37.4384063555,0.0390685574,0.18,0.4619883,0,59,4.625409539494251E-4,1.2194709E-4,1.2342632E-4,175,7,0,200,0,0
16871500,dawnskarma,10,1064,288,792,3,6,38.123867756,30-39,536,5,9,46,55,55,9,46,6,2.4377262853,754.0699168474,0.0159552129,0.1511784512,0.30772948,0,59,9.334114517529622E-5,6.7748384E-5,6.8570174E-5,77,5,0,195,0,0
16872938,lesiafed,10,8569,391,545,6,3423,47.7760993189,40-49,691,7,1,1,2,2,1,1,4,2.7142857143,0,8.457263651755744E-5,0,0,18,88,1.9588145204329276E-4,1.3549677E-5,1.3714035E-5,39,4,0,200,0,0
16877082,celesdavar,10,2516,875,264,30,15,43.5950734048,40-49,599,4,2,4,6,6,2,4,7,3.027878349,0.2558750398,0.0023119265,0.1333333333,0.3,0,59,5.228158286288721E-5,2.0324514E-5,2.0571053E-5,77,2,0,200,0,0
16912754,_amandamckenzie,10,487,246,433,13,1,33.6982990061,30-39,498,4,0,5,5,5,0,5,7,3.178791169,0,0,0.3,0.55,0,168,4.766339181938244E-5,0,6.8570175E-6,182,2,0,200,0,0
16971288,paulreniers,10,1341,333,1125,18,514,40.3386412651,40-49,542,5,34,83,117,117,34,83,6,2.4315713251,892.6576559419,0.0625488553,0.1296050693,0.30861422,0,59,2.1517040200971693E-4,2.3711934E-4,2.3999561E-4,182,2,0,199,0,0
16976126,janniaragon,10,105335,4001,3885,315,5326,57.0731509094,50-59,876,10,54,56,110,110,54,56,6,2.5209992759,4973.1564796946,0.0665569934,0.0689741451,0.18882434,0,59,3.227871467219842E-4,3.726161E-4,3.7713596E-4,182,78,0,201,0,0
16982873,VICTORIANICKERS,10,3397,280,355,9,3,53.8156580666,50-59,673,6,4,8,12,12,4,8,7,2.89608979,19.6630309219,0.0081162033,0.1212121212,0.48214287,0,59,7.898032147444589E-5,3.3874192E-5,3.4285087E-5,147,0,0,200,0,0
17031126,exovirtuelle,10,15742,3017,1157,125,6,61.5731182463,60-69,778,7,29,16,45,45,29,16,6,2.5691527878,689.1572974429,0.0339982798,0.098989899,0.30645162,0,59,1.8216142133381757E-4,2.0324514E-4,2.0571053E-4,145,14,0,200,0,0
17076793,wjordan,10,13806,551,700,27,1325,54.0132586554,50-59,738,8,38,45,83,83,38,45,6,2.4688631427,1867.0833537095,0.0532725722,0.0609756098,0.3076241,0,59,1.819790580812805E-4,2.642187E-4,2.674237E-4,77,5,1,201,1,0.0049751244
17116017,Pple1st,10,4979,395,540,13,891,48.561716097,40-49,690,7,80,108,188,188,80,108,6,2.2621288921,2222.4720821551,0.0960061233,0.095574013,0.32716128,0,59,2.515224881405701E-4,5.487619E-4,5.5541843E-4,77,61,1,201,1,0.0049751244
17141770,bpellerin,10,7688,781,113,56,0,55.2110878085,50-59,711,7,68,16,84,84,68,16,7,2.7132512672,472.6890005301,0.0944912055,0.1189041882,0.23173515,0,59,5.20665134713088E-4,4.6746383E-4,4.5942017E-4,175,58,2,202,2,0.0099009901
17161553,PeeJayAitch,10,2016,425,478,16,3,49.6893607792,40-49,697,5,26,26,52,52,26,26,7,2.8638667632,1048.1219050745,0.014583716,0.0972850679,0.26386914,0,59,2.1284080235572017E-4,1.8292063E-4,1.8513948E-4,182,227,0,200,0,0
17163145,JeffAtkinson,10,138,132,105,0,0,20.1280444826,20-29,470,3,36,34,70,70,36,34,6,2.5333091962,98.2771400338,0.0703526251,0.1507246377,0.47576532,0,59,1.9554516195423817E-4,2.5066902E-4,2.5370964E-4,25,4,0,137,0,0
17171476,rzypci,10,11278,250,285,5,645,46.8245462345,40-49,714,7,7,9,16,16,7,9,7,2.9656046343,4877.0636193817,0.0128789141,0.05,0.15454546,0,59,1.754966260904879E-4,5.4198706E-5,5.485614E-5,25,16,0,200,0,0
17172569,desireeatx,10,351,27,137,0,20,18.137015845,10-19,322,4,1,0,1,1,1,0,0,0,0,8.51326861236383E-5,0,0,0,55,8.902408629526586E-5,1.3549677E-5,0,175,0,1,201,1,0.0049751244
17220578,jeffnagel,10,6514,2638,348,169,56,54.2975650384,50-59,741,7,74,11,85,85,74,11,6,2.7559739319,435.1387409544,0.078991884,0.1337535014,0.23877193,0,59,4.464154889659097E-4,5.081129E-4,5.142763E-4,182,27,0,200,0,0
17394041,SDBSmith,10,393,19,128,0,11,21.6826995451,20-29,193,4,2,21,23,23,2,21,6,2.5365677046,4.0368043527,0.0036428126,0.2766798419,0.4952381,0,59,5.7283960538536256E-5,2.0324514E-5,2.0571053E-5,175,3,3,201,3,0.0149253731
17414861,SusanHaines,10,244,85,315,0,4,22.4787608792,20-29,418,4,2,51,53,53,2,51,6,2.4963794352,11.8582332495,0.0067384164,0.3022496372,0.49736047,0,59,5.799808040405623E-5,2.0324514E-5,2.0571053E-5,175,0,0,200,0,0
17428471,AlfredLam,10,18446,782,1336,21,1080,63.7284756781,60-69,757,8,3,16,19,19,3,16,7,2.9178131789,24.0755545596,0.0020189096,0.1111111111,0.16176471,0,59,5.778944936696881E-5,2.7099353E-5,2.742807E-5,175,3,0,200,0,0
17443632,AbeOudshoorn,10,5457,1420,400,75,53,61.8085144614,60-69,765,7,39,22,61,61,39,22,7,2.9800868936,335.2029086304,0.029532286,0.0773224044,0.2621951,0,59,2.3160454010327035E-4,2.7099354E-4,2.742807E-4,175,71,0,200,0,0
17458850,DanPaulOwen,10,2213,107,223,3,15,33.9676450898,30-39,622,5,17,40,57,57,17,40,6,2.622737147,133.4996512254,0.0303271165,0.1817042607,0.4121212,0,59,1.142370271152601E-4,1.2194709E-4,1.2342632E-4,25,8,0,200,0,0
17469300,robinmowat,10,4664,338,274,27,9,44.1069529694,40-49,659,6,18,23,41,41,18,23,7,2.8157132513,112.110000752,0.0178661433,0.1292682927,0.34252873,0,59,1.2350997832186764E-4,1.2872192E-4,1.3028333E-4,175,1,1,200,1,0.005
17522320,suehammell,10,260,817,228,53,4,45.7134046399,40-49,624,3,74,24,98,98,74,24,7,2.8084721217,3195.7382871351,0.0936016874,0.1878813381,0.38583604,0,59,3.75648365922708E-4,5.081129E-4,5.142763E-4,182,30,0,200,0,0
17535515,crowles,10,763,183,494,5,10,39.2213949689,30-39,537,5,20,45,65,65,20,45,6,2.6571325127,260.3813040113,0.0293832526,0.1992788462,0.4780392,0,59,2.178115739747831E-4,1.422716E-4,1.4399737E-4,175,3,1,199,1,0.0050251256
17546540,nickcott,10,7150,385,1445,17,40,47.4630905691,40-49,733,7,16,77,93,93,16,77,6,2.3435916003,6235.8614157555,0.026707895,0.1686535764,0.36180487,0,59,2.3773123905549185E-4,1.1517225E-4,1.16569296E-4,175,4,0,201,0,0
17568019,pattibacchus,10,9577,2859,1208,153,37,57.0007194878,50-59,777,7,118,61,179,179,118,61,6,2.6256335988,4235.824528034,0.1198626141,0.0901073379,0.2512718,0,59,6.629539370800779E-4,8.0620573E-4,8.159851E-4,182,99,0,200,0,0
17628505,renodiva,10,284,1183,1600,47,162,32.9803917568,30-39,558,4,2,9,11,11,2,9,7,3.1379435192,19.0639059326,0.002274017,0.1363636364,0.3472222,0,59,7.185702065585463E-5,2.0324514E-5,2.0571053E-5,182,11,0,200,0,0
17686959,thepoliticalcat,10,75621,4670,4317,207,1085,55.7769399012,50-59,791,10,20,18,38,38,20,18,6,2.7776973208,653.3969761851,0.0170930897,0.0476529161,0.33684212,0,59,1.2309925780738763E-4,1.422716E-4,1.4399737E-4,77,5,0,201,0,0
17735910,Hankers,10,13559,192,232,6,4,50.3878706857,50-59,714,7,16,18,34,34,16,18,7,2.79217958,33.358539445,0.0134765205,0.1532976827,0.5652174,0,59,1.1221607850481915E-4,1.1517225E-4,1.16569296E-4,175,28,0,199,0,0
17738467,tylercameron,10,9236,1282,614,46,1139,55.278611061,50-59,727,7,44,36,80,80,44,36,7,2.6716147719,21936.6803606509,0.0518333743,0.1121835443,0.24776785,0,59,3.871903140997503E-4,3.0486772E-4,3.0170876E-4,175,45,0,200,0,0
17763554,mickpanko,10,2035,844,1508,31,181,52.8276263017,50-59,676,6,2,6,8,8,2,6,7,3.1176683563,0,0.0014565134,0.2678571429,0.93333334,0,59,5.431277083031537E-5,2.0324514E-5,2.0571053E-5,25,3,0,200,0,0
17781921,MichaelErskine,10,631,48,79,0,0,28.30492051,20-29,489,4,6,7,13,13,6,7,7,2.8559015206,0.9968397583,0.0128073171,0.2243589744,0.8472222,0,59,7.531951515036513E-5,4.742387E-5,4.799912E-5,175,0,0,200,0,0
17809788,Falsum,10,11266,279,299,18,35,49.2118825318,40-49,751,7,13,12,25,25,13,12,7,2.659666908,63.851751784,0.025922437,0.125,0.31578946,0,59,9.543995158668211E-5,9.484774E-5,9.599824E-5,77,4,0,202,0,0
17824049,gjhall,10,5295,463,496,12,12,,,675,7,23,33,56,56,23,33,7,2.7744388125,194.8179772074,0.0365556106,0.1642857143,0.38648948,0,59,2.82122198932847E-4,1.6259612E-4,1.6456842E-4,175,6,0,200,0,0
17826663,danielletakacs,10,3965,559,230,20,52,49.5619223067,40-49,703,6,35,27,62,62,35,27,7,2.6567704562,957.534642314,0.057188928,0.1377578001,0.3979798,0,59,2.65421964630527E-4,2.4389417E-4,2.4685264E-4,175,38,0,200,0,0
17850064,CEamer,10,5606,382,553,34,0,46.0314038369,40-49,671,7,10,32,42,42,10,32,6,2.5695148443,3322.7418655218,0.028028344,0.1544715447,0.3910985,0,59,1.4117077888552593E-4,7.452322E-5,7.542719E-5,175,8,2,200,2,0.01
17869751,peterburbidge,10,1684,75,148,1,46,36.0739828237,30-39,631,6,28,50,78,78,28,50,6,2.3892107169,696.0550880715,0.060233073,0.145021645,0.4353599,0,59,1.3698160498930425E-4,1.9647031E-4,1.9885351E-4,25,7,2,200,2,0.01
17881831,jjbreakspear,10,5515,1030,913,31,6,59.1837059175,50-59,714,7,35,56,91,91,35,56,6,2.4971035482,871.4257643114,0.0587120333,0.1147741148,0.29016683,0,59,2.52530277326011E-4,2.4389417E-4,2.4685264E-4,182,12,0,200,0,0
17929477,pepprspraypatti,10,3033,52,203,5,379,43.3825544823,40-49,615,5,0,3,3,3,0,3,7,3.2005066956,0,0,0.1666666667,0.16666667,0,286,4.766339181938244E-5,0,6.8570175E-6,77,1,0,201,0,0
17934964,KMason_Wpg,10,4379,437,1254,7,35,55.7071463136,50-59,702,7,21,60,81,81,21,60,6,2.4710354815,1214.4348457054,0.0323361789,0.1672839506,0.36993006,0,59,1.1876895587970281E-4,1.4904643E-4,1.5085438E-4,25,20,0,200,0,0
17956672,csteffensen,10,677,47,309,2,773,24.6359149545,20-29,530,4,13,54,67,67,13,54,6,2.4033309196,145.3579581826,0.0306032021,0.2148349163,0.4228675,0,59,9.618340760694007E-5,9.484774E-5,9.599824E-5,25,1,3,200,3,0.015
18002867,Charles_K,10,8062,342,312,5,16,57.813961051,50-59,636,6,13,16,29,29,13,16,7,2.9290369298,62.0518328209,0.0173751547,0.1514778325,0.33982685,0,59,1.0164797475718737E-4,9.484774E-5,9.599824E-5,175,10,1,198,1,0.0050505051
18004988,Darkcreations,10,7105,319,499,10,4,41.0208098071,40-49,662,6,2,2,4,4,2,2,7,2.792903693,0,0.010412904,0.0833333333,1,0,59,6.138841666466816E-5,2.0324514E-5,2.0571053E-5,175,0,0,200,0,0
18040291,ovadosepeace,10,6537,417,1828,13,4,43.2590093502,40-49,618,6,2,5,7,7,2,5,7,3.0619116582,31.1169624742,9.346369051570256E-4,0.0476190476,0.2,0,59,5.204798738118303E-5,2.0324514E-5,2.0571053E-5,77,3,0,201,0,0
18049661,mkuzio,10,1332,488,1804,12,0,42.1063000183,40-49,545,5,8,57,65,65,8,57,6,2.4217958001,521.2282424894,0.0104881786,0.1396634615,0.26346037,0,59,9.405726589193434E-5,6.0973543E-5,6.171316E-5,175,10,1,200,1,0.005
18074404,steve_kee,10,12820,4835,1013,6,3,52.9295150487,50-59,699,7,5,13,18,18,5,13,7,2.963070239,7073.4052875028,0.0034529309,0.1013071895,0.2032967,0,59,9.34183442622178E-5,4.064903E-5,4.1142106E-5,175,23,0,200,0,0
18083531,VanCourierNews,10,11240,15194,4882,860,4,59.9676042175,50-59,774,7,120,42,162,162,120,42,6,2.585807386,8673.8763721626,0.1019780277,0.0661759068,0.15397392,0,59,7.158702676915325E-4,8.197554E-4,8.159851E-4,182,34,0,200,0,0
18117300,Proud_Canadian1,10,28828,1349,1676,73,178,46.2358011371,40-49,780,8,83,79,162,162,83,79,6,2.3193338161,9759.8448654805,0.1154907531,0.0544820183,0.17889908,0,59,5.056655740108458E-4,5.690864E-4,5.759895E-4,175,113,3,217,3,0.0138248848
18125387,amykishek,10,9883,646,610,24,5,43.2879835994,40-49,652,7,47,52,99,99,47,52,6,2.5586531499,3459.825787503,0.0828805436,0.1282209854,0.34265602,0,59,3.5941585787581284E-4,3.2519223E-4,3.2913685E-4,25,13,0,200,0,0
18200731,Gregor_Ash,10,6392,1832,1494,62,80,54.3009186283,50-59,728,7,95,90,185,185,95,90,6,2.4384503983,5571.0229725168,0.1112697941,0.1002350176,0.27597404,0,59,5.296345225438855E-4,6.5038446E-4,6.582737E-4,147,152,1,200,1,0.005
18253198,mensaghic,10,3604,184,284,1,7,40.2322936605,40-49,659,6,14,26,40,40,14,26,7,2.716871832,42.9916110001,0.0121470543,0.1538461538,0.42528737,0,59,1.0044290821384716E-4,1.0162257E-4,1.02855265E-4,175,11,1,200,1,0.005
18307401,raytomlin,10,2691,278,515,5,4,44.9359626694,40-49,659,6,18,37,55,55,18,37,7,2.6321506155,740.7633921805,0.0174350513,0.1104377104,0.3025641,0,59,1.249406497716646E-4,1.2872192E-4,1.3028333E-4,182,10,0,200,0,0
18308001,reirode,10,159,224,387,8,2,39.9234101618,30-39,601,3,1,1,2,2,1,1,1,1,0,8.095914281419891E-5,0,0,84,180,3.177448371356425E-4,1.3549677E-5,1.3714035E-5,96,3,0,161,0,0
18309992,ltrouble1,10,1094,151,339,2,2,36.4881222083,30-39,578,5,22,57,79,79,22,57,7,2.536929761,786.8179025968,0.0483771779,0.1814345992,0.42411423,0,59,3.2275347934149E-4,1.5582128E-4,1.577114E-4,25,12,6,200,6,0.03
18343975,danielefrank,10,553,18,97,0,4,16.1871305869,10-19,338,4,1,5,6,6,1,5,7,3.2204923968,0.1114071732,5.530520325598758E-4,0.1333333333,0.2,0,59,5.109304639811673E-5,1.3549677E-5,1.3714035E-5,182,0,0,200,0,0
18360735,suepeac,10,1921,74,131,0,43,25.0560438135,20-29,549,6,7,14,21,21,7,14,6,2.7092686459,77.9840051435,0.0065958117,0.1523809524,0.30392158,0,59,7.609196380552945E-5,5.4198706E-5,5.485614E-5,175,3,0,200,0,0
18435883,Dwayne_Nashkawa,10,1428,542,634,18,79,42.2037061962,40-49,629,5,19,25,44,44,19,25,6,2.8073859522,857.7925878963,0.0160968457,0.0861522199,0.20643939,0,59,1.4110622513532E-4,1.3549677E-4,1.3714035E-4,77,0,0,199,0,0
18445844,ocean_raven,10,21402,2020,2084,40,41,45.0583748596,40-49,693,7,6,13,19,19,6,13,6,2.6042722665,267.6719348687,0.0151726029,0.0584795322,0.18589744,0,59,7.315005964636702E-5,4.742387E-5,4.799912E-5,77,0,0,199,0,0
18460152,seanshaw,10,8917,718,496,50,6,50.5050055434,50-59,747,7,30,31,61,61,30,31,7,2.7451122375,703.5766104753,0.0288504862,0.0975409836,0.365722,0,59,1.8725886180475014E-4,2.1001999E-4,2.1256754E-4,25,74,2,200,2,0.01
18464551,germstv,10,6604,351,446,8,2330,47.8179767899,40-49,694,7,53,74,127,127,53,74,6,2.3732802317,1378.58672659,0.0656425086,0.073615798,0.329009,0,59,1.9218147087198356E-4,3.6584126E-4,3.7027895E-4,77,50,0,200,0,0
18572843,rocksolidcoach,10,1239,868,147,47,1,42.1410663496,40-49,621,4,4,1,5,5,4,1,7,3.2939898624,1.9210428283,0.0021487044,0.15,0.15,0,59,6.157420278447213E-5,3.3874192E-5,3.4285087E-5,182,20,0,200,0,0
18589172,WinstonCN,10,9863,972,68,50,0,56.316598185,50-59,727,8,11,0,11,11,11,0,0,0,0,0.004879909,0.1454545455,0.26363635,0,36,9.665365708681605E-5,8.129806E-5,0,175,5,3,201,3,0.0149253731
18592513,Ivan_Avery_Frey,10,83,13,19,0,0,12.3207895825,10-19,53,2,0,0,0,0,0,0,0,0,0,0,0,0,88,193,4.766339181938244E-5,0,0,79,0,0,86,0,0
18703833,kerrie12345,10,102,17,48,0,5,17.5152534531,10-19,239,3,2,5,7,7,2,5,7,2.9228819696,0.2156457771,0.0028826289,0.2142857143,0.65,0,59,5.739845538849406E-5,2.0324514E-5,2.0571053E-5,182,0,1,116,1,0.0086206897
18722095,richardfromm,10,2080,89,341,0,8,30.08996201,30-39,609,6,7,36,43,43,7,36,7,2.6705286025,327.1540077194,0.0101820722,0.1749723145,0.37268847,0,59,9.845643821081791E-5,5.4198706E-5,5.485614E-5,175,8,0,199,0,0
18746292,katewerk,10,6463,1330,319,54,9,58.0203232625,50-59,753,7,80,24,104,104,80,24,7,2.725923244,1804.230321554,0.0521448577,0.1080097087,0.21460675,0,59,5.497346580828796E-4,5.487619E-4,5.5541843E-4,175,94,0,194,0,0
18773366,SouthAfricaInfo,10,1884,293,33,7,1,25.8527716245,20-29,468,0,0,0,0,0,0,0,0,0,0,0,0,0,27,101,4.766339181938244E-5,0,0,24,0,0,200,0,0
18815141,katherineruta,10,1503,237,459,8,14,41.018791357,40-49,597,5,5,9,14,14,5,9,7,2.8251267198,40.0521695268,0.0108334292,0.0604395604,0.22222222,0,59,7.860878704539452E-5,4.064903E-5,4.1142106E-5,77,8,0,200,0,0
18855629,usacycling,10,8557,30274,557,1115,29,64.5625489293,60-69,818,7,1,0,1,1,1,0,0,0,0,1.1657741462183257E-4,0,0,0,46,4.985949819020907E-5,1.3549677E-5,0,175,14,0,200,0,0
18875010,slowmanluis,10,2736,105,92,0,203,43.7519730397,40-49,661,6,25,22,47,47,25,22,7,2.7700941347,242.6244156116,0.0204783062,0.1225716929,0.4294355,0,59,1.2191777207854821E-4,1.761458E-4,1.7828245E-4,182,68,0,200,0,0
18909549,mbarlondsmith,10,10631,489,1236,3,129,52.9338134176,50-59,595,7,4,14,18,18,4,14,6,2.6531498914,67.6874791178,0.0130102034,0.0980392157,0.23626374,0,59,6.423785715334653E-5,3.3874192E-5,3.4285087E-5,77,3,0,200,0,0
18929837,musicbaum,10,37331,1317,1694,29,3715,55.1083842775,50-59,785,9,16,20,36,36,16,20,7,2.6708906589,674.380617023,0.0202992774,0.0682539683,0.30952382,0,59,1.255552811412676E-4,1.1517225E-4,1.16569296E-4,175,9,0,202,0,0
18999763,CBCCommunity,10,20965,7030,1388,417,92,62.3915199555,60-69,786,8,100,26,126,126,100,26,6,2.6180304127,2598.5472070133,0.1243965898,0.0639365079,0.12527473,0,59,5.63235544109298E-4,6.8425864E-4,6.857017E-4,175,30,0,200,0,0
19006592,jmrob,10,7127,719,1355,15,202,45.0039590837,40-49,688,7,58,98,156,156,58,98,6,2.3519188993,7286.6935456765,0.0950221611,0.0970223325,0.31572327,0,59,3.1747694257718256E-4,3.9971547E-4,4.0456402E-4,77,20,1,202,1,0.004950495
19009348,BumfOnline,10,1698,122,315,2,9,45.80474392,40-49,582,5,6,9,15,15,6,9,7,2.9475018103,26.4801706719,0.0068538821,0.119047619,0.47777778,0,59,8.959494023957914E-5,4.742387E-5,4.799912E-5,175,11,0,200,0,0
19033312,seanneilbarron,10,1293,195,470,6,12,26.0762744646,20-29,564,5,4,12,16,16,4,12,7,2.773352643,10.6149214145,0.0019912722,0.1625,0.3939394,0,59,5.880067024446695E-5,3.3874192E-5,3.4285087E-5,25,2,2,199,2,0.0100502513
19038416,christellar,10,47980,3784,4158,313,1292,53.6314052738,50-59,799,9,115,152,267,267,115,152,6,2.2809558291,13158.6644794613,0.1225239496,0.0574469883,0.22460552,0,59,4.4622496368547767E-4,7.8588125E-4,7.9541403E-4,77,58,0,200,0,0
19041013,Bottie,10,10455,182,261,19,196,45.0301500293,40-49,712,7,3,3,6,6,3,3,7,3.4858797972,18.3227839994,7.692969730863337E-4,0,0,0,59,9.667228895847535E-5,2.7099353E-5,2.742807E-5,147,1,0,200,0,0
19082794,TehForgottenMan,10,14537,463,404,36,26,49.4363429925,40-49,760,8,71,40,111,111,71,40,6,2.4475018103,824.2733742938,0.0939377206,0.1194922195,0.31806722,0,59,2.528474046627654E-4,4.8778835E-4,4.937053E-4,77,15,1,201,1,0.0049751244
19092673,mattcasselman,10,750,222,79,8,10,43.4905414775,40-49,588,5,11,8,19,19,11,8,7,2.8924692252,10.2596919622,0.0139793666,0.1578947368,0.53846157,0,59,1.2739454601183565E-4,8.129806E-5,8.228421E-5,175,10,1,200,1,0.005
19110210,una1rose,10,12522,822,1751,22,46,46.1403856507,40-49,685,7,11,42,53,53,11,42,6,2.5687907314,4343.9531766936,0.0132918249,0.1150217707,0.22093023,0,59,9.704136372199615E-5,8.129806E-5,8.228421E-5,25,2,1,199,1,0.0050251256
19185104,peterh68,10,571,356,873,7,3,39.3667751831,30-39,508,5,8,33,41,41,8,33,7,2.4482259232,112.1405062416,0.0053487454,0.1695121951,0.3409091,0,59,6.440722095699255E-5,6.0973543E-5,6.171316E-5,175,2,0,200,0,0
19216420,davehuehn,10,88,73,347,3,3,24.1736188638,20-29,213,2,10,78,88,88,10,78,6,2.3689355539,100.3126050292,0.0145866256,0.2941483804,0.53927296,0,59,8.302489820100085E-5,7.452322E-5,7.542719E-5,25,2,0,89,0,0
19221008,Hepworks,10,6563,465,994,3,46,53.9287494161,50-59,690,6,36,77,113,113,36,77,6,2.302679218,2460.2431802687,0.0628925686,0.0973451327,0.24915966,0,59,2.837811434242163E-4,2.5066902E-4,2.5370964E-4,77,11,0,200,0,0
19261628,johnpegan,10,1921,277,249,24,7,35.7921457295,30-39,597,5,3,4,7,7,3,4,7,3.1035481535,713.7663568543,0.0082037513,0.0476190476,0.16666667,0,59,1.4038966322778523E-4,2.7099353E-5,2.742807E-5,182,0,0,200,0,0
19388993,jrdnovotny,10,1419,290,574,2,12,43.7215944128,40-49,607,6,12,30,42,42,12,30,6,2.5550325851,533.6949950976,0.0172281565,0.0801393728,0.23563218,0,59,8.874107224026334E-5,8.80729E-5,8.914123E-5,175,24,1,202,1,0.004950495
19422472,eganwrites,10,326,465,672,6,82,41.6128282593,40-49,610,5,2,7,9,9,2,7,7,2.9406227371,6.1659585019,0.0076451678,0.2083333333,0.6904762,0,59,7.15416634480453E-5,2.0324514E-5,2.0571053E-5,175,6,0,201,0,0
19492704,Andrew_MTL,10,3439,100,140,2,7,41.1112590993,40-49,654,6,1,8,9,9,1,8,7,2.9605358436,51.4738846944,9.569557519585276E-5,0.1388888889,0.2857143,0,59,5.9332207829924095E-5,1.3549677E-5,1.3714035E-5,175,7,0,199,0,0
19515093,GeorgesAvecLada,10,2134,412,873,17,1,36.8065842947,30-39,593,5,2,8,10,10,2,8,7,3.2041998552,26.4716169872,0.0012274537,0.0222222222,0.05357143,0,59,6.685719971222048E-5,2.0324514E-5,2.0571053E-5,175,1,0,199,0,0
19568866,SheikYurbouti,10,40723,327,278,41,1,46.4424353748,40-49,785,8,4,9,13,13,4,9,6,2.7005792904,1.173348375,0.0210393999,0.2115384615,0.6,0,59,7.337288616568902E-5,3.3874192E-5,3.4285087E-5,175,6,21,200,21,0.105
19572099,SaraEhrhardt,10,323,449,158,27,4,61.3068517686,60-69,590,4,33,12,45,45,33,12,7,3.0807385952,127.3176124509,0.0393718585,0.2045454545,0.5157658,0,59,2.0905546780725784E-4,2.303445E-4,2.3313859E-4,147,79,0,200,0,0
19631069,iainmarlow,10,10155,4139,986,241,24,59.3654403579,50-59,771,7,46,4,50,50,46,4,7,3.217595945,137.7369744534,0.0961610727,0.16,0.23891844,0,59,7.286429008038873E-4,3.1841738E-4,3.222798E-4,175,29,1,200,1,0.005
19632886,RosaTaggart,10,1714,99,135,5,24,41.5264192609,40-49,593,5,5,5,10,10,5,5,8,3.3204199855,24.8985454652,0.00136413,0.0888888889,0.5,0,59,7.215840900897663E-5,4.064903E-5,4.1142106E-5,175,47,0,200,0,0
19801613,orangeclockwork,10,2127,101,91,5,5,32.395051775,30-39,527,5,1,3,4,4,1,3,7,3.2494569153,0,0.0012164499,0.25,1,0,59,5.071094919721041E-5,1.3549677E-5,1.3714035E-5,25,2,0,200,0,0
19801825,mari_katz,10,3409,160,440,4,57,29.4661261423,20-29,608,6,21,51,72,72,21,51,7,2.5959449674,88.6032243669,0.0313624286,0.1971830986,0.42435065,0,59,1.0632513351666179E-4,1.4904643E-4,1.5085438E-4,25,5,0,199,0,0
19824615,GregPorter11,10,549,72,127,2,2,39.0725134732,30-39,499,5,1,7,8,8,1,7,7,3.1393917451,2.1821749721,1.7316960013171034E-4,0.1071428571,0.16666667,0,59,4.955437648162481E-5,1.3549677E-5,1.3714035E-5,182,4,0,200,0,0
19825011,Jamie_Brace,10,11335,687,1009,11,2020,51.4612116098,50-59,745,8,41,65,106,106,41,65,7,2.5394641564,1424.3117952469,0.0612158336,0.1150044924,0.2947053,0,59,3.2963207723069266E-4,2.845432E-4,2.8799474E-4,147,98,1,205,1,0.0048780488
20001199,idlehands85,10,1141,89,223,2,13,25.903489949,20-29,470,4,0,7,7,7,0,7,7,2.9388346001,0,0,0.2857142857,0.35714287,0,674,4.766339181938244E-5,0,6.8570175E-6,77,1,0,201,0,0
20020860,NaturesYear,10,307,202,49,13,3,44.7947733319,40-49,561,3,2,2,4,4,2,2,7,3.1375814627,4.4085739284,0.0034142775,0.0833333333,0.5,0,59,6.056654819830694E-5,2.0324514E-5,2.0571053E-5,175,3,0,200,0,0
20023516,JohnRiche,10,7837,924,1763,18,637,62.4224574646,60-69,763,7,52,111,163,163,52,111,6,2.3316437364,6349.3762328824,0.0648175997,0.097061274,0.2640731,0,59,3.0223137870712195E-4,3.590664E-4,3.6342192E-4,147,123,0,203,0,0
20078507,junekaiser,10,611,180,435,5,38,38.3008201669,30-39,504,5,18,48,66,66,18,48,6,2.4985517741,538.3013299204,0.0386335939,0.1641025641,0.40857142,0,59,1.2147543560658902E-4,1.2872192E-4,1.3028333E-4,182,3,1,200,1,0.005
20212493,GalexanderS,10,3236,175,393,2,4,57.2683255096,50-59,647,6,0,3,3,3,0,3,7,3.6478465436,0,0,0.1666666667,0.16666667,0,588,4.766339181938244E-5,0,6.8570175E-6,175,1,0,200,0,0
20245961,oldgrover,10,1968,77,152,3,20,25.8835190877,20-29,571,5,1,3,4,4,1,3,7,3.3664011586,0.4062975625,7.042199441008592E-4,0.0833333333,0.16666667,0,59,6.54787730174446E-5,1.3549677E-5,1.3714035E-5,175,0,0,200,0,0
20268038,FamilyAction,10,27,401,81,21,1,39.5768660469,30-39,574,5,10,3,13,13,10,3,7,2.9652425778,3.5296406758,0.019093115,0.1730769231,0.45454547,0,59,1.3710045504694535E-4,7.452322E-5,7.542719E-5,175,0,0,28,0,0
20370879,Oemissions,10,38737,504,1540,17,39,48.4386491914,40-49,674,9,44,86,130,130,44,86,6,2.4073135409,2152.0350706204,0.0685772163,0.124090638,0.24634726,0,59,1.977246665737141E-4,3.0486772E-4,3.085658E-4,77,10,0,210,0,0
20456667,NomfundoEngler,10,13251,1423,1148,8,784,58.4434283339,50-59,771,8,11,14,25,25,11,14,8,3.8218682114,52893.4147154483,9.573327737339303E-4,0.0483333333,0.1360294,0,59,4.428795753753939E-4,8.129806E-5,7.542719E-5,131,32,0,202,0,0
20466807,visualcreative,10,4429,1267,1897,52,15,40.0852160733,40-49,619,6,8,30,38,38,8,30,6,2.5629978277,55.2618826679,0.0163769916,0.1834992888,0.3465909,0,59,9.541090070785076E-5,6.0973543E-5,6.171316E-5,77,2,0,199,0,0
20495800,LombardiMike,10,3997,1606,1950,85,40,48.7757054335,40-49,712,6,74,95,169,169,74,95,6,2.3928312817,7613.7708011152,0.094580107,0.0730135249,0.3174837,0,59,4.931724902490304E-4,5.081129E-4,5.142763E-4,182,14,0,200,0,0
20610001,cyberclark,10,92,5,31,0,0,11.7341444214,10-19,55,1,0,1,1,1,0,1,7,3.699601882,0,0,0,0,0,365,4.766339181938244E-5,0,6.8570175E-6,175,3,0,99,0,0
20622618,xauriel,10,309,21,86,5,0,21.431450513,20-29,241,2,0,2,2,2,0,2,7,3.2406804198,0,0,0.5,0.5,0,622,4.766339181938244E-5,0,6.8570175E-6,77,0,0,200,0,0
20623400,ItsGodzirra,10,13683,1044,904,31,472,53.9094061311,50-59,758,8,49,52,101,101,49,52,7,2.5702389573,1076.2127930331,0.0254616282,0.0907920792,0.38530466,0,59,2.9076336229298303E-4,3.387419E-4,3.4285086E-4,175,52,2,200,2,0.01
20636473,djsaiyan,10,9160,459,803,9,7,36.5523304446,30-39,679,6,0,0,0,0,0,0,0,0,0,0,0,0,86,188,4.766339181938244E-5,0,0,76,1,0,200,0,0
20653699,sunraec,10,968,97,250,1,95,27.6192755222,20-29,478,4,4,9,13,13,4,9,6,2.6198406951,7.3724469402,0.0162794604,0.1794871795,0.5833333,0,59,8.449551191303301E-5,3.3874192E-5,3.4285087E-5,182,1,0,199,0,0
20679494,ibushfield,10,5244,1034,1523,50,7,61.5122401161,60-69,686,6,78,147,225,225,78,147,6,2.2288196959,16483.7585081334,0.1261779855,0.0776984127,0.22550221,0,59,6.57958700840686E-4,5.352122E-4,5.4170436E-4,182,19,0,200,0,0
20697134,briannemett,10,7236,446,681,11,1177,49.7823212376,40-49,721,8,33,61,94,94,33,61,6,2.4764663287,549.896222068,0.062630586,0.1262868909,0.36480185,0,59,2.0326109402902707E-4,2.303445E-4,2.2628158E-4,77,8,0,200,0,0
20753028,JohnCollison,10,33890,833,57,38,7,43.8559858904,40-49,782,9,40,3,43,43,40,3,7,3.3272990587,120.711891099,0.0433643488,0.1284606866,0.24038461,0,59,2.1471968466058288E-4,2.7776835E-4,2.811377E-4,77,12,0,200,0,0
20883508,dicandia,10,352,221,372,3,3,25.9656331489,20-29,515,4,69,61,130,130,69,61,6,2.5159304852,835.5375750579,0.1153801024,0.1687537269,0.3858586,0,59,3.0497352400302006E-4,4.7423868E-4,4.7999123E-4,25,1,2,200,2,0.01
21039946,christofow,10,3520,236,175,4,8,42.6463060473,40-49,658,6,13,24,37,37,13,24,7,2.6593048516,81.4911351115,0.0213415611,0.1681681682,0.36576355,0,59,1.058254062202739E-4,9.484774E-5,9.599824E-5,25,8,1,201,1,0.0049751244
21112018,MaddieDiMuccio,10,27610,1956,1278,52,12,53.485289566,50-59,783,8,55,56,111,111,55,56,6,2.4880521361,2993.3909737428,0.0404886329,0.036036036,0.18965517,0,59,2.6605504431189195E-4,3.7939096E-4,3.8399297E-4,175,69,1,201,1,0.0049751244
21153751,Jinxy00,10,32303,765,622,57,4511,44.1481198257,40-49,780,8,2,2,4,4,2,2,7,3.3291093411,0,0.0067593793,0.25,0.6666667,0,59,8.141040557742643E-5,2.0324514E-5,2.0571053E-5,77,4,0,200,0,0
21241934,kismith,10,2804,431,342,35,9,46.0640487704,40-49,657,6,28,25,53,53,28,25,7,2.6469949312,144.6507199261,0.0807806343,0.196298984,0.5262195,0,59,4.062199745119701E-4,1.9647031E-4,1.9885351E-4,175,8,34,200,32,0.16
21260022,adszymanski,10,1086,372,528,9,2,40.6106469196,40-49,601,5,37,73,110,110,37,73,6,2.4493120927,1124.3535969318,0.0513041256,0.0886572143,0.24521606,0,59,1.6384587623553576E-4,2.5744384E-4,2.6056665E-4,182,14,0,200,0,0
21269439,pattyk13,10,2371,122,271,1,261,45.9015309836,40-49,647,6,10,16,26,26,10,16,6,2.8566256336,87.0565309181,0.006686396,0.0938461538,0.25438598,0,59,8.076277327630499E-5,7.452322E-5,7.542719E-5,77,16,0,201,0,0
21315649,SeedyRoads,10,12613,590,851,12,5364,52.2660514557,50-59,714,8,118,154,272,272,118,154,6,2.2711803041,6589.7898733017,0.1294667956,0.0557711092,0.27230287,0,59,3.6076089349701174E-4,8.0620573E-4,8.159851E-4,77,67,12,204,8,0.0392156863
21326579,nikkikpetersen,10,1596,248,451,13,0,31.918957334,30-39,545,5,3,19,22,22,3,19,6,2.6748732802,31.0564863918,0.0048500337,0.1493506494,0.28654972,0,59,6.694166458923896E-5,2.7099353E-5,2.742807E-5,175,15,0,200,0,0
21350873,metricjulie,10,111097,4743,851,249,6594,57.6346479763,50-59,920,10,44,16,60,60,44,16,7,2.7802317161,4099.019096836,0.059615244,0.0836158192,0.18129432,0,59,3.6378518423451565E-4,3.0486772E-4,3.0170876E-4,175,34,2,202,2,0.0099009901
21379617,Manitobalex,10,32864,337,286,22,91,46.3301739863,40-49,774,8,13,5,18,18,13,5,7,3.0470673425,63.9952070065,0.0085047829,0.1764705882,0.32916668,0,59,1.096463578242545E-4,9.484774E-5,9.599824E-5,175,10,0,202,0,0
21423190,MsMarieB,10,18497,382,256,4,991,49.3501072749,40-49,733,8,10,7,17,17,10,7,7,2.9265025344,179.7236350497,0.0157077618,0.0882352941,0.20454545,0,59,9.279958706845214E-5,7.452322E-5,7.542719E-5,25,8,0,200,0,0
21441975,arashtoronto,10,763,640,679,8,3,36.6678464066,30-39,560,4,34,96,130,130,34,96,6,2.348660391,500.735929843,0.0585801697,0.1815146094,0.39349818,0,59,1.5343455506310437E-4,2.3711934E-4,2.3999561E-4,25,1,0,200,0,0
21460797,adamq112,10,10186,482,693,20,153,55.3807668533,50-59,739,7,62,66,128,128,62,66,6,2.5300506879,2856.0857869522,0.0751100292,0.148683563,0.33915743,0,59,3.403384406501594E-4,4.268148E-4,4.2513508E-4,175,105,5,202,5,0.0247524752
21510079,8skylark,10,3812,406,857,9,68,43.6311698004,40-49,641,7,9,22,31,31,9,22,6,2.5253439537,179.4134050909,0.022192153,0.123655914,0.37662336,0,59,8.359029679121716E-5,6.7748384E-5,6.8570174E-5,77,3,0,201,0,0
21515380,danspeerin,10,15289,1165,913,39,518,61.8439460584,60-69,761,7,82,40,122,122,82,40,6,2.594134685,1360.4793079854,0.1078745992,0.1041864246,0.22168317,0,59,3.314725973595561E-4,5.6231156E-4,5.6913245E-4,77,39,2,200,2,0.01
21547158,ThePhotowagon,10,3698,276,261,12,345,47.0240082548,40-49,652,6,15,22,37,37,15,22,6,2.6383055757,320.2368995985,0.0191119851,0.0840840841,0.35177866,0,59,1.0650651555238645E-4,1.0839741E-4,1.0971228E-4,77,26,1,200,1,0.005
21622781,MikeSeager,10,5705,1790,2003,31,107,50.5871635321,50-59,669,7,36,42,78,78,36,42,7,2.7816799421,937.147887053,0.0173967979,0.0739260739,0.32624114,0,59,1.9768716344129462E-4,2.5066902E-4,2.5370964E-4,175,28,0,201,0,0
21631912,__AvecClasse,10,32516,472,506,3,59,46.7588715942,40-49,777,8,0,2,2,2,0,2,8,4.0477741585,0,0,0.5,0.5,0,629,4.766339181938244E-5,0,6.8570175E-6,175,13,0,201,0,0
21701979,lindzmarsh,10,6478,2387,2619,67,4161,56.2988643222,50-59,738,7,36,63,99,99,36,63,6,2.4449674149,5077.5999623749,0.0466415787,0.0755514327,0.21867007,0,59,2.1410818834652687E-4,2.5066902E-4,2.5370964E-4,182,7,0,200,0,0
21736482,ReOwen,10,722,147,133,0,0,29.910439121,20-29,477,5,2,3,5,5,2,3,6,2.9724837075,310.296199265,0.0086663199,0.2,0.5,0,59,6.08487964861811E-5,2.0324514E-5,2.0571053E-5,77,0,0,200,0,0
21739932,PolityZA,10,10117,2931,68,87,1,52.4150227007,50-59,725,6,11,0,11,11,11,0,0,0,0,9.411481804219125E-4,0.0454545455,0.054545455,0,28,6.717931277396969E-4,8.129806E-5,0,131,4,0,200,0,0
21756477,Ewingsports,10,2707,978,544,43,6,51.9344815254,50-59,720,6,7,3,10,10,7,3,8,4.1176683563,77.1003522944,0.0125904824,0.1111111111,0.33333334,0,59,6.208261747933544E-4,5.4198706E-5,5.485614E-5,175,5,0,201,0,0
21767372,FriendlyLawyer,10,3789,220,324,14,4,41.6038512321,40-49,627,6,21,32,53,53,21,32,6,2.6719768284,245.0084543815,0.0322273918,0.1335268505,0.40465465,0,59,1.4319876827219627E-4,1.4904643E-4,1.5085438E-4,175,9,0,200,0,0
21825027,DanFmTo,10,2267,124,241,8,178,51.0061842478,50-59,658,6,15,13,28,28,15,13,6,2.6462708182,56.8305208549,0.0254502902,0.1494708995,0.2771739,0,59,9.28915383058573E-5,1.0839741E-4,1.0971228E-4,77,41,0,200,0,0
21927175,teririch,10,7500,369,647,5,23,46.2478879746,40-49,719,7,16,43,59,59,16,43,7,2.7172338885,679.1463856643,0.0086243195,0.0990648743,0.24524313,0,59,1.257533652361579E-4,1.1517225E-4,1.16569296E-4,182,28,0,200,0,0
21937574,sharongregson,10,4704,1000,1739,23,231,52.4914634426,50-59,720,7,76,132,208,208,76,132,6,2.283852281,11122.99771558,0.0972146402,0.1086956522,0.26359367,0,59,3.612719607473887E-4,5.216625E-4,5.211333E-4,182,94,0,200,0,0
22018359,dr_giuse,10,31,15,114,0,0,14.4922165919,10-19,85,2,0,1,1,1,0,1,7,4.3571428571,0,0,0,0,42,481,4.766339181938244E-5,0,6.8570175E-6,197,0,0,35,0,0
22100885,MatthewFCarroll,10,244,346,243,10,1,38.1420166665,30-39,557,4,33,36,69,69,33,36,6,2.472121651,674.2472821367,0.0503845981,0.1289428815,0.3340875,0,59,2.0997545304511197E-4,2.303445E-4,2.3313859E-4,77,12,0,200,0,0
22105251,paulosenra,10,2079,458,582,12,9,44.151616166,40-49,663,5,24,31,55,55,24,31,7,2.6940622737,3135.4755052585,0.0459600093,0.1602693603,0.34408033,0,59,1.9283372745090122E-4,1.6937095E-4,1.7142543E-4,175,6,1,200,1,0.005
22147325,joshstuart,10,5193,1469,1317,87,103,56.1227925772,50-59,686,7,60,92,152,152,60,92,6,2.3986241854,3364.741741358,0.1308011362,0.1079208784,0.3474205,0,59,5.37633694551518E-4,4.1326514E-4,4.1827807E-4,25,14,1,200,1,0.005
22173966,silvesterlaw,10,1250,400,734,7,4,42.2696601456,40-49,581,5,16,45,61,61,16,45,6,2.6049963794,1167.6817135482,0.0255656117,0.1754098361,0.41533688,0,59,2.554301821181974E-4,1.1517225E-4,1.16569296E-4,175,3,3,200,3,0.015
22202422,grenouf,10,10517,1026,1215,30,66,54.6196895054,50-59,758,7,57,84,141,141,57,84,6,2.3352643012,14834.6042187284,0.0514889582,0.0360688956,0.11874708,0,59,2.810861816992272E-4,3.9294062E-4,3.9085E-4,77,39,0,201,0,0
22224357,TZohner,10,4371,153,261,2,8,44.866242021,40-49,665,6,24,33,57,57,24,33,6,2.4431571325,335.1507277521,0.028153015,0.1409774436,0.37514517,0,59,1.2566513862029475E-4,1.6937095E-4,1.7142543E-4,182,62,1,201,1,0.0049751244
22225648,Solarsales,10,9396,1056,1923,8,179,47.2379195881,40-49,681,7,33,112,145,145,33,112,6,2.2440260681,1156.2872828615,0.0444431469,0.1194444444,0.30148005,0,59,1.3067345166789207E-4,2.303445E-4,2.3313859E-4,77,11,0,201,0,0
22229462,glyn1123,10,7970,886,1074,13,9,45.0122908332,40-49,660,7,68,98,166,166,68,98,6,2.263577118,3905.2039171288,0.107691737,0.0685651698,0.277616,0,59,2.747312796682878E-4,4.6746383E-4,4.7313422E-4,77,13,4,200,4,0.02
22279004,MurfAD,10,56806,395,302,9,13,42.7756354292,40-49,781,9,19,36,55,55,19,36,7,2.5836350471,779.1685598622,0.0266581954,0.1562289562,0.34444445,0,59,1.2871233839806094E-4,1.3549677E-4,1.3714035E-4,147,9,1,210,1,0.0047619048
22313084,JamesRADunn,10,92,16,71,0,41,23.8016531743,20-29,258,2,0,6,6,6,0,6,7,2.9449873326,0,0,0.4333333333,0.7,0,273,4.766339181938244E-5,0,6.8570175E-6,175,4,0,102,0,0
22330357,Canadian_Hockey,10,21968,7695,33,397,0,49.6379571617,40-49,736,5,7,0,7,7,7,0,0,0,0,0.0023459019,0,0,0,10,8.037676835998209E-5,5.4198706E-5,0,175,1,0,202,0,0
22331578,LabradorCrys,10,10,29,42,0,1,17.3287204491,10-19,49,1,0,2,2,2,0,2,7,3.3984799131,0,0,0.5,1,0,60,4.766339181938244E-5,0,6.8570175E-6,147,0,0,14,0,0
22373748,Beachlaw,10,555,38,103,0,60,41.5867809095,40-49,500,5,7,19,26,26,7,19,6,2.5213613324,42.7406753443,0.0157075604,0.2046153846,0.5105263,0,59,7.347003965645985E-5,5.4198706E-5,5.485614E-5,175,6,0,200,0,0
22420772,Kileyshill,10,6246,369,638,9,15,43.9107739214,40-49,700,7,5,6,11,11,5,6,7,3.1937002172,19.0978480121,0.0017334941,0.0272727273,0.1,0,59,6.608460231597533E-5,4.064903E-5,4.1142106E-5,147,21,0,200,0,0
22462514,rlegaarden,10,6651,382,918,8,155,46.6933567825,40-49,708,7,29,32,61,61,29,32,7,2.7451122375,1914.5899945246,0.0184897013,0.0737704918,0.24912892,0,59,2.3081460494585638E-4,2.0324514E-4,2.0571053E-4,175,20,0,200,0,0
22505409,cwilhelmson,10,8560,1799,1792,101,14,58.793895298,50-59,735,7,63,77,140,140,63,77,6,2.4094858798,11596.5668506668,0.0883446186,0.0811408016,0.20621733,0,59,5.196612741300303E-4,4.3358965E-4,4.319921E-4,182,54,0,200,0,0
22758206,PluckyDog,10,84,17,57,0,16,18.515042871,10-19,121,3,0,2,2,2,0,2,7,3.2609482447,0,0,0,0,0,354,4.766339181938244E-5,0,6.8570175E-6,77,0,0,104,0,0
22770859,Remzer,10,171,41,113,0,2,18.1361093016,10-19,340,3,1,2,3,3,1,2,8,3.4138305576,0,3.8974814466018106E-4,0.1666666667,1,0,59,5.3007122895156477E-5,1.3549677E-5,1.3714035E-5,182,2,0,178,0,0
22795286,matt_vaughan,10,1314,127,281,4,3,41.3333877353,40-49,576,5,8,13,21,21,8,13,7,2.8736422882,85.358510235,0.0032391466,0.080952381,0.24285714,0,59,8.969462314621388E-5,6.0973543E-5,6.171316E-5,147,8,0,193,0,0
22828825,Stephan2013NDP,10,2585,592,1026,15,0,48.1155314262,40-49,660,6,56,85,141,141,56,85,6,2.4467776973,3916.0027082553,0.0632659579,0.0820162107,0.28881988,0,59,4.1960033900667934E-4,3.8616578E-4,3.9085E-4,147,83,0,200,0,0
22829362,AlyZamp,10,383,54,52,1,3,23.8402550224,20-29,439,3,0,2,2,2,0,2,7,3.6301121969,0,0,0,0,0,680,4.766339181938244E-5,0,6.8570175E-6,175,8,0,200,0,0
22868993,lawrence_thomas,10,2033,974,1881,21,8,43.5014701705,40-49,617,6,5,23,28,28,5,23,6,2.6068066618,3428.4575338657,0.0053235265,0.082010582,0.1541502,0,59,8.058796909468738E-5,4.064903E-5,4.1142106E-5,175,4,0,200,0,0
22963074,kevin_ward_news,10,1558,882,477,57,1,41.9982314582,40-49,577,5,37,23,60,60,37,23,7,2.8435916003,853.7525416886,0.0459710439,0.1265536723,0.25632653,0,59,6.396733636536478E-4,2.5744384E-4,2.6056665E-4,147,2,0,200,0,0
22976448,jayfanmanitoba,10,2326,106,704,1,282,28.0192429327,20-29,366,6,24,72,96,96,24,72,6,2.5043446778,937.8594640123,0.0254005419,0.1191885965,0.27192983,0,59,1.2141121394064438E-4,1.6937095E-4,1.7142543E-4,175,0,6,204,6,0.0294117647
23002145,brando44,10,594,113,69,1,66,43.962980742,40-49,610,4,10,5,15,15,10,5,6,3.0083272991,46.9077601265,0.0054742176,0.0571428571,0.16363636,0,59,7.84038401549646E-5,7.452322E-5,7.542719E-5,77,13,0,200,0,0
23009685,Sweetthang30,10,1061,91,679,1,0,21.1617114208,20-29,368,4,0,2,2,2,0,2,8,3.6170828809,0,0,0,0,0,209,4.766339181938244E-5,0,6.8570175E-6,182,0,0,200,0,0
23042612,MizzzAlia,10,12773,246,685,6,1035,44.9399967652,40-49,714,7,5,9,14,14,5,9,7,2.8023171615,26.8023241433,0.0102982082,0.1263736264,0.37777779,0,59,7.301379137444745E-5,4.064903E-5,4.1142106E-5,182,6,0,200,0,0
23095574,CFIB,10,6511,2675,520,82,13,58.1073044189,50-59,767,7,76,39,115,115,76,39,6,2.4847936278,5126.8597012987,0.0906146773,0.1215865751,0.20026651,0,59,5.237264356491611E-4,5.216625E-4,5.2799034E-4,175,66,0,200,0,0
23127185,KatieFranzios,10,12662,2187,1104,94,1,55.6435864522,50-59,744,7,66,50,116,116,66,50,6,2.6524257784,4944.352541587,0.0883169043,0.1425787106,0.2633772,0,59,5.152162159985872E-4,4.5391417E-4,4.5942017E-4,175,47,0,200,0,0
23130850,DaleJr288,10,21113,667,1998,12,38,45.3108522994,40-49,741,9,59,185,244,244,59,185,6,2.1875452571,6315.481517274,0.08793106,0.1171321595,0.23955224,0,59,2.0941455878913798E-4,4.064903E-4,4.1142106E-4,175,17,0,199,0,0
23161031,TweetUlrich,10,799,143,162,2,0,40.7449496301,40-49,597,5,21,13,34,34,21,13,6,2.7711803041,210.3941586284,0.0191855165,0.1158645276,0.36594203,0,59,1.533130156504719E-4,1.4904643E-4,1.5085438E-4,147,50,0,200,0,0
23167983,YasminSadie,10,24895,1394,952,42,274,57.688574611,50-59,785,8,102,122,224,224,102,122,6,2.3363504707,28448.1208508352,0.1143289143,0.088524984,0.23829119,0,59,3.4519480096980904E-4,6.9780834E-4,7.062728E-4,77,35,1,199,1,0.0050251256
23236190,TracieEdward,10,9940,959,700,56,90,55.2053603939,50-59,739,7,74,69,143,143,74,69,6,2.4916727009,2616.3782333377,0.0808159268,0.0799763617,0.26378402,0,59,3.4008329491071193E-4,5.081129E-4,5.142763E-4,182,40,0,200,0,0
23236837,ac_stephen,10,1167,110,195,6,16,28.3569339446,20-29,600,5,9,21,30,30,9,21,6,2.6383055757,17.4334715853,0.0150189823,0.1804597701,0.42885375,0,59,7.579380916145234E-5,6.7748384E-5,6.8570174E-5,182,3,0,200,0,0
23259960,trevorcharles,10,680,360,1006,16,12,46.4712850622,40-49,589,5,10,27,37,37,10,27,7,2.6010137581,3126.1171526236,0.0126559312,0.1433933934,0.3505291,0,59,1.382820298602367E-4,7.452322E-5,7.542719E-5,77,73,4,200,4,0.02
23345269,VexxingVixen,10,4561,177,126,9,16,35.2345705559,30-39,604,6,4,5,9,9,4,5,7,3.1104272266,10.262947536,0.0030464547,0.1944444444,0.22222222,0,59,8.862341392071682E-5,3.3874192E-5,3.4285087E-5,77,2,0,200,0,0
23502909,PlanetsFuture,10,156,25,75,0,12,14.2170761044,10-19,124,4,2,7,9,9,2,7,6,2.792903693,1.1473123963,0.001829365,0.3194444444,0.44444445,0,59,5.422367963711197E-5,2.0324514E-5,2.0571053E-5,77,3,0,163,0,0
23566734,wilsack,10,3580,306,1133,3,200,42.902464193,40-49,646,6,4,19,23,23,4,19,7,2.8193338161,285.3857111948,0.0070723165,0.1640316206,0.31842107,0,59,7.41233674505249E-5,3.3874192E-5,3.4285087E-5,147,11,0,200,0,0
23622196,pat_costigan,10,157,165,474,5,0,25.0140641413,20-29,396,3,67,40,107,107,67,40,7,2.5829109341,125.5030619326,0.1275715586,0.1824193264,0.49830246,0,59,3.7065241237174283E-4,4.60689E-4,4.6627718E-4,25,2,0,157,0,0
23648440,catsagogo,10,5276,367,856,12,12,41.1897361709,40-49,664,7,60,134,194,194,60,134,6,2.2530774801,2469.8088074445,0.1063528357,0.102531916,0.2768954,0,59,2.3813349726586606E-4,4.1326514E-4,4.1827807E-4,77,1,0,200,0,0
23673518,e_c_a_l,10,456,87,119,2,19,32.5655651819,30-39,518,4,2,5,7,7,2,5,7,2.9656046343,228.8735596871,0.0065515691,0.0238095238,0.05,0,59,6.698315655411102E-5,2.0324514E-5,2.0571053E-5,25,1,0,200,0,0
23676939,ALXV5,10,5211,304,794,12,18,43.2451274,40-49,671,7,26,53,79,79,26,53,6,2.4920347574,519.2945033944,0.0249976273,0.1359948069,0.2923077,0,59,1.4643158407335775E-4,1.8292063E-4,1.8513948E-4,175,21,0,201,0,0
23712701,karastrang,10,253,167,95,6,18,26.8931313761,20-29,504,5,2,17,19,19,2,17,6,2.6451846488,26.7185756415,0.0021711132,0.3362573099,0.60457516,0,59,5.411624787352736E-5,2.0324514E-5,2.0571053E-5,175,0,5,200,5,0.025
23713082,mjamesanderson,10,2607,452,453,10,115,60.5713373319,60-69,673,6,80,61,141,141,80,61,6,2.4844315713,1189.9922864653,0.1237500299,0.1287740628,0.3619802,0,59,3.964958569429853E-4,5.487619E-4,5.5541843E-4,25,48,0,200,0,0
23764854,AlysonFair,10,3624,557,515,22,5,46.25316068,40-49,617,6,40,62,102,102,40,62,6,2.3957277335,1827.9958427421,0.1102153027,0.1937487866,0.52947366,0,59,5.536764518818741E-4,2.7776835E-4,2.811377E-4,175,8,1,200,1,0.005
23772203,kempthead,10,2949,1744,551,97,8,51.0926005899,50-59,718,6,77,36,113,113,77,36,6,2.5257060101,1538.8339293246,0.1245441418,0.1321112516,0.2794555,0,59,6.080789910953414E-4,5.284374E-4,5.348474E-4,147,19,0,200,0,0
23807006,AlexCallahan,10,1893,255,376,6,0,43.2153908615,40-49,597,5,30,42,72,72,30,42,7,2.6097031137,545.4221352165,0.0461557146,0.1361502347,0.3699095,0,59,3.2715477341635046E-4,2.1001999E-4,2.1256754E-4,25,16,3,200,3,0.015
23916808,DJJonniM,10,29612,920,1997,8,47,41.4499596717,40-49,720,8,2,3,5,5,2,3,7,3.6455467053,0,0.0016629847,0.5,0.6,0,59,5.676707609399651E-5,2.0324514E-5,2.0571053E-5,175,1,0,201,0,0
23968956,KatyChancey,10,12503,779,681,55,280,51.8313480608,50-59,739,7,9,6,15,15,9,6,6,2.8327299059,380.804531525,0.01493467,0.1095238095,0.3272727,0,59,9.382865472083114E-5,6.7748384E-5,6.8570174E-5,175,3,0,200,0,0
24097906,dustykelly,10,1367,233,149,8,2,45.8224571258,40-49,600,5,17,12,29,29,17,12,6,2.6462708182,66.2002620786,0.026822001,0.2155172414,0.4710145,0,59,1.8400857283628835E-4,1.2194709E-4,1.2342632E-4,182,15,0,199,0,0
24116965,campbelljustin,10,9615,534,801,15,119,48.2183696541,40-49,735,7,27,34,61,61,27,34,7,2.7251991311,4081.9692165094,0.0185325545,0.0653005464,0.2462888,0,59,1.9264617381733646E-4,1.8969548E-4,1.9199649E-4,175,24,4,201,4,0.0199004975
24202967,russell_bryant,10,218,57,188,1,106,19.8029841196,10-19,445,3,9,44,53,53,9,44,6,2.471397538,86.5555234236,0.0108177345,0.1806966618,0.3668076,0,59,7.545792295067039E-5,6.7748384E-5,6.8570174E-5,25,3,4,199,4,0.0201005025
24260774,jibrilsens99,10,13005,130,276,0,1308,38.3956639303,30-39,684,7,0,1,1,1,0,1,8,4.2964169381,0,0,0,0,0,597,4.766339181938244E-5,0,6.8570175E-6,175,2,0,200,0,0
24261516,SussanneS,10,2238,472,1083,18,29,45.7629487021,40-49,611,6,73,120,193,193,73,120,6,2.3106444605,2536.5570654258,0.0955703934,0.0932102763,0.34015152,0,59,3.192074059711126E-4,5.0133804E-4,5.074193E-4,182,25,0,200,0,0
24389581,ChrisInRegina,10,2674,157,149,8,206,35.1036907069,30-39,670,6,5,13,18,18,5,13,6,2.7335264301,113.0950948306,0.0172372291,0.2516339869,0.4375,0,59,2.1574214233087202E-4,4.064903E-5,4.1142106E-5,25,0,1,200,1,0.005
24412109,Gretzkyisgod99,10,846,76,298,1,28,35.6680311043,30-39,564,5,2,6,8,8,2,6,7,3.1426502534,0.2257799672,5.628569449010549E-4,0.1964285714,0.6,0,59,5.6346398263648655E-5,2.0324514E-5,2.0571053E-5,182,1,0,200,0,0
24467902,meaganhogg,10,4464,272,311,32,173,53.1829535472,50-59,679,6,4,6,10,10,4,6,7,3.0792903693,130.060793145,0.001880345,0.1555555556,0.39285713,0,59,7.362824611510665E-5,3.3874192E-5,3.4285087E-5,77,7,0,200,0,0
24497152,Eddie_Gravity,10,12255,270,441,2,18,46.6109544164,40-49,737,7,4,3,7,7,4,3,7,3.31173063,1.4491483685,0.0036612111,0.1904761905,0.45,0,59,5.745271813542097E-5,3.3874192E-5,3.4285087E-5,175,14,0,203,0,0
24563620,Anna_Lach,10,1138,313,464,16,0,41.3542482583,40-49,594,5,0,4,4,4,0,4,7,2.9956568947,0,0,0.4166666667,0.5,0,599,4.766339181938244E-5,0,6.8570175E-6,25,2,0,200,0,0
24597118,charlielapin,10,17102,253,320,6,200,59.5349613095,50-59,740,8,1,5,6,6,1,5,7,3.140839971,0.1947926701,5.113286017871398E-4,0.3,0.75,0,59,6.698948878056278E-5,1.3549677E-5,1.3714035E-5,175,1,0,201,0,0
24639266,LadySnarksalot,10,97635,1726,784,74,8851,56.2149663326,50-59,827,10,62,31,93,93,62,31,7,2.7494569153,7833.0030950192,0.0709244474,0.0931510051,0.23664597,0,59,3.5750434108117055E-4,4.268148E-4,4.319921E-4,77,82,1,202,1,0.004950495
24775854,MitchellDuce,10,286,233,876,1,306,51.3953328844,50-59,553,5,29,128,157,157,29,128,6,2.2943519189,5192.0203529268,0.0467181032,0.1589498612,0.30878937,0,59,1.9490039503346096E-4,2.0324514E-4,2.0571053E-4,25,28,0,200,0,0
24836413,RichTweets,10,1370,929,937,25,14,65.2384458226,60-69,694,5,79,93,172,172,79,93,6,2.395365677,2886.4787490948,0.0940919537,0.0792873657,0.25314844,0,59,3.8801425501032433E-4,5.419871E-4,5.485614E-4,182,62,2,200,2,0.01
24839123,DSolberg,10,13305,1085,916,24,30,65.1482638523,60-69,764,8,115,93,208,208,115,93,6,2.4706734251,6002.9123938695,0.1311019038,0.0742289112,0.21743295,0,59,8.371843565988694E-4,7.8588125E-4,7.9541403E-4,175,139,0,200,0,0
24892203,bethinhfx,10,849,54,164,1,235,39.0966666525,30-39,506,5,6,9,15,15,6,9,6,2.6705286025,18.4694832061,0.0200764959,0.119047619,0.3888889,0,59,7.656081151136116E-5,4.742387E-5,4.799912E-5,77,25,0,202,0,0
25075813,Dougustine,10,235,14,40,0,1,12.7974302053,10-19,476,3,0,0,0,0,0,0,0,0,0,0,0,0,226,563,4.766339181938244E-5,0,0,230,1,0,200,0,0
25122402,michaelkushnir,10,9722,1033,884,32,191,48.5537205437,40-49,741,7,69,90,159,159,69,90,6,2.3743664012,16240.11187435,0.093655277,0.0844279914,0.2809823,0,59,4.081595860636507E-4,4.7423868E-4,4.7999123E-4,25,26,1,199,1,0.0050251256
25198091,RachelDecoste,10,14673,994,602,21,626,60.5592235262,60-69,762,8,115,84,199,199,115,84,6,2.4391745112,7955.2204854414,0.1225340048,0.064895183,0.16397351,0,59,5.046036261030061E-4,7.8588125E-4,7.9541403E-4,77,182,0,205,0,0
25217615,jofo2005,10,9863,888,2002,7,279,44.1503640477,40-49,703,7,58,155,213,213,58,155,6,2.2776973208,7330.9059613853,0.0664491593,0.0673443175,0.18647642,0,59,2.2168567727786788E-4,3.9971547E-4,4.0456402E-4,77,6,1,200,1,0.005
25229592,steph_smith303,10,3473,411,469,3,5,42.2321314754,40-49,630,6,33,34,67,67,33,34,6,2.5825488776,289.2887987065,0.0458838782,0.1166892809,0.43687707,0,59,1.7232559068293128E-4,2.303445E-4,2.3313859E-4,182,37,0,182,0,0
25275001,caw2002tca,10,975,907,870,31,0,43.830742395,40-49,651,4,91,98,189,189,91,98,6,2.320057929,3524.6771585625,0.1135478651,0.0822357312,0.2631613,0,59,3.923900166357927E-4,6.2328513E-4,6.308456E-4,182,15,0,200,0,0
25299465,KKineshanko,10,3506,108,333,1,10,43.5774106365,40-49,665,6,10,6,16,16,10,6,7,3.0865314989,6.9489007454,0.0059901001,0.1916666667,0.6212121,0,59,8.071074578112005E-5,7.452322E-5,7.542719E-5,175,4,0,200,0,0
25309148,lynnsc08,10,25862,1207,1217,59,9,43.0747461308,40-49,764,8,1,1,2,2,1,1,1,1,0,8.095914281419891E-5,0,0,125,276,3.177448371356425E-4,1.3549677E-5,1.3714035E-5,128,6,0,200,0,0
25314706,philipstone,10,63,220,267,10,14,35.1284123985,30-39,457,3,12,13,25,25,12,13,7,2.9580014482,106.6932294433,0.0169646475,0.1316666667,0.32163742,0,59,1.8789836829371105E-4,8.80729E-5,8.914123E-5,182,9,0,66,0,0
25329655,GonzoSavage,10,1131,62,238,1,84,27.9321347672,20-29,473,5,1,8,9,9,1,8,7,2.9456915279,0.578644895,0.0060064755,0.2083333333,0.44642857,0,59,5.586306243973462E-5,1.3549677E-5,1.3714035E-5,175,1,1,200,1,0.005
25435971,_msRonnieG,10,8756,479,1075,13,79,47.9207125754,40-49,703,7,46,81,127,127,46,81,6,2.3113685735,4010.5410256979,0.0593537703,0.0828646419,0.24219726,0,59,2.216953878535532E-4,3.1841738E-4,3.222798E-4,182,34,1,200,1,0.005
25487241,talkingfrog,10,16649,602,33,17,72,55.3976726638,50-59,738,8,48,6,54,54,48,6,7,2.9855177408,39.6669373457,0.0663916767,0.1484975542,0.2264151,0,59,2.0781179195111677E-4,3.3196708E-4,3.2913685E-4,77,49,0,201,0,0
25603108,alruttan,10,1338,70,246,0,4,28.3923440931,20-29,520,5,2,2,4,4,2,2,8,3.924692252,2782.0529435862,1.7849121557963514E-4,0,0,0,59,1.906836246625111E-4,2.0324514E-5,2.0571053E-5,147,12,0,200,0,0
25636566,grahamur,10,976,1432,1961,40,117,46.5870481135,40-49,579,5,22,36,58,58,22,36,6,2.4981897176,943.2034127955,0.0384260892,0.0786448881,0.31031746,0,59,2.0404541720546525E-4,1.5582128E-4,1.577114E-4,175,2,1,200,1,0.005
25671509,MarkCoffin,10,2817,848,550,32,18,47.8996235919,40-49,693,6,55,62,117,117,55,62,6,2.3816075308,6026.0555739435,0.0877443963,0.1161214265,0.27317247,0,59,4.215482643304272E-4,3.7939096E-4,3.8399297E-4,147,15,1,200,1,0.005
25760258,PerryMarleau,10,5046,390,656,4,12,46.7672442143,40-49,682,7,7,26,33,33,7,26,7,2.7034757422,263.6659856032,0.0068494206,0.09375,0.18518518,0,59,6.734750128326231E-5,5.4198706E-5,5.485614E-5,175,21,1,201,1,0.0049751244
25849601,sbaranski,10,6877,2167,1049,75,26,62.0575964101,60-69,754,7,111,64,175,175,111,64,7,2.5771180304,5817.4361782529,0.1275292344,0.0773399015,0.18361092,0,59,7.796899148544E-4,7.587819E-4,7.6798594E-4,175,156,0,201,0,0
25886969,TwalRa,10,20869,1199,592,28,58,53.6558570012,50-59,780,8,17,18,35,35,17,18,6,2.6010137581,2697.1766108026,0.0254871486,0.1067226891,0.37351778,0,59,1.4116707375415994E-4,1.2194709E-4,1.2342632E-4,77,15,0,201,0,0
25947220,QueerVancouver,10,6608,333,229,13,179,60.8504269539,60-69,711,7,19,21,40,40,19,21,7,2.7255611875,111.1290304544,0.0282245413,0.1346153846,0.45441595,0,59,1.4540214366139012E-4,1.3549677E-4,1.3714035E-4,182,48,0,200,0,0
25955471,russlyster,10,797,408,744,8,1,28.1377749185,20-29,584,5,23,43,66,66,23,43,7,2.7328023172,207.5902071902,0.0201938049,0.1289044289,0.40821257,0,59,1.7940928954678434E-4,1.6259612E-4,1.6456842E-4,175,1,1,199,1,0.0050251256
26037015,Koldkanuck,10,451,25,82,1,3,34.3940274568,30-39,504,5,4,5,9,9,4,5,7,3.1010137581,3.1707446849,0.0019758184,0.0833333333,0.16666667,0,59,5.8275567771344066E-5,3.3874192E-5,3.4285087E-5,175,6,1,202,1,0.004950495
26040618,siomo,10,25517,1682,987,55,2,57.3747964071,50-59,760,8,22,36,58,58,22,36,7,2.7429398986,608.3873735147,0.0364765323,0.1624319419,0.26941177,0,59,2.7077042705462017E-4,1.5582128E-4,1.577114E-4,175,38,0,201,0,0
26056235,rssharmahome,10,1727,302,396,7,10,45.6857823973,40-49,606,6,15,21,36,36,15,21,7,2.9518464881,374.8522082645,0.0079602995,0.103968254,0.25132275,0,59,1.4799718309114733E-4,1.0839741E-4,1.0971228E-4,182,19,1,200,1,0.005
26099512,CitytvEdmonton,10,2028,7582,2195,308,2,56.1006394549,50-59,724,5,37,13,50,50,37,13,7,2.8454018827,1947.3464618321,0.0226853617,0.0657142857,0.1754386,0,59,2.4908475660157827E-4,2.5744384E-4,2.5370964E-4,175,19,0,200,0,0
26153606,markyolkowski,10,3332,247,445,2,11,42.5535534103,40-49,654,6,4,9,13,13,4,9,7,2.8146270818,42.1336262277,0.0055167568,0.1282051282,0.44444445,0,59,6.75183575577528E-5,3.3874192E-5,3.4285087E-5,175,0,0,200,0,0
26241393,FeliciaFahey,10,436,251,486,2,2,38.7704186863,30-39,521,4,37,48,85,85,37,48,6,2.5973931933,1270.9096688141,0.0324240638,0.068627451,0.30718085,0,59,1.6275341816484945E-4,2.5744384E-4,2.6056665E-4,182,9,0,200,0,0
26248942,ohheymike,10,1185,695,446,9,5,47.7375846664,40-49,612,5,7,32,39,39,7,32,6,2.5908761767,127.2017616112,0.0258422289,0.2597840756,0.5285205,0,59,1.2896084136043755E-4,5.4198706E-5,5.485614E-5,175,9,0,199,0,0
26273435,HanlansPoint,10,1139,91,257,1,25,47.4874652285,40-49,645,6,14,42,56,56,14,42,6,2.5137581463,121.9975149991,0.0116871793,0.187987013,0.3608156,0,59,8.630341332888368E-5,1.0162257E-4,1.02855265E-4,175,135,4,202,4,0.0198019802
26310909,ohyesyut,10,257,59,374,1,7,31.3011995785,30-39,451,4,2,6,8,8,2,6,7,3.226647357,1.6135710028,0.0018386278,0.1785714286,0.56666666,0,59,7.0859566919289E-5,2.0324514E-5,2.0571053E-5,147,1,0,200,0,0
26355733,m_lizzy,10,13961,283,302,10,139,46.0309014359,40-49,722,7,2,5,7,7,2,5,7,3.1832005793,32.6640109626,2.5579496115611205E-4,0.119047619,0.2,0,59,6.513815924119351E-5,2.0324514E-5,2.0571053E-5,182,4,0,200,0,0
26441172,JoeGrafe,10,786,254,449,2,239,56.7273861479,50-59,573,5,18,40,58,58,18,40,6,2.4561911658,1103.7938323804,0.0191081655,0.1085904416,0.2530454,0,59,9.695151667319865E-5,1.2872192E-4,1.3028333E-4,77,11,0,200,0,0
26491037,NathalieMadore,10,7017,323,313,29,8,40.7242548635,40-49,689,7,7,11,18,18,7,11,7,2.8461259957,26.7938459289,0.0116139141,0.1176470588,0.38636363,0,59,8.777983391739426E-5,5.4198706E-5,5.485614E-5,175,1,0,200,0,0
26548594,JohnGormleyLive,10,14469,9816,284,236,11,60.735468405,60-69,855,8,93,22,115,115,93,22,7,2.7031136857,10888.3247276531,0.0682037602,0.0730739893,0.14574315,0,59,7.56601558778163E-4,6.3683477E-4,6.308456E-4,175,309,0,200,0,0
26580562,evakatrina,10,27902,1675,1945,79,5078,45.1607890081,40-49,763,8,14,31,45,45,14,31,6,2.6245474294,5503.9382190569,0.0186585657,0.1414141414,0.32380953,0,59,1.1526692734813135E-4,1.0162257E-4,1.02855265E-4,175,4,0,200,0,0
26776939,mertonwa,10,339,71,134,0,3,31.2463578336,30-39,402,3,14,18,32,32,14,18,6,2.6828385228,296.626333209,0.0208444503,0.1622983871,0.5857143,0,59,1.0258062466437189E-4,1.0162257E-4,1.02855265E-4,182,9,0,200,0,0
27065260,marthaCBC,10,2485,621,593,28,9,45.3933732669,40-49,638,5,10,19,29,29,10,19,7,2.8265749457,3514.191857336,0.0138415297,0.1243842365,0.2210145,0,59,1.1496825643848242E-4,7.452322E-5,7.542719E-5,175,4,0,200,0,0
27150189,jrock71,10,8118,318,773,6,146,46.845820243,40-49,694,7,4,9,13,13,4,9,7,3.0025343954,11.2620728003,0.0017611166,0.1346153846,0.41666666,0,59,7.209410808824169E-5,3.3874192E-5,3.4285087E-5,175,3,0,201,0,0
27161840,HamBaconTomato,10,10095,1177,1352,61,14,45.9364777175,40-49,703,7,70,82,152,152,70,82,6,2.5039826213,3036.0102591366,0.1128655622,0.1189003137,0.36585137,0,59,4.4692647625749264E-4,4.8101353E-4,4.8684824E-4,175,8,0,200,0,0
27261031,johnkapp,10,18702,554,788,7,2073,52.7882179932,50-59,740,8,47,137,184,184,47,137,6,2.2306299783,6947.1899824503,0.0634108842,0.1091708244,0.2785888,0,59,2.2431597625321019E-4,3.2519223E-4,3.2913685E-4,25,21,0,201,0,0
27272767,dennisflood54,10,1035,90,179,0,42,36.2945968327,30-39,604,5,13,21,34,34,13,21,6,2.7530774801,222.5271062011,0.0140311157,0.1292335116,0.41897234,0,59,9.164733331633292E-5,9.484774E-5,9.599824E-5,147,6,0,200,0,0
27295541,MRenee_XO,10,12920,330,225,0,4651,42.819070404,40-49,744,8,0,0,0,0,0,0,0,0,0,0,0,0,85,183,4.766339181938244E-5,0,0,75,22,0,200,0,0
27344646,fraygulrock,10,54551,933,669,120,2981,34.6691195557,30-39,788,9,25,23,48,48,25,23,6,2.6115133961,695.6943132826,0.0332340786,0.0562943262,0.26190478,0,59,1.2969983605522908E-4,1.761458E-4,1.7828245E-4,77,1,0,200,0,0
27366533,barinderhans,10,621,146,195,6,0,41.9732470799,40-49,557,5,6,9,15,15,6,9,7,3.0763939175,63.1704100348,0.0026661028,0.1333333333,0.35454544,0,59,7.511410884105347E-5,4.742387E-5,4.799912E-5,182,3,0,200,0,0
27366826,unclemeat80,10,9034,2991,3328,52,24,54.9456432293,50-59,744,7,38,42,80,80,38,42,7,2.7157856626,1018.2559245831,0.0220549008,0.0713607595,0.3044898,0,59,2.535785130285121E-4,2.642187E-4,2.674237E-4,175,68,0,200,0,0
27371671,Norm_Farrell,10,2808,342,612,6,0,50.3805199123,50-59,686,6,76,125,201,201,76,125,6,2.4047791455,6277.2634526326,0.0864876765,0.0718159204,0.24368761,0,59,3.028191469636158E-4,5.216625E-4,5.2799034E-4,182,137,1,201,1,0.0049751244
27447051,querqle,10,2539,102,334,0,96,39.0202213714,30-39,532,6,6,23,29,29,6,23,7,2.604634323,9.5494079003,0.0058917487,0.1514778325,0.33152175,0,59,5.979329175933745E-5,4.742387E-5,4.799912E-5,77,4,0,200,0,0
27474582,GinnyMovat,10,3636,430,545,6,0,42.0221683813,40-49,639,6,23,38,61,61,23,38,7,2.6064446054,625.6224912341,0.0219241062,0.112568306,0.23847517,0,59,1.4946011925233164E-4,1.6259612E-4,1.6456842E-4,175,8,0,200,0,0
27485292,ChrisDawnMonroe,10,24928,1422,1878,50,3011,63.5493061318,60-69,753,8,62,111,173,173,62,111,6,2.3888486604,11354.2990957783,0.0780726178,0.100887216,0.31413877,0,59,3.104846864869364E-4,4.268148E-4,4.319921E-4,175,16,0,201,0,0
27494637,rosemurray,10,4724,93,143,1,13,29.0350365471,20-29,529,7,1,6,7,7,1,6,7,2.7614047791,2.1520605174,4.000049756176372E-4,0.3333333333,0.47619048,0,59,5.2295193539682E-5,1.3549677E-5,1.3714035E-5,175,0,3,200,3,0.015
27525925,judithjoy,10,885,205,627,1,54,31.6613265581,30-39,539,5,0,4,4,4,0,4,7,3.1454940282,0,0,0.1666666667,0.25,0,255,4.766339181938244E-5,0,6.8570175E-6,77,1,0,200,0,0
27685671,cdenoon,10,550,140,383,2,6,29.6290929438,20-29,545,4,5,32,37,37,5,32,6,2.5184648805,55.7249163799,0.0147915487,0.2034534535,0.39112905,0,59,8.522186694679043E-5,4.064903E-5,4.1142106E-5,182,1,0,200,0,0
27700851,CWChapter2,10,14673,1315,1356,65,139,51.1789210702,50-59,755,8,20,31,51,51,20,31,7,2.7675597393,380.3335558519,0.0147974304,0.0952941176,0.30840337,0,59,1.3586137734654212E-4,1.422716E-4,1.4399737E-4,175,23,0,200,0,0
27765177,alexfelsky,10,246,154,447,4,0,43.6609347284,40-49,515,4,26,56,82,82,26,56,7,2.4304851557,639.8277395477,0.0342818682,0.150255947,0.4006429,0,59,1.6417569170844312E-4,1.8292063E-4,1.8513948E-4,25,37,0,200,0,0
27899322,youthrage,10,481,178,153,4,6,40.6125386971,40-49,583,4,1,0,1,1,1,0,0,0,0,0.0014612145,0,0,0,56,5.040917864139971E-5,1.3549677E-5,0,147,0,0,200,0,0
27935316,Teirersias,10,24186,1078,1849,36,347,61.084608874,60-69,776,8,25,46,71,71,25,46,6,2.5380159305,3545.6432698293,0.0353359683,0.0748490946,0.25169083,0,59,2.4345268568741764E-4,1.761458E-4,1.7828245E-4,77,81,0,200,0,0
28011228,devanneobrien,10,1440,185,438,3,69,42.5789120114,40-49,608,5,21,39,60,60,21,39,6,2.5336712527,987.2821144308,0.0409922931,0.1426553672,0.33111703,0,59,1.4479923941439327E-4,1.4904643E-4,1.5085438E-4,147,17,2,200,1,0.005
28023722,ADHR,10,6515,194,331,5,0,37.2260474927,30-39,672,6,36,55,91,91,36,55,6,2.5162925416,375.9230249214,0.0579016621,0.1295482295,0.33713785,0,59,2.0641594905521573E-4,2.5066902E-4,2.5370964E-4,25,12,1,200,1,0.005
28127520,Sultan_Sadat,10,787,413,2000,4,339,36.3872196918,30-39,510,5,60,255,315,315,60,255,6,2.1372194062,7519.7055281195,0.0957719818,0.1266201597,0.2553888,0,59,2.67436800369882E-4,4.1326514E-4,4.1827807E-4,25,12,1,212,1,0.0047169811
28191911,jjfantauzzi,10,9766,1589,1806,80,385,55.1672244445,50-59,742,7,68,163,231,231,68,163,6,2.207096307,16896.7481698461,0.1029965295,0.1058535667,0.24823447,0,59,4.7875768539284134E-4,4.6746383E-4,4.6627718E-4,25,85,10,213,10,0.0469483568
28216493,DickWalsh00,10,4316,217,417,2,14,41.3088466311,40-49,649,6,3,5,8,8,3,5,7,3.236422882,2.109071843,0.0013300986,0.1964285714,0.35714287,0,59,5.559178938914123E-5,2.7099353E-5,2.742807E-5,147,2,0,200,0,0
28395319,JosephQuesnelJr,10,674,307,482,8,7,40.1078262268,40-49,665,5,31,43,74,74,31,43,6,2.6292541636,695.8132766103,0.0229450449,0.1440207331,0.28741407,0,59,2.039022956837312E-4,2.1679483E-4,2.1942456E-4,175,16,0,200,0,0
28435748,crussellsprout,10,2883,94,132,3,71,27.0985287461,20-29,546,6,3,5,8,8,3,5,7,3.0550325851,1.002107495,0.007523634,0.2857142857,0.45238096,0,59,6.651400947774504E-5,2.7099353E-5,2.742807E-5,182,2,1,199,1,0.0050251256
28574101,StevenForth,10,8787,2074,1831,73,0,58.6195007455,50-59,683,7,6,6,12,12,6,6,6,2.9561911658,20.8084926927,0.0081613147,0.1212121212,0.6904762,0,59,8.027057937040391E-5,4.742387E-5,4.799912E-5,182,0,0,200,0,0
28578004,Sabrina_B2011,10,458,61,204,1,21,29.3216038389,20-29,470,4,6,31,37,37,6,31,6,2.5756698045,1398.1320747903,0.0160729073,0.1719219219,0.32903227,0,59,8.991950123042926E-5,4.742387E-5,4.799912E-5,77,5,0,197,0,0
28642708,m_hollett,10,3282,2184,2011,62,8,55.2293903436,50-59,715,6,44,62,106,106,44,62,6,2.4923968139,5701.9836326041,0.068298653,0.1097933513,0.23580034,0,59,3.3259131374620087E-4,3.0486772E-4,3.085658E-4,25,9,0,200,0,0
28675105,DJ_JrM,10,1425,191,868,0,7,34.0312345418,30-39,533,5,0,1,1,1,0,1,7,3.6659428158,0,0,0,0,0,592,4.766339181938244E-5,0,6.8570175E-6,175,2,0,200,0,0
28839997,360renos,10,1939,522,499,27,13,41.6922976332,40-49,594,5,2,3,5,5,2,3,7,2.9793627806,34.1200263806,0.0011101844,0.05,0.16666667,0,59,6.680639037345635E-5,2.0324514E-5,2.0571053E-5,175,1,0,200,0,0
28883923,thewanderingjew,10,23762,1582,930,63,6,68.0610400489,60-69,767,8,2,2,4,4,2,2,7,3.3700217234,7.662627649,8.894896347006344E-4,0,0,0,59,8.135104476366581E-5,2.0324514E-5,2.0571053E-5,182,6,0,200,0,0
28899933,Guled91,10,2007,496,706,8,58,64.4609041076,60-69,667,6,13,35,48,48,13,35,7,2.565532223,497.8102551415,0.0274305595,0.2508865248,0.41966173,0,59,9.248540931750133E-5,9.484774E-5,9.599824E-5,25,17,1,200,1,0.005
28980136,CommonSenseNS,10,2847,208,136,6,6,39.2504586974,30-39,655,6,13,5,18,18,13,5,7,2.9398986242,90.7562225052,0.0049553149,0.2091503268,0.3529412,0,59,1.0576578660684584E-4,9.484774E-5,9.599824E-5,147,6,0,198,0,0
28987867,davidhapgood,10,69,29,54,1,3,15.7558819926,10-19,237,2,3,5,8,8,3,5,7,2.9485879797,3.7675934533,0.0087722539,0.1071428571,0.4,0,59,7.81217706299952E-5,2.7099353E-5,2.742807E-5,25,1,0,80,0,0
28990042,PierreMorinQc,10,54013,3221,666,131,64,57.569258925,50-59,881,9,26,13,39,39,26,13,7,2.7744388125,1161.5005411285,0.0303001757,0.0634278003,0.22649573,0,59,1.8525969682331024E-4,1.8292063E-4,1.8513948E-4,145,43,0,201,0,0
29024261,andyingy,10,2697,302,949,2,1126,49.127013438,40-49,636,7,5,0,5,5,5,0,0,0,0,0.0033818367,0.1,0.2,0,4,5.5869548929473745E-5,4.064903E-5,0,77,28,0,2,0,0
29195172,MalcolmQuerney,10,430,55,265,0,292,17.7020440173,10-19,390,4,9,30,39,39,9,30,6,2.5199131064,25.8320706069,0.0211167416,0.181511471,0.47011495,0,59,7.882990208257348E-5,6.7748384E-5,6.8570174E-5,77,0,0,200,0,0
29386701,jabest,10,16488,749,499,37,37,50.9512920945,50-59,744,8,21,10,31,31,21,10,7,2.9847936278,73.8673129827,0.0160211576,0.135483871,0.2646154,0,59,1.3710927164104568E-4,1.4904643E-4,1.5085438E-4,175,39,1,200,1,0.005
29395837,thakorine,10,1020,376,551,10,29,55.1187405221,50-59,617,6,3,6,9,9,3,6,7,3.094134685,67.8726603775,0.001402596,0.125,0.30952382,0,59,7.213412210804228E-5,2.7099353E-5,2.742807E-5,182,23,0,200,0,0
29480932,powers_rhonda,10,4306,257,763,5,288,42.8688006463,40-49,575,7,26,65,91,91,26,65,6,2.3769007965,1344.4581985625,0.0311005163,0.11001221,0.27472293,0,59,1.169996195062242E-4,1.8292063E-4,1.8513948E-4,77,1,0,200,0,0
29491462,Jason_Sheard,10,1462,394,1179,13,113,43.8579093315,40-49,616,6,14,64,78,78,14,64,6,2.3866763215,276.5812733393,0.0293659744,0.1351981352,0.2872024,0,59,1.2538960617175315E-4,1.0162257E-4,1.02855265E-4,25,6,0,200,0,0
29649595,jewellerytears,10,9113,182,178,8,71,41.0422978739,40-49,658,7,7,6,13,13,7,6,7,3.2157856626,1577.4541878915,0.0077870041,0.0961538462,0.30555555,0,59,1.1690011305688573E-4,5.4198706E-5,5.485614E-5,182,10,0,201,0,0
29708012,BigLandMan,10,8010,270,291,7,1022,41.9517284507,40-49,722,7,16,20,36,36,16,20,7,2.8660391021,130.452568129,0.0140029073,0.2063492063,0.3467742,0,59,1.1078840932487883E-4,1.1517225E-4,1.16569296E-4,147,52,1,200,1,0.005
29771859,albertajeff,10,4840,1362,1863,56,92,46.7243261423,40-49,702,6,88,124,212,212,88,124,6,2.2867487328,9787.1676145465,0.1103088512,0.0602476974,0.21770152,0,59,4.2954974202213323E-4,6.029606E-4,6.1027455E-4,175,39,4,200,4,0.02
29816478,BRinYEG,10,9239,1542,1113,58,12,53.8190931746,50-59,757,7,56,67,123,123,56,67,6,2.3946415641,3153.653286277,0.0656640206,0.100159936,0.2497611,0,59,3.523431336652251E-4,3.8616578E-4,3.9085E-4,175,39,3,200,3,0.015
29861638,Thuncher,10,4700,294,733,11,94,45.1560059706,40-49,619,7,11,31,42,42,11,31,7,2.7273714699,480.1948950275,0.0131057013,0.1318234611,0.33366936,0,59,1.257707923852733E-4,8.129806E-5,8.228421E-5,182,21,0,200,0,0
29893160,BeaVaugrante,10,6252,1662,1677,104,2,50.5529316545,50-59,717,7,24,26,50,50,24,26,7,2.6958725561,400.3682399165,0.0189851233,0.1375510204,0.28109756,0,59,1.8117198417820255E-4,1.6937095E-4,1.7142543E-4,145,9,0,200,0,0
29916000,TreeHugginLovin,10,28272,469,887,13,1177,41.8442253295,40-49,729,8,1,7,8,8,1,7,7,3.159666908,4.0554219969,1.6233840702319324E-4,0.125,0.1904762,0,59,4.99274624204015E-5,1.3549677E-5,1.3714035E-5,175,2,0,200,0,0
30165556,han_kyoul,10,4862,972,1603,78,43,54.1193348265,50-59,640,7,33,65,98,98,33,65,6,2.3776249095,741.4583621885,0.0766419497,0.1483273722,0.41138497,0,59,2.2013360478794134E-4,2.303445E-4,2.3313859E-4,25,6,0,200,0,0
30307665,ktleit,10,117,79,137,2,1,31.1531863893,30-39,425,3,19,40,59,59,19,40,6,2.6393917451,11.3629898735,0.0377151689,0.1998831093,0.5924696,0,59,1.3047740802484264E-4,1.3549677E-4,1.3714035E-4,25,13,3,127,3,0.0236220472
30373506,karalenamclean,10,1655,225,952,3,7,41.148728641,40-49,545,6,30,153,183,183,30,153,6,2.2425778421,3684.5975463489,0.0612073705,0.1420765027,0.277168,0,59,1.9289563217862133E-4,2.1001999E-4,2.1256754E-4,25,4,1,200,1,0.005
30483902,loganclyburne,10,54,14,124,0,2,21.6956761864,20-29,218,3,0,1,1,1,0,1,8,3.6706478465,0,0,0,0,0,73,4.766339181938244E-5,0,6.8570175E-6,175,3,0,58,0,0
30547690,scoalegil,10,3524,699,1003,32,22,56.4440289492,50-59,695,7,68,90,158,158,68,90,6,2.4482259232,2196.3802144872,0.0941463011,0.1038458437,0.32822776,0,59,3.892077816579743E-4,4.6746383E-4,4.7313422E-4,147,24,0,200,0,0
30554699,Norlaine,10,1867,199,738,1,1,33.1294155538,30-39,590,5,30,119,149,149,30,119,6,2.2907313541,753.0536696632,0.0482989302,0.1519136586,0.35137445,0,59,1.6655676200761697E-4,2.1001999E-4,2.1256754E-4,77,1,8,200,8,0.04
30584980,JimWaterloo,10,2713,168,119,8,3,29.8882083,20-29,592,6,15,7,22,22,15,7,7,3.0340333092,16.1933359038,0.0164874865,0.1341991342,0.40416667,0,59,9.119390195316822E-5,1.0839741E-4,1.0971228E-4,25,0,1,199,1,0.0050251256
30606946,Satyagrahi_ji,10,30922,6939,5956,384,17,46.800513166,40-49,772,9,9,9,18,18,9,9,6,2.9163649529,38.3889903124,0.0084195249,0.0490196078,0.3,0,59,8.157937662010426E-5,6.7748384E-5,6.8570174E-5,77,3,0,200,0,0
30677923,eh_c,10,9530,338,433,7,69,47.8368316025,40-49,764,8,34,51,85,85,34,51,7,2.4967414917,2067.3984544228,0.0350533009,0.0962184874,0.2838983,0,59,2.3197682887728195E-4,2.3711934E-4,2.3999561E-4,175,26,0,200,0,0
31159339,Stephistan,10,157,78,381,0,21,20.8904748848,20-29,323,2,8,20,28,28,8,20,6,2.7708182476,82.8441908096,0.0111861083,0.1600529101,0.40238094,0,59,8.903101926478417E-5,6.0973543E-5,6.171316E-5,175,1,0,157,0,0
31254552,aysha_marie,10,2638,215,542,3,143,35.5322835904,30-39,600,6,5,33,38,38,5,33,7,2.6238233164,5231.0112682967,0.011807852,0.167140825,0.3560606,0,59,9.200692019313362E-5,4.064903E-5,4.1142106E-5,175,4,0,201,0,0
31558972,ilovehue,10,11253,1124,669,71,1362,49.0203237743,40-49,741,7,1,3,4,4,1,3,7,2.9105720492,0.1069485568,0.0050763996,0.1666666667,0.33333334,0,59,5.2959838971500805E-5,1.3549677E-5,1.3714035E-5,25,3,1,200,1,0.005
31658445,CorneliusCotter,10,257,123,590,1,0,31.0880628071,30-39,553,3,42,122,164,164,42,122,6,2.3146270818,1953.2822201931,0.0765253177,0.1460047883,0.34920636,0,59,2.0958606100842227E-4,2.9131805E-4,2.9485175E-4,25,4,1,201,1,0.0049751244
32112311,M_Charpentier,10,13604,8537,9339,242,12,55.7843829159,50-59,778,7,40,83,123,123,40,83,7,2.4561911658,14825.3154223047,0.0668228107,0.0793682527,0.2061634,0,59,3.348955542064794E-4,2.7776835E-4,2.811377E-4,145,20,0,200,0,0
32138687,melaniekarin,10,20214,1089,1144,30,502,51.4429086034,50-59,769,8,13,19,32,32,13,19,6,2.6832005793,516.9881148183,0.0189576066,0.0725806452,0.2547619,0,59,1.2390614715017276E-4,9.484774E-5,9.599824E-5,175,10,0,200,0,0
32257133,G_McLachlan,10,554,209,420,11,58,43.7784507776,40-49,553,5,30,89,119,119,30,89,7,2.4406227371,912.4785811763,0.0547778442,0.1415752742,0.34925944,0,59,1.9118018702094015E-4,2.1001999E-4,2.1256754E-4,25,15,7,200,7,0.035
32324576,njdcole,10,1713,333,517,2,131,60.9682006812,60-69,660,6,44,60,104,104,44,60,7,2.5792903693,2324.072493513,0.0508397157,0.1064227035,0.35379368,0,59,2.7292882978061474E-4,3.0486772E-4,3.085658E-4,25,92,0,199,0,0
32521071,BrewsterHoops,10,9524,4723,1147,85,69,58.9504078054,50-59,778,8,2,2,4,4,2,2,1,1,0,1.6551228476954845E-4,0.0833333333,1,20,91,3.177448371356425E-4,2.0324514E-5,2.0571053E-5,18,53,0,201,0,0
32521228,SarahMurrant,10,3535,366,588,9,9,52.6777228919,50-59,670,6,46,65,111,111,46,65,6,2.5065170167,1789.8017588572,0.0461097025,0.1037674038,0.3804829,0,59,2.6814358380742356E-4,3.1841738E-4,3.222798E-4,147,40,1,199,1,0.0050251256
32594292,gruntlion,10,536,1046,1956,4,0,32.228569208,30-39,571,5,0,1,1,1,0,1,7,3.4125950054,0,0,0,0,0,694,4.766339181938244E-5,0,6.8570175E-6,77,3,0,197,0,0
32687067,MissKelsieW,10,166,45,183,1,2,33.600145595,30-39,408,3,0,3,3,3,0,3,7,3.2602243938,0,0,0.3333333333,0.33333334,0,113,4.766339181938244E-5,0,6.8570175E-6,25,3,0,200,0,0
32750374,shannyanny,10,150,41,130,1,1,22.8400463849,20-29,505,3,0,4,4,4,0,4,7,3.0959102425,0,0,0.25,0.33333334,0,670,4.766339181938244E-5,0,6.8570175E-6,182,0,0,155,0,0
32859202,Redroserocker,10,42817,249,125,6,53,41.9510895767,40-49,676,8,3,2,5,5,3,2,8,3.4735698769,0.3288450191,0.0022279166,0.05,0.33333334,0,59,8.420822240214159E-5,2.7099353E-5,2.742807E-5,147,5,0,201,0,0
32936416,jamesbridges16,10,1799,210,560,4,19,42.5733323392,40-49,591,6,25,50,75,75,25,50,7,2.6151339609,1046.1549572541,0.0387131851,0.167027027,0.4104658,0,59,1.660267871207473E-4,1.761458E-4,1.7828245E-4,175,23,6,200,6,0.03
32949218,moladi,10,6593,1020,1986,25,31,46.9401221561,40-49,699,7,2,2,4,4,2,2,1,1,2,1.619561731312207E-4,0,0,233,601,4.6360358251326255E-4,2.0324514E-5,2.0571053E-5,251,182,0,198,0,0
33082809,JoshLee_BAHoops,10,8830,771,1073,28,12,50.8955615577,50-59,740,7,2,2,4,4,2,2,1,1,0,1.6551228476954845E-4,0.0833333333,1,20,91,3.177448371356425E-4,2.0324514E-5,2.0571053E-5,18,21,0,201,0,0
33123665,erinbharrison,10,220,197,144,2,0,26.4388723321,20-29,455,2,52,27,79,79,52,27,6,2.7103548154,247.7927330443,0.0575783037,0.1382667965,0.3420765,0,59,2.6470679419419286E-4,3.590664E-4,3.6342192E-4,182,3,0,200,0,0
33131099,Slipcatch,10,16071,429,429,15,132,47.1208218751,40-49,712,7,2,5,7,7,2,5,9,4.8095582911,5.7275103981,1.9116222763364282E-4,0.119047619,0.35,0,59,9.271432853245506E-5,2.0324514E-5,2.0571053E-5,131,0,0,200,0,0
33269047,Scruffy19,10,2557,105,149,0,20,38.3835014219,30-39,594,6,5,8,13,13,5,8,7,2.7404055033,12.6642509239,0.0112411286,0.0705128205,0.2857143,0,59,6.762516204428346E-5,4.064903E-5,4.1142106E-5,77,6,1,200,1,0.005
33281941,smcgillivray,10,4663,26695,612,401,3,67.897409899,60-69,863,7,30,4,34,34,30,4,8,3.6238233164,582.2788188951,0.0135862624,0.0249554367,0.03326613,0,59,3.897943413302184E-4,2.1001999E-4,1.9199649E-4,182,217,0,200,0,0
33316076,SeanLyall,10,14843,516,1135,8,19,50.467196478,50-59,740,8,25,41,66,66,25,41,6,2.6723388849,2093.5060992665,0.0243842095,0.0738927739,0.23282829,0,59,1.800275727659591E-4,1.761458E-4,1.7828245E-4,147,69,0,205,0,0
33565866,smrtchng,10,1840,147,412,1,22,45.0706193805,40-49,629,5,19,63,82,82,19,63,6,2.4047791455,1146.7963271957,0.0218267295,0.0992171033,0.20375396,0,59,1.0857793779938616E-4,1.3549677E-4,1.3714035E-4,77,37,2,203,2,0.0098522167
33918309,dwjudson,10,2758,394,1454,10,3,53.3328422285,50-59,628,6,15,108,123,123,15,108,6,2.3186097031,544.8422880725,0.0290932562,0.18725843,0.35040775,0,59,1.2800804873668058E-4,1.0839741E-4,1.0971228E-4,175,10,0,200,0,0
33929160,AMSUL,10,347,82,528,1,0,37.2484957963,30-39,504,4,3,4,7,7,3,4,7,3.1853729182,313.1404180665,0.0022651714,0.0714285714,0.33333334,0,59,6.658978069307817E-5,2.7099353E-5,2.742807E-5,25,18,0,200,0,0
34073187,hhpouliot,10,410,115,201,0,71,40.2513992932,40-49,571,4,26,45,71,71,26,45,6,2.4790007241,136.9387157827,0.0468022346,0.1959758551,0.4827922,0,59,1.6473617927253924E-4,1.8292063E-4,1.8513948E-4,25,29,3,200,3,0.015
34121956,squamishsusan,10,2180,567,1209,16,23,47.6799079611,40-49,623,6,13,65,78,78,13,65,6,2.3475742216,935.1893423227,0.0201482149,0.1595071595,0.33519813,0,59,9.335847013887004E-5,9.484774E-5,9.599824E-5,175,7,1,200,1,0.005
34165887,leilanifarha,10,355,125,166,1,1,42.0113876806,40-49,520,4,15,20,35,35,15,20,6,2.6086169442,475.5451073524,0.0296764696,0.1915966387,0.4507389,0,59,2.2440998768626037E-4,1.0839741E-4,1.0971228E-4,25,13,1,200,1,0.005
34333300,k3voX,10,273,31,73,0,1,35.2651251721,30-39,517,4,8,14,22,22,8,14,7,2.8472121651,59.7676373616,0.0070488135,0.1017316017,0.489011,0,59,7.660301708532092E-5,6.0973543E-5,6.171316E-5,175,18,0,200,0,0
34478789,DufferinRider,10,2853,143,409,1,44,49.5567871709,40-49,643,6,15,34,49,49,15,34,6,2.5887038378,328.4561040458,0.0321961531,0.1607142857,0.3798799,0,59,1.859178902599346E-4,1.0839741E-4,1.0971228E-4,25,22,0,201,0,0
34509503,MomaLoves,10,212,11,109,0,44,23.9905291452,20-29,416,4,0,8,8,8,0,8,7,3.0456026059,0,0,0.1964285714,0.26785713,0,565,4.766339181938244E-5,0,6.8570175E-6,175,2,0,200,0,0
34743714,BrianLGardiner,10,284,405,1291,6,15,35.0611150714,30-39,500,4,62,122,184,184,62,122,6,2.3569876901,2146.4098553695,0.0829699368,0.111249703,0.32732528,0,59,2.999851989111623E-4,4.268148E-4,4.319921E-4,182,1,0,200,0,0
34784372,kitredmond,10,2216,357,187,12,19,55.9885950715,50-59,641,5,2,2,4,4,2,2,8,4.1049963794,84.4046836862,0.0042443942,0.0833333333,0.33333334,0,59,7.67611562224056E-5,2.0324514E-5,2.0571053E-5,175,12,0,200,0,0
34959839,Motlotlegi,10,37504,856,588,8,101,54.0464509754,50-59,794,8,5,5,10,10,5,5,9,4.8167994207,10920.6861815262,4.475943542607232E-4,0.1111111111,0.2857143,0,59,2.4436438074543676E-4,4.064903E-5,3.4285087E-5,131,11,0,201,0,0
35162290,140notes,10,2542,157,168,3,66,41.8273080628,40-49,637,5,4,6,10,10,4,6,7,3.1071687183,36.9490841401,0.002270228,0.1222222222,0.47619048,0,59,6.683807042800303E-5,3.3874192E-5,3.4285087E-5,175,3,0,200,0,0
35265785,Jim_Mullin,10,4887,1219,1017,55,402,50.365401794,50-59,722,7,12,16,28,28,12,16,7,2.867487328,148.1054452823,0.0113896698,0.1428571429,0.26811594,0,59,1.2236102549267677E-4,8.80729E-5,8.914123E-5,182,8,0,200,0,0
35303265,zoe_ferry,10,7764,986,1476,28,148,65.6652545495,60-69,704,7,48,85,133,133,48,85,6,2.4272266474,1723.7520335946,0.0570592023,0.1167122351,0.33471444,0,59,2.6942568556629E-4,3.3196708E-4,3.2913685E-4,175,11,1,200,1,0.005
35425956,areviaki,10,1000,92,382,0,10,28.2705066878,20-29,533,5,7,34,41,41,7,34,6,2.5481535119,145.3571139592,0.00941982,0.1969512195,0.34444445,0,59,6.498454055932449E-5,5.4198706E-5,5.485614E-5,77,2,1,200,1,0.005
35559137,abiramyv,10,3321,236,186,7,134,45.7809374336,40-49,637,6,3,11,14,14,3,11,6,2.8258508327,26.7082564504,0.0042101405,0.2252747253,0.41666666,0,59,5.649009877456675E-5,2.7099353E-5,2.742807E-5,182,20,0,200,0,0
35616759,jessicalepore,10,3208,107,330,0,73,28.2126576654,20-29,661,6,0,5,5,5,0,5,7,3.6463988418,0,0,0.3,0.35,0,593,4.766339181938244E-5,0,6.8570175E-6,175,1,0,199,0,0
35646312,redwoodwoof,10,4714,401,710,13,329,59.0599462179,50-59,674,7,7,13,20,20,7,13,7,2.9876900797,52.3030632098,0.0071666747,0.1210526316,0.2809524,0,59,9.195169803876163E-5,5.4198706E-5,5.485614E-5,175,6,0,200,0,0
36126551,RyanHastman,10,8890,1985,417,106,0,62.0542008762,60-69,757,7,82,28,110,110,82,28,7,2.7755249819,1163.4397897088,0.1077978959,0.1109257715,0.2594226,0,59,6.297367687795021E-4,5.6231156E-4,5.6913245E-4,175,43,1,200,1,0.005
36311064,rileyYVR,10,101,2,9,0,0,10.6708586376,10-19,151,3,0,0,0,0,0,0,0,0,0,0,0,0,147,330,4.766339181938244E-5,0,0,143,0,0,104,0,0
36398145,neal_gray,10,7571,447,60,22,34,42.1035274007,40-49,711,6,33,7,40,40,33,7,7,2.7346125996,89.1987302779,0.0461175935,0.1666666667,0.37878788,0,59,1.8089280038449028E-4,2.303445E-4,2.3313859E-4,175,4,0,200,0,0
36489207,Parker20000,10,4747,332,606,17,11,43.7239168731,40-49,671,6,1,1,2,2,1,1,1,1,0,8.095914281419891E-5,0,0,84,180,3.177448371356425E-4,1.3549677E-5,1.3714035E-5,96,3,0,199,0,0
36506853,Tonymitra,10,864,70,23,1,14,47.2023044807,40-49,617,6,4,2,6,6,4,2,7,3.2378711079,8.719847588,0.0034089998,0.1,0.33333334,0,59,6.629176319173669E-5,3.3874192E-5,3.4285087E-5,77,27,0,201,0,0
36711954,longpre11,10,11693,315,165,33,20,46.1876885392,40-49,699,7,3,4,7,7,3,4,7,3.0459811731,44.052609255,0.004902157,0.0952380952,0.5,0,59,6.595994995881416E-5,2.7099353E-5,2.742807E-5,175,7,0,200,0,0
36806135,CayleyRauw,10,74,93,115,1,0,16.7690091733,10-19,203,2,5,8,13,13,5,8,7,3.1104272266,85.685957524,0.0106280884,0.141025641,0.34444445,0,59,1.2852623637728337E-4,4.064903E-5,4.1142106E-5,175,0,0,76,0,0
36877156,ChantalSchutz,10,304,153,332,1,4,32.6677872322,30-39,461,4,0,3,3,3,0,3,7,3.275063337,0,0,0.5,1,0,327,4.766339181938244E-5,0,6.8570175E-6,182,2,0,201,0,0
37007942,Ceekay77,10,3331,71,236,3,59,36.8497117205,30-39,655,6,3,9,12,12,3,9,7,2.9044170891,98.6848433031,0.0037850548,0.2272727273,0.36363637,0,59,5.746402289790123E-5,2.7099353E-5,2.742807E-5,175,3,0,200,0,0
37051207,erin_hanson,10,2559,414,545,20,6,45.8005754276,40-49,659,6,6,15,21,21,6,15,6,2.7407675597,2879.0991079093,0.0033765357,0.1261904762,0.22222222,0,59,1.1560495941858885E-4,4.742387E-5,4.799912E-5,77,4,0,200,0,0
37085947,Sethpt,10,2056,223,189,4,24,43.8618687005,40-49,648,5,11,16,27,27,11,16,6,2.6918899348,146.4964502155,0.0261772414,0.2478632479,0.5494071,0,59,1.0335285792869833E-4,8.129806E-5,8.228421E-5,175,3,0,199,0,0
37089180,kokumb,10,931,32,132,0,8,40.5260212284,40-49,372,4,0,7,7,7,0,7,7,2.8150560984,0,0,0.1904761905,0.26190478,0,146,4.766339181938244E-5,0,6.8570175E-6,182,2,0,200,0,0
37346747,mjeso,10,1883,1010,1799,27,36,50.210535672,50-59,672,6,102,161,263,263,102,161,6,2.2429398986,9855.0144073166,0.1109630744,0.0736075233,0.24170406,0,59,4.7308772574019924E-4,6.9780834E-4,7.062728E-4,182,65,1,200,1,0.005
37491208,CanadasPredsFan,10,1239,256,148,7,8,47.6940263464,40-49,711,7,2,4,6,6,2,4,7,2.925416365,0,0.0059893987,0.2,0.9166667,0,59,5.859514976342125E-5,2.0324514E-5,2.0571053E-5,25,5,0,201,0,0
37513164,financialdude1,10,7708,80,25,0,0,42.3909593416,40-49,552,9,0,0,0,0,0,0,0,0,0,0,0,0,112,252,4.766339181938244E-5,0,0,103,0,1,200,1,0.005
37515185,RobertAHammer,10,157,54,126,1,0,32.2912834843,30-39,522,4,15,34,49,49,15,34,6,2.678493845,63.2563225424,0.013816883,0.1709183673,0.5159664,0,59,1.1441750347168622E-4,1.0839741E-4,1.0971228E-4,147,60,0,200,0,0
37517920,KingBhumi,10,656,59,391,1,3,23.6248175821,20-29,456,5,0,5,5,5,0,5,7,3.4118711545,0,0,0.35,0.5,0,635,4.766339181938244E-5,0,6.8570175E-6,175,0,0,200,0,0
37713606,hydroqueen,10,23082,1166,1114,20,76,41.9604682002,40-49,767,8,48,49,97,97,48,49,6,2.4308472122,5686.3054150004,0.055298565,0.0399484536,0.25142857,0,59,2.41131440719949E-4,3.3196708E-4,3.3599386E-4,147,56,2,200,2,0.01
37970352,JoeyViezner,10,4720,238,517,1,20,59.8461863431,50-59,644,6,13,59,72,72,13,59,6,2.5217233888,205.4260486972,0.0126877873,0.1825117371,0.35351667,0,59,9.573680008176647E-5,9.484774E-5,9.599824E-5,175,25,2,201,2,0.0099502488
38038939,Pjhwalsh,10,4306,472,434,8,181,45.7674224607,40-49,727,7,43,33,76,76,43,33,7,2.7979724837,712.5423375304,0.0362333766,0.0989473684,0.35058823,0,59,2.262769451470433E-4,2.9809287E-4,3.0170876E-4,175,25,5,200,5,0.025
38237891,Danfordgirl,10,50,7,59,0,0,12.0125759127,10-19,157,3,0,0,0,0,0,0,0,0,0,0,0,0,257,669,4.766339181938244E-5,0,0,262,0,0,50,0,0
38283135,speirsr,10,367,256,1323,6,3,36.5782044988,30-39,617,6,5,17,22,22,5,17,6,2.7060101376,467.5634272007,0.0046069475,0.1471861472,0.32026145,0,59,8.98166209192978E-5,4.064903E-5,4.1142106E-5,147,2,0,201,0,0
38360581,jennlhug,10,3655,109,197,2,152,36.434641402,30-39,643,5,0,1,1,1,0,1,9,4.6692001448,0,0,0,0,0,121,4.766339181938244E-5,0,6.8570175E-6,175,0,0,199,0,0
38452371,LeslieL8,10,302,27,121,3,12,23.0772808079,20-29,348,4,1,4,5,5,1,4,7,2.8283852281,0,0.0072676982,0.25,0.5,0,59,5.409653606626543E-5,1.3549677E-5,1.3714035E-5,182,0,0,195,0,0
38494251,amandawi,10,464,470,566,7,1,36.5909729267,30-39,570,4,50,71,121,121,50,71,6,2.4866039102,2633.228560643,0.0711762764,0.1225895317,0.35532212,0,59,3.7514333696505106E-4,3.4551675E-4,3.497079E-4,147,11,0,200,0,0
38499453,HFX_Lauren,10,9662,806,1083,16,86,50.2086559001,50-59,709,7,60,120,180,180,60,120,6,2.3435916003,4459.0697366108,0.0801369765,0.1106455618,0.3066786,0,59,3.4176127928158364E-4,4.1326514E-4,4.1827807E-4,147,229,1,204,1,0.0049019608
38548714,wildfiremike,10,26664,1597,1997,58,1061,49.9889714382,40-49,757,9,16,34,50,50,16,34,7,2.8877624909,1515.5597877865,0.0377313614,0.1608163265,0.33972126,0,59,2.2988780413094615E-4,1.1517225E-4,1.16569296E-4,175,5,0,201,0,0
38565862,Borlase_R,10,19,50,83,0,0,16.6102617044,10-19,347,2,4,7,11,11,4,7,7,2.9565532223,25.0242335341,0.0086074819,0.1545454545,0.61904764,0,59,8.984285008603383E-5,3.3874192E-5,3.4285087E-5,182,0,0,21,0,0
38639718,lise_latulippe,10,6885,376,852,4,75,34.1525889231,30-39,684,7,63,125,188,188,63,125,6,2.2943519189,847.6313686741,0.0739323705,0.0969678007,0.3248969,0,59,1.9240479139461948E-4,4.3358965E-4,4.3884912E-4,77,10,1,200,1,0.005
38744285,Phumbling,10,874,53,128,1,9,40.0028764067,40-49,536,4,18,22,40,40,18,22,6,2.8479362781,101.1956139203,0.0129180523,0.0865384615,0.23941799,0,59,1.0001460533966856E-4,1.2872192E-4,1.3028333E-4,182,31,1,200,1,0.005
38915473,AlineBouDiwan,10,31634,403,736,8,97,40.071737775,40-49,760,8,1,6,7,7,1,6,7,3.1187545257,0,7.157763006720327E-4,0.2857142857,0.33333334,0,59,4.862556720134632E-5,1.3549677E-5,1.3714035E-5,175,0,0,202,0,0
39040737,KnorthernKnight,10,25607,1595,2001,72,142,54.6465695973,50-59,785,8,9,20,29,29,9,20,6,2.792903693,110.4093692005,0.0052854932,0.0849753695,0.2012987,0,59,8.117565809917597E-5,6.7748384E-5,6.8570174E-5,77,3,0,200,0,0
39103314,tarekyassine,10,9568,363,1204,7,3,56.8655421578,50-59,646,6,1,7,8,8,1,7,7,3.2295438088,1.4592945721,0.0013981692,0.25,0.3809524,0,59,5.736916401455216E-5,1.3549677E-5,1.3714035E-5,175,0,0,199,0,0
39204895,benfromcanada,10,41065,945,802,64,2718,51.4351360192,50-59,831,9,22,19,41,41,22,19,6,2.7338884866,405.2141092564,0.0224090776,0.1158536585,0.23484848,0,59,1.3542138531437865E-4,1.5582128E-4,1.577114E-4,77,12,0,201,0,0
39234426,gsmardli,10,103,28,93,0,88,40.2981785025,40-49,482,4,5,10,15,15,5,10,7,2.8135409124,3107.9641512794,0.0039016835,0.1904761905,0.40384614,0,59,1.1209037143624014E-4,4.064903E-5,4.1142106E-5,182,11,1,200,1,0.005
39314178,dysviz,10,8480,262,886,4,86,28.8754856138,20-29,472,5,1,18,19,19,1,18,7,2.7954380883,4.1875331392,0.00142936,0.1900584795,0.28104576,0,59,4.959187791681241E-5,1.3549677E-5,1.3714035E-5,77,0,0,200,0,0
39401251,unitycharity,10,1928,7461,518,57,112,64.9197543751,60-69,740,6,2,5,7,7,2,5,7,3.1893555395,1.7100334275,0.00407659,0.1428571429,0.23333333,0,59,5.903057423772144E-5,2.0324514E-5,2.0571053E-5,175,38,0,201,0,0
39426054,nspc,10,4414,1598,556,60,7,52.9825911503,50-59,760,7,59,29,88,88,59,29,6,2.5818247647,3999.5888133547,0.03552364,0.0760188088,0.17122154,0,59,3.52020612946772E-4,4.064903E-4,4.1142106E-4,147,194,0,197,0,0
39664824,Tyson_Cormack,10,1923,298,612,1,543,35.8662514354,30-39,629,6,56,129,185,185,56,129,6,2.3023171615,4096.5778291951,0.0875497888,0.1668918919,0.36950725,0,59,2.1547432961945898E-4,3.8616578E-4,3.9085E-4,25,18,1,198,1,0.0050505051
40152815,tibiamyfibula,10,7107,249,329,6,890,50.6485047781,50-59,695,7,29,26,55,55,29,26,6,2.5409123823,272.726895185,0.0407756989,0.1528619529,0.31565657,0,59,1.278885596485696E-4,2.0324514E-4,2.0571053E-4,77,21,19,203,16,0.078817734
40191477,JohnnyJesus,10,45148,1281,665,33,5838,42.3315288536,40-49,783,9,75,81,156,156,75,81,7,2.509775525,4287.8867650638,0.0403198676,0.0653846154,0.26406926,0,59,3.500447719148558E-4,5.148877E-4,5.211333E-4,175,124,8,207,8,0.038647343
40248890,GordSpence,10,1933,124,122,6,4,40.017149642,40-49,624,5,2,2,4,4,2,2,7,3.234974656,0,0.0014993305,0.25,0.6666667,0,59,5.461901260015899E-5,2.0324514E-5,2.0571053E-5,25,0,0,200,0,0
40261852,YK_Centre,10,2460,602,1061,25,3,46.0855125526,40-49,672,6,15,62,77,77,15,62,6,2.357711803,1304.066434418,0.0319063183,0.1556732741,0.3515105,0,59,1.353059605831747E-4,1.0839741E-4,1.0971228E-4,175,10,1,200,1,0.005
40300267,Design4Change,10,7345,658,990,43,34,46.5338482074,40-49,685,6,50,64,114,114,50,64,6,2.5267921796,5067.8749659408,0.0708333771,0.1054184133,0.32960078,0,59,4.762875610385555E-4,3.4551675E-4,3.4285086E-4,147,62,0,202,0,0
40509565,Nehiyahskwew,10,4241,2188,681,45,1409,58.9291986744,50-59,760,6,95,34,129,129,95,34,6,2.6183924692,3055.4650856406,0.0627734811,0.0752180233,0.12425629,0,59,5.172066051582317E-4,6.5038446E-4,6.582737E-4,77,75,0,200,0,0
40551753,jaydenpfeifer,10,3485,934,206,31,12,45.8077449916,40-49,716,6,19,3,22,22,19,3,7,3.3522809558,17.686596127,0.0134251218,0.3181818182,0.65,0,59,1.4700738312462268E-4,1.3549677E-4,1.3714035E-4,25,25,0,199,0,0
40632978,joshjordaan,10,27616,1513,517,15,159,47.5736750037,40-49,787,8,7,3,10,10,7,3,10,5.8066618392,7480.1317003223,6.611089877166657E-4,0.1,0.17857143,0,59,3.6398005055694087E-4,5.4198706E-5,5.485614E-5,131,4,0,200,0,0
40704088,TrondFrantzen,10,4725,707,664,36,4,43.5306494381,40-49,656,6,9,13,22,22,9,13,7,2.953294714,281.1318743629,0.0062912859,0.0865800866,0.25,0,59,1.1740565688279992E-4,6.7748384E-5,6.8570174E-5,175,5,0,198,0,0
40735014,MrMLMurray,10,3534,340,493,10,20,36.238635674,30-39,638,5,13,26,39,39,13,26,6,2.490948588,223.219879527,0.0234248884,0.1241565452,0.35185185,0,59,1.3238565414617608E-4,9.484774E-5,9.599824E-5,182,3,2,200,2,0.01
40756532,StopWarCa,10,2323,1504,1270,83,1,42.7594503628,40-49,705,6,81,102,183,183,81,102,6,2.377262853,7071.4913590242,0.1127264229,0.0873115955,0.23297049,0,59,5.041349729123458E-4,5.555367E-4,5.622754E-4,182,29,0,200,0,0
40934757,adrienneconley,10,363,65,89,3,7,41.916594978,40-49,525,4,8,17,25,25,8,17,7,2.7617668356,19.9635293834,0.0125126992,0.1883333333,0.6875,0,59,8.645634787951843E-5,6.0973543E-5,6.171316E-5,25,16,0,199,0,0
40950257,markymark7717,10,12092,954,2001,26,338,47.6743353185,40-49,742,7,36,61,97,97,36,61,6,2.4576393917,7045.7422581481,0.0392958277,0.0850515464,0.1922807,0,59,1.8071094440586817E-4,2.5066902E-4,2.5370964E-4,77,8,2,201,2,0.0099502488
40976505,TwittleAir,10,2766,225,883,1,148,41.3894260856,40-49,594,6,2,7,9,9,2,7,7,3.179217958,2986.1933351889,5.275540620604663E-4,0.2083333333,0.45238096,0,59,5.422733728369901E-5,2.0324514E-5,2.0571053E-5,182,0,0,200,0,0
41043869,JeffClark1969,10,12214,965,1997,38,31,63.0038594685,60-69,722,8,104,192,296,296,104,192,6,2.2396813903,9739.7331947271,0.1143896096,0.0761337609,0.2263032,0,59,3.963185248223385E-4,7.1135804E-4,7.1998686E-4,175,49,1,201,1,0.0049751244
41112530,catmommy23,10,243,5,17,0,0,11.7341444214,10-19,15,4,0,0,0,0,0,0,0,0,0,0,0,0,87,192,4.766339181938244E-5,0,0,78,0,0,200,0,0
41205644,BKJohnstone,10,1759,895,1220,32,93,49.1364628837,40-49,633,6,62,96,158,158,62,96,6,2.3540912382,1559.0909487119,0.1077663779,0.1206562928,0.3014528,0,59,4.277028746100591E-4,4.268148E-4,4.319921E-4,175,38,5,200,4,0.02
41259348,sherwinvaz,10,853,38,95,0,71,25.7186651634,20-29,535,4,0,1,1,1,0,1,1,1,0,0,0,0,0,556,4.766339181938244E-5,0,6.8570175E-6,175,3,0,199,0,0
41413178,QMUNITY,10,1104,1632,651,96,0,50.844888647,50-59,728,5,31,17,48,48,31,17,6,2.9138305576,1238.9655464033,0.0284241301,0.0709219858,0.25100806,0,59,2.864530202883983E-4,2.1679483E-4,2.1256754E-4,182,30,0,200,0,0
41624572,CanadaOrangeCat,10,2596,8438,8528,49,8,57.207099337,50-59,714,6,33,35,68,68,33,35,6,2.433743664,2421.7514031921,0.039884751,0.0335820896,0.23865546,0,59,1.6266492172438128E-4,2.303445E-4,2.3313859E-4,77,9,0,200,0,0
41706757,tapferkeit,10,55236,2427,2164,54,8722,46.570641239,40-49,790,9,127,126,253,253,127,126,6,2.3023171615,13327.9147511287,0.1115963941,0.0357456553,0.23363149,0,59,3.867204741869749E-4,8.671793E-4,8.7769824E-4,77,130,0,202,0,0
41824705,JaiJoseph,10,2394,178,187,0,136,37.6938984562,30-39,655,6,1,1,2,2,1,1,8,4.225923244,0,9.470643154997745E-5,0,0,0,59,7.001758610043551E-5,1.3549677E-5,1.3714035E-5,147,2,0,200,0,0
41831995,PoliticalBee,10,81252,4531,4982,339,100213,45.9526913349,40-49,762,10,15,19,34,34,15,19,7,2.8417813179,598.7409206373,0.0113539123,0.0454545455,0.20476191,0,59,1.2725494386353864E-4,1.0839741E-4,1.0971228E-4,77,1,0,201,0,0
42070392,TylerMacNeill,10,835,384,394,2,149,37.9504757913,30-39,603,5,3,2,5,5,3,2,8,3.7049239681,0,0.0020915013,0.15,0.6666667,0,59,6.701400002323148E-5,2.7099353E-5,2.742807E-5,175,4,0,197,0,0
42198561,TheMarthaChaves,10,1343,518,650,7,241,50.0689091998,50-59,646,6,10,14,24,24,10,14,6,2.7610427227,66.9137769079,0.0057433183,0.0634057971,0.18333334,0,59,7.533928453948993E-5,7.452322E-5,7.542719E-5,77,15,0,200,0,0
42222564,elavoie,10,23365,254,201,7,17,35.8595307739,30-39,714,8,7,7,14,14,7,7,7,2.953294714,102.1172716142,0.0062990084,0.1483516484,0.4090909,0,59,8.913313296755876E-5,5.4198706E-5,5.485614E-5,175,34,0,202,0,0
42376010,siksaapo,10,3983,600,1492,10,139,43.9139622137,40-49,618,6,58,131,189,189,58,131,6,2.2487328023,11712.3651403689,0.0573010985,0.0701058201,0.20226704,0,59,2.21112139659348E-4,3.9971547E-4,4.0456402E-4,77,14,0,197,0,0
42612159,Bretooo,10,1888,356,1280,10,10,37.2613386286,30-39,578,5,40,116,156,156,40,116,6,2.2950760319,426.6341008466,0.0801859211,0.2016129032,0.4712258,0,59,2.0980726184086285E-4,2.7776835E-4,2.811377E-4,25,12,1,200,1,0.005
42652292,MRALBERTA99,10,331,440,1249,15,16,34.0800806385,30-39,478,3,1,11,12,12,1,11,7,2.9985517741,0.283388394,7.853389160614392E-4,0.2348484848,0.46363637,0,59,5.3055346944817696E-5,1.3549677E-5,1.3714035E-5,175,0,0,200,0,0
42691701,lucyfukushima,10,493,37,243,0,2,22.3547546888,20-29,195,4,2,8,10,10,2,8,7,3.1020999276,17.8456285052,0.0018314959,0.1888888889,0.29166666,0,59,5.811716942399721E-5,2.0324514E-5,2.0571053E-5,77,0,0,200,0,0
42901893,Bootero,10,1758,160,760,3,501,28.8999920637,20-29,569,5,0,1,1,1,0,1,8,4.5421643142,0,0,0,0,0,603,4.766339181938244E-5,0,6.8570175E-6,145,1,0,200,0,0
42982767,BCCIC,10,1567,1209,1170,76,1,47.2063628701,40-49,669,5,8,6,14,14,8,6,7,3.0952208545,69.0395276792,0.0017062702,0.043956044,0.12727273,0,59,9.247442812998662E-5,6.0973543E-5,6.171316E-5,182,26,1,200,1,0.005
43171504,jaymini,10,1453,508,616,37,0,44.1121289144,40-49,639,5,27,37,64,64,27,37,6,2.5282404055,563.3016409817,0.0385044964,0.1284722222,0.35362318,0,59,2.573159591720578E-4,1.8969548E-4,1.9199649E-4,175,4,2,200,2,0.01
43209544,casydelafuente,10,8673,269,270,0,32,36.1385814706,30-39,686,6,0,0,0,0,0,0,0,0,0,0,0,0,151,339,4.766339181938244E-5,0,0,149,8,0,200,0,0
43618205,424union,10,278,483,1295,6,0,29.9992040459,20-29,476,4,55,95,150,150,55,95,6,2.3189717596,4430.05006133,0.0718775483,0.0833557047,0.28697664,0,59,2.6150871049513823E-4,3.7939096E-4,3.8399297E-4,182,0,1,198,1,0.0050505051
43705629,ECJLajoie,10,4281,669,1306,13,392,40.9981994529,40-49,695,6,37,60,97,97,37,60,6,2.4257784214,1138.1530629584,0.0525511102,0.1096434708,0.28063166,0,59,1.6600267306985682E-4,2.5744384E-4,2.6056665E-4,175,12,0,200,0,0
43742840,f_de_carolis,10,216,125,486,1,53,39.3122813707,30-39,407,3,0,1,1,1,0,1,7,4.3571428571,0,0,0,0,42,446,4.766339181938244E-5,0,6.8570175E-6,197,0,0,200,0,0
43988109,selinarobinson,10,4680,867,474,47,17,49.4037112384,40-49,711,7,58,28,86,86,58,28,7,2.7907313541,4742.4745663525,0.0509523069,0.1095759234,0.29464287,0,59,3.6087895620023365E-4,3.9971547E-4,3.9770702E-4,182,54,0,200,0,0
44280511,yardiblack,10,1765,168,482,1,3,40.3416128473,40-49,500,5,0,0,0,0,0,0,0,0,0,0,0,0,89,199,4.766339181938244E-5,0,0,80,1,0,202,0,0
44316923,MylanTootoosis,10,837,740,248,18,304,46.4324292925,40-49,679,5,25,0,25,25,25,0,0,0,0,0.0101127136,0.1466666667,0.21166667,0,6,1.9776221035049511E-4,1.761458E-4,0,77,2,0,199,0,0
44366939,geckospots,10,2827,71,155,2,19,40.9319231623,40-49,640,6,2,3,5,5,2,3,7,3.0228095583,6.6160422565,0.0067898577,0.1,0.33333334,0,59,6.145639297450098E-5,2.0324514E-5,2.0571053E-5,25,30,1,199,1,0.0050251256
44596346,Jacanews,10,48906,28515,3002,364,33,66.185755227,60-69,888,8,32,9,41,41,32,9,10,5.7404055033,43959.5905718239,0.0055275955,0.037195122,0.08266129,0,59,0.0014606629,2.2356966E-4,1.8513948E-4,131,105,0,239,0,0
44777956,heatherkel,10,82,48,71,7,4,24.1252369731,20-29,203,2,11,16,27,27,11,16,7,2.7241129616,7.5942251986,0.0123852343,0.2136752137,0.5842105,0,59,8.73919075608123E-5,8.129806E-5,8.228421E-5,182,8,0,110,0,0
44829951,liampoleary,10,144,95,97,5,1,22.2824142445,20-29,185,3,0,6,6,6,0,6,7,3.1197973218,0,0,0.2333333333,0.26666668,0,334,4.766339181938244E-5,0,6.8570175E-6,25,0,0,146,0,0
44964136,Babs_Freezy,10,2634,166,155,0,6,44.2998259424,40-49,675,6,1,1,2,2,1,1,12,7.8020984081,0,8.095914281419891E-5,0,0,0,250,1.0633321402051042E-4,1.3549677E-5,1.3714035E-5,131,21,0,200,0,0
45169003,Intelevore,10,10437,321,326,8,27,43.4250844769,40-49,733,7,12,14,26,26,12,14,7,2.8609703114,53.3491610716,0.0077975983,0.0984615385,0.44166666,0,59,8.983161663665405E-5,8.80729E-5,8.914123E-5,147,16,1,202,1,0.004950495
45230771,JesseSturgeon,10,3292,346,348,12,8,45.8701441047,40-49,690,6,28,42,70,70,28,42,7,2.6915278783,1300.4476806598,0.0326093047,0.102484472,0.3210034,0,59,1.4992323588892712E-4,1.9647031E-4,1.9885351E-4,182,25,0,200,0,0
45423472,JonnySopotiuk,10,3005,974,659,51,22,61.6048429112,60-69,677,6,60,83,143,143,60,83,6,2.3906589428,6492.8468587965,0.099310786,0.0629370629,0.21265398,0,59,3.33948536913323E-4,4.1326514E-4,4.1827807E-4,182,37,0,200,0,0
45628001,laycer,10,2039,68,384,0,83,28.7767747608,20-29,578,6,0,1,1,1,0,1,1,1,0,0,0,0,0,116,4.766339181938244E-5,0,6.8570175E-6,25,10,0,198,0,0
46102486,Joe990gp,10,6876,257,429,2,88,54.6449274113,50-59,728,7,3,5,8,8,3,5,9,4.8084721217,40.7280366692,2.884094123799279E-4,0.0714285714,0.35,0,59,1.156965290957207E-4,2.7099353E-5,2.742807E-5,131,8,0,201,0,0
46118051,HeyClaire,10,4888,554,257,30,27,52.6398770826,50-59,693,6,20,13,33,33,20,13,6,2.6690803765,31.7696103397,0.0401460547,0.1979166667,0.40343916,0,59,1.0882287254326535E-4,1.422716E-4,1.4399737E-4,77,1,0,200,0,0
46221000,kristaburns,10,1761,171,494,1,141,39.4663457586,30-39,609,6,1,0,1,1,1,0,0,0,0,0.0041882386,0,0,0,50,5.351726810400683E-5,1.3549677E-5,0,175,0,0,200,0,0
46280896,Estey12,10,1434,160,238,1,1,37.8571628871,30-39,635,5,22,30,52,52,22,30,6,2.6223750905,558.1627577322,0.0417339755,0.1843891403,0.51422477,0,59,2.8188300082798094E-4,1.5582128E-4,1.577114E-4,25,30,6,180,6,0.0333333333
46438367,CTVBarrieNews,10,11891,12281,253,226,4,61.7135643101,60-69,788,6,35,10,45,45,35,10,7,3.2697320782,12497.5521208371,0.0208369207,0.0893939394,0.12317073,0,59,6.196463633372518E-4,2.4389417E-4,2.1256754E-4,175,50,0,200,0,0
46714028,EhsanBegloo,10,7657,458,479,20,17,30.7232334576,30-39,708,7,0,0,0,0,0,0,0,0,0,0,0,0,251,654,4.766339181938244E-5,0,0,256,0,0,200,0,0
46760617,ctothecampbell,10,1184,139,232,1,127,42.892164784,40-49,591,5,26,38,64,64,26,38,6,2.5687907314,420.3600775968,0.034461148,0.0947420635,0.3321719,0,59,1.5376672402945635E-4,1.8292063E-4,1.8513948E-4,147,26,0,200,0,0
46913993,blackspruce47,10,9029,736,1708,37,169,44.04931244,40-49,754,8,85,233,318,318,85,233,6,2.1676321506,6821.3011199407,0.1190047113,0.0826141301,0.22178851,0,59,3.658277432516395E-4,5.826361E-4,5.897035E-4,77,12,1,200,1,0.005
46919079,Terrilltf,10,23391,1761,1999,56,1788,58.0165139168,50-59,755,9,73,87,160,160,73,87,6,2.471397538,4384.4473667213,0.0561679708,0.0499606918,0.24931335,0,59,3.2439791822310316E-4,5.0133804E-4,5.074193E-4,77,39,0,201,0,0
46956207,paulchislett,10,8817,650,1707,23,7,44.0237642653,40-49,671,7,34,89,123,123,34,89,6,2.3627805938,1338.7900347399,0.0563377235,0.0968945755,0.24993758,0,59,1.6760576308754482E-4,2.3711934E-4,2.3999561E-4,182,4,0,199,0,0
46987778,dylanhenrich,10,1548,30,39,0,1,13.3542931879,10-19,442,4,0,1,1,1,0,1,7,3.4379297865,0,0,0,0,0,648,4.766339181938244E-5,0,6.8570175E-6,25,0,0,200,0,0
47032219,rvgenaille,10,12850,1378,1977,67,554,54.6534674359,50-59,756,7,47,50,97,97,47,50,6,2.5861694424,1200.8397677158,0.043494747,0.0776417526,0.21248934,0,59,1.8640224395274126E-4,3.2519223E-4,3.2913685E-4,182,23,1,200,1,0.005
47425783,MDNOShaughnessy,10,2057,234,797,3,50,37.9824524207,30-39,621,6,30,113,143,143,30,113,6,2.3805213613,884.7688448233,0.0581708577,0.1699497685,0.36796346,0,59,1.7958799157068457E-4,2.1001999E-4,2.1256754E-4,25,3,1,200,1,0.005
47454245,mcmillan_cm,10,6408,342,417,12,6,35.7800023626,30-39,714,7,50,53,103,103,50,53,6,2.4782766112,803.1720352405,0.0769752881,0.1253569389,0.32034633,0,59,2.294232783816416E-4,3.4551675E-4,3.497079E-4,25,6,0,200,0,0
47719216,joeyconnick,10,782,24,26,0,1,13.1153710366,10-19,478,4,0,0,0,0,0,0,0,0,0,0,0,0,146,329,4.766339181938244E-5,0,0,142,0,0,200,0,0
47721136,jaytoner,10,3933,330,421,2,0,58.8996181823,50-59,696,6,2,3,5,5,2,3,8,3.6958725561,9.0193872854,3.3980486688312385E-4,0.05,0.33333334,0,59,7.642844737381648E-5,2.0324514E-5,2.0571053E-5,175,18,0,200,0,0
47766094,sensorglitch,10,1743,86,159,5,0,25.1691608187,20-29,513,4,1,3,4,4,1,3,7,3.3718320058,0,0.0041391127,0.4166666667,0.5833333,0,59,5.444496901079586E-5,1.3549677E-5,1.3714035E-5,175,4,0,200,0,0
47773642,R_Momtahen,10,1604,254,474,2,93,60.9425786011,60-69,593,5,9,22,31,31,9,22,7,2.7092686459,348.8990126628,0.0090696501,0.1731182796,0.3233618,0,59,8.28156476082456E-5,6.7748384E-5,6.8570174E-5,182,7,0,197,0,0
47823348,CharlesMicah,10,8105,285,183,7,237,42.5708265667,40-49,721,7,31,22,53,53,31,22,6,2.641564084,2081.4157607184,0.0534040109,0.0925253991,0.2968254,0,59,3.521241478670561E-4,2.1679483E-4,2.1942456E-4,182,20,0,200,0,0
47845089,paulbthompson,10,315,104,284,3,4,41.8978333763,40-49,527,4,11,40,51,51,11,40,7,2.6495293266,138.3049375945,0.0148881547,0.2196078431,0.43498942,0,59,8.862982542279124E-5,8.129806E-5,8.228421E-5,25,15,1,199,1,0.0050251256
47956279,curtisonyon,10,1259,166,389,0,3,22.7089316698,20-29,573,5,21,52,73,73,21,52,6,2.5314989138,129.8203156393,0.0520926126,0.2290715373,0.510452,0,59,1.8501482073432783E-4,1.4904643E-4,1.5085438E-4,175,2,1,200,1,0.005
48434871,connollychris,10,643,205,256,3,4,33.7491123625,30-39,556,4,8,16,24,24,8,16,6,2.8316437364,73.1454994609,0.0063031563,0.1105072464,0.25146198,0,59,1.0578057094748012E-4,6.0973543E-5,6.171316E-5,77,3,0,200,0,0
48457938,cclar104,10,1251,183,296,1,322,41.4579793011,40-49,602,5,5,10,15,15,5,10,7,2.933743664,299.3300807963,0.006663209,0.1380952381,0.28030303,0,59,6.640605166087396E-5,4.064903E-5,4.1142106E-5,175,8,0,199,0,0
48519675,leftnewsorg,10,5933,634,220,46,1,47.254436787,40-49,637,6,59,31,90,90,59,31,6,2.5492396814,600.4456845769,0.0724958377,0.1103620474,0.29872695,0,59,2.6868889366263337E-4,4.064903E-4,4.1142106E-4,182,37,2,200,2,0.01
48708159,jasonkeays,10,18351,2930,1020,45,126,65.9742026523,60-69,849,8,66,78,144,144,66,78,6,2.4561911658,4446.7325160825,0.0780917986,0.1198038073,0.28338158,0,59,3.5307204470080557E-4,4.5391417E-4,4.5942017E-4,25,105,11,215,11,0.0511627907
48914528,GodlessPeace,10,7495,11,106,7,14,34.9351629472,30-39,588,7,1,8,9,9,1,8,7,2.8410572049,0.1260167668,5.230293915920288E-4,0.2222222222,0.3392857,0,59,4.9098089440135504E-5,1.3549677E-5,1.3714035E-5,77,1,1,199,1,0.0050251256
48925188,zedlacher,10,7967,2582,621,63,3946,55.052384494,50-59,760,7,11,7,18,18,11,7,7,3.0963070239,5817.1724678338,0.0096234266,0.0849673203,0.22435898,0,59,2.4632379901718787E-4,8.129806E-5,8.228421E-5,77,46,0,199,0,0
49018161,Gottahrdt,10,67932,1760,2001,48,32,43.4783738639,40-49,783,9,14,12,26,26,14,12,6,2.5894279508,190.2089140703,0.0266471215,0.1092307692,0.39215687,0,59,1.5343990458394736E-4,1.0162257E-4,1.02855265E-4,175,5,0,200,0,0
49104523,KathileeUE,10,5,5,13,0,0,11.7341444214,10-19,15,1,0,3,3,3,0,3,7,3.207383279,0,0,0.5,0.8333333,0,612,4.766339181938244E-5,0,6.8570175E-6,25,0,0,10,0,0
49336963,dpbaril,10,212,40,61,0,3,33.221335582,30-39,407,3,0,0,0,0,0,0,0,0,0,0,0,0,191,412,4.766339181938244E-5,0,0,194,12,0,200,0,0
49400099,pugs14,10,5381,219,883,5,549,42.1934464776,40-49,632,7,51,143,194,194,51,143,6,2.2776973208,1618.9623968033,0.0843295631,0.1195448961,0.29400802,0,59,2.0067442367764564E-4,3.522916E-4,3.565649E-4,25,8,1,200,1,0.005
49478990,rikkiratliff,10,7462,1162,889,50,4,59.191957833,50-59,759,7,73,54,127,127,73,54,7,2.6915278783,1950.313826254,0.0630871979,0.0959255093,0.23979811,0,59,5.08993282403748E-4,5.0133804E-4,5.074193E-4,175,121,0,201,0,0
49500506,hipchic99,10,4707,1166,1740,35,714,46.8154598003,40-49,681,6,15,53,68,68,15,53,7,2.4750181028,2158.2204722488,0.026337151,0.1121597893,0.25555557,0,59,1.1836400991918576E-4,1.0839741E-4,1.0971228E-4,175,1,0,200,0,0
49707617,CarletonPlace,10,5621,544,907,11,598,49.8994469147,40-49,732,7,113,161,274,274,113,161,6,2.1951484432,6361.4497008647,0.1150485143,0.075345579,0.28195995,0,59,3.5070668243556455E-4,7.7233155E-4,7.817E-4,77,113,5,201,4,0.0199004975
49774237,steelheadtroy,10,102,19,73,0,3,13.0346706108,10-19,31,3,1,4,5,5,1,4,7,2.7892831282,2.7398768442,1.7169007310089858E-4,0.2,0.5,0,59,5.1152316329146804E-5,1.3549677E-5,1.3714035E-5,25,0,1,114,1,0.0087719298
49986500,amyczhou,10,8390,322,735,0,274,44.5030599081,40-49,707,7,10,42,52,52,10,42,6,2.4290369298,117.5219857822,0.0247616843,0.1915535445,0.410148,0,59,1.0491809176176147E-4,7.452322E-5,7.542719E-5,175,7,3,201,3,0.0149253731
49989431,NOtoGMOs,10,13154,2608,1738,173,144,53.9457550356,50-59,722,8,22,34,56,56,22,34,6,2.4634322954,1999.6840636603,0.0377706313,0.1,0.35285285,0,59,1.3149786532114634E-4,1.5582128E-4,1.577114E-4,77,6,0,203,0,0
50089721,BoitumeloKie,10,8619,282,522,1,11,55.6201005042,50-59,745,7,1,4,5,5,1,4,10,5.7436640116,3.8088235294,8.482513872459663E-5,0.15,0.41666666,0,59,6.900734194419263E-5,1.3549677E-5,1.3714035E-5,131,9,0,201,0,0
50287133,semrasevi,10,2487,856,715,21,1,,,664,6,39,47,86,86,39,47,6,2.6075307748,487.4138639952,0.0543766908,0.1541723666,0.34848484,0,59,4.1076482743417943E-4,2.7099354E-4,2.742807E-4,175,52,1,200,1,0.005
50298501,AndersHolder,10,289,26,73,0,2,30.9348223664,30-39,435,4,0,3,3,3,0,3,7,3.2052117264,0,0,0.1666666667,0.16666667,0,549,4.766339181938244E-5,0,6.8570175E-6,25,2,0,200,0,0
50301987,NellaVS,10,832,57,104,0,6,26.3139158122,20-29,589,5,0,1,1,1,0,1,11,6.8812884546,0,0,0,0,0,235,4.766339181938244E-5,0,6.8570175E-6,131,4,0,200,0,0
50458600,ArnellTF,10,8742,1008,1376,17,1130,54.9788646908,50-59,741,7,76,86,162,162,76,86,6,2.4569152788,9482.9285028849,0.0616285627,0.035235028,0.19288646,0,59,3.666186572118594E-4,5.216625E-4,5.2799034E-4,77,111,0,201,0,0
50526279,president82,10,209,82,156,1,3,25.1963651684,20-29,398,3,9,10,19,19,9,10,7,2.944243302,188.9626750488,0.013515852,0.1695906433,0.51648355,0,59,7.403506440958168E-5,6.7748384E-5,6.8570174E-5,182,2,0,196,0,0
50648768,SeabiscuitAAL,10,17817,335,554,12,102,41.7749565076,40-49,629,8,0,2,2,2,0,2,8,3.8516105682,0,0,0,0,0,584,4.766339181938244E-5,0,6.8570175E-6,25,2,0,199,0,0
50664739,HayeseLaw,10,1614,482,182,46,1,48.0144429422,40-49,614,5,2,3,5,5,2,3,7,3.1372194062,2.0839515003,7.683967222346596E-4,0.2,0.3,0,59,5.3327280530843136E-5,2.0324514E-5,2.0571053E-5,175,0,0,200,0,0
50821940,pasqualelm,10,18377,1612,1985,101,89,58.6239584431,50-59,766,8,15,26,41,41,15,26,7,2.7223026792,1306.0370513957,0.0376808831,0.112195122,0.2530242,0,59,3.375963098801838E-4,1.0839741E-4,1.0971228E-4,145,6,0,200,0,0
51099638,James_W_J_Crown,10,652,115,315,1,4,19.5667397122,10-19,482,5,32,85,117,117,32,85,6,2.4482259232,565.0703386359,0.0532991273,0.1842027704,0.4755747,0,59,1.6835230075929768E-4,2.2356966E-4,2.2628158E-4,25,3,5,200,5,0.025
51158869,smitty_1993,10,666,201,396,1,166,48.2255605435,40-49,537,5,4,8,12,12,4,8,7,2.8707458364,12.4595875195,0.0123900953,0.1893939394,0.36666667,0,59,6.856373692320037E-5,3.3874192E-5,3.4285087E-5,175,0,0,198,0,0
51184630,mlinto,10,1133,121,546,2,2,29.6439130504,20-29,512,5,10,53,63,63,10,53,6,2.3428674873,82.1029908456,0.0194049107,0.1902201741,0.37808418,0,59,7.662555128347711E-5,7.452322E-5,7.542719E-5,77,1,0,200,0,0
51393920,Gerry_74_,10,59,14,54,0,2,12.6209713021,10-19,34,2,0,1,1,1,0,1,7,4.3571428571,0,0,0,0,42,518,4.766339181938244E-5,0,6.8570175E-6,197,0,0,60,0,0
51448005,MikeMcD76,10,28621,649,1304,40,28,45.0786759952,40-49,759,8,55,61,116,116,55,61,6,2.4243301955,1433.3608371942,0.0726728643,0.1109445277,0.26190478,0,59,2.1501320866666444E-4,3.7939096E-4,3.8399297E-4,77,66,0,201,0,0
51460312,adrianbruff,10,32,24,62,0,0,18.7462836117,10-19,112,1,0,1,1,1,0,1,7,3.4813608397,0,0,0,0,0,663,4.766339181938244E-5,0,6.8570175E-6,175,0,0,34,0,0
51584200,cherriprobinson,10,391,133,177,3,0,28.8911212136,20-29,480,3,12,18,30,30,12,18,6,2.7429398986,105.0032899146,0.0134755646,0.1091954023,0.35526314,0,59,9.280768941870924E-5,8.80729E-5,8.914123E-5,182,1,0,199,0,0
51705064,pietleroux,10,219,117,79,2,4,43.3961624909,40-49,541,4,0,0,0,0,0,0,0,0,0,0,0,0,157,348,4.766339181938244E-5,0,0,155,2,0,201,0,0
51822482,BiancadiCalvi,10,503,94,204,0,2,34.9706690911,30-39,484,4,0,0,0,0,0,0,0,0,0,0,0,0,188,407,4.766339181938244E-5,0,0,190,0,0,200,0,0
51841191,aubrey_harris,10,21182,644,805,53,101,47.9046248474,40-49,724,8,13,35,48,48,13,35,6,2.5137581463,1467.6654078369,0.0181608793,0.1502659574,0.3888889,0,59,1.1280196320734485E-4,9.484774E-5,9.599824E-5,175,5,1,200,1,0.005
52211676,CTVNewsJoe,10,1848,1082,659,48,1,51.0654903185,50-59,729,6,10,16,26,26,10,16,7,3.0108616944,111.6206288456,0.0081728404,0.14,0.2952381,0,59,1.703713238606684E-4,7.452322E-5,7.542719E-5,182,33,0,200,0,0
52435593,scott451,10,9002,274,394,3,1073,43.5017813709,40-49,676,7,43,60,103,103,43,60,6,2.3729181752,668.1943956768,0.0735025394,0.1147915477,0.3808853,0,59,1.6673594761634246E-4,2.9809287E-4,3.0170876E-4,77,16,1,200,1,0.005
52448170,raffa007,10,166,13,195,0,6,12.5541969358,10-19,53,2,0,1,1,1,0,1,7,4.3571428571,0,0,0,0,42,471,4.766339181938244E-5,0,6.8570175E-6,197,0,0,166,0,0
52770588,KatRizzi,10,838,47,160,0,145,25.6561617878,20-29,523,4,1,3,4,4,1,3,7,3.0542691751,1140.5269097686,8.095914281419891E-5,0.0833333333,0.16666667,0,632,7.721876118969924E-5,1.3549677E-5,1.3714035E-5,175,37,0,198,0,0
52815305,davidjp87,10,6392,148,373,6,125,44.3176516324,40-49,667,6,2,8,10,10,2,8,7,2.9011585807,0.9700734016,0.0033619851,0.2,0.4642857,0,59,6.04984438273824E-5,2.0324514E-5,2.0571053E-5,175,0,0,200,0,0
53211399,katrinashannon,10,5410,200,406,4,5,27.5891965263,20-29,593,7,27,58,85,85,27,58,6,2.4536567705,3059.4427066096,0.0410964825,0.1119047619,0.2877624,0,59,1.764340349554319E-4,1.8969548E-4,1.9199649E-4,77,1,0,200,0,0
53542320,mbilek,10,1054,246,271,9,6,41.9151376183,40-49,601,5,62,71,133,133,62,71,6,2.3504706734,1676.2039443726,0.0881462107,0.1384711779,0.35191151,0,59,2.517698858496312E-4,4.268148E-4,4.319921E-4,25,12,0,200,0,0
53807352,ForwaardChange,10,1707,795,2000,19,4,39.4912529573,30-39,572,6,80,169,249,249,80,169,6,2.282404055,3697.3752138817,0.1103601953,0.1074459127,0.280493,0,59,3.4920925931512976E-4,5.487619E-4,5.5541843E-4,182,3,0,200,0,0
53820195,RoshniMurthy,10,1249,413,717,21,0,38.4612100496,30-39,570,5,2,18,20,20,2,18,7,3.0539464156,5.4554026828,0.0012171323,0.2,0.32163742,0,59,5.631313337313691E-5,2.0324514E-5,2.0571053E-5,175,11,0,201,0,0
53913259,gastongourde,10,5953,394,525,22,10,46.0222453197,40-49,643,7,7,9,16,16,7,9,7,2.9112961622,102.2622515091,0.0056239274,0.0875,0.36666667,0,59,8.762044318671856E-5,5.4198706E-5,5.485614E-5,145,2,0,200,0,0
54152264,quinnmacdonald,10,8963,342,912,9,699,48.0351764943,40-49,692,7,11,22,33,33,11,22,6,2.6437364229,8381.8706579946,0.0142316641,0.1600378788,0.27955666,0,59,1.4476428231313207E-4,8.129806E-5,8.228421E-5,77,1,1,201,1,0.0049751244
54169562,Blaiserboy,10,13098,2082,1959,5,0,51.4724435885,50-59,734,7,53,51,104,104,53,51,6,2.3559015206,1251.4097017732,0.0865726624,0.0484503361,0.3149492,0,59,2.2607497526394305E-4,3.6584126E-4,3.7027895E-4,77,121,0,214,0,0
54303129,VeganCyclist,10,16900,2025,851,198,13,51.4487569677,50-59,757,8,7,9,16,16,7,9,7,3.0083272991,81.9549292793,0.0045061568,0.0875,0.16025642,0,59,1.0422413384167332E-4,5.4198706E-5,5.485614E-5,182,7,0,200,0,0
54441681,cor456,10,4939,733,1211,23,8,46.6894434442,40-49,690,7,105,140,245,245,105,140,6,2.2871107893,14756.6774053197,0.1157925429,0.080946805,0.21938312,0,59,4.033144939923385E-4,7.181328E-4,7.2684383E-4,182,70,0,201,0,0
54614327,lesleyrosiak,10,2144,208,433,3,49,44.2779252802,40-49,651,6,2,5,7,7,2,5,7,3.1654598117,2.2842070908,0.0015184068,0.119047619,0.35,0,59,5.368883452800697E-5,2.0324514E-5,2.0571053E-5,25,0,0,200,0,0
54658610,gtraveler,10,186,22,26,1,0,15.4064772372,10-19,92,1,0,0,0,0,0,0,0,0,0,0,0,0,244,636,4.766339181938244E-5,0,0,248,0,0,187,0,0
54866693,JCorbeilNDP,10,348,169,585,7,1,26.7874867888,20-29,436,4,39,104,143,143,39,104,7,2.3515568429,329.4728114833,0.0892597564,0.2268295085,0.48645517,0,59,2.2582662367103402E-4,2.7099354E-4,2.742807E-4,25,1,1,199,1,0.0050251256
54868672,LambertoLambo,10,332,43,130,0,6,28.0394249286,20-29,355,4,0,1,1,1,0,1,7,4.3571428571,0,0,0,0,42,509,4.766339181938244E-5,0,6.8570175E-6,197,2,0,200,0,0
54937843,JohnnieOil,10,29910,1153,1212,51,165,49.0172101756,40-49,771,8,60,58,118,118,60,58,7,2.7172338885,1301.4782971491,0.0345243203,0.0692452557,0.33167702,0,59,2.940641824222156E-4,4.1326514E-4,4.1827807E-4,175,28,0,201,0,0
55142273,jaywattsiii,10,15089,1304,2001,13,107,63.2003467323,60-69,744,8,22,56,78,78,22,56,6,2.5438088342,5814.6821611573,0.0305059439,0.1202131202,0.25883257,0,59,3.108266052846334E-4,1.5582128E-4,1.577114E-4,77,17,0,202,0,0
55204495,angelocandido,10,794,66,144,0,0,29.058790446,20-29,499,5,0,1,1,1,0,1,7,4.3571428571,0,0,0,0,42,417,4.766339181938244E-5,0,6.8570175E-6,197,0,0,200,0,0
55434187,chrystallll,10,18046,1308,746,8,204,49.0227400821,40-49,727,7,0,2,2,2,0,2,7,3.4676076728,0,0,0.5,0.5,0,666,4.766339181938244E-5,0,6.8570175E-6,175,0,0,200,0,0
55873451,Ma_Fleming,10,430,737,378,17,5,46.0221292314,40-49,600,5,45,33,78,78,45,33,6,2.5206372194,2671.0871846374,0.0557719946,0.0436230436,0.18282314,0,59,2.0079793251667616E-4,3.1164257E-4,3.154228E-4,25,4,0,197,0,0
55901461,swissguy5,10,1827,85,168,4,1,40.7293352569,40-49,581,5,7,14,21,21,7,14,6,2.661115134,5.5750885039,0.0162276272,0.1619047619,0.36666667,0,59,6.492803921307102E-5,5.4198706E-5,5.485614E-5,77,7,1,200,1,0.005
56147178,jbuhrow,10,114,92,727,0,0,25.7236850513,20-29,388,3,0,1,1,1,0,1,7,3.6659428158,0,0,0,0,0,589,4.766339181938244E-5,0,6.8570175E-6,175,8,0,115,0,0
56280776,peter_68,10,182,55,112,2,1,28.1169604896,20-29,498,3,4,7,11,11,4,7,6,2.7697320782,16.7041122462,0.004567104,0.1818181818,0.66071427,0,59,6.934231213448564E-5,3.3874192E-5,3.4285087E-5,182,4,12,191,12,0.0628272251
56330720,sgriccio1001,10,893,87,283,0,131,20.8037786648,20-29,507,4,0,1,1,1,0,1,7,4.3571428571,0,0,0,0,42,450,4.766339181938244E-5,0,6.8570175E-6,197,0,0,200,0,0
56503668,CTVNewsVI,10,12252,10711,726,441,6,60.6500439212,60-69,787,8,68,8,76,76,68,8,7,3.159666908,641.8469242052,0.0575029376,0.0761403509,0.13128729,0,59,6.486434952456938E-4,4.6746383E-4,4.4570613E-4,182,185,0,200,0,0
56541037,SmilingFlower,10,6711,206,549,1,203,40.8482703899,40-49,596,7,15,30,45,45,15,30,6,2.6933381608,841.1011228285,0.0167587413,0.1095959596,0.24621849,0,59,9.27483994507171E-5,1.0839741E-4,1.0971228E-4,77,3,0,198,0,0
56690455,momorycroft,10,565,149,382,3,3,35.2361230438,30-39,521,4,50,72,122,122,50,72,6,2.4869659667,3780.7231405989,0.0961326281,0.1790407804,0.44221723,0,59,3.118165086805881E-4,3.4551675E-4,3.497079E-4,25,10,4,200,4,0.02
56917803,Grant_AB,10,3755,270,320,17,1,42.999845637,40-49,642,6,44,36,80,80,44,36,6,2.6350470673,2795.9267204245,0.0818950572,0.1530063291,0.32331732,0,59,3.040668886193313E-4,3.0486772E-4,3.0170876E-4,25,32,2,200,2,0.01
57057185,bigbodypresents,10,24765,505,730,12,1051,50.1168678344,50-59,738,8,13,14,27,27,13,14,7,2.9612599566,152.7687886316,0.0124085128,0.1196581197,0.3888889,0,59,1.1555994294930295E-4,9.484774E-5,9.599824E-5,147,9,0,1,0,0
57103588,henryca3,10,1977,505,487,15,57,43.7287879986,40-49,638,6,33,64,97,97,33,64,6,2.4217958001,4992.7445546074,0.0789948075,0.145725945,0.4056338,0,59,3.7437272491046134E-4,2.303445E-4,2.3313859E-4,25,12,1,200,1,0.005
57568642,WayneFougere,10,3043,156,523,4,4,41.168474751,40-49,665,6,4,42,46,46,4,42,6,2.4822592324,17.5250136756,0.013759941,0.2483091787,0.4280177,0,59,8.02961692986099E-5,3.3874192E-5,3.4285087E-5,175,5,0,200,0,0
57994093,Beethro,10,408,61,488,0,1,20.0899216675,20-29,438,4,3,15,18,18,3,15,6,2.7154236061,221.8599987659,0.0097685644,0.1274509804,0.22083333,0,59,6.317107074164852E-5,2.7099353E-5,2.742807E-5,145,2,0,200,0,0
58006535,prenerk,10,6603,357,955,13,48,54.6648339451,50-59,702,7,12,26,38,38,12,26,6,2.5014482259,233.3747641366,0.0246293763,0.140113798,0.36243385,0,59,1.3446023012800867E-4,8.80729E-5,8.914123E-5,77,1,3,200,3,0.015
58023261,fredlamontagne,10,570,140,159,2,8,22.5287411023,20-29,506,4,1,0,1,1,1,0,0,0,0,5.530520325598758E-4,0,0,0,23,5.109304639811673E-5,1.3549677E-5,0,145,0,0,200,0,0
58118846,pbnantel,10,589,35,304,0,23,42.3264719373,40-49,398,4,0,4,4,4,0,4,7,2.9120521173,0,0,0.4166666667,0.6666667,0,389,4.766339181938244E-5,0,6.8570175E-6,147,1,0,200,0,0
58125261,johnny_tt,10,1563,114,495,2,14,43.8610889839,40-49,570,6,1,2,3,3,1,2,8,3.9659666908,0,9.146094802217654E-5,0.1666666667,0.5,0,59,5.782617045574943E-5,1.3549677E-5,1.3714035E-5,175,2,0,201,0,0
58321430,nickofthenorth,10,2583,426,870,14,4,41.0631087197,40-49,637,6,24,38,62,62,24,38,6,2.5778421434,252.7418980068,0.0328755752,0.1337916446,0.33091787,0,59,1.4697296827338225E-4,1.6937095E-4,1.7142543E-4,147,11,0,175,0,0
58340767,tylermeredith,10,6566,650,1081,22,7,44.7299096413,40-49,659,7,44,74,118,118,44,74,6,2.3805213613,3848.5028289549,0.0884160547,0.1106765175,0.33670887,0,59,3.2202531932088563E-4,3.0486772E-4,3.085658E-4,175,6,0,200,0,0
58502105,R_Kibonge,10,1284,148,250,1,30,26.3785887337,20-29,572,5,8,23,31,31,8,23,7,2.7241129616,27.742468416,0.0166032715,0.1774193548,0.486166,0,59,8.374704918671837E-5,6.0973543E-5,6.171316E-5,25,5,0,199,0,0
59114494,BoredomCorner,10,7887,122,92,4,638,42.9938394911,40-49,683,7,6,2,8,8,6,2,7,3.1216509776,2.2829509734,0.0100521008,0.25,0.52380955,0,59,7.687370640809293E-5,4.742387E-5,4.799912E-5,77,1,0,200,0,0
59641324,justskp,10,2937,152,655,2,51,35.2329945996,30-39,570,6,0,4,4,4,0,4,7,2.9160332971,0,0,0.3333333333,0.5833333,0,659,4.766339181938244E-5,0,6.8570175E-6,147,1,0,200,0,0
59748410,mphele,10,5042,591,906,3,84,60.3210605908,60-69,743,7,15,17,32,32,15,17,8,3.8167994207,63606.1308367329,0.0012803987,0.0322580645,0.13725491,0,59,5.076484981460328E-4,1.0839741E-4,1.02855265E-4,131,185,0,203,0,0
59767832,kgallag1,10,7,6,48,0,1,16.5262378324,10-19,15,0,0,0,0,0,0,0,0,0,0,0,0,0,1,63,4.766339181938244E-5,0,0,0,0,0,8,0,0
59834690,cybergirl2010,10,11929,3088,3391,38,10,55.8742290392,50-59,760,8,14,22,36,36,14,22,6,2.4315713251,467.9711787483,0.0302794709,0.080952381,0.2826087,0,59,1.407461571903556E-4,1.0162257E-4,1.02855265E-4,175,19,0,195,0,0
60116717,KT_Mtjoy,10,110,26,101,0,0,13.1898573515,10-19,176,3,2,5,7,7,2,5,7,3.1064446054,2.4090901793,0.0011222385,0.2380952381,0.53333336,0,59,5.7687166695632854E-5,2.0324514E-5,2.0571053E-5,77,0,0,118,0,0
60358873,teralcock,10,501,42,57,4,8,24.7267314342,20-29,500,4,9,6,15,15,9,6,6,2.594858798,13.8802556547,0.0129956982,0.2142857143,0.44871795,0,59,6.546711604391829E-5,6.7748384E-5,6.8570174E-5,77,1,0,200,0,0
60468248,midwifek,10,3246,262,248,21,22,53.3064740389,50-59,656,6,26,38,64,64,26,38,6,2.546705286,364.8990847749,0.0359933688,0.1470734127,0.33588436,0,59,1.546226923717343E-4,1.8292063E-4,1.8513948E-4,25,51,0,200,0,0
61011254,ToryLineDuJour,10,4692,530,1708,13,1,43.5391600432,40-49,679,6,45,109,154,154,45,109,7,2.4026068067,3258.4285679601,0.0406732744,0.1044053985,0.21972254,0,59,2.487945628659126E-4,3.1164257E-4,3.154228E-4,175,7,0,200,0,0
61064326,johalifax,10,6796,769,729,31,17,48.9583522418,40-49,726,7,68,69,137,137,68,69,6,2.3841419261,2790.2384345025,0.0848722861,0.0920996136,0.30207837,0,59,3.708208601067554E-4,4.6746383E-4,4.7313422E-4,147,44,0,200,0,0
61089107,bronwwyynn,10,155,157,640,2,6,29.4703643059,20-29,375,4,30,75,105,105,30,75,6,2.4826212889,1365.5272836623,0.028980293,0.118040293,0.34385964,0,59,1.7941822283903776E-4,2.1001999E-4,2.1256754E-4,147,3,0,176,0,0
61213720,CTVW5,10,1349,3276,140,139,1,59.0320144225,50-59,741,5,56,8,64,64,56,8,7,3.0702389573,264.3239517649,0.0477118404,0.0701884921,0.09906487,0,59,5.968652488136042E-4,3.8616578E-4,3.9085E-4,175,225,0,198,0,0
61290528,Supersteiner,10,14,17,23,0,1,18.4387678033,10-19,120,1,2,1,3,3,2,1,9,4.9243301955,74.055150388,1.9396535757101904E-4,0,0,0,59,1.3429891297816687E-4,2.0324514E-5,2.0571053E-5,147,3,0,21,0,0
61465748,Stancy_E,10,277,27,100,0,28,26.7542784029,20-29,521,4,0,1,1,1,0,1,7,4.3571428571,0,0,0,0,42,478,4.766339181938244E-5,0,6.8570175E-6,197,2,0,199,0,0
61503377,keddah83,10,10994,337,596,3,23,49.2393666592,40-49,752,8,0,0,0,0,0,0,0,0,0,0,0,0,105,238,4.766339181938244E-5,0,0,95,22,0,201,0,0
61679924,quiddityks,10,593,161,275,9,1,40.1751812556,40-49,554,5,8,12,20,20,8,12,6,2.6661839247,112.3139302197,0.0137067136,0.0710526316,0.3030303,0,59,9.628217881996182E-5,6.0973543E-5,6.171316E-5,182,1,0,200,0,0
62139614,JDarwin,10,2305,102,465,2,649,34.1282650481,30-39,536,6,13,23,36,36,13,23,6,2.5597393193,64.8782523617,0.0172347325,0.123015873,0.31349206,0,59,8.789172058885515E-5,9.484774E-5,9.599824E-5,77,3,1,200,1,0.005
62707770,LanternBell,10,2008,27,81,2,1,22.2526561701,20-29,532,5,0,2,2,2,0,2,7,3.3937748824,0,0,0.5,1,0,295,4.766339181938244E-5,0,6.8570175E-6,25,0,0,200,0,0
62851023,jen_britton,10,990,325,280,10,0,42.6478409111,40-49,595,4,31,16,47,47,31,16,7,2.8812454743,131.755167519,0.0317481911,0.0934320074,0.3003565,0,59,1.6217130457187956E-4,2.1679483E-4,2.1942456E-4,182,48,0,200,0,0
63111785,MrSeatMan,10,933,444,1477,0,49,41.9382230132,40-49,538,5,1,2,3,3,1,2,8,3.8077480087,303.5640591115,9.332717723623285E-5,0,0,0,59,1.1874831691900532E-4,1.3549677E-5,1.3714035E-5,77,2,0,200,0,0
63371371,adamharris09,10,3088,344,555,14,20,42.799321264,40-49,628,6,9,14,23,23,9,14,7,2.7324402607,276.6733074133,0.0102011222,0.1343873518,0.25730994,0,59,9.47389372892923E-5,6.7748384E-5,6.8570174E-5,147,4,0,200,0,0
63542749,SusanRab,10,838,260,386,6,4,39.352089533,30-39,609,5,35,44,79,79,35,44,6,2.6180304127,408.6787370253,0.0351697879,0.0993184031,0.3280116,0,59,1.8254666446643517E-4,2.4389417E-4,2.4685264E-4,182,1,0,200,0,0
63604080,RicardoVeneza,10,2033,299,338,17,8,42.0482135777,40-49,553,5,3,11,14,14,3,11,7,2.9087617668,46.8188377905,5.162143567640901E-4,0.1648351648,0.27272728,0,59,7.001621858176281E-5,2.7099353E-5,2.742807E-5,175,11,0,200,0,0
63795844,Shawn_J_Martin,10,1153,77,186,0,42,34.7969206942,30-39,547,5,8,30,38,38,8,30,6,2.5213613324,159.6074831928,0.0164144217,0.1934566145,0.40221775,0,59,7.763138396349287E-5,6.0973543E-5,6.171316E-5,25,9,2,200,2,0.01
63826204,fotoGnique,10,8255,522,1675,22,1721,44.4232073862,40-49,574,7,11,49,60,60,11,49,6,2.4963794352,298.8234826788,0.0128091407,0.1562146893,0.3047059,0,59,9.273156734757708E-5,8.129806E-5,8.228421E-5,145,0,1,200,1,0.005
64545499,Jenn_McCreath,10,21750,753,1677,12,3260,53.2603122827,50-59,744,8,34,67,101,101,34,67,7,2.5083272991,2625.1205740034,0.0432012072,0.1061386139,0.23132911,0,59,1.7483757270313714E-4,2.3711934E-4,2.3999561E-4,147,91,1,205,1,0.0048780488
64854080,buckaroomel,10,89,133,459,0,9,14.7330971624,10-19,223,3,22,97,119,119,22,97,6,2.301955105,557.8556049942,0.0373567716,0.1613730238,0.3316842,0,59,1.5154504775834242E-4,1.5582128E-4,1.577114E-4,25,0,2,88,2,0.0227272727
65027992,MartaAnso_,10,7711,298,306,2,61,46.3258517089,40-49,731,7,1,1,2,2,1,1,1,1,0,8.095914281419891E-5,0,0,172,374,3.177448371356425E-4,1.3549677E-5,1.3714035E-5,171,51,0,200,0,0
65111698,socialist_ca,10,1683,961,482,56,19,49.2462363103,40-49,698,5,50,27,77,77,50,27,6,2.6857349747,1144.3932004043,0.0468310747,0.1021872864,0.24061343,0,59,2.4176414687974995E-4,3.4551675E-4,3.497079E-4,182,204,19,200,18,0.09
65254904,KiavashNajafi,10,100,92,269,1,0,41.4397167619,40-49,507,3,58,58,116,116,58,58,6,2.5749456915,439.9375098402,0.1081877962,0.1635682159,0.35998628,0,59,4.258568506938501E-4,3.9971547E-4,4.0456402E-4,25,59,7,166,7,0.0421686747
65425265,AliBenlyazid,10,1070,69,290,2,402,35.5827603532,30-39,533,5,0,0,0,0,0,0,0,0,0,0,0,0,53,138,4.766339181938244E-5,0,0,47,1,0,200,0,0
65609326,dunerabideau,10,1301,240,1228,1,195,35.8634305097,30-39,610,6,65,199,264,264,65,199,6,2.1661839247,4744.0158189772,0.1024759029,0.1098484848,0.23228364,0,59,2.740268611915673E-4,4.4713932E-4,4.5256317E-4,25,10,0,200,0,0
65732483,kenharasym,10,590,215,411,14,75,34.7839068518,30-39,492,4,6,10,16,16,6,10,6,2.7581462708,281.0417431765,0.0086640283,0.1125,0.3181818,0,59,6.757202841357687E-5,4.742387E-5,4.799912E-5,77,2,0,199,0,0
65915419,KenGray,10,5311,3181,2958,219,0,50.4759704696,50-59,714,6,76,116,192,192,76,116,6,2.37653874,8662.7860201425,0.1299212857,0.1053664921,0.25584754,0,59,5.110901812201569E-4,5.216625E-4,5.2799034E-4,175,11,0,200,0,0
65964860,TylerLively,10,1887,184,228,1,13,37.0953532921,30-39,622,5,4,5,9,9,4,5,7,3.3381607531,70.8445140052,7.901380272360091E-4,0.0416666667,0.25,0,59,7.122978249044732E-5,3.3874192E-5,3.4285087E-5,147,5,0,199,0,0
66112820,Calculator60,10,8383,293,218,4,3,44.0315198733,40-49,661,7,23,24,47,47,23,24,7,2.7219406227,732.8431856007,0.0166302986,0.098519889,0.28520498,0,59,1.4969092762184876E-4,1.6259612E-4,1.6456842E-4,182,26,0,205,0,0
66140247,jeffgalbraith,10,661,60,127,3,79,27.9629047885,20-29,594,5,3,9,12,12,3,9,7,3.0387400434,0.0869287273,0.0051819939,0.3106060606,0.5090909,0,59,5.817540069427819E-5,2.7099353E-5,2.742807E-5,175,4,0,200,0,0
66268665,LucilleRoss,10,449,10,10,0,5,33.2239565625,30-39,435,4,0,0,0,0,0,0,0,0,0,0,0,0,219,541,4.766339181938244E-5,0,0,223,6,0,200,0,0
66476470,MariaBenavides,10,41021,483,184,1,10915,44.3636933657,40-49,743,8,5,2,7,7,5,2,5,2.75,6.5,4.417312202366687E-4,0.1666666667,0.65,31,107,3.916273935552961E-4,4.064903E-5,3.4285087E-5,108,8,0,200,0,0
66501568,DeniseLynnDoyle,10,450,216,734,2,5,42.7691904507,40-49,578,5,6,52,58,58,6,52,6,2.5394641564,288.7393802648,0.0132938086,0.2673926195,0.4880261,0,59,9.6984982784159E-5,4.742387E-5,4.799912E-5,25,13,0,200,0,0
66841110,europaien,10,16323,1225,1044,23,9230,55.2184734451,50-59,763,7,3,3,6,6,3,3,7,2.9348298335,981.2978752529,0.006323784,0.0333333333,0.33333334,0,59,7.182783506213557E-5,2.7099353E-5,2.742807E-5,25,4,0,201,0,0
67171013,AstuteCitizen,10,8331,146,175,3,5183,49.451259403,40-49,597,8,15,18,33,33,15,18,6,2.6886314265,95.964175773,0.0195319923,0.0804924242,0.29285714,0,59,9.175435121998043E-5,1.0839741E-4,1.0971228E-4,175,10,0,205,0,0
67278150,ma_mchugh,10,601,204,254,25,24,51.6559088177,50-59,542,5,24,29,53,53,24,29,6,2.6393917451,105.5322817964,0.025223015,0.1690856313,0.43414634,0,59,1.412587454937319E-4,1.6937095E-4,1.7142543E-4,147,8,0,200,0,0
67913395,napemily,10,4465,189,92,6,211,56.0767465412,50-59,652,6,7,6,13,13,7,6,7,2.9304851557,8.9639866502,0.0242915135,0.1923076923,0.5833333,0,59,1.6333297171209322E-4,5.4198706E-5,5.485614E-5,182,4,0,200,0,0
67934260,IAMACANUCK18,10,1927,42,220,0,23,26.3320108249,20-29,571,6,0,1,1,1,0,1,8,3.9938472675,0,0,0,0,0,260,4.766339181938244E-5,0,6.8570175E-6,182,0,0,199,0,0
68143662,dipuoseema,10,52058,1114,1996,13,994,42.9686642664,40-49,729,9,4,3,7,7,4,3,10,5.8055756698,162.3485482908,3.586626168603777E-4,0.1904761905,0.33333334,0,59,1.354573078233972E-4,3.3874192E-5,3.4285087E-5,131,1,0,201,0,0
68191922,KateBethRoss,10,80,34,44,1,1,15.8128304428,10-19,234,2,0,1,1,1,0,1,8,3.5566413319,0,0,0,0,0,341,4.766339181938244E-5,0,6.8570175E-6,25,0,0,88,0,0
68718696,Odawa_NFC,10,154,198,673,4,0,43.429183283,40-49,562,4,19,40,59,59,19,40,6,2.5640839971,617.4108636152,0.0122580399,0.0844535359,0.23461092,0,59,1.0536240154240996E-4,1.3549677E-4,1.3714035E-4,77,21,1,199,1,0.0050251256
68853920,Chase__B,10,1037,76,391,1,14,25.6549556953,20-29,427,5,1,7,8,8,1,7,7,3.0546705286,0.931567206,7.886875684697816E-4,0.1607142857,0.33333334,0,59,5.2767751117976666E-5,1.3549677E-5,1.3714035E-5,147,0,0,199,0,0
68898817,screamingweenie,10,455,405,288,32,5,46.2609886902,40-49,599,4,5,0,5,5,5,0,0,0,0,0.0054433871,0.35,0.65,0,21,1.028448913228706E-4,4.064903E-5,0,182,2,0,200,0,0
69024005,francismule,10,1552,3375,1510,4,7,56.1975484769,50-59,653,5,4,6,10,10,4,6,5,2.2307692308,132.8333333333,3.348127087933221E-4,0.1111111111,0.33333334,42,307,6.122715185939804E-4,3.3874192E-5,2.742807E-5,197,23,0,200,0,0
69036362,melmobarrie,10,15716,1258,1906,42,28,53.5595456606,50-59,761,8,59,84,143,143,59,84,6,2.3544532947,7363.5350971796,0.0584756824,0.0583571358,0.198124,0,59,3.002731564983367E-4,4.064903E-4,4.1142106E-4,182,128,0,201,0,0
69505975,ctjn,10,48,47,95,0,0,16.3608738954,10-19,232,2,0,0,0,0,0,0,0,0,0,0,0,0,91,204,4.766339181938244E-5,0,0,82,0,0,51,0,0
69541907,Esmerodo,10,821,47,292,0,118,37.1709392825,30-39,571,5,1,8,9,9,1,8,7,3.0684286749,0.4452258781,4.47826911704656E-4,0.25,0.2638889,0,59,4.9183871495963767E-5,1.3549677E-5,1.3714035E-5,77,1,0,200,0,0
69637223,Morgan_G4,10,712,135,191,2,4,32.7650498286,30-39,588,5,2,2,4,4,2,2,8,3.6705286025,5711,5.425026505626595E-4,0,0,0,59,9.731927321770742E-5,2.0324514E-5,1.3714035E-5,175,2,0,199,0,0
69720985,pao_garciav,10,827,129,82,0,514,29.008117169,20-29,579,6,0,0,0,0,0,0,0,0,0,0,0,0,144,325,4.766339181938244E-5,0,0,140,0,0,188,0,0
69789140,SteveYoungCTV,10,3987,1276,382,55,4,45.5413585897,40-49,713,6,21,15,36,36,21,15,7,3.1748732802,339.46979561,0.0224037084,0.130952381,0.21827957,0,59,2.3468920214891897E-4,1.4904643E-4,1.5085438E-4,175,6,0,200,0,0
69890762,julakaba,10,15895,334,337,1,2,41.939445034,40-49,662,6,0,0,0,0,0,0,0,0,0,0,0,0,204,521,4.766339181938244E-5,0,0,208,2,0,202,0,0
69931952,filippoghidelli,10,4738,91,337,0,1341,19.7271203305,10-19,505,7,0,1,1,1,0,1,7,4.3571428571,0,0,0,0,42,525,4.766339181938244E-5,0,6.8570175E-6,197,1,0,200,0,0
70445552,BigShoey,10,5935,358,126,13,76,32.0401202995,30-39,715,7,17,16,33,33,17,16,7,2.8124547429,79.4949686014,0.0144263951,0.1553030303,0.41230768,0,59,1.14168454581681E-4,1.2194709E-4,1.2342632E-4,175,0,1,200,1,0.005
70553160,gordbailey,10,21534,316,547,21,6,45.747432081,40-49,678,8,2,7,9,9,2,7,7,3.2223026792,6.3846917864,0.0014627123,0.1805555556,0.2857143,0,59,5.4084934222729225E-5,2.0324514E-5,2.0571053E-5,175,2,0,201,0,0
70693316,terrylo_calgary,10,20484,644,592,19,1143,63.8279857241,60-69,738,8,3,4,7,7,3,4,7,3.2729905865,1.3495978848,0.0011999471,0.0476190476,0.33333334,0,59,6.398554009974338E-5,2.7099353E-5,2.742807E-5,175,8,0,201,0,0
71358586,MartinGratton,10,191,13,85,0,2,23.3466910443,20-29,388,5,0,21,21,21,0,21,7,2.7745204488,0,0,0.3357142857,0.5095238,0,551,4.766339181938244E-5,0,6.8570175E-6,175,5,0,201,0,0
71390388,AlbertaAltruist,10,17346,1017,140,41,0,58.2887737382,50-59,774,8,61,20,81,81,61,20,7,2.698044895,256.3120460336,0.043706872,0.1416666667,0.29688832,0,59,2.8939693906534505E-4,4.2003999E-4,4.2513508E-4,175,150,3,203,3,0.0147783251
71611873,sez_i,10,2653,131,235,6,201,41.2013728651,40-49,533,6,19,34,53,53,19,34,6,2.5296886314,152.7518854809,0.0279588336,0.1404208999,0.3785425,0,59,1.0082603365193977E-4,1.3549677E-4,1.3714035E-4,77,8,3,200,3,0.015
72736745,pt_ndp,10,55,41,1,3,0,22.0250688037,20-29,241,2,6,0,6,6,6,0,0,0,0,0.0156682351,0.4,0.6,0,49,7.616978704625355E-5,4.742387E-5,0,25,2,0,57,0,0
72737393,VIVOMediaArts,10,1665,1759,282,121,20,48.2079766651,40-49,686,6,6,1,7,7,6,1,7,3.2914554671,0,0.0045562017,0.3095238095,0.54761904,0,59,8.185366442777322E-5,4.742387E-5,4.799912E-5,182,35,0,200,0,0
72884615,timhowl,10,537,181,92,2,1,28.6453769096,20-29,547,4,56,28,84,84,56,28,7,2.6484431571,62.2372910479,0.1280797104,0.2015203672,0.5360577,0,59,3.586490304184517E-4,3.8616578E-4,3.9085E-4,25,13,20,200,19,0.095
72911723,ArtistforOcean,10,7189,1114,868,87,12,50.1516360581,50-59,726,5,2,12,14,14,2,12,7,3.0441708907,2962.7241745972,3.3427210315339814E-4,0.0549450549,0.083333336,0,59,5.864287845423757E-5,2.0324514E-5,2.0571053E-5,175,1,0,200,0,0
73333278,MsRock4Ever,10,77020,7281,7928,186,22093,56.2340038973,50-59,869,10,25,35,60,60,25,35,6,2.7089065894,4955.1092536343,0.0136882412,0.0367231638,0.1614114,0,59,1.5218091962015392E-4,1.761458E-4,1.7828245E-4,77,21,0,201,0,0
73583637,AndreaCSt,10,474,476,1641,21,6,34.0023764286,30-39,542,4,2,6,8,8,2,6,7,3.1350470673,2.7798470108,0.0027468382,0.1607142857,0.33333334,0,59,6.974292029098908E-5,2.0324514E-5,2.0571053E-5,175,4,0,200,0,0
73592681,themaxstern,10,5145,464,693,7,391,62.6969469373,60-69,689,6,36,67,103,103,36,67,6,2.4087617668,446.3836909187,0.0511665826,0.1698077289,0.3746694,0,59,2.019993761598332E-4,2.5066902E-4,2.5370964E-4,175,23,0,200,0,0
73651314,dwalshmedia,10,21963,1046,1999,50,5,43.9473982889,40-49,768,9,25,40,65,65,25,40,6,2.6314265025,2379.0187516976,0.0289881693,0.1211538462,0.24040404,0,59,1.9253206608590553E-4,1.761458E-4,1.7828245E-4,182,15,0,208,0,0
73815018,andyradia,10,3045,711,2001,26,4,51.9504154032,50-59,677,6,84,194,278,278,84,194,6,2.1759594497,17815.3003018237,0.1289236153,0.083564917,0.19742443,0,59,5.203039090359992E-4,5.7586125E-4,5.8284646E-4,175,41,0,200,0,0
74179953,SimcoeNorthNDP,10,604,239,594,9,27,45.6035811163,40-49,616,5,84,179,263,263,84,179,6,2.2425778421,8280.7038804958,0.1118329205,0.1318027458,0.30593085,0,59,3.366762026224031E-4,5.7586125E-4,5.8284646E-4,25,73,7,201,7,0.0348258706
74227540,johnnyfriesen,10,10726,977,1109,41,2,49.4526762489,40-49,748,7,45,55,100,100,45,55,7,2.642288197,3548.7433746215,0.0507531408,0.1548484848,0.29331613,0,59,2.1675836677962777E-4,3.1164257E-4,3.154228E-4,175,25,0,200,0,0
74275413,KingstonNDP,10,667,268,295,16,1,40.629112562,40-49,530,5,79,20,99,99,79,20,7,2.7436640116,400.3754007021,0.0932844881,0.1731601732,0.30512017,0,59,3.0483411787877215E-4,5.419871E-4,5.485614E-4,25,29,0,200,0,0
74347962,theDaye,10,5404,784,1995,40,125,60.0745784965,60-69,651,7,30,108,138,138,30,108,6,2.2809558291,2057.9798313521,0.0379810123,0.1260975352,0.28073394,0,59,2.26190744320365E-4,2.1001999E-4,2.1256754E-4,175,5,0,200,0,0
74532855,lukasnorman,10,1377,244,192,1,171,37.5472509441,30-39,602,5,19,28,47,47,19,28,7,2.7776973208,140.0727569142,0.0171118995,0.1526364477,0.4606855,0,59,1.6162159323951128E-4,1.3549677E-4,1.3714035E-4,147,21,0,200,0,0
74660931,keithjs,10,9009,213,181,8,726,53.3031107818,50-59,728,8,26,23,49,49,26,23,7,2.6665459812,796.6343190532,0.0334191713,0.0480442177,0.16989248,0,59,1.7638693679776526E-4,1.8292063E-4,1.8513948E-4,175,21,0,201,0,0
75155945,GlobalSaskatoon,10,10556,6259,223,162,4,59.9453472761,50-59,785,6,29,20,49,49,29,20,7,2.9304851557,1357.4555062852,0.0203500324,0.0765306122,0.22352941,0,59,2.0633594562959067E-4,2.0324514E-4,1.9885351E-4,25,95,0,200,0,0
75190893,kylecmatthews,10,14482,953,1200,33,74,51.9390740134,50-59,739,8,33,55,88,88,33,55,6,2.585807386,891.9200173409,0.0362932182,0.1485109718,0.27675676,0,59,1.9497594657999904E-4,2.303445E-4,2.3313859E-4,175,23,0,201,0,0
76215754,jansescape,10,968,132,87,1,3,31.4363585618,30-39,578,5,12,7,19,19,12,7,7,3.1364952933,26.7159042665,0.0134564373,0.1988304094,0.63736266,0,59,8.442057102321493E-5,8.80729E-5,8.914123E-5,182,7,0,200,0,0
76940591,goitsekonopi,10,6076,506,380,6,87,51.0390909899,50-59,722,7,1,1,2,2,1,1,9,4.9826212889,0,9.260397024517242E-5,0,0,0,59,1.4582508020379197E-4,1.3549677E-5,1.3714035E-5,131,11,0,200,0,0
77302546,DLynxleg,10,4426,94,311,2,577,44.2160730464,40-49,656,6,1,4,5,5,1,4,7,3.2422157857,0.3668149744,2.399419374534004E-4,0.2,0.5,0,59,5.012596746682805E-5,1.3549677E-5,1.3714035E-5,77,2,1,201,1,0.0049751244
77421074,ElaineCarol3,10,4458,240,139,11,700,40.7066833313,40-49,640,7,4,2,6,6,4,2,7,3.0897900072,22.6083819408,0.0108372409,0.1,0.41666666,0,59,9.377406436295081E-5,3.3874192E-5,3.4285087E-5,25,6,0,200,0,0
77716291,RolandGurney,10,1312,109,965,2,13,19.4320135962,10-19,461,4,0,4,4,4,0,4,7,3.3025696706,0,0,0.1666666667,0.25,0,151,4.766339181938244E-5,0,6.8570175E-6,182,1,0,200,0,0
77865221,deepus_ex,10,1202,128,479,4,1070,39.6589811067,30-39,514,5,6,18,24,24,6,18,6,2.6122375091,31.6387773188,0.0146870112,0.1539855072,0.36601308,0,59,6.903962118572616E-5,4.742387E-5,4.799912E-5,77,1,0,200,0,0
78069472,LemonadebyLaura,10,10497,598,666,23,96,44.5920857394,40-49,664,7,3,10,13,13,3,10,6,2.8635047067,60.0007985038,0.0042619988,0.1602564103,0.3181818,0,59,7.79709105442743E-5,2.7099353E-5,2.742807E-5,77,0,0,200,0,0
78141614,jbs24,10,1957,61,213,0,6,29.4355627181,20-29,557,5,0,0,0,0,0,0,0,0,0,0,0,0,142,322,4.766339181938244E-5,0,0,138,2,0,201,0,0
78259129,1africa1love,10,1518,104,219,3,27,42.9316949143,40-49,614,5,1,2,3,3,1,2,2,1.3333333333,101.8234252551,9.493101931988185E-5,0.1666666667,0.16666667,0,40,6.482161632919536E-5,1.3549677E-5,1.3714035E-5,131,4,0,200,0,0
78394471,mavatcher,10,478,91,143,0,8,29.4637235725,20-29,577,4,0,0,0,0,0,0,0,0,0,0,0,0,143,324,4.766339181938244E-5,0,0,139,1,0,197,0,0
78627903,ChristianConsrv,10,3245,357,75,15,7,51.9629449642,50-59,697,6,46,12,58,58,46,12,7,2.7418537292,442.8200335279,0.0670422289,0.1228070175,0.23142858,0,59,3.929907054209571E-4,3.1841738E-4,3.222798E-4,175,69,0,200,0,0
78812863,avdhuman,10,63378,1956,1434,11,5,45.7346448154,40-49,649,9,2,1,3,3,2,1,8,3.5104996379,2.6511806832,0.00194812,0,0,0,59,5.30237973953846E-5,2.0324514E-5,2.0571053E-5,175,0,0,201,0,0
78898625,7PinkPanther7,10,195629,1264,884,44,2,47.997087501,40-49,880,11,13,13,26,26,13,13,7,2.6357711803,725.4927106818,0.0198434614,0.0661538462,0.35238096,0,59,1.1359646095822023E-4,9.484774E-5,9.599824E-5,145,30,1,201,1,0.0049751244
78998102,RampageRobinson,10,7,2,12,0,1,11.0632857838,10-19,2,0,0,0,0,0,0,0,0,0,0,0,0,0,268,697,4.766339181938244E-5,0,0,275,0,0,10,0,0
79015001,colinmckone,10,591,126,207,3,6,23.5460606736,20-29,479,4,12,26,38,38,12,26,6,2.8859522085,13.3529967475,0.0255789749,0.2880512091,0.5681818,0,59,1.241115671540107E-4,8.80729E-5,8.914123E-5,175,0,0,200,0,0
79262203,BillBrydon,10,5136,258,161,5,44,41.9326828149,40-49,616,7,6,9,15,15,6,9,7,2.8511947864,15.8087687115,0.0129526352,0.1666666667,0.33333334,0,59,6.843193894642676E-5,4.742387E-5,4.799912E-5,25,0,0,201,0,0
79518394,MRevaitNews,10,940,300,388,12,11,44.0943228829,40-49,608,5,8,9,17,17,8,9,7,3.0014482259,144.9902532817,0.0035507829,0.1433823529,0.5090909,0,59,9.19223454182003E-5,6.0973543E-5,6.171316E-5,175,24,0,200,0,0
79929470,MelisaFerreira,10,1867,361,1111,8,9,30.2625471879,30-39,623,6,26,88,114,114,26,88,6,2.4116582187,375.996647089,0.055471818,0.208430368,0.4700191,0,59,1.6312184816732087E-4,1.8292063E-4,1.8513948E-4,25,7,4,198,4,0.0202020202
80027957,TweetJewels,10,2664,257,393,16,25,47.0284300127,40-49,579,6,36,53,89,89,36,53,6,2.5047067343,436.3362907167,0.0617954766,0.1560265577,0.51949155,0,59,2.735267895698449E-4,2.5066902E-4,2.5370964E-4,25,12,2,200,2,0.01
80406408,kejohnson22,10,66,82,155,3,7,29.8087671526,20-29,368,3,2,2,4,4,2,2,8,4.6401446655,0,1.6551228476954845E-4,0.0833333333,1,0,657,1.8304710587575002E-4,2.0324514E-5,2.0571053E-5,278,3,0,68,0,0
80694782,KyleDimmock,10,1091,66,182,2,2,28.4417729465,20-29,527,3,2,1,3,3,2,1,7,3.4793627806,0.1173943475,6.749693430172256E-4,0.3333333333,0.5,0,59,5.363924842386966E-5,2.0324514E-5,2.0571053E-5,147,0,0,200,0,0
80940096,caseyoraa,10,6900,780,721,45,19,47.2491065066,40-49,731,7,41,42,83,83,41,42,6,2.5492396814,948.0779847065,0.0499539893,0.0953570379,0.2813067,0,59,2.0103925634782187E-4,2.845432E-4,2.8799474E-4,182,53,0,200,0,0
80970676,DevPeace,10,1244,1059,1253,54,3,48.2931251247,40-49,639,5,18,17,35,35,18,17,7,2.8283852281,6284.2892505204,0.0103882565,0.0092436975,0.05882353,0,59,1.6342094285658055E-4,1.2872192E-4,1.3028333E-4,25,37,0,200,0,0
81231446,jhburgess98,10,5717,1988,1917,53,2871,51.2707418709,50-59,760,8,9,9,18,18,9,9,7,3.0119478639,59.3706737125,0.0041982115,0.0588235294,0.3888889,0,59,9.26410157731335E-5,6.7748384E-5,6.8570174E-5,77,3,0,200,0,0
81290051,louisa_faux,10,218,9,32,1,19,15.74156519,10-19,150,3,2,3,5,5,2,3,7,3.169442433,1.6721238372,0.0018761827,0.05,0.16666667,0,59,6.00029184837161E-5,2.0324514E-5,2.0571053E-5,182,0,0,199,0,0
81408373,ColinBetts,10,1455,93,97,1,49,28.6771290577,20-29,571,5,6,9,15,15,6,9,7,2.7813178856,13.1734159262,0.0115182447,0.1857142857,0.33974358,0,59,7.339611440537749E-5,4.742387E-5,4.799912E-5,175,2,0,200,0,0
81770444,Whameedoodle,10,1416,27,130,0,0,42.0893465217,40-49,578,5,2,4,6,6,2,4,7,3.2146994931,18.6305312078,3.9695274303147625E-4,0,0,0,59,5.2679362187249974E-5,2.0324514E-5,2.0571053E-5,77,15,0,201,0,0
81855161,mdavid6,10,149,9,51,0,0,13.4620039902,10-19,50,3,0,1,1,1,0,1,7,3.2616720955,0,0,0,0,0,351,4.766339181938244E-5,0,6.8570175E-6,77,2,0,161,0,0
81902567,littleengine74,10,5881,80,322,1,30,39.371824171,30-39,678,7,3,7,10,10,3,7,7,3.0785662563,4171.7167407764,0.0013584753,0.0888888889,0.19642857,0,59,8.369346206609345E-5,2.7099353E-5,2.742807E-5,175,1,0,200,0,0
82064317,SANGONeT,10,15615,7859,3693,244,21,59.6378739386,50-59,768,7,9,2,11,11,9,2,1,1,2545.5805323624,0.001156456,0.0454545455,0.054545455,0,29,2.8566328699620276E-4,6.7748384E-5,6.8570174E-5,131,11,0,200,0,0
82398317,Whiff83,10,28665,961,1181,27,220,45.5584495404,40-49,784,8,22,26,48,48,22,26,7,2.5119478639,588.5950725278,0.0212834735,0.1343085106,0.35555556,0,59,1.4905734730002293E-4,1.5582128E-4,1.577114E-4,147,68,0,201,0,0
82494649,datatect,10,22874,625,171,18,293,54.1904465487,50-59,776,8,100,24,124,124,100,24,6,2.6281679942,422.7374150251,0.1224708611,0.1532258065,0.2846871,0,59,3.4167931646848445E-4,6.8425864E-4,6.9255877E-4,77,133,2,214,2,0.0093457944
82674850,MyTorontoHome,10,1616,389,306,10,27,41.18111474,40-49,606,5,1,2,3,3,1,2,7,3.3120926865,0,4.568820289893232E-4,0.1666666667,1,0,59,4.955208345819835E-5,1.3549677E-5,1.3714035E-5,25,2,0,200,0,0
82789713,SandiEllen,10,6623,87,82,3,0,31.6646614339,30-39,584,6,2,3,5,5,2,3,7,3.2451122375,4.6464217069,2.769230147602957E-4,0.05,0.33333334,0,59,6.486470594191115E-5,2.0324514E-5,2.0571053E-5,77,0,0,200,0,0
82940718,KathleenRange,10,253,137,77,6,1,41.9536111525,40-49,547,4,8,6,14,14,8,6,7,3.1517016655,2.2850739314,0.0066562828,0.1428571429,0.85714287,0,59,9.302173548053334E-5,6.0973543E-5,6.171316E-5,175,12,1,200,1,0.005
83091807,160B,10,5925,517,760,15,594,43.5471901846,40-49,703,7,0,1,1,1,0,1,8,3.85305827,0,0,0,0,0,679,4.766339181938244E-5,0,6.8570175E-6,77,0,0,200,0,0
83180342,shawnwlewis,10,4216,323,333,10,42,45.3904046444,40-49,680,7,67,91,158,158,67,91,6,2.41564084,2431.2735004793,0.0986580109,0.1315004434,0.34195277,0,59,3.076977664568555E-4,4.60689E-4,4.6627718E-4,25,71,1,200,1,0.005
83304354,JackCanada1,10,4236,796,1965,39,1928,38.0475607603,30-39,571,6,4,37,41,41,4,37,7,2.6716147719,192.9327592482,0.0037338871,0.1408536585,0.24174175,0,59,6.8886496656868E-5,3.3874192E-5,3.4285087E-5,77,1,0,200,0,0
83499887,AlphaCannyBody,10,10922,230,221,0,787,44.6506489534,40-49,697,6,1,1,2,2,1,1,2,1.5,0,8.271798374069241E-5,0,0,67,157,2.4481546444683235E-4,1.3549677E-5,1.3714035E-5,59,6,0,199,0,0
83684703,NotYetCanadian,10,724,227,352,8,1,36.0244481675,30-39,522,5,3,6,9,9,3,6,7,2.8714699493,46.4579265252,0.002098845,0.2638888889,0.3611111,0,59,5.7066931284313235E-5,2.7099353E-5,2.742807E-5,175,3,3,200,2,0.01
83748727,FaithGoldy,10,12188,1375,713,28,4,65.0085594158,60-69,761,7,91,66,157,157,91,66,6,2.5510499638,5197.0238466351,0.0958865927,0.083496652,0.20112045,0,59,6.062996062477786E-4,6.2328513E-4,6.308456E-4,175,106,0,202,0,0
83827013,Hitman82,10,6158,169,362,0,92,63.2176661888,60-69,597,6,0,2,2,2,0,2,6,3.4285714286,0,0,0.5,1,42,426,4.766339181938244E-5,0,6.8570175E-6,197,0,0,200,0,0
83955501,Sebastian_NR,10,6623,1417,1307,2,263,44.9347680777,40-49,711,7,0,0,0,0,0,0,0,0,0,0,0,0,101,226,4.766339181938244E-5,0,0,91,4,0,201,0,0
84331320,nickerpot,10,1394,363,832,12,38,38.0503791857,30-39,623,5,4,7,11,11,4,7,7,2.944243302,8.8576227746,0.007570198,0.1454545455,0.39285713,0,59,6.64875197630098E-5,3.3874192E-5,3.4285087E-5,175,0,0,200,0,0
84368341,madinuk,10,31746,2151,885,89,11,61.138383242,60-69,787,8,69,22,91,91,69,22,7,2.8540912382,5047.2507876929,0.0733363024,0.0669108669,0.135851,0,59,5.413585076529394E-4,4.7423868E-4,4.7313422E-4,77,88,0,199,0,0
84401415,BillKingLanark,10,1583,418,1023,3,72,54.0506751173,50-59,627,6,17,67,84,84,17,67,6,2.4855177408,302.5046652658,0.0218039486,0.1701090075,0.36700767,0,59,1.4919584196631437E-4,1.2194709E-4,1.2342632E-4,175,15,1,200,1,0.005
84702727,JTerr88,10,15402,1084,1140,40,26,,,759,8,22,41,63,63,22,41,6,2.4120202752,677.9089896737,0.0416733214,0.1259600614,0.2996454,0,59,1.3319079096507893E-4,1.5582128E-4,1.577114E-4,175,3,0,200,0,0
84730224,stevenpenner,10,1282,111,181,0,6,28.4844745111,20-29,543,5,6,19,25,25,6,19,7,2.8414192614,56.2385641723,0.0138767066,0.21,0.45238096,0,59,8.123609430416518E-5,4.742387E-5,4.799912E-5,175,0,1,198,1,0.0050505051
84964287,janice2222,10,670,331,603,2,8,40.3310002624,40-49,529,4,31,55,86,86,31,55,7,2.6249094859,547.1776053619,0.0162300145,0.0794801642,0.3242424,0,59,1.8060274404537647E-4,2.1679483E-4,2.1942456E-4,175,3,0,200,0,0
85146999,Albertagirl46,10,6920,1104,1477,33,11,45.2964810307,40-49,719,7,109,161,270,270,109,161,6,2.2299058653,16244.2680690542,0.1157671117,0.044031392,0.18532096,0,59,4.2933265148460204E-4,7.452322E-4,7.542719E-4,77,18,0,200,0,0
85229508,rileysmithphoto,10,5609,1047,735,25,44,47.6990105415,40-49,707,7,9,4,13,13,9,4,7,3.0307748009,2955.6882760859,0.0110319089,0.141025641,0.5277778,0,59,1.1491580543391357E-4,6.7748384E-5,6.8570174E-5,147,15,0,200,0,0
85683126,HillsDW,10,362,84,208,1,1,21.798775178,20-29,385,4,8,21,29,29,8,21,7,2.8454018827,12.624888175,0.0144169395,0.2770935961,0.56666666,0,59,1.0187954916322918E-4,6.0973543E-5,6.171316E-5,175,0,2,198,2,0.0101010101
86033873,mcgregordu,10,415,80,74,1,6,27.890133196,20-29,550,4,10,17,27,27,10,17,6,2.6307023896,58.3737267373,0.0133717381,0.1210826211,0.4779412,0,59,9.493992899801746E-5,7.452322E-5,7.542719E-5,182,3,1,200,1,0.005
86237142,EricMcLeanPR,10,455,286,554,13,1,30.4249653631,30-39,564,4,2,20,22,22,2,20,6,2.6734250543,73.701487221,0.0049707957,0.2640692641,0.51842105,0,59,5.35309442745286E-5,2.0324514E-5,2.0571053E-5,175,2,5,200,5,0.025
86360812,KevinSMcArthur,10,24193,882,620,52,10,50.4831377175,50-59,778,8,19,15,34,34,19,15,7,2.8812454743,9552.2156307849,0.0194404736,0.0418894831,0.12252964,0,59,2.0323489521364453E-4,1.3549677E-4,1.3714035E-4,182,38,0,200,0,0
86392086,jlynneda,10,62389,787,807,29,2737,42.0013135689,40-49,770,9,15,14,29,29,15,14,7,2.9214337437,65.5554244705,0.0059788641,0.1243842365,0.37619048,0,59,8.534409480358999E-5,1.0839741E-4,1.0971228E-4,77,6,0,202,0,0
87159394,maxperri71,10,7622,571,1282,2,1164,43.8996868521,40-49,702,7,0,1,1,1,0,1,7,4.3571428571,0,0,0,0,42,418,4.766339181938244E-5,0,6.8570175E-6,197,1,0,200,0,0
87247412,CanadianPeace,10,649,959,821,38,1,43.6412867162,40-49,688,5,76,78,154,154,76,78,6,2.3645908762,4198.6090246097,0.0956279273,0.1035141329,0.25110382,0,59,3.435939637198833E-4,5.216625E-4,5.2799034E-4,182,50,15,200,15,0.075
87344994,stephanieerb,10,25,16,61,0,2,15.8399468089,10-19,146,2,1,7,8,8,1,7,6,2.9692251991,0,4.7465073898765066E-4,0.2678571429,0.47619048,0,59,4.9009182956424754E-5,1.3549677E-5,1.3714035E-5,182,1,0,30,0,0
87836882,ilamzzone,10,7855,530,749,9,337,43.7990668825,40-49,689,7,1,3,4,4,1,3,7,3.2744388125,1.1883506583,1.6917414222839314E-4,0.1666666667,0.33333334,0,59,5.24952780416993E-5,1.3549677E-5,1.3714035E-5,182,4,0,200,0,0
88301686,CPbeacon,10,928,722,639,28,22,43.6187350123,40-49,636,5,7,6,13,13,7,6,7,3.2845763939,634.8488225849,0.0113064349,0.1217948718,0.375,0,59,4.410684572139483E-4,5.4198706E-5,5.485614E-5,175,11,0,200,0,0
88305524,Azheibell,10,4375,80,343,2,85,24.9577080581,20-29,554,7,0,7,7,7,0,7,7,3.0810712993,0,0,0.3333333333,0.42857143,0,298,4.766339181938244E-5,0,6.8570175E-6,25,0,0,200,0,0
88799262,greentak,10,78557,2703,2913,132,5363,55.3462555951,50-59,838,9,1,2,3,3,1,2,7,3.2125271542,0,9.664037912845491E-4,0.1666666667,1,0,59,5.0898997129838516E-5,1.3549677E-5,1.3714035E-5,77,9,0,201,0,0
89261271,joehill42,10,209,173,166,15,1,27.4781649048,20-29,448,3,33,33,66,66,33,33,7,2.5999275887,95.3200526444,0.0385576797,0.1699300699,0.43306738,0,59,1.398086752203558E-4,2.303445E-4,2.3313859E-4,25,0,0,200,0,0
89704537,bonezmtl,10,2668,178,428,3,22,46.6496878522,40-49,675,6,39,88,127,127,39,88,6,2.2708182476,2269.6633302013,0.0640382461,0.1012998375,0.3123085,0,59,1.6394661145726798E-4,2.7099354E-4,2.742807E-4,77,38,0,203,0,0
89733259,DCShalala,10,12923,683,610,27,16,53.4079075526,50-59,764,8,29,35,64,64,29,35,7,2.4627081825,3592.8099200428,0.0368960176,0.1297123016,0.32757092,0,59,1.9853099131038435E-4,2.0324514E-4,1.9885351E-4,175,50,3,200,3,0.015
89801274,GAdvLaurie,10,11565,1358,1996,33,49,51.6890699643,50-59,716,8,0,2,2,2,0,2,7,3.4230908433,0,0,0,0,0,562,4.766339181938244E-5,0,6.8570175E-6,175,3,0,200,0,0
89812685,ea_p,10,3901,451,640,17,11,60.1258936818,60-69,670,6,47,108,155,155,47,108,6,2.3323678494,1859.8917306046,0.0847730415,0.1402178467,0.34733894,0,59,3.004176651356732E-4,3.2519223E-4,3.2913685E-4,25,37,6,200,6,0.03
90552383,Jeffsariot,10,1708,66,225,0,1,33.9864666489,30-39,523,5,5,27,32,32,5,27,7,2.6183924692,21.7635797966,0.0167070072,0.2741935484,0.48850575,0,59,7.026500819350756E-5,4.064903E-5,4.1142106E-5,175,0,1,200,1,0.005
90572771,SaskLiberals,10,163,513,155,23,0,42.6190773983,40-49,601,3,26,19,45,45,26,19,7,2.8997103548,199.2870438888,0.0208944727,0.1358585859,0.34453782,0,59,1.481761617139714E-4,1.8292063E-4,1.8513948E-4,25,5,2,171,2,0.0116959064
90783594,jbierm02,10,9214,435,401,7,37,47.8195178531,40-49,688,7,85,94,179,179,85,94,6,2.2805937726,1752.0883898507,0.11762096,0.0688280711,0.3943299,0,59,2.8345823762620256E-4,5.826361E-4,5.897035E-4,77,65,1,200,1,0.005
90919783,BillyHowes,10,185,288,216,7,0,25.8614043174,20-29,438,3,1,5,6,6,1,5,7,2.9511223751,0,0.0024064222,0.2666666667,0.75,0,59,5.09234828373167E-5,1.3549677E-5,1.3714035E-5,182,1,0,185,0,0
91017612,jcat111,10,1922,175,836,0,236,44.8366705453,40-49,551,6,33,133,166,166,33,133,6,2.2700941347,3333.7291976982,0.0431381456,0.1244614823,0.27967647,0,59,1.693010228950021E-4,2.303445E-4,2.3313859E-4,77,14,0,202,0,0
91035609,sassa26_ca2003,10,2533,521,985,9,16,45.9829604239,40-49,660,6,87,161,248,248,87,161,6,2.2795076032,7090.5017843782,0.0960901169,0.0828816769,0.22029795,0,59,2.951600643912358E-4,5.9618574E-4,6.034175E-4,182,43,0,200,0,0
91175967,PamelaHarrison_,10,654,151,196,7,17,36.2288258109,30-39,540,5,18,26,44,44,18,26,6,2.5789283128,178.8996828626,0.0359215644,0.189217759,0.44761905,0,59,1.220863382132626E-4,1.2872192E-4,1.3028333E-4,147,2,0,200,0,0
91404588,MarkCRobins,10,29128,1111,1084,57,59,44.7375466475,40-49,760,9,50,66,116,116,50,66,6,2.4413468501,2960.3768730686,0.0661058657,0.0832833583,0.28947368,0,59,1.9860632121521037E-4,3.4551675E-4,3.497079E-4,175,18,0,201,0,0
91532149,ChadErosChillBC,10,441,152,318,6,3,43.1359609134,40-49,607,5,27,28,55,55,27,28,7,2.8921071687,564.3225997104,0.0139758044,0.0632996633,0.33793104,0,59,2.020038003565045E-4,1.8969548E-4,1.9199649E-4,182,145,0,199,0,0
91711944,karpocheb,10,551,122,524,1,1,40.3961462502,40-49,527,5,25,67,92,92,25,67,7,2.5438088342,560.702524003,0.0459426214,0.1390348782,0.32380953,0,59,2.1216778831833076E-4,1.761458E-4,1.7828245E-4,25,1,0,198,0,0
91892348,KhanYEG,10,4625,4547,1572,25,418,55.0345100531,50-59,695,7,60,129,189,189,60,129,6,2.3385228096,7036.6698078258,0.0538744817,0.0801812451,0.22612502,0,59,3.010271545492135E-4,4.1326514E-4,4.1827807E-4,175,13,1,200,1,0.005
92116441,cupepropublic,10,1170,327,470,14,23,38.5182073996,30-39,584,5,58,79,137,137,58,79,6,2.3287472846,1498.9001242369,0.0809935946,0.1215650494,0.32181817,0,59,2.4133090029810603E-4,3.9971547E-4,4.0456402E-4,182,13,1,200,1,0.005
92179147,LizRiceToronto,10,1749,473,401,27,4,40.5051769462,40-49,646,6,8,10,18,18,8,10,6,2.9319333816,2778.1200940885,0.0102295364,0.1078431373,0.3560606,0,59,1.0606531581340866E-4,6.0973543E-5,6.171316E-5,175,3,0,200,0,0
92356084,rwunion,10,424,62,6,5,1,25.1568410803,20-29,454,3,5,1,6,6,5,1,7,3.4989138306,1.2966697959,0.0086089096,0.2666666667,0.5,0,59,6.222113095447765E-5,4.064903E-5,4.1142106E-5,182,0,0,200,0,0
92620044,kiranrhines,10,1540,170,189,14,1,35.4144921324,30-39,507,6,18,20,38,38,18,20,7,2.8153511948,21.9032868175,0.0539699156,0.219772404,0.47634408,0,59,2.2395388437408803E-4,1.2872192E-4,1.3028333E-4,175,3,3,200,3,0.015
92665203,MichaelJMo,10,2534,103,190,3,317,27.9899436762,20-29,471,5,4,18,22,22,4,18,7,2.8283852281,578.976319329,0.0061723786,0.1623376623,0.34313726,0,59,1.6813914337751687E-4,3.3874192E-5,3.4285087E-5,175,4,0,200,0,0
92913722,StephenJNichols,10,12707,626,2002,8,6,49.1928219317,40-49,715,8,28,89,117,117,28,89,6,2.3399710355,1522.4309249406,0.0346147282,0.1261420572,0.23871288,0,59,1.544653432027843E-4,1.9647031E-4,1.9885351E-4,175,3,0,200,0,0
93006802,luckhardtjason,10,5759,99,121,0,25,18.7021484552,10-19,625,7,12,10,22,22,12,10,6,2.7411296162,9.0188499223,0.0192761686,0.2294372294,0.36052632,0,59,7.9598459735701E-5,8.80729E-5,8.914123E-5,77,0,0,200,0,0
93311996,LuisGarcia019,10,5639,462,701,0,1004,44.5719030351,40-49,724,6,3,3,6,6,3,3,1,1,6,2.4299109516265612E-4,0,0,100,225,6.094623278908828E-4,2.7099353E-5,2.742807E-5,237,7,0,200,0,0
93675048,ValLali,10,3000,306,833,4,22,46.2052995878,40-49,623,6,19,65,84,84,19,65,7,2.5010861694,158.6398846603,0.0426627861,0.2041021228,0.497669,0,59,1.2356814101577255E-4,1.3549677E-4,1.3714035E-4,25,12,0,201,0,0
94020511,dcourtens,10,2937,307,804,4,0,36.0487563383,30-39,530,6,9,41,50,50,9,41,6,2.4942070963,124.2762882717,0.0255289445,0.1804081633,0.3932927,0,59,8.550294150112878E-5,6.7748384E-5,6.8570174E-5,25,7,0,200,0,0
94031113,AbadKhanNS,10,15434,961,1278,31,191,50.8732212916,50-59,769,8,76,116,192,192,76,116,6,2.3417813179,4049.5334454419,0.1001497556,0.0809064136,0.28058064,0,59,4.18267350959937E-4,5.216625E-4,5.2799034E-4,147,128,0,200,0,0
94261963,jamie_daw,10,1035,495,704,24,1,50.7308455654,50-59,618,5,7,23,30,30,7,23,6,2.5300506879,338.7565082015,0.0098044834,0.1402298851,0.32608697,0,59,6.762396620382715E-5,5.4198706E-5,5.485614E-5,77,0,1,200,1,0.005
94587356,xandderasyasyme,10,13263,261,299,0,605,42.8390371076,40-49,735,7,0,0,0,0,0,0,0,0,0,0,0,0,158,353,4.766339181938244E-5,0,0,156,5,0,201,0,0
94669804,KeenanAylwin,10,987,207,609,2,499,53.590730012,50-59,590,5,14,71,85,85,14,71,6,2.433019551,420.6945733042,0.0278060692,0.1602240896,0.31525874,0,59,1.3342904569767114E-4,1.0162257E-4,1.02855265E-4,175,12,12,200,12,0.06
94791047,zunkery,10,233,15,64,0,0,21.7980132107,20-29,462,3,0,0,0,0,0,0,0,0,0,0,0,0,118,263,4.766339181938244E-5,0,0,111,0,0,199,0,0
95105815,jess_mccrae,10,39721,247,349,12,1138,44.7367602786,40-49,771,8,13,20,33,33,13,20,7,2.8435916003,91.5832685055,0.0143951366,0.1060606061,0.23166667,0,59,1.103410203064532E-4,9.484774E-5,9.599824E-5,175,13,1,202,1,0.004950495
95166331,kyamarty,10,440,23,170,1,16,15.4476683229,10-19,325,4,0,1,1,1,0,1,7,4.3571428571,0,0,0,0,42,472,4.766339181938244E-5,0,6.8570175E-6,197,1,0,200,0,0
95385781,Ekction,10,3934,120,209,0,3,41.7111111764,40-49,656,7,2,8,10,10,2,8,9,4.7494569153,17.0961611917,1.9160625184716658E-4,0.1333333333,0.3392857,0,59,1.1466576214887037E-4,2.0324514E-5,2.0571053E-5,131,12,0,197,0,0
95462457,stwoball,10,1653,66,70,5,13,42.5169831783,40-49,564,6,4,5,9,9,4,5,7,3.1057204924,7.6701208255,0.0041384606,0.1527777778,0.35714287,0,59,6.287755756435965E-5,3.3874192E-5,3.4285087E-5,77,4,0,199,0,0
95539607,ottawa_jen,10,2222,158,794,3,22,42.7112371744,40-49,618,6,37,112,149,149,37,112,6,2.3957277335,862.624160106,0.0757627344,0.1725013604,0.35569105,0,59,2.843170184997458E-4,2.5744384E-4,2.6056665E-4,25,43,5,200,5,0.025
95577307,OrcaBC101,10,10421,2298,2409,72,348,54.9088130419,50-59,755,8,22,31,53,53,22,31,6,2.5992034757,890.9985776123,0.0300880567,0.0362844702,0.15698925,0,59,1.6763115022351379E-4,1.5582128E-4,1.577114E-4,182,7,0,200,0,0
95720474,carlyoboth,10,1640,367,434,16,15,55.9030699286,50-59,631,6,2,2,4,4,2,2,8,4.6401446655,0,1.6551228476954845E-4,0.0833333333,1,0,657,1.8304710587575002E-4,2.0324514E-5,2.0571053E-5,278,8,0,200,0,0
96267206,princesstuborg,10,204,19,70,0,16,12.9466240821,10-19,250,3,0,3,3,3,0,3,7,3.1769815418,0,0,0.3333333333,0.5,0,285,4.766339181938244E-5,0,6.8570175E-6,25,0,0,199,0,0
96306270,roccorossiTO,10,7455,4181,3143,289,2,57.2649151588,50-59,767,7,98,103,201,201,98,103,6,2.4645184649,22097.5616018741,0.1256099432,0.0857960199,0.20299776,0,59,9.030405652900043E-4,6.70709E-4,6.7884475E-4,175,22,0,201,0,0
96412638,lifeislife4life,10,2881,811,1999,7,99,41.5536401075,40-49,664,6,5,13,18,18,5,13,7,2.8320057929,127.2614147889,0.0043617227,0.1339869281,0.2761905,0,59,7.235668025258412E-5,4.064903E-5,4.1142106E-5,145,1,0,199,0,0
96450418,DavidHeap,10,7133,1172,904,83,40,51.2207876817,50-59,730,7,40,42,82,82,40,42,6,2.4688631427,1156.4605869539,0.0550999993,0.0945498344,0.29461586,0,59,1.781397876349106E-4,2.7776835E-4,2.811377E-4,182,17,0,199,0,0
96469541,she_et_al,10,253,94,238,2,8,27.0267171151,20-29,488,4,3,10,13,13,3,10,7,2.8569876901,7.0748104146,0.0083922262,0.1923076923,0.5555556,0,59,8.08603307559569E-5,2.7099353E-5,2.742807E-5,25,1,0,200,0,0
96641833,Glenn_Nolan_,10,725,181,111,8,0,44.1113079867,40-49,578,5,1,2,3,3,1,2,7,3.4572773353,0,1.791656809418672E-4,0.1666666667,0.5,0,59,5.280670972462148E-5,1.3549677E-5,1.3714035E-5,175,7,0,200,0,0
96761456,s_roddick,10,1894,456,397,11,13,36.2068426703,30-39,639,6,25,30,55,55,25,30,6,2.557204924,3904.5108483237,0.0304539258,0.1067340067,0.2794872,0,59,1.8794688373095176E-4,1.761458E-4,1.7828245E-4,77,3,0,199,0,0
96799205,Eastportorganic,10,13008,874,1989,17,268,49.9540921551,40-49,756,8,75,142,217,217,75,142,6,2.2498189718,9271.5564507415,0.0915224793,0.0813492063,0.20718168,0,59,2.973732146582056E-4,5.148877E-4,5.211333E-4,77,37,0,201,0,0
97065800,SimonJolicoeur,10,1826,370,796,10,16,40.7771521037,40-49,632,5,17,37,54,54,17,37,7,2.5839971035,102.9607366789,0.0308593962,0.2243186583,0.45024154,0,59,1.3500756523912837E-4,1.2194709E-4,1.2342632E-4,25,3,0,200,0,0
97175858,MarleneRivier,10,419,217,108,20,0,56.8464492345,50-59,563,3,48,32,80,80,48,32,6,2.5691527878,370.7409594691,0.0759884241,0.1650316456,0.34545454,0,59,2.0811786669288224E-4,3.3196708E-4,3.3599386E-4,25,46,0,200,0,0
97274376,MarjoryLoveys,10,107,112,151,9,0,32.218578462,30-39,394,3,13,29,42,42,13,29,6,2.6169442433,47.4536510338,0.0258215555,0.2032520325,0.47916666,0,59,1.0919660823861563E-4,9.484774E-5,9.599824E-5,175,3,1,142,1,0.0070422535
97460162,RickyEMarima,10,5417,264,1038,1,136,47.1768516704,40-49,680,6,1,4,5,5,1,4,10,5.8808834178,1479.0197522507,1.5584411420357073E-4,0.1,0.25,0,59,1.8561525158315001E-4,1.3549677E-5,1.3714035E-5,131,0,0,201,0,0
97474079,susannakelley,10,4878,965,1002,31,52,48.9026989072,40-49,705,7,83,86,169,169,83,86,6,2.3193338161,2790.0124781035,0.1204405864,0.1142575373,0.2727159,0,59,5.474442930278094E-4,5.690864E-4,5.759895E-4,175,32,0,200,0,0
97474900,McClaser,10,406,97,192,2,3,28.9138669235,20-29,466,4,6,9,15,15,6,9,7,2.8989862419,70.8604627303,0.0128989828,0.180952381,0.41025642,0,59,8.039271913822205E-5,4.742387E-5,4.799912E-5,175,6,1,200,1,0.005
97540555,adamfriesen,10,1068,361,355,6,4,40.7530403944,40-49,644,5,61,76,137,137,61,76,6,2.4569152788,1770.8266671398,0.095075734,0.0971983684,0.30100334,0,59,4.44707865777528E-4,4.2003999E-4,4.2513508E-4,25,10,1,200,1,0.005
97839765,Northern_Clips,10,45037,1337,21,111,548,50.4797532689,50-59,755,9,21,2,23,23,21,2,7,3.1502534395,60.3344337646,0.0205629479,0.1126482213,0.18577075,0,59,1.7064702308621939E-4,1.4904643E-4,1.4399737E-4,77,12,0,201,0,0
98019343,JeninCanada,10,17521,679,328,44,246,40.1380975652,40-49,770,8,20,18,38,38,20,18,6,2.7556118755,479.4576807332,0.0371153749,0.1266002845,0.35978836,0,59,1.2002293279105789E-4,1.422716E-4,1.4399737E-4,77,4,0,199,0,0
99626313,danielsvnchez,10,2579,141,139,0,150,41.7971687705,40-49,649,5,1,1,2,2,1,1,6,3.4375,0,9.370277259923005E-5,0,0,31,107,1.512131191740977E-4,1.3549677E-5,1.3714035E-5,108,6,0,201,0,0
99879869,KelseyCMS,10,2797,116,190,4,12,36.7498561089,30-39,647,6,0,2,2,2,0,2,7,3.0437929786,0,0,0.5,0.5,0,607,4.766339181938244E-5,0,6.8570175E-6,25,0,0,199,0,0
100033160,NewWestBC,10,22079,5020,5517,126,0,44.2758857475,40-49,681,9,36,40,76,76,36,40,7,2.774076756,4956.1956915956,0.0423731719,0.0680701754,0.14495192,0,59,2.40439950810893E-4,2.5066902E-4,2.4685264E-4,182,3,0,201,0,0
100300239,JonWiseman,10,23564,430,327,2,307,56.8678703194,50-59,763,8,5,9,14,14,5,9,7,2.9236060825,789.4231369754,0.0087570231,0.1373626374,0.34545454,0,59,8.237194650995779E-5,4.064903E-5,4.1142106E-5,175,26,0,201,0,0
100531055,knoxkp,10,15742,2125,2033,111,20,57.8886987338,50-59,765,7,59,82,141,141,59,82,6,2.3399710355,3418.8272595674,0.071769274,0.0647416413,0.2904475,0,59,2.441636838289222E-4,4.064903E-4,4.1142106E-4,77,62,0,201,0,0
100689906,Chan_ing,10,12740,189,141,8,1,44.813418309,40-49,739,8,6,10,16,16,6,10,7,3.0648081101,32.8729806247,0.008346392,0.175,0.43589744,0,59,9.447227241068669E-5,4.742387E-5,4.799912E-5,175,5,0,201,0,0
101657044,KeepCanadaWild,10,3385,1436,541,69,306,50.6761082308,50-59,713,7,51,15,66,66,51,15,7,2.9047791455,3766.8657169262,0.0389009197,0.0920745921,0.16189364,0,59,2.82309618244797E-4,3.522916E-4,3.497079E-4,77,16,0,200,0,0
102570249,michaeltbutler,10,11209,513,1776,14,169,48.039535538,40-49,681,8,29,128,157,157,29,128,6,2.255249819,5519.8714369559,0.0381906063,0.1189776253,0.24146076,0,59,1.6721029748264062E-4,2.0324514E-4,2.0571053E-4,175,11,0,199,0,0
103216409,goddessofdork,10,14271,1094,2006,10,272,45.643123501,40-49,687,8,6,35,41,41,6,35,7,2.6944243302,452.7056470509,0.0028557115,0.1396341463,0.23968254,0,59,7.307548790922839E-5,4.742387E-5,4.799912E-5,182,0,0,201,0,0
103594620,uswjamie,10,607,119,170,2,25,24.688176552,20-29,493,4,23,27,50,50,23,27,6,2.669442433,121.1399821144,0.0375662047,0.0995918367,0.41612902,0,59,1.460564453607406E-4,1.6259612E-4,1.6456842E-4,182,1,1,200,1,0.005
103735808,curtismarta,10,759,108,529,0,35,25.7523898908,20-29,523,4,2,17,19,19,2,17,6,2.6517016655,11.2438731447,0.0026562848,0.3011695906,0.50653595,0,59,5.4632118348681266E-5,2.0324514E-5,2.0571053E-5,25,3,1,199,1,0.0050251256
104300984,AndrewNg_,10,5149,334,350,12,23,46.4277927871,40-49,685,6,11,10,21,21,11,10,7,3.0043446778,91.9393343598,0.0155162225,0.1214285714,0.28308824,0,59,1.3126129654203374E-4,8.129806E-5,8.228421E-5,175,21,0,200,0,0
104372498,montreal110,10,19900,955,981,22,704,57.056756927,50-59,771,8,16,23,39,39,16,23,7,2.7038377987,1213.4119083098,0.0214860693,0.0931174089,0.43083003,0,59,1.4002715190901996E-4,1.1517225E-4,1.16569296E-4,145,29,0,201,0,0
104612784,AQOCI,10,366,662,241,39,1,48.6636479186,40-49,595,4,11,13,24,24,11,13,7,2.8801593049,956.185378808,0.0101476258,0.0452898551,0.14338236,0,59,1.3335964154285426E-4,8.129806E-5,8.228421E-5,145,20,0,200,0,0
104626843,RamFire55,10,30435,635,1999,22,4075,42.3383780076,40-49,770,9,1,15,16,16,1,15,7,3.292903693,24.7145331925,8.512794957170976E-5,0.1666666667,0.24761905,0,59,5.42481403625946E-5,1.3549677E-5,1.3714035E-5,25,28,0,201,0,0
104644390,codyincalgary,10,11812,6149,4841,97,1618,72.4287142569,70-79,786,8,153,166,319,319,153,166,6,2.2907313541,52725.8964918179,0.1017946747,0.0244474675,0.1229671,0,59,7.958821825692646E-4,0.001043325,0.0010559807,175,257,0,200,0,0
104757726,CoryBrigham,10,550,76,51,3,2,24.1596506254,20-29,456,4,0,0,0,0,0,0,0,0,0,0,0,0,164,362,4.766339181938244E-5,0,0,162,0,1,199,1,0.0050251256
105208870,phpndp,10,2774,440,426,12,1,48.1632634886,40-49,661,6,114,76,190,190,114,76,6,2.5036205648,1668.9767675005,0.1298700924,0.1453912559,0.2904677,0,59,4.4575049009328325E-4,7.791064E-4,7.88557E-4,25,158,4,218,4,0.0183486239
105329140,ataratree,10,1299,354,1354,5,52,40.9956652258,40-49,506,5,3,23,26,26,3,23,7,2.7034757422,197.8382964245,0.0082308478,0.1307692308,0.23517786,0,59,6.630848079704268E-5,2.7099353E-5,2.742807E-5,182,2,0,199,0,0
105391738,ppilarski,10,12997,1454,1134,38,5,50.0609394808,50-59,779,8,60,54,114,114,60,54,6,2.4746560463,2742.7114058327,0.0441945499,0.0816643378,0.23258889,0,59,3.479371036140966E-4,4.1326514E-4,4.1827807E-4,175,70,1,200,1,0.005
105597356,kristydziuba,10,343,26,111,0,373,41.8064479062,40-49,482,5,2,6,8,8,2,6,7,3.0213613324,0.6429438243,0.0014820786,0.2321428571,0.53333336,0,59,5.19494790887159E-5,2.0324514E-5,2.0571053E-5,25,0,0,201,0,0
105601666,garnitafaisal,10,1058,181,91,0,32,42.5950336319,40-49,618,5,0,0,0,0,0,0,0,0,0,0,0,0,106,240,4.766339181938244E-5,0,0,97,29,0,200,0,0
106157525,HarbaouiMehdi,10,3216,11755,247,1,17,45.9364561109,40-49,699,6,0,0,0,0,0,0,0,0,0,0,0,0,63,152,4.766339181938244E-5,0,0,56,3,0,200,0,0
106271958,ThomasRoskos,10,1283,42,123,0,31,21.0911324216,20-29,517,5,0,0,0,0,0,0,0,0,0,0,0,0,178,381,4.766339181938244E-5,0,0,178,0,0,200,0,0
106285121,Belgraves,10,16430,546,547,17,559,53.7103242453,50-59,763,8,90,91,181,181,90,91,6,2.4011585807,1526.5672931173,0.0994056474,0.0876918355,0.3,0,59,2.791702420469976E-4,6.165103E-4,6.2398857E-4,77,112,0,201,0,0
106524304,AncientForestBC,10,447,850,182,56,1,47.1096650137,40-49,622,3,22,9,31,31,22,9,7,2.8037653874,219.8604014418,0.0104166652,0.1301075269,0.22364673,0,59,1.8964817371049957E-4,1.5582128E-4,1.577114E-4,182,8,0,200,0,0
107120252,LinCee3,10,1711,136,211,1,14,40.5623498858,40-49,596,6,2,4,6,6,2,4,7,2.9268645909,2955.3643320914,7.399321322563143E-4,0.2333333333,0.4,0,59,6.237014113099844E-5,2.0324514E-5,2.0571053E-5,25,17,0,198,0,0
107312325,Myhasle,10,18319,652,856,19,2075,40.1406351451,40-49,747,8,90,148,238,238,90,148,6,2.2139753802,4916.1326269625,0.1069144629,0.0629897529,0.2250172,0,59,2.7670563071895984E-4,6.165103E-4,6.2398857E-4,77,63,1,200,1,0.005
107374967,A_Costantino,10,5344,536,533,2,10,46.8871414273,40-49,726,6,0,1,1,1,0,1,7,4.3571428571,0,0,0,0,42,430,4.766339181938244E-5,0,6.8570175E-6,197,7,0,200,0,0
107568917,AussiePetCanada,10,9672,1199,1571,25,7,57.4722698721,50-59,728,7,0,19,19,19,0,19,7,2.8707926167,0,0,0.1286549708,0.1871345,0,595,4.766339181938244E-5,0,6.8570175E-6,182,4,0,200,0,0
107759109,BariLeia,10,4413,194,193,3,1263,46.0110673426,40-49,687,6,20,26,46,46,20,26,6,2.5275162925,6343.1695596103,0.0310466924,0.1115942029,0.22972973,0,59,1.8662714770692826E-4,1.422716E-4,1.4399737E-4,175,12,0,201,0,0
107794362,RunnertheFirst,10,19386,828,467,23,2,48.1379640052,40-49,755,8,56,87,143,143,56,87,6,2.4522085445,6327.187922564,0.0939701757,0.0817492367,0.29908836,0,59,4.231688597484884E-4,3.8616578E-4,3.9085E-4,175,103,0,202,0,0
107911173,HowRandomCanUBe,10,8901,194,309,0,196,39.1788152119,30-39,687,7,1,1,2,2,1,1,2,1.5,0,8.271798374069241E-5,0,0,67,157,2.4481546444683235E-4,1.3549677E-5,1.3714035E-5,59,1,0,200,0,0
108103088,mike_incalgary,10,3229,686,1455,10,17,37.5759947568,30-39,658,6,19,51,70,70,19,51,7,2.41564084,685.5576207524,0.0267383391,0.114699793,0.31561086,0,59,1.271045271599596E-4,1.3549677E-4,1.3714035E-4,175,2,1,200,1,0.005
108422084,Laura_ex0,10,26003,197,501,0,3281,37.6428027437,30-39,682,8,5,13,18,18,5,13,7,2.7244750181,97.0520169569,0.0149046817,0.1339869281,0.36263737,0,59,6.755361286442575E-5,4.064903E-5,4.1142106E-5,182,3,0,200,0,0
109065918,QMInews,10,11264,2360,387,105,3,57.775777474,50-59,770,7,51,16,67,67,51,16,7,2.9112961622,2785.2249218879,0.0612364765,0.0956580733,0.157218,0,59,4.985922810267231E-4,3.522916E-4,3.565649E-4,175,17,0,200,0,0
109135911,PeterSharp4MLA,10,589,132,286,7,11,44.5213641104,40-49,585,4,22,34,56,56,22,34,7,2.707096307,704.0930155061,0.0089944703,0.0980519481,0.3579365,0,59,1.368838516806166E-4,1.5582128E-4,1.577114E-4,182,50,0,200,0,0
109305145,bayuttu,10,148,23,131,0,152,23.9896875148,20-29,371,4,0,1,1,1,0,1,7,4.3571428571,0,0,0,0,42,513,4.766339181938244E-5,0,6.8570175E-6,197,0,0,200,0,0
109315305,Penalosa_G,10,1439,2546,100,114,4,57.9416335255,50-59,746,5,26,2,28,28,26,2,7,3.3551774077,101.7765516,0.0133473198,0.0515873016,0.06837607,0,59,1.815876333753093E-4,1.8292063E-4,1.7142543E-4,175,25,0,199,0,0
109606685,LucianoRagazzi,10,330,140,200,1,4,30.9680796314,30-39,405,4,0,1,1,1,0,1,7,4.3571428571,0,0,0,0,42,462,4.766339181938244E-5,0,6.8570175E-6,197,0,0,198,0,0
110099532,hsmelday,10,96,173,1132,0,34,21.7876623334,20-29,330,4,24,156,180,180,24,156,6,2.2548877625,1037.4083077838,0.0325359108,0.1677529485,0.31206107,0,59,1.239737039235226E-4,1.6937095E-4,1.7142543E-4,25,2,0,104,0,0
110263832,Antagoniste_net,10,30755,3462,764,98,340,54.4476601846,50-59,873,8,19,14,33,33,19,14,7,3.1343229544,246.8236945179,0.0133048889,0.0757575758,0.23320158,0,59,1.589985136048694E-4,1.3549677E-4,1.3714035E-4,175,63,0,202,0,0
111013062,mandahuggankiss,10,34,20,70,0,0,16.5030795238,10-19,80,2,0,0,0,0,0,0,0,0,0,0,0,0,225,560,4.766339181938244E-5,0,0,228,1,0,35,0,0
111056608,cinDYkztillo,10,41253,1333,1168,7,240,41.3663491657,40-49,788,9,0,0,0,0,0,0,0,0,0,0,0,0,117,262,4.766339181938244E-5,0,0,110,20,0,201,0,0
111127530,JakeAReid,10,11703,1192,1134,36,9,57.4073868645,50-59,757,7,56,89,145,145,56,89,6,2.3247646633,4719.9273140697,0.0800280012,0.0794061303,0.2693169,0,59,3.566503648167231E-4,3.8616578E-4,3.9085E-4,147,52,0,200,0,0
111385022,DJasarevic,10,451,16,24,0,0,12.7421097528,10-19,351,3,0,0,0,0,0,0,0,0,0,0,0,0,194,495,4.766339181938244E-5,0,0,198,0,0,198,0,0
111389524,Beezersun,10,7030,2613,820,91,6,60.2387555595,60-69,760,6,11,4,15,15,11,4,7,3.3312816799,533.3880006989,0.0055963816,0.0238095238,0.06363636,0,59,3.857321955627781E-4,8.129806E-5,8.228421E-5,175,10,0,201,0,0
111715724,lawrencecanuck,10,8424,127,1077,0,4,25.2693703672,20-29,526,7,5,33,38,38,5,33,7,2.6241853729,113.7277996958,0.0103997697,0.2019914651,0.3436975,0,59,6.639421492076006E-5,4.064903E-5,4.1142106E-5,175,3,0,203,0,0
111986967,TreanaCampbell,10,391,35,87,1,4,29.1885438637,20-29,435,4,5,15,20,20,5,15,7,2.7215785663,46.4038364304,0.003150362,0.1526315789,0.3809524,0,59,7.052860754340886E-5,4.064903E-5,4.1142106E-5,182,2,0,200,0,0
112440440,DanielSilke,10,2241,1481,443,34,9,53.3502538114,50-59,695,4,2,2,4,4,2,2,11,6.7389572773,1,1.690091954166046E-4,0.1666666667,0.33333334,0,59,1.3398216399917022E-4,2.0324514E-5,2.0571053E-5,131,0,0,200,0,0
112467648,KEDeveaux,10,410,117,80,2,1,31.9659339347,30-39,522,4,8,6,14,14,8,6,7,2.7563359884,43.9890290513,0.0270032709,0.1758241758,0.47777778,0,59,1.7759948277974697E-4,6.0973543E-5,6.171316E-5,147,1,0,200,0,0
112517348,cdn2010,10,3467,81,161,3,217,42.991339582,40-49,628,5,10,16,26,26,10,16,7,2.7150615496,1147.7199750336,0.0113147355,0.0676923077,0.2757353,0,59,7.993542684063007E-5,7.452322E-5,7.542719E-5,175,22,0,198,0,0
112613293,Tamaraweb,10,1077,137,198,3,22,34.178930807,30-39,494,5,16,25,41,41,16,25,6,2.6241853729,115.9912039106,0.0177873338,0.1530487805,0.4716749,0,59,9.549630176145718E-5,1.1517225E-4,1.0971228E-4,182,7,0,200,0,0
112634116,BrandontheFick,10,4548,145,198,2,67,38.8747574982,30-39,634,7,6,8,14,14,6,8,7,3.0336712527,13.7573086568,0.0055853302,0.2527472527,0.44871795,0,59,7.364537959386271E-5,4.742387E-5,4.799912E-5,175,2,2,200,2,0.01
112944623,albertarabbit,10,6800,344,388,11,9,46.8720698847,40-49,785,9,90,85,175,175,90,85,6,2.3649529327,2077.841146584,0.1077844432,0.0942528736,0.29889807,0,59,3.1565731859426355E-4,6.165103E-4,6.2398857E-4,77,290,0,202,0,0
113145326,Liepollo99,10,688,382,86,0,59,42.0342039875,40-49,616,5,2,1,3,3,2,1,1,1,1.6666666667,1.7837983517383303E-4,0,0,0,42,1.1506646415610332E-4,2.0324514E-5,1.3714035E-5,131,0,0,199,0,0
113326816,Murphyoo,10,1039,414,1971,1,137,29.3796336589,20-29,511,5,1,21,22,22,1,21,7,2.9717595945,17.6080951965,3.073833002155888E-4,0.1385281385,0.2,0,59,5.2130951925054486E-5,1.3549677E-5,1.3714035E-5,147,0,0,197,0,0
113522488,geera186,10,1538,190,286,0,47,34.1302925549,30-39,623,5,0,0,0,0,0,0,0,0,0,0,0,0,66,156,4.766339181938244E-5,0,0,58,10,0,200,0,0
113953933,jordangrondin,10,422,123,761,0,8,40.7073867058,40-49,558,5,11,67,78,78,11,67,7,2.3399710355,214.6474003578,0.0152078892,0.1721611722,0.34056988,0,59,7.486086994520558E-5,8.129806E-5,8.228421E-5,175,30,7,205,6,0.0292682927
114199041,FabioCostante,10,1427,434,361,15,0,46.8722547582,40-49,618,5,11,22,33,33,11,22,6,2.6375814627,2744.994694292,0.0241675643,0.1960227273,0.3583744,0,59,9.82248778766653E-5,8.129806E-5,8.228421E-5,175,8,0,200,0,0
114259006,maugarciac,10,3463,247,348,1,322,42.2047718523,40-49,688,6,1,1,2,2,1,1,2,1.5,0,8.271798374069241E-5,0,0,129,289,2.4481546444683235E-4,1.3549677E-5,1.3714035E-5,121,12,0,200,0,0
114595836,LuckyJaxson,10,163,57,95,1,2,21.0202724751,20-29,307,3,13,17,30,30,13,17,7,2.8660391021,25.0800675866,0.0116578502,0.2563218391,0.51384616,0,59,9.443145563030683E-5,9.484774E-5,9.599824E-5,147,2,1,164,1,0.006097561
115136553,NickTFacey,10,2369,423,585,18,12,47.5161185098,40-49,684,6,25,30,55,55,25,30,6,2.6350470673,4062.2919937033,0.0272282672,0.0835016835,0.29920635,0,59,2.4994662595763216E-4,1.761458E-4,1.7828245E-4,182,41,0,200,0,0
115145169,suclapham,10,1470,241,1357,0,14,25.7029845229,20-29,448,5,34,211,245,245,34,211,6,2.2038377987,3679.1780990635,0.0655046636,0.1542656407,0.27951822,0,59,1.662947842793084E-4,2.3711934E-4,2.3999561E-4,25,6,1,200,1,0.005
115145326,JMW9400,10,6248,134,82,0,1578,40.4332768411,40-49,635,7,1,2,3,3,1,2,8,3.8711078928,0.3943321727,2.1024667019605328E-4,0,0,0,59,5.4806984028620324E-5,1.3549677E-5,1.3714035E-5,182,1,0,200,0,0
115813342,e_flanagan,10,837,367,745,10,14,28.8523145252,20-29,579,5,12,45,57,57,12,45,6,2.4145546705,2266.4029941305,0.0375949973,0.1864035088,0.3922294,0,59,1.0165885368854652E-4,8.80729E-5,8.914123E-5,25,0,2,197,2,0.0101522843
116476946,JamesatLFPress,10,6340,1532,241,76,19,49.3800088743,40-49,706,7,14,2,16,16,14,2,7,3.4170890659,48.8328257317,0.0127852666,0.1875,0.36813188,0,59,1.423663286312385E-4,1.0162257E-4,1.02855265E-4,175,8,1,200,1,0.005
116503910,glebetrotter,10,2570,249,286,14,4,53.3760516272,50-59,646,6,24,30,54,54,24,30,6,2.5448950036,666.3751328938,0.0396336976,0.0964360587,0.2837838,0,59,1.3758247995326262E-4,1.6937095E-4,1.7142543E-4,25,10,0,200,0,0
116510993,NancyC252,10,344,70,145,2,1,42.7182142111,40-49,557,4,32,35,67,67,32,35,6,2.7581462708,191.4994375788,0.022461257,0.1114880145,0.5301282,0,59,1.842740578468536E-4,2.2356966E-4,2.2628158E-4,147,68,0,200,0,0
116525163,fusionsarnia,10,186,248,569,3,2,23.887173606,20-29,517,4,3,5,8,8,3,5,7,3.1962346126,0.6418131736,0.0018586747,0.1428571429,0.6,0,59,5.763711510654633E-5,2.7099353E-5,2.742807E-5,182,37,0,186,0,0
117247943,jafroese,10,58,9,25,0,2,16.7576971628,10-19,100,2,0,0,0,0,0,0,0,0,0,0,0,0,94,219,4.766339181938244E-5,0,0,85,5,0,61,0,0
117453967,Heather4Regina,10,2343,469,387,19,23,46.3388406728,40-49,693,6,43,49,92,92,43,49,6,2.5300506879,722.6384120931,0.0512437187,0.1218346871,0.4172131,0,59,2.27533092399461E-4,2.9809287E-4,3.0170876E-4,25,44,7,199,7,0.0351758794
117482770,johnluton,10,1140,161,113,4,3,40.8193096627,40-49,543,4,10,10,20,20,10,10,7,3.0944967415,27.5438647548,0.0069809518,0.2342105263,0.33333334,0,59,8.065131459514466E-5,7.452322E-5,7.542719E-5,182,5,2,200,2,0.01
117810351,WSWS_Updates,10,9008,3432,12,251,0,55.824112577,50-59,764,3,23,0,23,23,23,0,0,0,0,0.0102274499,0.0197628458,0.02964427,0,12,2.818573903822988E-4,1.6259612E-4,0,77,20,0,202,0,0
118090161,automandan,10,413,38,96,0,18,13.5457577316,10-19,467,3,0,6,6,6,0,6,7,3.0123054651,0,0,0.2333333333,0.23333333,0,676,4.766339181938244E-5,0,6.8570175E-6,182,2,0,200,0,0
118484087,Maxim_Brock_U,10,717,109,189,7,1,30.1963611331,30-39,437,4,0,3,3,3,0,3,7,2.9674267101,0,0,0.5,0.8333333,0,620,4.766339181938244E-5,0,6.8570175E-6,175,3,0,200,0,0
118541476,KPrakan,10,1988,105,262,1,98,47.7428819449,40-49,646,6,0,1,1,1,0,1,7,3.4314151285,0,0,0,0,0,305,4.766339181938244E-5,0,6.8570175E-6,25,12,0,201,0,0
118583379,conleymb,10,1223,571,1481,24,50,54.8631011331,50-59,608,5,35,73,108,108,35,73,6,2.4409847936,920.2739655485,0.0643022276,0.1497057805,0.35857716,0,59,2.459581249192445E-4,2.4389417E-4,2.4685264E-4,175,6,1,200,1,0.005
119149614,curiousceramics,10,2952,154,372,8,3,50.4943252142,50-59,598,6,38,86,124,124,38,86,6,2.4319333816,984.8565018611,0.0806909619,0.1561762392,0.3997941,0,59,2.4366396853390634E-4,2.642187E-4,2.674237E-4,25,9,1,199,1,0.0050251256
119453781,ESG_Solutions,10,193,255,173,7,0,31.6198571896,30-39,454,2,2,1,3,3,2,1,7,3.3939174511,0,8.778161481489067E-4,0.1666666667,1,0,59,6.257457047376092E-5,2.0324514E-5,2.0571053E-5,77,7,0,197,0,0
119552413,MinaGirgis_,10,5242,193,212,1,2589,41.0521334803,40-49,685,6,1,1,2,2,1,1,3,2,0,8.273692819691865E-5,0,0,49,134,2.229792226986586E-4,1.3549677E-5,1.3714035E-5,181,5,0,200,0,0
119563210,ChairmanDenis,10,683,112,189,3,0,28.4895632888,20-29,548,4,1,2,3,3,1,2,7,3.3696596669,0,5.657872909358423E-4,0.1666666667,0.5,0,59,5.2223113463920244E-5,1.3549677E-5,1.3714035E-5,25,1,1,200,1,0.005
119711865,dexterchaos,10,2492,183,440,2,787,47.4612988274,40-49,651,6,40,107,147,147,40,107,6,2.3316437364,1030.6107163742,0.0427496615,0.1091696953,0.28894082,0,59,1.4265540570426385E-4,2.7776835E-4,2.811377E-4,77,24,1,202,1,0.004950495
119911112,james_ogrady,10,3106,322,731,8,183,41.6790088236,40-49,611,6,13,43,56,56,13,43,6,2.4703113686,1047.4649840597,0.0206700938,0.1642857143,0.37979797,0,59,1.0871836618073989E-4,9.484774E-5,9.599824E-5,175,11,0,200,0,0
120217372,esmecomfort,10,17689,837,659,46,40,48.2718209783,40-49,747,8,21,24,45,45,21,24,6,2.6650977552,409.1090839778,0.0245287654,0.0974747475,0.27935606,0,59,1.458888217114084E-4,1.4904643E-4,1.5085438E-4,175,9,0,200,0,0
120965356,marsofearth,10,2228,117,179,6,13,21.2757835456,20-29,551,6,1,3,4,4,1,3,7,2.8182476466,0,0.0072676982,0.25,0.8333333,0,59,5.409653606626543E-5,1.3549677E-5,1.3714035E-5,25,0,0,200,0,0
121486117,GamingCounsel,10,11628,3719,295,232,17,53.5034950465,50-59,748,8,0,0,0,0,0,0,0,0,0,0,0,0,40,120,4.766339181938244E-5,0,0,37,3,0,200,0,0
121492132,free2choose80,10,543,78,372,1,0,16.5504634468,10-19,582,5,0,7,7,7,0,7,7,3.1574375679,0,0,0.2619047619,0.2857143,0,279,4.766339181938244E-5,0,6.8570175E-6,175,5,0,200,0,0
121644639,GSawision,10,33139,840,2001,45,51,54.1257522882,50-59,777,9,52,119,171,171,52,119,6,2.3392469225,7921.1476406396,0.0821526757,0.1118679051,0.2425685,0,59,2.3119650001525706E-4,3.590664E-4,3.6342192E-4,175,58,0,201,0,0
121785205,RonnieNDP,10,1967,150,374,4,463,44.0573048505,40-49,600,6,45,90,135,135,45,90,7,2.4377262853,1527.5909860376,0.0629109383,0.1383084577,0.28478712,0,59,1.809585003901791E-4,3.1164257E-4,3.154228E-4,25,26,1,200,1,0.005
121853848,KikkiPlanet,10,88490,9211,8167,301,8618,63.9543795024,60-69,925,10,134,177,311,311,134,177,6,2.2682838523,45964.2319134624,0.087523153,0.0318016803,0.105879396,0,59,6.542788740688233E-4,9.146032E-4,9.1884035E-4,175,409,0,203,0,0
122053347,JustplainCarrie,10,26639,762,848,28,10,50.3182707675,50-59,778,9,96,129,225,225,96,129,6,2.2802317161,4810.6028190032,0.1222614753,0.0826190476,0.25337407,0,59,3.3936427548705286E-4,6.571593E-4,6.651307E-4,77,34,0,199,0,0
122155951,DisDrivenLife,10,1543,4192,891,190,2,48.9807351908,40-49,738,6,1,1,2,2,1,1,1,1,0,8.095914281419891E-5,0,0,125,276,3.177448371356425E-4,1.3549677E-5,1.3714035E-5,128,45,0,200,0,0
122865295,reg_martin,10,50,35,107,0,27,19.8172052202,10-19,173,2,0,5,5,5,0,5,7,2.9960188201,0,0,0.35,0.4,0,383,4.766339181938244E-5,0,6.8570175E-6,25,4,0,60,0,0
122912745,mrhetjha,10,4273,75,257,0,4,43.183215344,40-49,644,7,0,3,3,3,0,3,10,5.7466521896,0,0,0.5,1,0,233,4.766339181938244E-5,0,6.8570175E-6,131,0,0,203,0,0
123035624,WaffleWolfer,10,1446,22,23,2,31,24.7533441756,20-29,584,5,0,0,0,0,0,0,0,0,0,0,0,0,95,220,4.766339181938244E-5,0,0,86,0,0,199,0,0
123104917,nicole_paul,10,660,371,682,9,13,60.2989865343,60-69,655,5,29,40,69,69,29,40,6,2.4996379435,3116.7045673547,0.0290973055,0.1114663257,0.35753933,0,59,1.9298601907542486E-4,2.0324514E-4,2.0571053E-4,182,14,1,200,1,0.005
123119092,LabradorPike,10,3413,743,911,14,12,43.4144581485,40-49,704,6,24,41,65,65,24,41,6,2.5807385952,2488.3578086051,0.0190858142,0.1637019231,0.3,0,59,2.006306684414262E-4,1.6937095E-4,1.6456842E-4,147,12,0,200,0,0
123151726,EsmirMilavic,10,33722,1205,1627,50,395,59.7453049586,50-59,769,9,42,77,119,119,42,77,6,2.4670528602,1621.9704836056,0.0554078705,0.1041874377,0.2616729,0,59,2.7970031583714774E-4,2.9131805E-4,2.9485175E-4,182,33,0,200,0,0
123279913,WrightRyan,10,13696,275,147,16,28,54.4010103912,50-59,743,8,23,15,38,38,23,15,6,2.8345401883,27.1297326298,0.0263423099,0.1813655761,0.35987905,0,59,1.1605693636231526E-4,1.6259612E-4,1.6456842E-4,175,22,2,202,2,0.0099009901
124216813,LiciaCorbella,10,735,1827,176,92,5,50.3980252279,50-59,711,4,71,11,82,82,71,11,7,2.8262128892,478.4336849617,0.0532023594,0.1278229449,0.20762132,0,59,4.06208576728278E-4,4.8778835E-4,4.937053E-4,175,32,0,199,0,0
124236594,SNoutreach,10,125,176,50,12,0,34.8541698834,30-39,433,2,2,1,3,3,2,1,7,3.377986966,5.6619725707,0.0038458861,0,0,0,59,7.823571773760271E-5,2.0324514E-5,2.0571053E-5,77,1,0,135,0,0
124302756,VassyKapelos,10,19543,6635,3951,182,795,60.7044600613,60-69,799,8,148,149,297,297,148,149,6,2.3146270818,38895.1881235627,0.1264805479,0.0478091728,0.13871141,0,59,9.001449785248817E-4,0.0010094509,0.0010148386,175,113,2,200,2,0.01
124342294,Brightheart002,10,2944,50,97,1,200,34.7447631235,30-39,578,6,3,5,8,8,3,5,7,3.4098479363,2.6359187455,0.0011674397,0.1785714286,0.53333336,0,59,6.671435040763346E-5,2.7099353E-5,2.742807E-5,175,4,0,191,0,0
124502440,ABPremierComms,10,4667,5847,5856,158,6,61.4092143301,60-69,767,7,122,126,248,248,122,126,6,2.3913830558,33472.4987840446,0.0861614826,0.0259729659,0.139656,0,59,7.992777196607292E-4,8.333051E-4,8.434132E-4,175,139,4,200,4,0.02
125647874,GSantos0697,10,5599,118,126,0,851,42.0067300299,40-49,691,6,0,0,0,0,0,0,0,0,0,0,0,0,0,707,4.766339181938244E-5,0,0,281,7,0,201,0,0
125712591,LucaMelchionda,10,131,44,251,0,21,19.5709889235,10-19,337,3,0,2,2,2,0,2,5,2.9285714286,0,0,0,0,42,534,4.766339181938244E-5,0,6.8570175E-6,197,2,0,141,0,0
125848560,stevem20,10,7915,528,179,30,340,40.6551522358,40-49,732,7,2,2,4,4,2,2,6,2.8106444605,0,0.0088891818,0.0833333333,1,0,59,5.826027095134241E-5,2.0324514E-5,2.0571053E-5,77,2,0,200,0,0
126062120,melaniejching,10,7818,544,694,31,609,60.3113654716,60-69,669,7,23,49,72,72,23,49,6,2.4210716872,953.1398629743,0.046420828,0.125,0.3055195,0,59,1.485858039199001E-4,1.6259612E-4,1.6456842E-4,175,7,0,200,0,0
126191957,LMacB,10,1193,105,96,5,85,40.5318067444,40-49,608,5,3,4,7,7,3,4,7,3.1589427951,1.0662385228,0.0012994074,0.1666666667,0.4,0,59,5.821101035683384E-5,2.7099353E-5,2.742807E-5,182,4,0,200,0,0
126693754,MomsGB,10,7486,182,118,1,3276,43.602789687,40-49,741,7,2,2,4,4,2,2,1,1,0,1.6551228476954845E-4,0.0833333333,1,110,248,3.177448371356425E-4,2.0324514E-5,2.0571053E-5,101,42,0,201,0,0
126727928,JsP_lenore,10,4664,154,1997,0,434,43.5412500413,40-49,528,6,4,0,4,4,4,0,0,0,0,0.0106198904,0.4166666667,0.8333333,0,15,6.399496156156001E-5,3.3874192E-5,0,77,33,0,202,0,0
127310706,_Brennaluz,10,15452,665,362,2,8,34.0502264576,30-39,738,7,0,0,0,0,0,0,0,0,0,0,0,0,98,223,4.766339181938244E-5,0,0,89,0,0,198,0,0
127551326,packermanno,10,13,5,109,0,0,16.2021988767,10-19,25,1,0,1,1,1,0,1,8,3.6178067318,0,0,0,0,0,62,4.766339181938244E-5,0,6.8570175E-6,182,0,0,15,0,0
127901611,Rambojks,10,1741,64,160,0,16,31.933791127,30-39,626,6,1,1,2,2,1,1,7,3.0970311369,0,0.0018324255,0,0,0,59,4.9898166797253515E-5,1.3549677E-5,1.3714035E-5,77,6,0,199,0,0
128028442,dohRG,10,19422,946,1091,52,12,48.9336825511,40-49,759,8,12,25,37,37,12,25,7,2.5916002896,104.5151304566,0.0226333796,0.0840840841,0.27833334,0,59,1.0485193595333791E-4,8.80729E-5,8.914123E-5,77,1,0,201,0,0
130278992,JuanmaGalvan,10,7755,124,166,2,4235,24.991740648,20-29,550,7,1,1,2,2,1,1,2,1.5,0,8.271798374069241E-5,0,0,77,173,2.4481546444683235E-4,1.3549677E-5,1.3714035E-5,69,0,0,201,0,0
130341846,MichaelVStewart,10,3191,489,1999,5,6,28.3163095508,20-29,535,6,3,21,24,24,3,21,7,2.7729905865,13.8149007488,9.944038603021481E-4,0.2155797101,0.3809524,0,59,5.6859411935780956E-5,2.7099353E-5,2.742807E-5,175,1,0,200,0,0
131175096,billmilliken,10,10846,1009,1425,34,565,50.4124748804,50-59,720,8,27,41,68,68,27,41,7,2.6650977552,333.39488125,0.058303878,0.1545215101,0.40862745,0,59,2.5355076162923685E-4,1.8969548E-4,1.9199649E-4,175,19,1,201,1,0.0049751244
131324734,l_gowan,10,4830,456,1044,8,38,47.4028796837,40-49,681,7,13,28,41,41,13,28,7,2.6915278783,97.8854862619,0.0179653233,0.1762195122,0.472043,0,59,1.0657244377682239E-4,9.484774E-5,9.599824E-5,175,7,1,200,1,0.005
131527548,mike_toscano,10,543,74,288,0,1,25.53472138,20-29,483,4,4,10,14,14,4,10,7,2.7729905865,93.6511129204,0.0152138128,0.2142857143,0.58181816,0,59,7.616229118314244E-5,3.3874192E-5,3.4285087E-5,25,2,0,199,0,0
131647033,gotta_be_kd_03,10,839,132,440,0,122,30.9365387936,30-39,435,5,2,6,8,8,2,6,7,2.9359160029,3.1117161917,0.0046944823,0.0714285714,0.2,0,59,5.498142947186374E-5,2.0324514E-5,2.0571053E-5,77,4,0,199,0,0
131859786,Sandy1Canada,10,5523,201,500,5,515,47.5716448647,40-49,634,7,18,42,60,60,18,42,6,2.4322954381,462.9157791882,0.0207101575,0.0966101695,0.23837209,0,59,8.803913791715299E-5,1.2872192E-4,1.3028333E-4,77,5,1,202,1,0.004950495
131860405,wwwbikerider,10,14293,297,452,12,1422,44.1686719186,40-49,710,8,3,11,14,14,3,11,7,3.0619116582,16.5077757035,0.0011312147,0.1043956044,0.22727273,0,59,6.709393866321591E-5,2.7099353E-5,2.742807E-5,175,6,1,201,1,0.0049751244
131968998,nickfaye,10,11434,889,344,21,0,51.0641517744,50-59,763,7,7,2,9,9,7,2,7,3.2288196959,10.2973646765,0.0028551214,0.2361111111,0.51785713,0,59,6.911049620301658E-5,5.4198706E-5,5.485614E-5,25,24,1,200,1,0.005
131986093,bradrichert,10,5747,744,1184,38,58,55.110978716,50-59,696,7,15,43,58,58,15,43,7,2.585083273,1410.0459222453,0.0143042994,0.1025408348,0.2459596,0,59,9.76459414601711E-5,1.0839741E-4,1.0971228E-4,182,22,0,200,0,0
132021619,djsteverapson,10,335,113,346,3,14,36.182151148,30-39,534,4,5,15,20,20,5,15,7,2.670166546,3270.5676257915,0.0111772774,0.0763157895,0.20952381,0,59,6.279594073324892E-5,4.064903E-5,4.1142106E-5,175,14,1,201,1,0.0049751244
132298022,Notemash7,10,8016,212,443,1,51,47.6284299759,40-49,740,7,0,1,1,1,0,1,10,5.8863554108,0,0,0,0,0,394,4.766339181938244E-5,0,6.8570175E-6,131,38,0,200,0,0
132315750,nglrss,10,3089,111,190,0,4,58.2626532623,50-59,580,5,0,1,1,1,0,1,7,4.3571428571,0,0,0,0,42,489,4.766339181938244E-5,0,6.8570175E-6,197,0,0,200,0,0
132675721,valeriav_ayala,10,16909,825,1715,0,600,36.407097811,30-39,739,7,8,6,14,14,8,6,5,2.5,52,6.887664827670333E-4,0.0549450549,0.32142857,31,107,7.309451876586533E-4,6.0973543E-5,5.485614E-5,108,22,0,201,0,0
132950661,gmohamed111,10,8232,690,2002,14,1438,50.8553196886,50-59,663,7,6,39,45,45,6,39,6,2.5543084721,170.2071270739,0.0107572359,0.2161616162,0.31976745,0,59,1.0161368635217337E-4,4.742387E-5,4.799912E-5,175,9,0,201,0,0
133063614,AdvertiseCanada,10,9799,356,132,4,0,43.8987394782,40-49,612,7,4,7,11,11,4,7,7,3.0253439537,14.5253067407,0.0022895403,0.1090909091,0.13636364,0,59,5.440398314952323E-5,3.3874192E-5,3.4285087E-5,77,1,0,200,0,0
133106532,SylvanaRdz,10,10820,330,532,2,72,42.2330075707,40-49,702,7,0,0,0,0,0,0,0,0,0,0,0,0,68,158,4.766339181938244E-5,0,0,60,11,0,201,0,0
134511670,d_joue,10,29635,1220,870,25,118,56.7879380013,50-59,786,8,16,17,33,33,16,17,6,2.6929761043,1369.2536041922,0.0227436729,0.1098484848,0.3061594,0,59,2.810461270073972E-4,1.1517225E-4,1.16569296E-4,145,11,0,201,0,0
134881959,httpinfocoms,10,153,5,10,0,0,11.8833382982,10-19,55,2,0,0,0,0,0,0,0,0,0,0,0,0,121,268,4.766339181938244E-5,0,0,114,6,0,186,0,0
135260229,McIverWealth,10,1736,294,279,2,1,38.1660201418,30-39,545,4,2,2,4,4,2,2,8,4.2585083273,2951.8623666277,1.938952402119067E-4,0,0,0,59,8.514124698645533E-5,2.0324514E-5,2.0571053E-5,175,12,0,200,0,0
135269277,teritarose,10,7192,267,291,2,87,42.2033888767,40-49,677,7,2,4,6,6,2,4,7,3.1911658219,13.2881847111,1.6025863950973497E-4,0.1333333333,0.13333334,0,59,6.845803231391448E-5,2.0324514E-5,1.3714035E-5,25,5,0,200,0,0
135292251,RitchieTrev,10,2454,452,731,15,17,41.0860837465,40-49,640,6,54,95,149,149,54,95,6,2.425416365,3509.584471687,0.0721358324,0.1033919826,0.33212122,0,59,3.1580178055453425E-4,3.726161E-4,3.7713596E-4,182,13,0,200,0,0
136226033,nocsg,10,5968,586,668,21,53,50.6223237366,50-59,717,7,4,3,7,7,4,3,8,4.1267197683,11616.3750657057,0.0014391888,0,0,0,59,2.508878238756336E-4,3.3874192E-5,3.4285087E-5,77,9,0,200,0,0
136679359,Disasternat,10,2656,564,641,24,11,59.78093549,50-59,635,6,77,90,167,167,77,90,6,2.4916727009,6514.2209495624,0.1069650392,0.076148907,0.2867812,0,59,4.521934823745819E-4,5.284374E-4,5.348474E-4,147,67,0,199,0,0
136729875,DanielNow,10,2471,531,2001,11,101,61.0203884149,60-69,651,6,32,71,103,103,32,71,6,2.5065170167,761.8881900789,0.0398666229,0.1435370265,0.36688313,0,59,1.6470666229111199E-4,2.2356966E-4,2.2628158E-4,175,16,9,200,9,0.045
137008699,JWBurns11,10,33381,568,539,8,120,45.5132810735,40-49,779,8,1,1,2,2,1,1,1,1,0,8.095914281419891E-5,0,0,139,318,3.177448371356425E-4,1.3549677E-5,1.3714035E-5,135,31,0,200,0,0
137530133,MLDionne,10,18229,1309,1897,15,1011,54.3510327331,50-59,707,8,6,9,15,15,6,9,7,2.6397538016,897.5932383648,0.0092740309,0.0428571429,0.20833333,0,59,6.821957221743625E-5,4.742387E-5,4.799912E-5,77,1,0,201,0,0
137778787,matt_bowes,10,8022,590,999,19,36,56.2439894285,50-59,742,7,6,18,24,24,6,18,7,2.9094858798,110.3542543384,0.0028143191,0.0652173913,0.1503268,0,59,6.912609277787494E-5,4.742387E-5,4.799912E-5,175,6,0,200,0,0
138311326,jpmccullagh,10,2392,150,103,3,4,42.0494868535,40-49,669,6,28,22,50,50,28,22,6,2.7758870384,3772.2388356663,0.0393223466,0.1040816327,0.35561496,0,59,3.125035387219579E-4,1.9647031E-4,1.9885351E-4,175,25,1,200,1,0.005
138313609,Jagnets,10,1786,29,99,0,307,28.8281177514,20-29,498,6,3,10,13,13,3,10,7,2.9739319334,24.9975145103,0.0017268753,0.1987179487,0.46363637,0,59,5.855450185054661E-5,2.7099353E-5,2.742807E-5,182,2,0,200,0,0
138313976,FatherTheo,10,5800,1452,1742,26,5,41.4739455203,40-49,661,6,6,8,14,14,6,8,6,2.8349022448,27.9404069757,0.0110649941,0.0989010989,0.48214287,0,59,7.556793058032999E-5,4.742387E-5,4.799912E-5,77,3,0,200,0,0
138956534,NDPmc33,10,3518,292,558,2,164,43.4562103666,40-49,682,6,51,87,138,138,51,87,6,2.3562635771,3492.7048902288,0.0944802304,0.1862371734,0.36839056,0,59,2.6010920590038025E-4,3.522916E-4,3.497079E-4,25,22,11,200,11,0.055
139949751,arthurmrtinez,10,4547,154,228,0,70,39.8867990267,30-39,681,6,0,0,0,0,0,0,0,0,0,0,0,0,138,314,4.766339181938244E-5,0,0,134,3,0,200,0,0
140186605,Canada_1867,10,117,106,219,4,0,22.175018001,20-29,495,1,14,32,46,46,14,32,6,2.5919623461,322.0733830677,0.0200421062,0.1217391304,0.38004032,0,59,9.80383839748735E-5,1.0162257E-4,1.02855265E-4,175,0,2,117,2,0.0170940171
140252240,cathmckenna,10,3911,1307,628,36,12,52.9347673431,50-59,730,7,51,42,93,93,51,42,6,2.5789283128,1458.1933063517,0.0760454572,0.1167601683,0.27210486,0,59,4.911658765125602E-4,3.522916E-4,3.497079E-4,175,27,0,200,0,0
140497014,davedua,10,1345,29,95,0,2,17.4208141642,10-19,242,6,0,4,4,4,0,4,7,3.6445892146,0,0,0.4166666667,0.5,0,323,4.766339181938244E-5,0,6.8570175E-6,175,0,0,201,0,0
140559917,Queendavidg,10,7037,73,79,2,12,22.557814098,20-29,580,7,0,0,0,0,0,0,0,0,0,0,0,0,10,75,4.766339181938244E-5,0,0,9,0,0,2,0,0
140601401,davidmjbrown,10,1317,810,992,17,1,42.0533559679,40-49,609,5,7,6,13,13,7,6,6,2.8160753077,98.4484142512,0.0069551749,0.0512820513,0.2857143,0,59,7.479135248581457E-5,5.4198706E-5,5.485614E-5,175,1,0,200,0,0
140899011,ShorterNet,10,629,43,112,0,0,34.58851713,30-39,480,4,13,46,59,59,13,46,6,2.4134685011,193.3008611789,0.0240571213,0.15371128,0.405314,0,59,8.462840027656988E-5,9.484774E-5,9.599824E-5,77,7,6,200,6,0.03
140985152,EdithLK,10,1361,616,881,37,10,43.5642613374,40-49,659,5,67,77,144,144,67,77,6,2.4290369298,1516.9319337256,0.1044419126,0.132964258,0.28985506,0,59,3.8116745181248127E-4,4.60689E-4,4.6627718E-4,182,14,0,200,0,0
141246833,brendajeans,10,1757,171,270,5,34,38.8824744136,30-39,588,6,36,39,75,75,36,39,6,2.594858798,777.894750526,0.0438143964,0.1147747748,0.28506494,0,59,2.134032176624374E-4,2.5066902E-4,2.5370964E-4,182,24,0,200,0,0
141601658,FlyDownIndieLab,10,80,7,51,0,0,17.4164663491,10-19,78,1,0,0,0,0,0,0,0,0,0,0,0,0,57,142,4.766339181938244E-5,0,0,51,0,0,82,0,0
142075614,LuisP0lanco,10,20707,241,376,1,271,38.7232094747,30-39,770,8,0,0,0,0,0,0,0,0,0,0,0,0,54,139,4.766339181938244E-5,0,0,48,5,0,201,0,0
142408161,CelesteCote,10,7115,877,673,33,161,63.4004776639,60-69,719,7,66,70,136,136,66,70,6,2.4717595945,3702.1005082552,0.1074785216,0.0964052288,0.23975927,0,59,4.8650780581674125E-4,4.5391417E-4,4.5942017E-4,77,46,0,200,0,0
142414161,JasonHjal,10,288,188,419,3,1,23.7071851914,20-29,532,4,39,92,131,131,39,92,6,2.4293989862,986.060222139,0.0658976696,0.1320610687,0.32040405,0,59,2.717356797305165E-4,2.7099354E-4,2.742807E-4,25,2,1,200,1,0.005
142781050,GlutenFreeDoll,10,5452,505,587,12,251,48.9602972031,40-49,653,6,1,1,2,2,1,1,7,3.6654598117,0.3954869914,9.097881966006322E-5,0,0,0,59,5.2959920036862476E-5,1.3549677E-5,1.3714035E-5,175,2,0,200,0,0
142889852,ChantalCarey,10,334,658,2000,15,0,36.0286442139,30-39,553,4,43,161,204,204,43,161,6,2.3037653874,4463.2902577461,0.0693290845,0.1467449049,0.32762232,0,59,2.5633289971630174E-4,2.9809287E-4,2.9485175E-4,25,6,0,201,0,0
142923968,barbie_portillo,10,2092,204,245,0,85,40.2411047998,40-49,621,6,2,2,4,4,2,2,2,1.5,0,1.6918397403777635E-4,0.0833333333,1,50,135,2.0487890973081165E-4,2.0324514E-5,2.0571053E-5,188,79,0,199,0,0
143102350,Adamo83,10,966,50,422,0,201,37.8347560463,30-39,527,5,0,1,1,1,0,1,7,4.3571428571,0,0,0,0,42,451,4.766339181938244E-5,0,6.8570175E-6,197,0,0,199,0,0
144061938,tmaythai,10,7927,357,1376,2,73,43.4967487582,40-49,672,7,27,44,71,71,27,44,6,2.4493120927,508.1993237668,0.0404735059,0.0973843058,0.34975845,0,59,1.4306847072700847E-4,1.8969548E-4,1.9199649E-4,77,2,0,200,0,0
144983983,soozerjen,10,233,183,287,11,2,31.6128538411,30-39,484,4,4,6,10,10,4,6,7,3.1372194062,6.1370694061,0.0024936968,0.2555555556,0.45833334,0,59,6.882699816359499E-5,3.3874192E-5,3.4285087E-5,182,2,1,200,1,0.005
145821257,IanStumpf,10,3433,185,167,3,19,47.5438148339,40-49,688,6,13,9,22,22,13,9,7,3.112961622,596.3794663204,0.0122104737,0.0844155844,0.22794117,0,59,1.455940550036879E-4,9.484774E-5,9.599824E-5,175,10,0,200,0,0
145935577,jkoblovsky,10,6345,1313,1308,82,6,47.4702218896,40-49,714,7,30,39,69,69,30,39,6,2.4963794352,1121.7678064935,0.0386258277,0.0539215686,0.22884615,0,59,1.82036434321774E-4,2.1001999E-4,2.1256754E-4,77,7,1,200,1,0.005
146530868,ashedletzky,10,214,148,105,11,0,40.4545180985,40-49,495,3,17,15,32,32,17,15,7,2.820057929,159.2323716835,0.027026518,0.1189516129,0.3115942,0,59,1.6999309891585758E-4,1.2194709E-4,1.2342632E-4,175,7,1,200,1,0.005
146903498,lebza0108,10,22555,424,572,3,159,44.1464324159,40-49,769,8,0,1,1,1,0,1,10,5.8863554108,0,0,0,0,0,247,4.766339181938244E-5,0,6.8570175E-6,131,36,0,202,0,0
147406418,renatamtzh,10,9419,657,310,0,190,44.7586311406,40-49,739,7,0,0,0,0,0,0,0,0,0,0,0,0,240,617,4.766339181938244E-5,0,0,244,3,0,200,0,0
147774520,agthsmkt,10,6559,315,182,13,150,55.9122697792,50-59,743,7,35,0,35,35,35,0,0,0,0,0.0203148508,0.2067226891,0.37815127,0,7,2.0309959045792237E-4,2.4389417E-4,0,175,74,0,204,0,0
148821315,cstocovaz,10,312,11,38,0,0,41.2339975169,40-49,281,4,0,7,7,7,0,7,7,2.8943177705,0,0,0.5,0.8333333,0,214,4.766339181938244E-5,0,6.8570175E-6,175,0,0,200,0,0
148943350,ChelseaDuque,10,1575,147,164,0,1,40.5576899305,40-49,653,5,2,2,4,4,2,2,5,3.125,15.5,1.6908911076522195E-4,0,0,31,107,2.811523778832337E-4,2.0324514E-5,2.0571053E-5,108,9,0,201,0,0
149196780,mballism,10,1185,237,423,6,183,57.5330726311,50-59,558,5,24,30,54,54,24,30,6,2.6082548878,112.8127785486,0.0228620408,0.1264849755,0.50178254,0,59,1.2155738694595952E-4,1.6937095E-4,1.7142543E-4,182,17,0,201,0,0
149339613,J_Jankovic,10,1249,168,379,8,15,38.5048015511,30-39,591,5,1,3,4,4,1,3,7,3.4134685011,0.05,3.3206101455596817E-4,0.0833333333,0.16666667,0,59,5.057014355129365E-5,1.3549677E-5,1.3714035E-5,25,1,0,200,0,0
149969383,AnneSoo_Pixii,10,6078,217,138,2,99,41.761557643,40-49,638,7,0,0,0,0,0,0,0,0,0,0,0,0,141,320,4.766339181938244E-5,0,0,137,13,0,202,0,0
150289374,UFCW1000A,10,1313,635,831,19,6,46.6412443748,40-49,630,5,93,141,234,234,93,141,6,2.2708182476,4641.3267237987,0.1039335953,0.0762811342,0.25644994,0,59,3.276364213860739E-4,6.3683477E-4,6.445596E-4,182,52,0,199,0,0
151596369,karenriivaas,10,3855,156,172,0,224,38.184816085,30-39,618,6,0,0,0,0,0,0,0,0,0,0,0,0,128,284,4.766339181938244E-5,0,0,120,7,0,201,0,0
152441399,ShelbyChallis,10,649,64,101,0,47,32.8016298126,30-39,504,4,0,3,3,3,0,3,7,3.1281216069,0,0,0.5,0.6666667,0,312,4.766339181938244E-5,0,6.8570175E-6,25,2,0,199,0,0
152498426,TheLeftPopulist,10,4424,229,466,7,5,51.6224581176,50-59,708,6,40,89,129,129,40,89,6,2.3272990587,796.2147131245,0.049264114,0.0979893411,0.28963795,0,59,1.4827457411433948E-4,2.7776835E-4,2.811377E-4,77,7,2,205,2,0.0097560976
153058098,SophieTremblayM,10,5540,952,907,41,7,42.7749686855,40-49,722,7,35,41,76,76,35,41,7,2.5651701665,7884.1927195073,0.0422349892,0.0589473684,0.23140097,0,59,2.5775635492318464E-4,2.4389417E-4,2.4685264E-4,182,69,0,197,0,0
153153789,gopats14,10,66,44,139,0,0,20.0618751456,20-29,258,3,2,8,10,10,2,8,7,2.9449674149,10.7587783094,0.0019829633,0.2333333333,0.32222223,0,59,5.0480698268931626E-5,2.0324514E-5,2.0571053E-5,147,1,0,83,0,0
153545959,artgalkingston,10,706,367,277,17,3,32.5514250754,30-39,528,5,5,2,7,7,5,2,7,3.1926140478,17.7090083974,0.0033068251,0.1904761905,0.53333336,0,59,6.945946551130297E-5,4.064903E-5,4.1142106E-5,175,1,0,199,0,0
153900200,_DamaryG,10,1580,211,229,4,249,38.7376319771,30-39,619,5,0,0,0,0,0,0,0,0,0,0,0,0,184,395,4.766339181938244E-5,0,0,186,4,0,200,0,0
153972100,Catelli_NQU,10,22095,216,373,14,15,,,753,8,24,43,67,67,24,43,6,2.6082548878,248.6655069966,0.0284862546,0.0884215287,0.29646465,0,59,1.6643900189469593E-4,1.6937095E-4,1.7142543E-4,175,32,0,200,0,0
154136730,JDignum,10,11683,254,357,7,7267,43.9207482062,40-49,663,8,29,39,68,68,29,39,6,2.661115134,4964.5574642454,0.0353293129,0.115452151,0.33163264,0,59,1.5963293788669446E-4,2.0324514E-4,2.0571053E-4,77,16,1,202,1,0.004950495
154138577,Tony_Adey,10,3565,552,488,17,2,46.0138074559,40-49,722,6,44,57,101,101,44,57,6,2.5463432295,1268.4103788621,0.057848301,0.1106930693,0.30653363,0,59,2.3769289035605444E-4,3.0486772E-4,3.085658E-4,147,35,0,200,0,0
154579171,connectLOCAL,10,2837,625,636,22,0,40.8422444335,40-49,603,6,2,4,6,6,2,4,7,3.1469949312,197.6975079843,1.9926825736618723E-4,0.1,0.1,0,59,5.874442040373237E-5,2.0324514E-5,1.3714035E-5,175,0,0,200,0,0
154945079,M_artini_72,10,1953,364,1324,4,17,44.7343590064,40-49,607,6,24,75,99,99,24,75,6,2.3616944243,2803.2544171014,0.0272332778,0.0940012369,0.21807018,0,59,1.2872486501277884E-4,1.6937095E-4,1.7142543E-4,182,20,1,200,1,0.005
155631208,kylejhutton,10,4493,168,145,9,0,46.1225676785,40-49,664,6,32,30,62,62,32,30,6,2.5691527878,172.8907714837,0.0528617387,0.1337916446,0.37676767,0,59,1.7145958944174243E-4,2.2356966E-4,2.2628158E-4,175,77,0,201,0,0
155792555,patimbeau,10,1862,386,336,13,4,32.1709928628,30-39,626,5,58,60,118,118,58,60,7,2.565532223,352.7602583472,0.0940828317,0.1332029552,0.3958692,0,59,2.7347699078696016E-4,3.9971547E-4,4.0456402E-4,25,2,4,200,4,0.02
156040251,kelseymech,10,534,165,163,6,1,38.8546457848,30-39,566,4,15,15,30,30,15,15,6,2.734974656,3019.819651225,0.019040044,0.1517241379,0.37549406,0,59,2.2164940321511102E-4,1.0839741E-4,1.02855265E-4,77,7,0,200,0,0
156180693,vanvanesha,10,2110,254,194,1,4,42.2027120295,40-49,681,6,0,0,0,0,0,0,0,0,0,0,0,0,81,177,4.766339181938244E-5,0,0,72,63,0,199,0,0
156257348,TomShi_,10,3605,112,135,0,1,34.5463045893,30-39,665,6,0,0,0,0,0,0,0,0,0,0,0,0,270,701,4.766339181938244E-5,0,0,277,2,0,200,0,0
156503527,vickyhdz99,10,1254,253,739,0,9,39.1082392259,30-39,623,5,0,1,1,1,0,1,3,2,0,0,0,0,50,367,4.766339181938244E-5,0,6.8570175E-6,188,15,0,200,0,0
157096043,Slothra,10,11872,706,1311,32,124,60.1713590006,60-69,755,7,13,22,35,35,13,22,7,2.9236060825,254.9706823001,0.0131699679,0.118487395,0.34,0,59,1.4753625408857698E-4,9.484774E-5,9.599824E-5,182,11,0,200,0,0
157109830,ManangaSir,10,2739,165,130,0,26,45.601155694,40-49,614,6,0,1,1,1,0,1,10,5.8863554108,0,0,0,0,0,405,4.766339181938244E-5,0,6.8570175E-6,131,5,0,202,0,0
158007214,EyeCrazy,10,933,112,132,7,1,45.6420682283,40-49,605,4,13,14,27,27,13,14,7,2.7892831282,52.1873384177,0.0137494273,0.1267806268,0.33095238,0,59,1.0372564666000854E-4,9.484774E-5,9.599824E-5,175,16,0,200,0,0
158060763,pazzabella4,10,468,68,490,0,218,31.4971647811,30-39,477,5,3,10,13,13,3,10,6,2.783128168,22.4725763647,0.0043757259,0.0897435897,0.23333333,0,59,5.369317981744936E-5,2.7099353E-5,2.742807E-5,182,11,0,198,0,0
158209691,KarenCantu97,10,3582,322,273,0,33,38.4626621548,30-39,676,6,1,1,2,2,1,1,5,3.1111111111,0,8.629398748422644E-5,0,0,79,175,1.7241345328047235E-4,1.3549677E-5,1.3714035E-5,106,30,0,200,0,0
158474584,IntelligentMgmt,10,2103,308,242,18,5,33.6006361211,30-39,600,4,0,2,2,2,0,2,7,3.2891784292,0,0,0,0,0,544,4.766339181938244E-5,0,6.8570175E-6,175,6,0,200,0,0
158502985,GlobalRegina,10,8929,5481,856,134,3,47.2557195303,40-49,772,6,37,14,51,51,37,14,7,2.9402606807,883.7036673,0.0232925392,0.0839215686,0.20060976,0,59,2.5081015454382567E-4,2.5744384E-4,2.6056665E-4,25,34,0,201,0,0
158570147,finalproof,10,2053,480,621,9,13,58.8295624937,50-59,606,6,10,20,30,30,10,20,7,2.9529326575,227.9438254268,0.0066063159,0.1103448276,0.41842106,0,59,1.0753693474067138E-4,7.452322E-5,7.542719E-5,175,1,0,200,0,0
158852785,Mental_Radio,10,2133,316,202,13,2,46.5546882216,40-49,674,6,31,20,51,51,31,20,6,2.7628530051,657.2628079362,0.0419383558,0.0968627451,0.2927928,0,59,1.8303115394571092E-4,2.1679483E-4,2.1942456E-4,182,63,0,200,0,0
159090407,markspowart17,10,1310,309,701,12,7,45.1341763535,40-49,582,5,3,24,27,27,3,24,7,2.9225199131,27.2170074444,9.387895612076007E-4,0.1680911681,0.29710144,0,59,7.158036189305336E-5,2.7099353E-5,2.742807E-5,175,1,0,200,0,0
159282071,rezboi39,10,16019,434,1176,5,42,44.5939224101,40-49,685,8,14,53,67,67,14,53,6,2.4503982621,3716.0975651484,0.0175066277,0.1071913161,0.24201742,0,59,9.964833946133632E-5,1.0162257E-4,1.02855265E-4,175,17,4,207,4,0.0193236715
159409311,UtsavSanduja,10,4511,308,127,6,613,,,631,6,3,3,6,6,3,3,8,3.6089790007,11.437421101,3.508519172625066E-4,0.0666666667,0.33333334,0,59,6.899255471731019E-5,2.7099353E-5,2.742807E-5,175,0,0,200,0,0
159578935,KristofTO,10,8161,383,660,16,4,49.333199444,40-49,725,7,18,42,60,60,18,42,6,2.5423606083,505.9878621069,0.0223875277,0.093220339,0.19935246,0,59,1.1116310897266736E-4,1.2872192E-4,1.3028333E-4,175,15,0,201,0,0
159845237,wypbell,10,121,61,201,0,0,18.8203429392,10-19,401,3,5,22,27,27,5,22,6,2.6151339609,100.1529521384,0.0167497073,0.1923076923,0.43073592,0,59,7.547725868533808E-5,4.064903E-5,4.1142106E-5,25,0,0,119,0,0
160027610,LakeBass,10,366,268,55,7,12,50.2950043474,50-59,735,7,76,10,86,86,76,10,7,2.8816075308,90.8485508446,0.0733321301,0.1597811218,0.27160493,0,59,2.2300142723628377E-4,5.216625E-4,5.2799034E-4,77,55,7,201,7,0.0348258706
160033836,kevinzahara,10,1540,300,414,6,143,49.9370008999,40-49,625,6,13,16,29,29,13,16,7,2.8685734975,70.7375809633,0.0102372684,0.1342364532,0.45789474,0,59,1.1024318156155528E-4,9.484774E-5,9.599824E-5,175,7,1,200,1,0.005
160073664,rjmjanes,10,3903,401,564,21,4,55.8156679742,50-59,642,6,13,35,48,48,13,35,6,2.6466328747,293.7336637936,0.0215329219,0.1227836879,0.27098152,0,59,1.246988784036982E-4,9.484774E-5,9.599824E-5,77,7,0,197,0,0
160102712,IRISHGUNN,10,5653,188,762,2,9,31.4465516014,30-39,694,7,1,1,2,2,1,1,8,3.4981897176,0,5.726297154501598E-4,0,0,0,59,5.1953197916787175E-5,1.3549677E-5,1.3714035E-5,175,3,0,200,0,0
160356456,Barbeau_Eric,10,1215,395,436,5,3,45.9533823765,40-49,587,5,4,4,8,8,4,4,7,2.9797248371,42.1666158368,0.0045037141,0.0714285714,0.23333333,0,59,6.454793855092471E-5,3.3874192E-5,3.4285087E-5,145,4,0,200,0,0
160432735,Sonny_Resist,10,2887,153,137,11,8,38.1779453281,30-39,650,6,3,5,8,8,3,5,7,3.2910934106,8.7267100923,0.0018863787,0.1071428571,0.26666668,0,59,5.936634121627782E-5,2.7099353E-5,2.742807E-5,77,5,0,200,0,0
160969761,NoBSThirsty,10,5714,330,425,3,407,46.2668241579,40-49,724,7,11,18,29,29,11,18,7,3.0249818972,107.1781672569,0.0086945596,0.1293103448,0.4368421,0,59,8.315376488070379E-5,8.129806E-5,8.228421E-5,147,18,0,201,0,0
160971280,Paulina_Gza,10,1069,169,390,0,12,35.5683319315,30-39,522,4,2,2,4,4,2,2,1,1,2,1.619561731312207E-4,0,0,129,289,4.6360358251326255E-4,2.0324514E-5,2.0571053E-5,121,5,0,200,0,0
161073782,frankluba,10,4441,1452,1189,83,20,51.6812433465,50-59,704,6,37,37,74,74,37,37,7,2.6024619841,2368.6668511012,0.0506629416,0.1227323214,0.3074074,0,59,2.989064468341741E-4,2.5744384E-4,2.4685264E-4,182,32,0,200,0,0
161348163,Bradley1701,10,6014,485,756,11,14,41.6267780499,40-49,695,7,12,22,34,34,12,22,6,2.5314989138,445.6168652795,0.0158978102,0.0811051693,0.24891774,0,59,8.78526927072255E-5,8.80729E-5,8.914123E-5,175,3,6,200,3,0.015
161384254,ialuddington,10,1816,107,141,8,37,,,605,5,1,2,3,3,1,2,8,3.7443881245,0,1.7851939293320152E-4,0.1666666667,1,0,59,6.220377345149536E-5,1.3549677E-5,1.3714035E-5,25,5,0,200,0,0
161507331,JasminMuj,10,6873,508,397,20,3,61.3531392499,60-69,735,7,11,5,16,16,11,5,7,2.9040550326,10.6316980128,0.0138636418,0.1458333333,0.35897437,0,59,8.451259966757191E-5,8.129806E-5,8.228421E-5,182,12,0,200,0,0
161849864,neilredknap,10,2994,224,90,8,0,43.1069026606,40-49,670,6,58,34,92,92,58,34,6,2.51955105,394.7908649348,0.0857549888,0.1540850454,0.38178053,0,59,2.3211305578027254E-4,3.9971547E-4,4.0456402E-4,25,60,3,201,3,0.0149253731
162230121,BentheGood,10,2711,269,124,7,5,46.7971947608,40-49,628,5,29,17,46,46,29,17,7,2.8269370022,34.584235732,0.0565380046,0.1425120773,0.5204301,0,59,1.9733698009012112E-4,2.0324514E-4,2.0571053E-4,25,7,0,200,0,0
162443820,Dawn_One,10,1176,58,60,1,13,40.3952316533,40-49,575,5,6,8,14,14,6,8,6,2.7063721941,2.4778916704,0.0130808122,0.2637362637,0.50757575,0,59,6.682477180916478E-5,4.742387E-5,4.799912E-5,77,3,0,200,0,0
162606435,vancitydan,10,22518,603,1218,23,283,40.291488634,40-49,761,8,11,13,24,24,11,13,6,2.7527154236,39.8717351571,0.0124573007,0.125,0.2777778,0,59,1.0459665868433208E-4,8.129806E-5,8.228421E-5,77,1,0,202,0,0
162901927,FloydShivambu,10,967,17279,1045,62,35,62.9356633462,60-69,782,5,34,4,38,38,34,4,9,4.8881245474,51126.8976612942,0.0029398871,0.0405405405,0.07397504,0,59,0.0014422857,2.3711934E-4,1.5085438E-4,131,65,0,200,0,0
163462941,mbchambersofcom,10,5341,1949,928,69,3714,48.6983940466,40-49,693,6,7,14,21,21,7,14,7,2.9413468501,5176.404901952,0.0036647109,0.1333333333,0.20263158,0,59,9.215234850583492E-5,5.4198706E-5,5.485614E-5,175,23,0,200,0,0
163808974,AldrinSampear,10,14543,3866,332,63,18,59.7279129171,50-59,772,7,7,2,9,9,7,2,10,5.8834178132,5524.25,6.573146968169046E-4,0.1111111111,0.17857143,0,59,3.489511176763887E-4,5.4198706E-5,3.4285087E-5,131,6,0,238,0,0
163861697,S_EFortin,10,12186,1788,887,50,7,57.5103130308,50-59,784,7,25,21,46,46,25,21,6,2.726647357,534.846661785,0.0261692398,0.0700483092,0.37076923,0,59,1.622357464787849E-4,1.761458E-4,1.7828245E-4,145,26,1,201,1,0.0049751244
164262472,francobbe1,10,1209,400,1046,2,12,58.4639849357,50-59,583,5,0,3,3,3,0,3,5,2.8,0,0,0,0,42,542,4.766339181938244E-5,0,6.8570175E-6,197,0,0,198,0,0
164324862,flemingjude,10,32785,460,1101,22,8989,41.015995368,40-49,716,9,25,47,72,72,25,47,6,2.3642288197,415.8658010654,0.0329103426,0.1490610329,0.31101695,0,59,1.3372488811408411E-4,1.761458E-4,1.7828245E-4,77,9,0,202,0,0
164945916,YTPaleo,10,177,57,99,0,6,35.8220531067,30-39,424,4,2,2,4,4,2,2,7,3.4489500362,0,5.800334814577069E-4,0.0833333333,1,0,59,5.673840485779813E-5,2.0324514E-5,2.0571053E-5,175,3,0,200,0,0
165039539,MitchelmoreMHA,10,6295,1449,1295,40,13,53.1304487406,50-59,742,6,56,64,120,120,56,64,7,2.547429399,2934.740364576,0.0680553818,0.1170868347,0.30139,0,59,3.6529945775610697E-4,3.8616578E-4,3.9085E-4,147,189,0,201,0,0
165483720,alanvaldez17,10,1325,120,182,0,24,34.385612199,30-39,620,5,0,0,0,0,0,0,0,0,0,0,0,0,245,637,4.766339181938244E-5,0,0,249,5,0,200,0,0
166617790,jeff_p_harris,10,609,72,257,1,8,27.6875346687,20-29,535,5,2,6,8,8,2,6,7,3.2067342505,1.3364059742,0.0017961792,0.1964285714,0.19642857,0,59,5.7760314508422583E-5,2.0324514E-5,2.0571053E-5,175,0,0,199,0,0
166638826,tenzinster,10,604,232,667,3,268,47.0990208643,40-49,605,5,31,81,112,112,31,81,6,2.3787110789,7570.2423680794,0.0499530265,0.1486486486,0.3593959,0,59,2.488649085879921E-4,2.1679483E-4,2.1942456E-4,25,33,1,200,1,0.005
167209803,juliafeltham,10,7738,1575,1182,45,137,63.6923775442,60-69,739,7,33,29,62,62,33,29,6,2.4768283852,995.5060592411,0.0382029202,0.1295610788,0.32978722,0,59,1.9901023499065503E-4,2.303445E-4,2.3313859E-4,147,19,0,199,0,0
167431567,CBCHereandNow,10,6787,3372,77,146,2,57.3265931484,50-59,761,7,39,2,41,41,39,2,7,3.462346126,62.7315086273,0.0371618457,0.093902439,0.12134147,0,59,2.6914955310338454E-4,2.7099354E-4,2.742807E-4,175,18,0,200,0,0
167988120,_andycortes,10,6440,381,362,1,84,42.1309572208,40-49,680,6,0,0,0,0,0,0,0,0,0,0,0,0,43,127,4.766339181938244E-5,0,0,40,0,0,201,0,0
168504027,RandySRoberts,10,2161,270,912,5,75,55.7214621808,50-59,649,6,2,11,13,13,2,11,7,2.9446053584,3.7969870531,0.003095996,0.1794871795,0.35454544,0,59,5.8669885626361245E-5,2.0324514E-5,2.0571053E-5,175,28,0,201,0,0
168706121,vacceo55,10,6801,926,1288,8,15,49.2204198526,40-49,726,7,2,2,4,4,2,2,1,1,2,1.619561731312207E-4,0,0,77,173,4.6360358251326255E-4,2.0324514E-5,2.0571053E-5,69,12,0,201,0,0
168751913,leobourdon,10,1441,356,361,5,16,43.6393617323,40-49,609,6,76,85,161,161,76,85,6,2.3635047067,5310.2795013106,0.101794838,0.0611801242,0.27396476,0,59,4.0106461189682387E-4,5.216625E-4,5.2799034E-4,175,25,3,199,3,0.0150753769
168965357,DASILVALAW,10,9972,447,812,18,93,42.9579567271,40-49,704,7,3,7,10,10,3,7,7,3.1828385228,2970.2442018374,9.74447996613796E-4,0.0555555556,0.21428572,0,59,9.622530249220143E-5,2.7099353E-5,2.742807E-5,175,1,0,199,0,0
169173525,Volontariste,10,7911,839,592,45,296,46.8722919657,40-49,759,8,12,11,23,23,12,11,7,3.1650977552,562.4312167683,0.0060527768,0.0375494071,0.19871795,0,59,1.1115539303451024E-4,8.80729E-5,8.914123E-5,175,4,0,201,0,0
169236244,drstoopid,10,398,12,65,0,3,33.3091590163,30-39,510,4,1,11,12,12,1,11,7,2.857711803,0.2991058494,0.0011612234,0.2803030303,0.3909091,0,59,4.97960096043267E-5,1.3549677E-5,1.3714035E-5,77,1,3,200,3,0.015
169631777,Spoogicus,10,487,31,111,0,5,17.1299232928,10-19,468,3,0,0,0,0,0,0,0,0,0,0,0,0,258,671,4.766339181938244E-5,0,0,263,0,0,200,0,0
169670184,rk70534,10,33932,671,2002,26,41,57.3380450313,50-59,735,9,14,15,29,29,14,15,6,2.7212165098,154.518721836,0.0135760106,0.0492610837,0.251634,0,59,8.690524878032668E-5,1.0162257E-4,1.02855265E-4,77,11,0,201,0,0
169697739,ChildVelez,10,2377,136,282,0,178,43.1886799771,40-49,604,6,7,12,19,19,7,12,7,2.7009413469,979.9207310438,0.0099109894,0.1461988304,0.30952382,0,59,8.651529536510242E-5,5.4198706E-5,5.485614E-5,25,19,0,201,0,0
169982074,valeriociabocco,10,317,32,89,0,1,41.3645456848,40-49,550,4,0,1,1,1,0,1,7,4.3571428571,0,0,0,0,42,578,4.766339181938244E-5,0,6.8570175E-6,197,3,0,200,0,0
170283914,gbuccino,10,1801,111,227,0,0,30.3409259488,30-39,540,5,0,4,4,4,0,4,6,2.7142857143,0,0,0.3333333333,0.5833333,42,453,4.766339181938244E-5,0,6.8570175E-6,197,2,0,200,0,0
170384986,moebius_strip,10,8954,170,304,3,298,49.3006439228,40-49,699,7,17,39,56,56,17,39,7,2.5123099203,350.2621997647,0.039156156,0.1756493506,0.41565657,0,59,1.3683143800813908E-4,1.2194709E-4,1.2342632E-4,175,32,0,201,0,0
171041974,andrea_viliotti,10,106539,2028,2231,48,38298,55.7614881308,50-59,883,10,2,4,6,6,2,4,5,2.5384615385,361.3333333333,1.6564699961174E-4,0.1,0.25,42,307,5.895913283265687E-4,2.0324514E-5,2.0571053E-5,197,35,0,201,0,0
171606833,LindaFrum,10,83,256,400,3,3,45.6144407072,40-49,539,3,22,36,58,58,22,36,7,2.5463432295,455.0343157964,0.0501904326,0.1796733212,0.4285024,0,59,8.006420585267686E-4,1.5582128E-4,1.577114E-4,175,8,0,125,0,0
171734558,sara_mayo,10,2335,695,619,20,1303,49.0445012407,40-49,694,6,19,18,37,37,19,18,6,2.8892107169,9047.2790651487,0.0222166434,0.0908408408,0.18850575,0,59,1.5294551444951395E-4,1.3549677E-4,1.3714035E-4,175,8,0,200,0,0
172166938,ecodecoARORA,10,1795,365,1640,2,123,34.8218614773,30-39,573,5,0,0,0,0,0,0,0,0,0,0,0,0,26,100,4.766339181938244E-5,0,0,23,0,0,200,0,0
172251540,amandajhudson_,10,1958,195,220,18,1,25.1787058744,20-29,588,5,33,30,63,63,33,30,6,2.6111513396,577.4594399472,0.0613082497,0.1210957501,0.3826135,0,59,2.3946181340455186E-4,2.303445E-4,2.3313859E-4,25,0,1,200,1,0.005
173029216,Maxx_Chaos,10,6255,132,372,3,315,45.7589759613,40-49,707,7,2,10,12,12,2,10,6,2.753801593,15.281074513,0.0019154153,0.1590909091,0.32222223,0,59,5.387296380726123E-5,2.0324514E-5,2.0571053E-5,77,2,0,201,0,0
173086720,nbmtrem,10,3406,237,311,10,6,42.2053421603,40-49,694,7,72,75,147,147,72,75,6,2.4681390297,1091.7461672914,0.1159112491,0.1345168204,0.38340178,0,59,3.020626436980376E-4,4.945632E-4,5.0056225E-4,25,23,1,199,1,0.0050251256
173137904,vancouver_rt,10,659168,5857,0,226,0,41.5176094738,40-49,870,12,12,0,12,12,12,0,0,0,0,0.0113779474,0.1590909091,0.23484848,0,9,1.1940837057250041E-4,8.80729E-5,0,182,1,0,203,0,0
173232573,jacopobonato,10,749,37,125,1,190,15.8666134137,10-19,407,5,0,1,1,1,0,1,7,4.3571428571,0,0,0,0,42,487,4.766339181938244E-5,0,6.8570175E-6,197,0,0,199,0,0
173465009,joeyarchibald,10,3759,640,2001,7,9,56.2883115802,50-59,682,6,32,88,120,120,32,88,6,2.2668356264,3397.1361149884,0.0543077291,0.1133753501,0.27293524,0,59,1.5990921122152024E-4,2.2356966E-4,2.2628158E-4,77,17,0,200,0,0
173580066,toronto_rt,10,730835,4461,0,189,0,41.1737993773,40-49,885,11,13,0,13,13,13,0,0,0,0,0.0156772672,0.0512820513,0.08974359,0,25,1.1871174518429019E-4,9.484774E-5,0,77,3,0,190,0,0
174085518,shrynyk,10,65,9,54,0,1,12.2285441559,10-19,49,2,3,9,12,12,3,9,7,2.7328023172,1.71615627,0.0069198579,0.3636363636,0.6090909,0,59,5.572315073626785E-5,2.7099353E-5,2.742807E-5,25,0,0,66,0,0
174262288,AndrewBresnahan,10,1236,451,675,16,20,42.0480370018,40-49,596,5,17,45,62,62,17,45,6,2.4420709631,616.0680739644,0.0377511274,0.1562665256,0.34285715,0,59,1.5845311238607857E-4,1.2194709E-4,1.2342632E-4,25,8,1,200,1,0.005
174285518,Crommunist,10,21151,3109,293,117,38,62.6031363067,60-69,797,8,44,21,65,65,44,21,6,2.5409123823,4265.0255705203,0.0550346573,0.1112980769,0.1938899,0,59,3.0815688429728017E-4,3.0486772E-4,3.085658E-4,77,60,0,201,0,0
174416040,jonathoncomfort,10,1770,404,267,22,78,62.3575660827,60-69,664,6,42,49,91,91,42,49,6,2.5695148443,4096.8463007088,0.0416146091,0.0796092796,0.22885571,0,59,1.639302590890036E-4,2.9131805E-4,2.8799474E-4,77,40,2,201,2,0.0099502488
174528249,talithacalder,10,993,221,330,5,20,40.7963181089,40-49,584,5,9,14,23,23,9,14,6,2.6955104996,88.1799712861,0.0223766964,0.1996047431,0.42105263,0,59,1.1744166423325433E-4,6.7748384E-5,6.8570174E-5,25,2,0,198,0,0
174803745,DesmondThoabala,10,349,48,306,0,14,33.4853841786,30-39,514,4,0,0,0,0,0,0,0,0,0,0,0,0,127,282,4.766339181938244E-5,0,0,119,2,0,200,0,0
174812966,CFJC_News,10,3482,2745,1051,86,0,51.5180679056,50-59,735,6,22,25,47,47,22,25,7,3.009775525,982.0272822095,0.0150968463,0.0966697502,0.17884615,0,59,3.202466962634124E-4,1.5582128E-4,1.5085438E-4,182,16,0,200,0,0
175092287,ggarnero,10,31,31,153,0,5,50.0059266311,50-59,566,6,0,1,1,1,0,1,7,4.3571428571,0,0,0,0,42,443,4.766339181938244E-5,0,6.8570175E-6,197,0,0,7,0,0
175339172,sbrotherhood,10,7988,299,459,10,90,40.5749772394,40-49,715,7,1,1,2,2,1,1,7,3.3740043447,0,7.498832390327803E-4,0,0,0,59,5.151823382879552E-5,1.3549677E-5,1.3714035E-5,25,1,0,200,0,0
175350403,thaby25,10,575,17,30,1,14,24.9601550698,20-29,520,4,0,1,1,1,0,1,10,5.8863554108,0,0,0,0,0,393,4.766339181938244E-5,0,6.8570175E-6,131,3,0,200,0,0
175437035,ronwoodman,10,2140,843,1650,12,28,47.1615281866,40-49,684,6,85,154,239,239,85,154,6,2.2805937726,17388.7884986956,0.1135775133,0.0811152913,0.22161172,0,59,4.42538758562482E-4,5.826361E-4,5.897035E-4,147,41,0,200,0,0
175452918,TheDudeInSF,10,22931,1497,1816,57,11659,60.9391852398,60-69,775,8,3,3,6,6,3,3,7,3.3653149891,2997.4250632476,8.199359293258835E-4,0,0,0,59,9.264874003479446E-5,2.7099353E-5,2.742807E-5,77,2,0,198,0,0
175696165,winnipeg_rt,10,334166,1507,0,44,0,40.3639037191,40-49,759,10,4,0,4,4,4,0,0,0,0,0.0091564452,0.25,0.25,0,45,8.974947208745803E-5,3.3874192E-5,0,175,0,0,201,0,0
176207343,bobzimmermp,10,3394,1061,170,99,2,51.047259234,50-59,729,6,55,18,73,73,55,18,7,2.8519188993,351.8081101479,0.0793627905,0.1322298326,0.21585082,0,59,4.551596788456869E-4,3.7939096E-4,3.8399297E-4,175,27,15,200,12,0.06
176306039,WOComoxValley,10,463,26,88,0,1,21.1081886256,20-29,457,4,3,6,9,9,3,6,7,3.1893555395,0.2000261969,0.0032237174,0.2916666667,0.33333334,0,59,5.272463851643105E-5,2.7099353E-5,2.742807E-5,77,3,0,199,0,0
176693963,mike_schouten,10,1211,237,403,15,4,45.7894297426,40-49,617,6,4,35,39,39,4,35,7,2.5633598841,206.7979029984,0.0011927165,0.209851552,0.365873,0,59,6.514927980088808E-5,3.3874192E-5,3.4285087E-5,175,22,4,200,4,0.02
177134474,ravbasil,10,452,84,124,0,2,39.8095989575,30-39,610,5,8,9,17,17,8,9,7,2.9569152788,12.7098315135,0.0125516912,0.1176470588,0.32575756,0,59,6.47160241221658E-5,6.0973543E-5,6.171316E-5,77,10,0,200,0,0
177303552,KendallMade,10,562,71,23,2,7,29.0385761834,20-29,477,4,0,3,3,3,0,3,7,3.2399565689,0,0,0.1666666667,0.16666667,0,187,4.766339181938244E-5,0,6.8570175E-6,77,0,0,200,0,0
177416004,nojgr,10,5658,107,391,2,51,43.2579397063,40-49,594,7,30,63,93,93,30,63,6,2.3812454743,1073.7619996035,0.0345562919,0.108345021,0.278133,0,59,1.3087857485916232E-4,2.1001999E-4,2.1256754E-4,77,12,3,200,3,0.015
177602450,jodypercy,10,1907,475,1034,14,1,44.2799169578,40-49,668,6,67,153,220,220,67,153,6,2.2483707458,5889.0694090654,0.0967333778,0.10290577,0.28646836,0,59,3.279456220075369E-4,4.60689E-4,4.6627718E-4,25,20,0,200,0,0
177869990,glennixdorf,10,4035,366,593,7,19,40.6618427117,40-49,648,7,11,21,32,32,11,21,7,2.7251991311,24.4064841393,0.0133240669,0.1370967742,0.5285714,0,59,1.0131872080528984E-4,8.129806E-5,8.228421E-5,175,10,0,200,0,0
178007000,Sammy_Potato,10,2165,171,288,5,14,40.8493821243,40-49,602,6,0,0,0,0,0,0,0,0,0,0,0,0,242,628,4.766339181938244E-5,0,0,246,3,0,200,0,0
178291278,mrl58,10,1116,61,175,0,87,41.8401792871,40-49,564,6,1,2,3,3,1,2,7,3.1401158581,5224.8110065941,9.332717723623285E-5,0,0,0,59,1.1874831691900532E-4,1.3549677E-5,1.3714035E-5,77,4,0,200,0,0
178879310,tweetingLew,10,850,46,99,0,4,31.3192489175,30-39,563,5,3,13,16,16,3,13,6,2.7041998552,22.5239065284,0.0013908885,0.1875,0.26666668,0,59,5.492182029323013E-5,2.7099353E-5,2.742807E-5,175,4,1,200,1,0.005
179027982,emjay1968,10,2816,201,495,3,1571,45.6971028048,40-49,689,6,1,1,2,2,1,1,2,1.5,0,8.271798374069241E-5,0,0,233,601,2.4481546444683235E-4,1.3549677E-5,1.3714035E-5,251,1,0,200,0,0
179074921,ShantiAboobaker,10,16740,794,729,15,62,40.2520813942,40-49,750,8,3,5,8,8,3,5,9,4.8131788559,5760.0876935664,3.3340475798115975E-4,0.1607142857,0.4,0,59,2.5404261520010213E-4,2.7099353E-5,2.742807E-5,131,1,0,200,0,0
179095263,fjgomezl,10,798,67,272,1,88,21.0185843534,20-29,433,5,2,8,10,10,2,8,7,2.8906589428,2.3233061278,4.863212542693479E-4,0.2777777778,0.43055555,0,59,5.3750573888466044E-5,2.0324514E-5,2.0571053E-5,25,0,0,200,0,0
179142840,litalighting,10,1357,190,332,2,248,36.199037871,30-39,518,5,0,0,0,0,0,0,0,0,0,0,0,0,35,112,4.766339181938244E-5,0,0,32,7,0,200,0,0
179402986,robgillezeau,10,180,102,403,3,3,21.7122168627,20-29,227,4,13,54,67,67,13,54,6,2.4475018103,54.1229702235,0.0291081291,0.249886929,0.556391,0,59,1.1522955062783576E-4,9.484774E-5,9.599824E-5,25,0,2,178,1,0.0056179775
180037479,BonneAmie1955,10,1315,58,176,1,142,42.9362850853,40-49,545,6,0,2,2,2,0,2,7,3.3253709736,0,0,0.5,1,0,301,4.766339181938244E-5,0,6.8570175E-6,182,4,0,201,0,0
180093728,mallorydaley,10,2612,220,648,4,187,41.0335545904,40-49,661,6,33,91,124,124,33,91,6,2.4326574946,2073.7670021283,0.0646097727,0.1553238919,0.37138158,0,59,1.9443874899371358E-4,2.303445E-4,2.3313859E-4,25,92,1,200,1,0.005
180513765,esspres,10,1523,186,367,10,21,43.8184532663,40-49,628,6,25,45,70,70,25,45,6,2.5485155684,1251.6912905717,0.0233922016,0.085300207,0.32222223,0,59,1.3637855887771655E-4,1.761458E-4,1.7828245E-4,182,17,3,199,2,0.0100502513
180572286,Megs102496,10,1004,42,178,0,23,25.7094853435,20-29,486,4,1,3,4,4,1,3,7,3.4706734251,5.2001044891,1.123771223906718E-4,0.0833333333,0.16666667,0,59,8.747171713835997E-5,1.3549677E-5,1.3714035E-5,25,0,0,200,0,0
180798968,OSSTF27,10,18913,579,430,30,1316,36.1097005824,30-39,702,8,56,37,93,93,56,37,7,2.7241129616,994.861926098,0.0475109342,0.0841514727,0.25407925,0,59,2.3717302952788535E-4,3.8616578E-4,3.9085E-4,182,18,0,200,0,0
181006628,31yrsincalgary,10,548,51,76,0,2,25.3490654518,20-29,503,4,7,8,15,15,7,8,7,2.8696596669,7.9715205884,0.0125743222,0.0952380952,0.60714287,0,59,8.549659654930226E-5,5.4198706E-5,5.485614E-5,175,2,0,200,0,0
181043440,mdelow,10,26,21,23,0,0,38.0549015583,30-39,377,3,2,3,5,5,2,3,7,3.3685734975,1.4341103142,3.029091113390972E-4,0.15,0.8333333,0,59,6.277680507229316E-5,2.0324514E-5,2.0571053E-5,77,16,2,93,2,0.0215053763
181176786,cyberrat46,10,81,5,37,0,1,11.7341444214,10-19,4,3,0,1,1,1,0,1,7,3.2616720955,0,0,0,0,0,203,4.766339181938244E-5,0,6.8570175E-6,77,0,0,112,0,0
182803165,fmeilleur,10,202,15,47,0,2,21.2913126358,20-29,225,3,0,0,0,0,0,0,0,0,0,0,0,0,201,512,4.766339181938244E-5,0,0,205,4,0,200,0,0
182834773,Debhopey,10,3888,439,551,7,84,48.3544372061,40-49,728,7,13,15,28,28,13,15,7,2.8160753077,83.6359937757,0.0087571799,0.0925925926,0.29239765,0,59,7.832946954552573E-5,9.484774E-5,9.599824E-5,147,4,0,200,0,0
183107904,ant6n,10,25,14,20,1,0,32.1141635942,30-39,353,3,1,1,2,2,1,1,8,3.9504341534,0,8.095914281419891E-5,0,0,0,555,1.0633321402051042E-4,1.3549677E-5,1.3714035E-5,25,3,1,36,1,0.0277777778
184321146,uofcfreethinker,10,5763,71,49,4,9,30.5697219176,30-39,537,7,2,2,4,4,2,2,7,3.2143374366,0.1740087725,0.0019836923,0.1666666667,0.5,0,59,5.3469172697084375E-5,2.0324514E-5,2.0571053E-5,77,0,0,200,0,0
184844629,Mexicowannabe,10,127,90,144,1,0,21.1614361681,20-29,347,3,0,6,6,6,0,6,7,2.9728555917,0,0,0.4333333333,0.6666667,0,315,4.766339181938244E-5,0,6.8570175E-6,182,0,0,128,0,0
184886329,voteepstein,10,7537,142,117,16,0,19.5983463856,10-19,739,7,3,3,6,6,3,3,7,3.3986241854,28523,5.896642973866346E-4,0.0333333333,0.083333336,0,59,3.25310547523735E-4,2.7099353E-5,2.742807E-5,62,0,0,200,0,0
184956827,angieeveera,10,7708,800,716,69,3184,47.577668334,40-49,615,7,0,0,0,0,0,0,0,0,0,0,0,0,252,656,4.766339181938244E-5,0,0,257,0,0,201,0,0
185079991,ryanpyne,10,214,94,106,1,6,21.8182874572,20-29,475,4,3,9,12,12,3,9,7,3.0771180304,3.9918849778,0.002950835,0.1287878788,0.26666668,0,59,5.80131896651857E-5,2.7099353E-5,2.742807E-5,175,1,0,200,0,0
185109209,RaggedVixen,10,5937,170,133,7,264,41.8452835641,40-49,576,6,2,3,5,5,2,3,7,3.170166546,0.2723317381,0.002250974,0.35,0.45,0,59,5.6852804234300206E-5,2.0324514E-5,2.0571053E-5,77,0,0,199,0,0
185411514,DBEMediaGroup,10,25794,315,2,13,2,22.6147829399,20-29,685,8,1,1,2,2,1,1,9,5.39608979,2761,8.097840108284366E-5,0.5,0.5,0,59,2.0015364029587904E-4,1.3549677E-5,1.3714035E-5,62,0,0,200,0,0
185465445,DBECanada,10,14967,170,6,11,0,37.5500372427,30-39,864,5,2,2,4,4,2,2,8,4.396813903,11417,1.6759312929238103E-4,0.0833333333,0.16666667,0,59,3.0996629756878597E-4,2.0324514E-5,2.0571053E-5,62,812,0,200,0,0
185630556,votelau,10,6376,424,607,19,1346,49.2129955931,40-49,707,7,49,87,136,136,49,87,6,2.3175235337,6498.6216613967,0.0520211395,0.0592592593,0.17028509,0,59,2.607135952838694E-4,3.387419E-4,3.4285086E-4,25,44,0,200,0,0
185947193,MVLibertas,10,56139,661,613,18,3,45.4887664419,40-49,785,9,37,47,84,84,37,47,7,2.6430123099,2740.0750480212,0.0432879683,0.0866322433,0.2621274,0,59,3.531975535663362E-4,2.5744384E-4,2.6056665E-4,175,38,2,202,2,0.0099009901
186216628,EvansXFM,10,15015,443,936,8,22,48.2302096852,40-49,734,7,5,13,18,18,5,13,7,3.3435916003,138.8941483785,0.0054024756,0.1405228758,0.20833333,0,59,7.840716014282384E-5,4.064903E-5,4.1142106E-5,175,2,0,202,0,0
186285606,pettyrivergirl,10,7888,335,302,5,33,51.7292474458,50-59,722,8,39,25,64,64,39,25,6,2.7067342505,340.2730549848,0.038112024,0.1264880952,0.34042552,0,59,1.4838387758110924E-4,2.7099354E-4,2.742807E-4,77,28,0,199,0,0
186481198,karlasecaida,10,12278,242,312,0,0,46.1298176561,40-49,731,7,2,2,4,4,2,2,1,1,0,1.6551228476954845E-4,0.0833333333,1,186,403,3.177448371356425E-4,2.0324514E-5,2.0571053E-5,193,61,0,201,0,0
186500600,msewen,10,2726,832,1095,56,39,49.0858645693,40-49,698,7,50,63,113,113,50,63,6,2.5101375815,10919.9780582246,0.0477577923,0.0480404551,0.23214285,0,59,2.586619101505649E-4,3.4551675E-4,3.4285086E-4,182,22,0,200,0,0
186984132,ryansdds,10,1036,259,403,9,2,57.5920128064,50-59,618,5,46,48,94,94,46,48,6,2.5354815351,339.4474609027,0.0732155172,0.1209105468,0.42226335,0,59,2.559092697342227E-4,3.1841738E-4,3.222798E-4,182,35,0,200,0,0
187140926,daniela_aum,10,46349,1385,2002,47,3970,55.6112888602,50-59,753,9,49,60,109,109,49,60,6,2.4272266474,1574.9541931163,0.0661348262,0.1208800544,0.29988244,0,59,3.0831262209177543E-4,3.387419E-4,3.4285086E-4,77,7,0,201,0,0
187214966,DaisyLouMae,10,3502,552,1634,10,90,41.7455656873,40-49,595,6,10,53,63,63,10,53,6,2.3616944243,1590.9075766166,0.0164463862,0.1623143881,0.3015374,0,59,8.003717491171401E-5,7.452322E-5,7.542719E-5,147,0,0,200,0,0
187348023,eastcoastmurray,10,328,265,321,5,8,20.9111202413,20-29,596,5,8,19,27,27,8,19,7,2.7639391745,80.089255782,0.0047233678,0.235042735,0.4604743,0,59,9.102286866526458E-5,6.0973543E-5,6.171316E-5,175,40,0,200,0,0
188297924,Ben_Bergen,10,2181,2124,742,102,0,45.6399223378,40-49,699,5,75,35,110,110,75,35,6,2.5492396814,5634.226784458,0.0832549368,0.1038365304,0.17858677,0,59,3.099309505718844E-4,5.148877E-4,5.211333E-4,175,11,0,200,0,0
188300404,GillesGoguen,10,319,42,120,0,18,19.1787575083,10-19,343,4,5,7,12,12,5,7,7,2.9250543085,45.154585092,0.0084023347,0.0833333333,0.30357143,0,59,7.903711079014592E-5,4.064903E-5,4.1142106E-5,182,0,0,198,0,0
188379252,MattSchein,10,2881,521,2001,9,60,42.702804128,40-49,630,6,47,154,201,201,47,154,6,2.2476466329,1567.4387033677,0.0935776105,0.1464925373,0.316325,0,59,2.6774517336612387E-4,3.2519223E-4,3.2913685E-4,25,43,1,200,1,0.005
188733067,chartrandm,10,7876,953,1347,15,40,41.5573696428,40-49,723,7,35,54,89,89,35,54,6,2.5257060101,1064.8194280574,0.0445731342,0.0843973442,0.26731887,0,59,1.594811484145552E-4,2.4389417E-4,2.4685264E-4,77,31,3,202,3,0.0148514851
188983641,KatieBrist,10,27656,232,1067,6,523,34.6196007346,30-39,729,8,9,41,50,50,9,41,6,2.6057204924,134.0188429295,0.0264684452,0.2620408163,0.47971013,0,59,8.784999368869234E-5,6.7748384E-5,6.8570174E-5,175,3,3,202,3,0.0148514851
189004642,kristruelsen,10,58,37,40,0,3,17.2096651077,10-19,227,3,0,0,0,0,0,0,0,0,0,0,0,0,96,221,4.766339181938244E-5,0,0,87,0,0,58,0,0
189159758,peeekon,10,8453,1012,162,0,114,48.507477032,40-49,752,7,3,4,7,7,3,4,4,2.3888888889,2.5,2.632209343701974E-4,0.119047619,0.35,58,182,1.2230955088791392E-4,2.7099353E-5,2.742807E-5,166,20,0,201,0,0
189319558,evillevilive,10,707,213,376,3,284,44.4538867158,40-49,566,4,0,2,2,2,0,2,7,3.4075280492,0,0,0,0,0,652,4.766339181938244E-5,0,6.8570175E-6,182,8,0,200,0,0
189505553,RayShell84,10,192,35,51,1,39,25.3036984898,20-29,538,4,0,0,0,0,0,0,0,0,0,0,0,0,261,682,4.766339181938244E-5,0,0,267,8,0,193,0,0
189619402,EugeneHaslam,10,4955,1090,324,50,5,45.870062076,40-49,691,7,18,20,38,38,18,20,7,2.8084721217,112.7196142274,0.0327142731,0.1941678521,0.3693182,0,59,1.4871709421222784E-4,1.2872192E-4,1.3028333E-4,175,7,0,200,0,0
190016827,ndpmcgill,10,167,99,44,5,0,40.0003356874,40-49,501,3,24,15,39,39,24,15,7,2.8602461984,36.3568876461,0.040966823,0.2273954116,0.49092743,0,59,1.4509834130231781E-4,1.6937095E-4,1.7142543E-4,25,28,1,171,1,0.0058479532
190038605,kim_crawley,10,3140,1217,1306,82,22,61.4627312018,60-69,644,6,1,4,5,5,1,4,7,3.0391020999,1.3989838984,7.015245492867714E-4,0.35,0.4,0,59,5.519028946521249E-5,1.3549677E-5,1.3714035E-5,175,0,0,200,0,0
190240891,amdrobinson,10,7020,724,1295,14,65,61.2164756492,60-69,699,6,10,29,39,39,10,29,6,2.6223750905,139.0897007185,0.0104912539,0.1403508772,0.3014113,0,59,8.438958516041712E-5,7.452322E-5,7.542719E-5,175,11,0,200,0,0
190434235,TemporalThinker,10,7743,433,631,13,74,46.1321064121,40-49,709,7,12,27,39,39,12,27,7,2.6560463432,3315.9362471573,0.0163930483,0.1228070175,0.30804598,0,59,9.567322846712725E-5,8.80729E-5,8.914123E-5,77,12,1,200,1,0.005
190738551,1310news,10,24568,4389,678,161,9,47.0326548463,40-49,786,7,31,23,54,54,31,23,6,2.7769732078,5765.1993862223,0.0385795385,0.1387141859,0.25458938,0,59,3.1458240629552597E-4,2.1679483E-4,2.0571053E-4,175,133,1,200,1,0.005
190762455,mikebednarski,10,693,59,62,2,300,45.6068120907,40-49,630,5,7,10,17,17,7,10,7,2.8370745836,13.9649744217,0.0071246841,0.1580882353,0.31428573,0,59,6.880329416203665E-5,5.4198706E-5,5.485614E-5,182,24,0,200,0,0
191105604,Jansen_Irene,10,160,148,260,5,138,31.0023993835,30-39,430,3,20,26,46,46,20,26,6,2.6524257784,95.2016962809,0.0321838265,0.1787439614,0.4421922,0,59,1.2171549676253942E-4,1.422716E-4,1.4399737E-4,182,0,2,166,2,0.0120481928
191228643,VoiceNoSong,10,31,13,90,0,3,15.1483942347,10-19,64,1,1,3,4,4,1,3,7,3.1115133961,0.7721864282,7.139805181832617E-4,0.1666666667,0.33333334,0,59,5.516821006077309E-5,1.3549677E-5,1.3714035E-5,77,0,0,32,0,0
191422128,BeverlyTaft,10,631,136,128,0,84,35.7331646183,30-39,554,5,19,10,29,29,19,10,7,2.8530050688,74.6243957094,0.0262587255,0.1490147783,0.3917749,0,59,1.307012022639963E-4,1.3549677E-4,1.3714035E-4,25,12,1,200,1,0.005
191549788,JoanJardin,10,5391,375,314,21,7,44.2788350693,40-49,642,7,45,31,76,76,45,31,6,2.7433019551,833.9485480298,0.0381364096,0.0959649123,0.28047138,0,59,2.143368813922474E-4,3.1164257E-4,3.154228E-4,182,16,0,199,0,0
191832828,Waterlady01,10,126,26,96,0,3,23.2275874987,20-29,303,3,6,9,15,15,6,9,7,2.9402606807,5.6197986219,0.0030446292,0.1428571429,0.5888889,0,59,7.182128511371096E-5,4.742387E-5,4.799912E-5,175,0,0,129,0,0
192455232,TakebackthRight,10,4673,177,299,3,1,38.0222815511,30-39,626,5,17,42,59,59,17,42,7,2.5510499638,296.4810327499,0.0211259151,0.1414377557,0.35,0,59,1.1224531211768176E-4,1.2194709E-4,1.2342632E-4,77,5,0,200,0,0
192620272,robbincanada,10,955,73,137,2,336,44.2709789525,40-49,655,6,16,16,32,32,16,16,7,2.7918175235,67.6747971595,0.0111885088,0.1381048387,0.45256916,0,59,1.0968576545188313E-4,1.1517225E-4,1.16569296E-4,175,33,3,201,3,0.0149253731
192656149,timquerengesser,10,4928,984,897,24,109,49.5148694156,40-49,722,7,49,47,96,96,49,47,6,2.5448950036,3950.1057363177,0.0466493334,0.0532894737,0.14965035,0,59,3.9727288161443434E-4,3.387419E-4,3.4285086E-4,77,47,0,200,0,0
192659552,AnnaAnthro,10,17356,631,1279,38,38,42.421023696,40-49,680,8,30,77,107,107,30,77,6,2.4091238233,674.7884913412,0.0682840382,0.164168577,0.36206895,0,59,1.7488925349658905E-4,2.1001999E-4,2.1256754E-4,175,6,0,202,0,0
193370454,BlackburnEssex,10,13412,2182,653,50,5,51.7251435965,50-59,743,6,17,13,30,30,17,13,7,2.9431571325,875.9084349208,0.0092873522,0.116091954,0.3030303,0,59,1.510479890086778E-4,1.2194709E-4,1.2342632E-4,175,122,0,201,0,0
193438104,LeBlancMJ,10,3553,205,524,5,431,40.1948763711,40-49,633,6,7,9,16,16,7,9,7,3.0423606083,17.3576355302,0.0068163422,0.0791666667,0.3888889,0,59,7.63330922031442E-5,5.4198706E-5,5.485614E-5,182,6,0,200,0,0
193450991,jeffreylowes,10,4613,251,207,7,7,53.4190674739,50-59,720,6,27,27,54,54,27,27,7,2.6643736423,646.904162566,0.0300377834,0.1212438854,0.2780127,0,59,1.5420606185470196E-4,1.8969548E-4,1.9199649E-4,175,17,0,200,0,0
193566462,massivhedwound,10,12865,309,189,8,12,38.3258046539,30-39,731,8,21,10,31,31,21,10,7,3.0890658943,16.6457267133,0.0158326274,0.1731182796,0.37076923,0,59,1.1490423638761994E-4,1.4904643E-4,1.5085438E-4,182,15,0,200,0,0
194166404,sexualhealthcan,10,1643,698,533,35,10,55.9775091219,50-59,670,5,23,26,49,49,23,26,6,2.5890658943,663.7433220654,0.0310292243,0.0892857143,0.21696697,0,59,1.4607966741897167E-4,1.6259612E-4,1.6456842E-4,182,31,0,200,0,0
194301614,AracelyHdzt,10,8184,180,160,0,169,43.2181829947,40-49,718,7,0,0,0,0,0,0,0,0,0,0,0,0,133,302,4.766339181938244E-5,0,0,125,13,0,201,0,0
194490269,arcticyaks,10,2688,26,47,0,123,34.5852066472,30-39,513,5,1,3,4,4,1,3,7,3.1064446054,7.0148720636,0.0031452058,0.0833333333,0.083333336,0,59,5.4955272417785166E-5,1.3549677E-5,1.3714035E-5,77,6,2,200,2,0.01
195164291,AllPopGuy,10,9887,728,1796,15,498,59.7722598272,50-59,691,8,74,102,176,176,74,102,6,2.3171614772,3902.9040527138,0.0933169557,0.0868831169,0.28973013,0,59,3.3004533804474655E-4,5.081129E-4,5.142763E-4,175,34,1,200,1,0.005
195419614,nickthemack,10,1439,67,158,1,331,28.5589735938,20-29,523,6,14,26,40,40,14,26,6,2.5629978277,75.398046039,0.0280589985,0.2288461538,0.3936508,0,59,9.155974362110047E-5,1.0162257E-4,1.02855265E-4,77,6,0,200,0,0
195981833,hillarygzz,10,2286,200,303,1,9,29.5901714557,20-29,588,5,0,1,1,1,0,1,1,1,0,0,0,0,114,387,4.766339181938244E-5,0,6.8570175E-6,183,13,0,200,0,0
196218449,tprcrdr,10,7857,274,610,4,34,43.7578431757,40-49,700,7,10,20,30,30,10,20,6,2.7154236061,109.7466481972,0.0119172289,0.1218390805,0.40952381,0,59,7.954826412344507E-5,7.452322E-5,7.542719E-5,77,8,0,200,0,0
196362333,Jas_Boyal,10,1106,44,174,1,20,24.3925776615,20-29,594,5,0,1,1,1,0,1,7,3.6659428158,0,0,0,0,0,594,4.766339181938244E-5,0,6.8570175E-6,175,0,0,199,0,0
197131222,SahraMaclean,10,1701,422,472,10,11,41.0761368299,40-49,648,6,44,69,113,113,44,69,6,2.3906589428,1079.7649043336,0.0634714221,0.1066687737,0.28873456,0,59,2.1778391295398299E-4,3.0486772E-4,3.085658E-4,25,11,0,199,0,0
197561835,share_ca,10,1291,334,320,18,0,42.2506410669,40-49,589,4,2,2,4,4,2,2,7,3.1144098479,0,0.0032390815,0.25,0.6666667,0,59,5.4048015011410756E-5,2.0324514E-5,2.0571053E-5,182,3,0,200,0,0
197650075,NothingworksDan,10,367,48,196,0,21,15.1642347214,10-19,422,4,5,18,23,23,5,18,7,2.6683562636,44.6268595084,0.0064242067,0.1739130435,0.39181286,0,59,6.687278835987146E-5,4.064903E-5,4.1142106E-5,175,2,0,199,0,0
197891853,calindab,10,207,144,369,1,9,29.487255568,20-29,472,3,31,66,97,97,31,66,6,2.4768283852,534.022448381,0.0618549994,0.1539948454,0.34465533,0,59,1.8622780664151914E-4,2.1679483E-4,2.1942456E-4,182,3,3,200,3,0.015
197927845,garthmullins,10,496,570,1824,8,14,44.1415563376,40-49,606,5,36,106,142,142,36,106,6,2.3526430123,3913.6679122253,0.0382847341,0.0816102287,0.17067003,0,59,1.6391073480734992E-4,2.5066902E-4,2.5370964E-4,77,4,1,200,1,0.005
198159177,IlModoIntorno,10,1214,90,215,1,12,19.4836887329,10-19,533,5,0,1,1,1,0,1,7,4.3571428571,0,0,0,0,42,424,4.766339181938244E-5,0,6.8570175E-6,197,2,0,185,0,0
198291682,tcd_news,10,17116,916,112,23,9,44.9444634776,40-49,725,7,1,6,7,7,1,6,7,3.1614771904,1.5236355236,2.1688368519156648E-4,0.0952380952,0.13333334,0,59,5.178934283969027E-5,1.3549677E-5,1.3714035E-5,175,7,0,201,0,0
198632817,hurtubiselihc,10,1974,522,419,25,6,44.7782046851,40-49,646,6,13,16,29,29,13,16,7,2.9120202752,87.4392001666,0.0125636544,0.104679803,0.35263157,0,59,1.0699251999698878E-4,9.484774E-5,9.599824E-5,175,7,0,200,0,0
198722685,MBolero,10,3229,110,278,1,1818,41.6986727686,40-49,603,6,21,36,57,57,21,36,6,2.6042722665,163.4499028382,0.0254586949,0.0980576441,0.28910255,0,59,1.2578626416275113E-4,1.4904643E-4,1.5085438E-4,77,10,1,199,1,0.0050251256
199354634,MovingBoxesca,10,15234,810,642,23,174,55.7186678304,50-59,734,7,4,4,8,8,4,4,7,2.9706734251,186.2245299856,0.0051411342,0.0178571429,0.1,0,59,7.246087866042086E-5,3.3874192E-5,3.4285087E-5,175,9,0,204,0,0
199620260,filo_78,10,384,16,137,0,0,23.7828775018,20-29,267,4,0,1,1,1,0,1,7,4.3571428571,0,0,0,0,42,474,4.766339181938244E-5,0,6.8570175E-6,197,0,0,200,0,0
199833381,AlChwk,10,868,67,120,1,1,33.3640282859,30-39,573,5,9,12,21,21,9,12,7,3.0966690804,42.2527891839,0.0066419048,0.1428571429,0.42380953,0,59,1.1838935276164378E-4,6.7748384E-5,6.8570174E-5,182,76,1,199,1,0.0050251256
200210559,bigvcloc,10,543,71,164,0,2,35.7788912917,30-39,506,5,2,5,7,7,2,5,7,3.1618392469,0.023255814,9.404829716946491E-4,0.2857142857,0.56666666,0,59,5.519164894825621E-5,2.0324514E-5,2.0571053E-5,175,7,0,199,0,0
200222010,Bubbaw2822,10,456,6,43,0,3,13.9296384012,10-19,275,4,0,3,3,3,0,3,7,3.2044878755,0,0,0,0,0,672,4.766339181938244E-5,0,6.8570175E-6,182,0,0,200,0,0
200803148,annamariab,10,61,16,103,0,1,17.3826071548,10-19,131,2,0,1,1,1,0,1,7,4.3571428571,0,0,0,0,42,491,4.766339181938244E-5,0,6.8570175E-6,197,0,0,65,0,0
201265978,DoubleTAP49,10,11841,687,1363,25,710,39.1322171008,30-39,744,7,5,8,13,13,5,8,7,3.0847212165,46.6598826271,0.0030434041,0.0961538462,0.3472222,0,59,6.531685747886615E-5,4.064903E-5,4.1142106E-5,175,3,0,199,0,0
201570773,thefunkyartist,10,1403,169,516,0,21,26.1357088975,20-29,558,5,4,6,10,10,4,6,7,3.0452570601,2.8795532434,0.0025210879,0.1555555556,0.47619048,0,59,7.2512324255642E-5,3.3874192E-5,3.4285087E-5,182,2,0,199,0,0
202463956,CERCChair,10,765,254,165,2,0,35.7283426096,30-39,604,5,19,13,32,32,19,13,7,2.9956553222,210.7377482843,0.0169199739,0.1280241935,0.46190476,0,59,1.1831382032663249E-4,1.3549677E-4,1.3714035E-4,182,28,0,200,0,0
202716010,Thee_Ruiner,10,737,152,405,3,16,41.7104790623,40-49,565,4,0,4,4,4,0,4,7,3.159971046,0,0,0.3333333333,0.5833333,0,189,4.766339181938244E-5,0,6.8570175E-6,175,0,0,200,0,0
202907476,tmcgeer,10,130,96,119,8,5,32.6218206579,30-39,433,2,5,3,8,8,5,3,7,3.3236784938,0,0.0041643732,0.25,0.93333334,0,59,7.306553565139719E-5,4.064903E-5,4.1142106E-5,182,2,0,137,0,0
203559806,lucmenard,10,4548,133,93,2,19,29.1787435678,20-29,630,7,23,15,38,38,23,15,6,2.6049963794,311.4555056372,0.0386189275,0.1180654339,0.30788177,0,59,2.703352272128553E-4,1.6259612E-4,1.6456842E-4,77,2,0,200,0,0
203646071,donnlovett,10,2150,332,529,7,2,45.5086370204,40-49,628,6,30,57,87,87,30,57,7,2.612961622,1101.0195881329,0.0341636098,0.1369954558,0.34871098,0,59,2.088635955098288E-4,2.1001999E-4,2.1256754E-4,175,43,0,202,0,0
204034040,claudionail,10,17112,143,293,3,388,37.8615409831,30-39,749,8,2,2,4,4,2,2,8,4.0485155684,2949.3526115179,0.0042693632,0.0833333333,0.16666667,0,59,6.996440064995338E-5,2.0324514E-5,2.0571053E-5,175,10,0,200,0,0
204188190,FelipeCaz,10,1931,126,230,0,90,34.5818602451,30-39,598,5,1,1,2,2,1,1,5,3.2222222222,0,8.451525587974923E-5,0,0,79,175,1.8975606405723553E-4,1.3549677E-5,1.3714035E-5,106,8,0,200,0,0
204623944,alexbarron95,10,5799,298,339,0,13,40.0485563052,40-49,682,6,0,0,0,0,0,0,0,0,0,0,0,0,113,253,4.766339181938244E-5,0,0,104,4,0,200,0,0
204658137,neilrmciver,10,818,67,143,0,7,19.57187488,10-19,435,5,3,4,7,7,3,4,7,3.3425054308,7688.1113766078,0.0045582321,0.119047619,0.35,0,59,9.251793784671673E-5,2.7099353E-5,2.742807E-5,182,1,0,199,0,0
205359259,checkraiseNS,10,20820,1013,911,37,17,42.7048183535,40-49,773,8,36,26,62,62,36,26,7,2.8055756698,835.7327522426,0.0280301093,0.0909571655,0.2780127,0,59,1.8425336302598986E-4,2.5066902E-4,2.5370964E-4,147,68,0,199,0,0
205539960,Sarah4NWO,10,2130,504,230,38,0,47.7461238401,40-49,679,5,75,24,99,99,75,24,6,2.6665459812,573.6642397812,0.0833972122,0.1747062461,0.2789988,0,59,2.743219464842678E-4,5.148877E-4,5.211333E-4,25,17,0,200,0,0
205596173,BenBrisebois,10,22645,1006,1143,35,15,42.3567636982,40-49,769,8,65,126,191,191,65,126,6,2.2787834902,6391.6547455861,0.1284161256,0.1141636815,0.31191155,0,59,3.5480582272629055E-4,4.4713932E-4,4.5256317E-4,25,37,1,200,1,0.005
205988930,SteveFilipovic,10,8733,639,1058,30,1802,54.1117633219,50-59,740,8,90,133,223,223,90,133,6,2.3750905141,13172.6494578179,0.0677406049,0.0388235769,0.13259569,0,59,2.994832846886751E-4,6.165103E-4,6.2398857E-4,77,264,0,213,0,0
206022655,dougquan,10,484,382,239,21,0,42.9402673215,40-49,592,4,14,19,33,33,14,19,7,3.066980449,27.4010931585,0.0284601372,0.1628787879,0.37076923,0,59,3.1587732175115675E-4,1.0162257E-4,1.02855265E-4,175,5,0,200,0,0
206220968,TheresaLubowitz,10,6102,737,374,25,11,67.0966345716,60-69,720,7,74,35,109,109,74,35,6,2.6241853729,656.4970939356,0.0770965363,0.1331974176,0.31904763,0,59,3.159473605473263E-4,5.081129E-4,5.142763E-4,175,52,3,200,3,0.015
206340892,rrrwong,10,3888,485,476,28,73,43.740946651,40-49,656,6,16,20,36,36,16,20,6,2.6846488052,227.6911294324,0.0312356074,0.1531746032,0.35098523,0,59,1.2151185588206492E-4,1.1517225E-4,1.16569296E-4,182,5,1,200,1,0.005
207775670,GerryRogersMHA,10,1542,1650,520,45,5,50.5142678444,50-59,711,5,71,50,121,121,71,50,7,2.481173063,10182.6437885433,0.0875618293,0.0995179063,0.28542742,0,59,5.645900402507321E-4,4.8778835E-4,4.8684824E-4,147,151,0,200,0,0
208467742,PhilSoubliere,10,2184,149,314,1,0,38.4621959902,30-39,553,5,24,56,80,80,24,56,6,2.3196958726,470.7816216847,0.0430022209,0.1310126582,0.38690478,0,59,1.2614665379402626E-4,1.6937095E-4,1.7142543E-4,77,4,1,200,1,0.005
208672074,McKayInc,10,425,24,115,0,0,32.0903731699,30-39,537,4,7,7,14,14,7,7,7,2.9728457639,13.765279108,0.0082627238,0.1373626374,0.2651515,0,59,7.31977192486779E-5,5.4198706E-5,5.485614E-5,175,28,0,200,0,0
208776992,spankules,10,8169,486,531,26,6,47.5956739802,40-49,736,7,50,70,120,120,50,70,6,2.4608979001,2498.4874748799,0.057317772,0.1056022409,0.35632715,0,59,2.6181849269644926E-4,3.4551675E-4,3.497079E-4,175,23,0,200,0,0
209176493,1923Memoir,10,11400,1698,1902,52,11,48.616813972,40-49,749,7,3,12,15,15,3,12,6,2.7049239681,405.1206805659,0.0047693265,0.1523809524,0.3560606,0,59,1.2248118773998526E-4,2.7099353E-5,2.742807E-5,175,52,0,201,0,0
209488200,sho0oo,10,3958,273,367,0,2814,42.9481988885,40-49,693,6,0,0,0,0,0,0,0,0,0,0,0,0,62,150,4.766339181938244E-5,0,0,55,30,0,201,0,0
209603205,lornepw,10,4165,136,146,2,6,42.6195854868,40-49,622,6,28,36,64,64,28,36,6,2.5191889935,226.2800598128,0.0378355236,0.0850694444,0.3825911,0,59,1.2183759726785554E-4,1.9647031E-4,1.9885351E-4,77,6,1,200,1,0.005
209693045,Clapperdudgeon,10,5065,1501,1946,7,35,45.7740013799,40-49,691,7,33,58,91,91,33,58,6,2.3986241854,2270.1380478139,0.0245757905,0.0661782662,0.24954627,0,59,1.6977323196410053E-4,2.303445E-4,2.3313859E-4,175,38,3,208,3,0.0144230769
209750575,AlastairFraser,10,5767,380,621,9,0,44.1149932254,40-49,721,7,30,65,95,95,30,65,6,2.377262853,1266.2051821603,0.0395011833,0.0968645017,0.24679089,0,59,1.6449045313444394E-4,2.1001999E-4,2.1256754E-4,175,25,2,200,2,0.01
210695187,HRisInnovative,10,1873,342,502,7,12,43.1935677037,40-49,570,5,1,2,3,3,1,2,7,3.3055756698,0,3.5449754150513306E-4,0.5,0.5,0,59,4.9082377485836015E-5,1.3549677E-5,1.3714035E-5,175,0,0,200,0,0
211294453,nicodaigle,10,50997,1458,1929,28,754,46.4591912835,40-49,771,9,21,23,44,44,21,23,6,2.7458363505,6081.3339320898,0.0230225884,0.1072938689,0.38916257,0,59,1.947457686434641E-4,1.4904643E-4,1.5085438E-4,145,11,0,201,0,0
211550181,chrissanislo,10,5167,287,273,20,6,46.8301142328,40-49,700,7,4,3,7,7,4,3,7,3.5358435916,6.3257720553,0.0016531524,0.1666666667,0.3,0,59,6.228816390055448E-5,3.3874192E-5,3.4285087E-5,175,10,0,200,0,0
211634693,alexavellian,10,1698,613,999,20,349,49.8143982197,40-49,653,6,13,34,47,47,13,34,7,2.7273714699,3089.6354954188,0.0170063341,0.1216466235,0.2823613,0,59,1.2424312189392254E-4,9.484774E-5,9.599824E-5,175,25,0,200,0,0
212005915,rotaraf,10,2932,182,281,2,38,46.9126747142,40-49,580,6,0,1,1,1,0,1,7,4.3571428571,0,0,0,0,42,432,4.766339181938244E-5,0,6.8570175E-6,197,1,0,200,0,0
212096392,tamsau,10,784,3,21,0,0,11.3417172752,10-19,283,5,0,5,5,5,0,5,7,3.066956207,0,0,0.3,0.45,0,681,4.766339181938244E-5,0,6.8570175E-6,77,0,0,200,0,0
212350812,jecpond,10,261,17,171,0,2,24.2146281433,20-29,170,5,4,31,35,35,4,31,7,2.8120926865,8.5436834866,0.003883851,0.2672268908,0.51827955,0,59,5.759385578697765E-5,3.3874192E-5,3.4285087E-5,182,2,1,200,1,0.005
212392947,pelluca82,10,49,24,595,0,0,14.1758850186,10-19,194,3,0,1,1,1,0,1,7,4.3571428571,0,0,0,0,42,482,4.766339181938244E-5,0,6.8570175E-6,197,0,0,51,0,0
212691017,AmeEspinosaa,10,1101,153,543,0,59,31.9618409507,30-39,599,5,1,1,2,2,1,1,3,2,0,8.095914281419891E-5,0,0,48,133,8.05725874402837E-5,1.3549677E-5,1.3714035E-5,127,44,0,200,0,0
212703871,JulienMtz,10,6518,157,30,0,218,41.685822001,40-49,729,7,2,2,4,4,2,2,1,1,0,1.6551228476954845E-4,0.0833333333,1,110,248,3.177448371356425E-4,2.0324514E-5,2.0571053E-5,101,50,0,201,0,0
212942917,JeanAProulx,10,1933,331,575,12,49,46.8524625555,40-49,611,5,47,95,142,142,47,95,6,2.3812454743,3738.7883776675,0.0688005343,0.1076316052,0.2711162,0,59,2.554321415603622E-4,3.2519223E-4,3.2913685E-4,175,42,0,200,0,0
213023643,Calgary62,10,5086,131,69,8,26,32.6845261001,30-39,632,6,10,5,15,15,10,5,7,3.2233888487,3.4691417976,0.0062911801,0.1571428571,0.6888889,0,59,8.285775135368621E-5,7.452322E-5,7.542719E-5,175,7,0,200,0,0
213126390,zinejdarita,10,987,264,322,6,7,41.2108099962,40-49,596,5,49,42,91,91,49,42,7,2.716147719,151.7598888831,0.0657747426,0.2052503053,0.39017543,0,59,2.185374837767446E-4,3.387419E-4,3.4285086E-4,25,21,2,200,2,0.01
213666045,Mark_Bain,10,760,196,589,11,13,44.6692995657,40-49,536,5,9,14,23,23,9,14,7,3.0916002896,605.3149940631,0.002633631,0.023715415,0.083333336,0,59,9.911339166775193E-5,6.7748384E-5,6.8570174E-5,175,8,0,199,0,0
213705283,sashaFiiERCE_,10,9422,125,408,0,4,39.0879098107,30-39,696,6,0,2,2,2,0,2,8,3.9989142237,0,0,0.5,0.5,0,317,4.766339181938244E-5,0,6.8570175E-6,175,3,0,200,0,0
213751216,cameronsgray,10,1368,855,1798,32,80,63.2714161617,60-69,637,6,41,91,132,132,41,91,6,2.3750905141,4278.4275815282,0.0626180121,0.1136363636,0.27217823,0,59,2.6425358805131255E-4,2.845432E-4,2.8799474E-4,182,14,4,200,4,0.02
213915057,kimberlyagapi,10,1088,56,50,0,260,30.0576644191,30-39,574,4,1,1,2,2,1,1,7,3.5271542361,0,3.0582412155350945E-4,0,0,0,59,5.376466550426384E-5,1.3549677E-5,1.3714035E-5,175,1,0,200,0,0
213958282,Bill_world,10,7182,730,846,51,249,53.9802924599,50-59,715,7,6,8,14,14,6,8,7,2.7820419986,590.2456805917,0.0086560947,0.0549450549,0.19444445,0,59,8.660582985036121E-5,4.742387E-5,4.799912E-5,182,3,0,200,0,0
214324469,tfalcone86,10,9204,378,486,9,0,57.5567771868,50-59,722,7,28,32,60,60,28,32,6,2.4808110065,368.926754555,0.0451908087,0.2,0.4146939,0,59,1.506051303342794E-4,1.9647031E-4,1.9885351E-4,175,19,0,203,0,0
214494357,DartmouthDerek,10,7181,1149,1501,22,653,59.4624759833,50-59,755,7,60,78,138,138,60,78,6,2.3530050688,5625.5099071478,0.0656283386,0.0602454247,0.19389902,0,59,2.6560192866461176E-4,4.1326514E-4,4.1827807E-4,147,61,0,200,0,0
214946558,LibConcordia,10,117,156,47,5,0,41.7051578767,40-49,519,4,16,34,50,50,16,34,6,2.5238957277,198.1154703728,0.0478320679,0.2208163265,0.560054,0,59,2.3374801675396184E-4,1.1517225E-4,1.16569296E-4,175,11,1,187,1,0.0053475936
215476372,scholzie21,10,1988,135,301,1,47,44.1324205468,40-49,607,6,2,6,8,8,2,6,7,3.0792903693,4.2670280484,0.0083350706,0.2857142857,0.4642857,0,59,5.9177104267620355E-5,2.0324514E-5,2.0571053E-5,175,1,0,200,0,0
215501705,Matthew_Barlow,10,44871,967,764,43,43,50.6182049199,50-59,806,9,56,57,113,113,56,57,6,2.4746560463,721.447488463,0.0729564481,0.0661346397,0.41158193,0,59,2.0169426469153595E-4,3.8616578E-4,3.9085E-4,77,54,0,202,0,0
215839962,anardozi,10,5185,290,415,8,322,43.3043871225,40-49,628,7,10,17,27,27,10,17,7,2.8370745836,176.4063778867,0.0082703661,0.1438746439,0.31385282,0,59,8.199005109743253E-5,7.452322E-5,7.542719E-5,77,9,1,196,1,0.0051020408
215983210,wsadave,10,315,49,116,0,3,29.4926729526,20-29,434,4,22,35,57,57,22,35,6,2.8073859522,92.5348518558,0.015097845,0.1563283208,0.6118619,0,59,1.46909062650511E-4,1.5582128E-4,1.577114E-4,147,21,0,200,0,0
215995013,ByronSanford,10,3819,332,315,8,745,46.5889550692,40-49,638,6,0,0,0,0,0,0,0,0,0,0,0,0,60,148,4.766339181938244E-5,0,0,53,0,0,201,0,0
216273727,taweetthis,10,3348,285,793,4,8,41.3393647503,40-49,607,6,17,36,53,53,17,36,7,2.9417089066,539.7318474556,0.0135878264,0.1201015965,0.2987805,0,59,1.3447471936301708E-4,1.2194709E-4,1.2342632E-4,147,10,0,200,0,0
216394071,unitedlabour,10,511,160,456,3,3,44.635871873,40-49,598,5,34,67,101,101,34,67,6,2.4482259232,2203.0830238493,0.0260007209,0.0894059406,0.3061963,0,59,1.4726860036226474E-4,2.3711934E-4,2.3999561E-4,182,56,0,200,0,0
216475552,darrenhill1,10,4166,1492,839,70,4,52.1885978924,50-59,731,7,35,35,70,70,35,35,6,2.4949312093,1711.7184495721,0.0370651269,0.1033126294,0.29294118,0,59,2.146674960489934E-4,2.4389417E-4,2.4685264E-4,25,40,0,202,0,0
216513475,MayorOfKingston,10,1265,2355,460,91,212,53.6009457488,50-59,732,5,34,11,45,45,34,11,7,3.0586531499,203.2170328936,0.0240750729,0.0934343434,0.17071524,0,59,2.687225519197749E-4,2.3711934E-4,2.3999561E-4,175,93,0,200,0,0
216554278,kosmovinylHAF,10,38,29,35,1,0,24.2740429206,20-29,89,1,15,0,15,15,15,0,0,0,0,0.0393673227,0.4571428571,0.8142857,0,8,1.2860159418686735E-4,1.0839741E-4,0,25,0,0,40,0,0
216609343,hpliszka,10,7310,450,913,12,16,60.1004120314,60-69,704,7,21,29,50,50,21,29,6,2.4963794352,290.8540429312,0.0235213792,0.1440816327,0.31341463,0,59,1.070125113893727E-4,1.4904643E-4,1.5085438E-4,77,40,0,201,0,0
216732503,caw_kaikit,10,4871,172,153,5,2,47.0277327722,40-49,644,7,55,32,87,87,55,32,6,2.5452570601,1187.38842432,0.0701662294,0.1121357926,0.263214,0,59,3.260880519893814E-4,3.7939096E-4,3.8399297E-4,182,76,1,201,1,0.0049751244
216787361,DanBurritt,10,4408,2380,1324,101,147,54.411734724,50-59,750,7,90,49,139,139,90,49,7,2.6292541636,3183.1838991082,0.0790264771,0.094307163,0.19465895,0,59,5.932487963075106E-4,6.165103E-4,6.1027455E-4,182,20,1,200,1,0.005
216822870,JBSmokyday,10,1143,1121,1041,33,145,44.3095561462,40-49,627,5,27,32,59,59,27,32,6,2.5622737147,1038.7813601756,0.0249801792,0.0587375804,0.22522523,0,59,1.3084683020707437E-4,1.8969548E-4,1.9199649E-4,77,10,1,200,1,0.005
217177064,Elaine4mortgage,10,1306,278,398,9,3,45.1667689536,40-49,625,5,0,1,1,1,0,1,7,3.5258776692,0,0,0,0,0,216,4.766339181938244E-5,0,6.8570175E-6,147,0,0,200,0,0
217193419,imagineacircle,10,2161,421,915,15,23,63.2372906716,60-69,633,5,2,2,4,4,2,2,7,2.8645908762,12.960979565,0.0019810132,0.0833333333,0.33333334,0,59,6.276994682687292E-5,2.0324514E-5,2.0571053E-5,182,2,0,200,0,0
217251219,iiibooo,10,12061,1704,1787,70,5,43.4392133723,40-49,770,7,30,27,57,57,30,27,6,2.5825488776,8438.3388985889,0.0430876129,0.0629699248,0.29829547,0,59,2.30482170154504E-4,2.1001999E-4,2.1256754E-4,145,6,0,199,0,0
217286273,SINGTAOTeddy,10,1518,246,705,2,2,33.8334049168,30-39,577,5,8,37,45,45,8,37,7,2.7834902245,167.4144384791,0.0058871908,0.1449494949,0.2972973,0,59,9.064869552954336E-5,6.0973543E-5,6.171316E-5,175,2,0,200,0,0
217304371,MariannaWright,10,38,8,51,0,1,16.8844974908,10-19,42,2,0,1,1,1,0,1,7,3.4379297865,0,0,0,0,0,598,4.766339181938244E-5,0,6.8570175E-6,25,0,0,36,0,0
217338176,PuLPNoGood,10,460,71,153,0,34,22.658853933,20-29,505,4,3,8,11,11,3,8,6,2.8146270818,16.6061892934,0.005956797,0.0727272727,0.21428572,0,59,5.95158375254654E-5,2.7099353E-5,2.742807E-5,175,5,0,199,0,0
217574180,Paola_mv,10,1305,158,301,0,15,40.0126162038,40-49,562,5,1,0,1,1,1,0,0,0,0,7.92005701980554E-5,0,0,65,154,8.817727671970712E-5,1.3549677E-5,0,265,1,0,201,0,0
217583369,CommieZombies,10,4191,437,618,13,52,45.54653021,40-49,731,6,19,36,55,55,19,36,6,2.4608979001,1607.4594151208,0.0158301527,0.0656565657,0.18397436,0,59,1.2443957846600497E-4,1.3549677E-4,1.3028333E-4,175,40,0,200,0,0
217586917,TTovatweet,10,637,170,191,0,4,27.6699427046,20-29,546,4,4,16,20,20,4,16,6,2.6937002172,346.6799851681,0.0057370302,0.2657894737,0.48039216,0,59,6.29485820666643E-5,3.3874192E-5,3.4285087E-5,25,13,0,200,0,0
217676483,CdeMbuso,10,304,23,59,0,5,41.1288135528,40-49,476,4,0,0,0,0,0,0,0,0,0,0,0,0,265,692,4.766339181938244E-5,0,0,272,0,0,200,0,0
217849245,TGCTS,10,6768,668,526,26,314,46.7636747327,40-49,728,7,16,7,23,23,16,7,7,3.1364952933,947.8393157361,0.0105101554,0.0750988142,0.20955883,0,59,2.0977984540599637E-4,1.1517225E-4,1.16569296E-4,175,37,0,198,0,0
218565801,Global_Montreal,10,18206,3248,1510,120,6,48.2153076304,40-49,765,7,20,28,48,48,20,28,7,2.7480086894,2090.2017660001,0.0147997385,0.0846631206,0.15576923,0,59,2.0937124215521908E-4,1.422716E-4,1.4399737E-4,175,31,0,200,0,0
219003291,FAPareja,10,588,35,83,0,0,38.6389885851,30-39,577,5,3,14,17,17,3,14,7,3.0887038378,2972.0395352778,0.002092191,0.1838235294,0.225,0,59,5.717518235318366E-5,2.7099353E-5,2.742807E-5,182,19,0,200,0,0
219007676,NeilJEdmondson,10,31170,1864,1453,59,64,52.5981577771,50-59,818,8,121,112,233,233,121,112,7,2.4808110065,13390.169706615,0.0667595534,0.0334282966,0.16597271,0,59,7.059632664543062E-4,8.265303E-4,8.3655614E-4,175,210,0,200,0,0
219492211,Aclark_2,10,13411,701,511,0,25,43.4395362846,40-49,762,7,0,0,0,0,0,0,0,0,0,0,0,0,17,85,4.766339181938244E-5,0,0,16,4,0,201,0,0
219775240,kennuck,10,29,16,42,0,0,18.0133778723,10-19,168,1,3,4,7,7,3,4,6,3.1158580739,2.1243271632,0.0013286817,0.1666666667,0.5,0,59,5.854451748713134E-5,2.7099353E-5,2.742807E-5,182,6,0,34,0,0
220005384,nikhalkias,10,2716,317,579,3,340,34.5612952679,30-39,674,6,0,5,5,5,0,5,7,3.4448063699,0,0,0.25,0.3,0,646,4.766339181938244E-5,0,6.8570175E-6,175,13,0,200,0,0
220203225,TriVestWealth,10,5611,4268,441,40,8,47.7428667666,40-49,687,6,3,2,5,5,3,2,7,3.2429398986,0.6510345566,0.0020656075,0.1,0.5,0,59,6.066771119848294E-5,2.7099353E-5,2.742807E-5,175,4,0,200,0,0
220518078,johnndp,10,213,7,30,0,3,17.7974754862,10-19,317,3,0,7,7,7,0,7,7,3.0043431053,0,0,0.380952381,0.5,0,205,4.766339181938244E-5,0,6.8570175E-6,25,0,0,200,0,0
220576066,yeepoa,10,2179,192,420,3,365,45.3423840381,40-49,640,6,13,29,42,42,13,29,6,2.5785662563,505.7165363032,0.0088533789,0.0609756098,0.16129032,0,59,9.058291089398579E-5,9.484774E-5,9.599824E-5,77,14,0,199,0,0
220607738,timanson,10,615,101,255,2,5,34.166788271,30-39,560,5,1,1,2,2,1,1,7,3.2679217958,0,8.070841687102028E-4,0,0,0,59,5.0805410034042593E-5,1.3549677E-5,1.3714035E-5,175,3,0,200,0,0
220692202,RTRMedia,10,2542,891,1013,20,184,50.5494267908,50-59,690,6,3,9,12,12,3,9,7,3.1057204924,2844.067930027,0.0015282217,0.1060606061,0.25,0,59,1.6928585422936577E-4,2.7099353E-5,2.742807E-5,175,31,0,200,0,0
220765357,DanielDickin,10,1542,368,908,5,1,40.5778156769,40-49,680,5,40,82,122,122,40,82,7,2.4761042723,2265.8554358177,0.0357533504,0.1075734995,0.26355773,0,59,2.1074564970132177E-4,2.7776835E-4,2.811377E-4,175,15,0,200,0,0
220778300,cupedoll_500,10,25611,849,879,47,272,40.9639252092,40-49,772,9,84,82,166,166,84,82,6,2.39608979,4594.8703522031,0.0950559899,0.056626506,0.2488889,0,59,2.986547488859032E-4,5.7586125E-4,5.8284646E-4,77,22,3,201,3,0.0149253731
221074956,JBestCOPEDir,10,1137,158,95,2,0,41.9362310665,40-49,584,5,36,25,61,61,36,25,6,2.7190441709,489.6902367148,0.0324368485,0.0967213115,0.33658537,0,59,1.621276021569369E-4,2.5066902E-4,2.5370964E-4,182,38,0,200,0,0
221232525,SandyRCollins,10,3560,612,197,16,0,49.5666996994,40-49,751,6,20,12,32,32,20,12,7,3.0836350471,60.6883368852,0.010609402,0.1804435484,0.4,0,59,1.6665255531771883E-4,1.422716E-4,1.4399737E-4,147,76,0,201,0,0
221250191,barachoix,10,3027,214,737,5,19,28.3316593821,20-29,588,6,9,32,41,41,9,32,6,2.6089790007,281.8664730177,0.0157410276,0.1170731707,0.24621212,0,59,7.381673485142243E-5,6.7748384E-5,6.8570174E-5,77,2,1,200,1,0.005
221355278,LJNor,10,1905,249,580,2,90,42.4411485911,40-49,526,6,18,44,62,62,18,44,6,2.4561911658,159.895966636,0.0340949127,0.1099947118,0.32399577,0,59,1.0772640563888703E-4,1.2872192E-4,1.3028333E-4,182,10,1,202,1,0.004950495
221414237,kris_purdy,10,484,119,279,1,0,20.8617597695,20-29,405,4,1,17,18,18,1,17,7,2.7469225199,7.8218172617,0.0072676982,0.2156862745,0.31985295,0,59,5.409653606626543E-5,1.3549677E-5,1.3714035E-5,25,1,0,200,0,0
221519496,glenhansman,10,12205,1452,1426,55,0,56.1970022965,50-59,764,8,81,67,148,148,81,67,7,2.6335988414,4264.3656107976,0.0827836245,0.0770362199,0.26654297,0,59,3.934050771912854E-4,5.555367E-4,5.622754E-4,182,145,0,199,0,0
221579366,NSValley,10,3752,147,301,4,3,44.2114159339,40-49,634,7,26,57,83,83,26,57,6,2.4134685011,2995.2127308844,0.0347458466,0.1404642962,0.3519302,0,59,1.9013709720454847E-4,1.8292063E-4,1.7828245E-4,77,11,1,204,1,0.0049019608
222819990,SocialDemoMatty,10,810,132,489,2,4,38.0133163228,30-39,543,5,21,79,100,100,21,79,6,2.2603186097,1891.3737906824,0.0364926823,0.1332323232,0.2981175,0,59,1.259815746753084E-4,1.4904643E-4,1.5085438E-4,182,1,0,200,0,0
222874113,PeterNeilsonPMN,10,3213,656,1982,7,96,36.1692730965,30-39,643,6,28,76,104,104,28,76,6,2.528602462,1650.6620572283,0.0348082148,0.1110903659,0.27766958,0,59,1.7170244067910717E-4,1.9647031E-4,1.9885351E-4,175,3,0,200,0,0
223173217,lamat_rising,10,5196,109,84,7,0,36.0856433898,30-39,650,6,7,2,9,9,7,2,7,3.2338884866,5.1856371573,0.0049638521,0.0972222222,0.15277778,0,59,6.765528248253419E-5,5.4198706E-5,5.485614E-5,77,9,0,201,0,0
223320350,susankim6722,10,2625,229,462,9,50,35.6992518573,30-39,631,5,34,64,98,98,34,64,6,2.4996379435,1551.6408612078,0.0548723645,0.1242373238,0.342711,0,59,1.90145051594117E-4,2.3711934E-4,2.3999561E-4,25,10,0,200,0,0
223321367,GregorsGreenBK,10,5403,523,362,31,20,44.2541243283,40-49,669,7,21,22,43,43,21,22,7,2.963070239,416.2489487987,0.013541516,0.0863787375,0.3048433,0,59,2.327439359152399E-4,1.4904643E-4,1.5085438E-4,182,28,0,200,0,0
223516060,Mister_Twitt,10,2387,72,543,0,9,20.7035990189,20-29,572,6,16,78,94,94,16,78,6,2.4022447502,339.0603276648,0.0379263765,0.2203157172,0.40697673,0,59,1.34582802177308E-4,1.1517225E-4,1.16569296E-4,25,3,1,200,1,0.005
224142741,Robert_MacKay_,10,3069,57,23,1,75,47.6481354145,40-49,686,7,11,2,13,13,11,2,7,3.4938450398,11.7181919674,0.0112913127,0.1666666667,0.28846154,0,59,7.643072479795534E-5,8.129806E-5,8.228421E-5,182,115,0,202,0,0
224366663,ItsRyanClayton,10,8469,1683,1947,74,14,65.8833786466,60-69,759,7,104,151,255,255,104,151,6,2.2277335264,15408.1645855076,0.1202321897,0.0750964953,0.21260087,0,59,5.332854641119058E-4,7.1135804E-4,7.1998686E-4,182,240,0,200,0,0
224400947,pinkolefty,10,3596,260,422,5,109,47.6989197388,40-49,696,7,28,59,87,87,28,59,6,2.4265025344,857.0593736052,0.0335073043,0.1168136862,0.27408412,0,59,1.3375335252035873E-4,1.9647031E-4,1.9885351E-4,77,17,1,200,1,0.005
224438454,Bemtig,10,7037,193,276,4,3,45.3165004969,40-49,663,7,23,39,62,62,23,39,6,2.481897176,767.653779656,0.0297875357,0.0922792173,0.33963415,0,59,1.0799941663168796E-4,1.6259612E-4,1.6456842E-4,77,29,0,201,0,0
224786514,newswatchcanada,10,19775,1751,2000,68,3,38.8525270244,30-39,779,7,49,56,105,105,49,56,7,2.6028240406,3755.6777835877,0.0736530702,0.1083333333,0.26503164,0,59,3.7215253413804954E-4,3.387419E-4,3.4285086E-4,175,6,0,201,0,0
225166458,Querl_ParaDox,10,1952,255,1414,7,61,40.9945840837,40-49,570,5,2,25,27,27,2,25,6,2.5720492397,12.5402644035,0.0012772029,0.245014245,0.39666668,0,59,5.156118570562226E-5,2.0324514E-5,2.0571053E-5,182,2,0,200,0,0
225438673,peaceterry,10,366,39,155,0,0,26.5747335921,20-29,404,4,21,54,75,75,21,54,6,2.4073135409,285.2016453723,0.0370682179,0.1947747748,0.4423729,0,59,1.1908682404144644E-4,1.4904643E-4,1.5085438E-4,25,14,0,200,0,0
225516033,jspoupart,10,13720,387,929,11,106,51.4671538035,50-59,776,8,7,13,20,20,7,13,7,2.7711803041,86.5002567436,0.0124649523,0.0631578947,0.23076923,0,59,8.518935881691853E-5,5.4198706E-5,5.485614E-5,77,3,1,200,1,0.005
225966242,RmdReviewTorrie,10,1450,408,500,14,2,50.4508659231,50-59,632,5,2,1,3,3,2,1,7,3.7404055033,18.912207205,0.0019244441,0,0,0,59,5.847796954207064E-5,2.0324514E-5,2.0571053E-5,175,5,0,200,0,0
225998714,b0ngh1tt3r,10,12418,145,243,4,129,37.423341755,30-39,703,7,1,4,5,5,1,4,7,3.2588703838,754.3344114255,1.0971857430924134E-4,0.1,0.25,0,59,7.739826507714665E-5,1.3549677E-5,1.3714035E-5,175,18,0,200,0,0
226987255,sebastianobella,10,7477,4047,1720,3,22,38.5809121939,30-39,643,7,0,3,3,3,0,3,5,2.7142857143,0,0,0.3333333333,0.6666667,42,308,4.766339181938244E-5,0,6.8570175E-6,197,2,0,200,0,0
227002800,ZachJeffries10,10,1559,905,600,30,7,48.1952570163,40-49,683,6,39,48,87,87,39,48,6,2.5496017379,677.3426762279,0.0362720963,0.1471531676,0.35579455,0,59,2.0745168328317759E-4,2.7099354E-4,2.742807E-4,175,29,0,200,0,0
227328570,savardpat,10,531,30,72,1,4,15.6953720134,10-19,80,4,3,6,9,9,3,6,7,2.9674149167,0,0.0012726693,0.2916666667,0.71428573,0,59,5.329118046635133E-5,2.7099353E-5,2.742807E-5,175,0,0,200,0,0
227704544,aunttallulah,10,211,34,103,0,1,19.775884328,10-19,388,3,6,8,14,14,6,8,7,3.0329471398,1.8558297666,0.0105893993,0.1483516484,0.83928573,0,59,9.029807349144199E-5,4.742387E-5,4.799912E-5,25,0,0,200,0,0
228707979,o5carpapa,10,869,81,188,0,65,41.5983327078,40-49,646,6,24,57,81,81,24,57,6,2.5626357712,623.3659412472,0.023094457,0.0782407407,0.24780701,0,59,1.1434735536204844E-4,1.6937095E-4,1.7142543E-4,77,69,0,200,0,0
228751496,HelenaLamego,10,144,26,43,0,0,30.0406056031,30-39,487,3,2,2,4,4,2,2,3,2.1666666667,0.4166666667,1.784917808865624E-4,0.0833333333,0.5,58,182,8.933347482493614E-5,2.0324514E-5,2.0571053E-5,166,5,0,157,0,0
228826411,DianeThorneMLA,10,1413,639,248,35,94,46.2119289291,40-49,650,6,70,21,91,91,70,21,7,2.8924692252,1750.7343404405,0.0850645179,0.1709401709,0.34582084,0,59,4.0513291059159225E-4,4.8101353E-4,4.8684824E-4,182,48,1,200,1,0.005
228962972,AdamHobbsNDP,10,882,69,82,2,4,51.7419108155,50-59,547,5,18,21,39,39,18,21,7,2.5792903693,25.844829014,0.0370977461,0.173414305,0.5953846,0,59,1.1135211024071872E-4,1.2872192E-4,1.3028333E-4,25,9,1,199,1,0.0050251256
229067990,KasTwits,10,1446,34,60,0,1,28.8900686218,20-29,574,5,3,2,5,5,3,2,7,3.0423606083,241.092616355,0.0076426898,0.1,0.5,0,59,7.323383315716547E-5,2.7099353E-5,2.742807E-5,77,0,0,200,0,0
229929984,jeremybaarbe,10,3311,279,335,11,15,58.6599827493,50-59,701,6,9,19,28,28,9,19,7,2.7215785663,31.9059996364,0.0078002089,0.1111111111,0.23809524,0,59,7.309097954172443E-5,6.7748384E-5,6.8570174E-5,182,6,0,200,0,0
230166410,whittedo,10,67,9,19,0,1,20.3008353838,20-29,176,2,0,1,1,1,0,1,8,3.6178067318,0,0,0,0,0,143,4.766339181938244E-5,0,6.8570175E-6,182,0,0,113,0,0
230220287,Coteter,10,6008,217,298,10,1843,46.641993125,40-49,671,7,46,57,103,103,46,57,6,2.3338160753,601.7704556809,0.0608909868,0.0800494955,0.38687235,0,59,1.593536267812318E-4,3.1841738E-4,3.222798E-4,77,15,4,201,4,0.0199004975
231736397,unwornslinky,10,333,67,161,9,2,27.1393689655,20-29,464,4,2,4,6,6,2,4,7,2.9471397538,0.2488093947,0.0060838903,0.1,0.41666666,0,59,5.797859674167497E-5,2.0324514E-5,2.0571053E-5,25,3,2,196,2,0.0102040816
231957153,AgentK24,10,1085,60,65,0,160,38.2227595903,30-39,576,5,0,0,0,0,0,0,0,0,0,0,0,0,93,215,4.766339181938244E-5,0,0,84,4,0,198,0,0
231969013,EvanMenzies,10,1099,393,637,4,7,47.6290807452,40-49,694,6,39,49,88,88,39,49,7,2.60391021,3411.9800480458,0.0290149551,0.1154649948,0.3636612,0,59,2.2356759361887423E-4,2.7099354E-4,2.742807E-4,175,29,1,200,1,0.005
232316218,zeroedout420,10,694,55,315,0,23,18.1609935054,10-19,505,5,2,22,24,24,2,22,6,2.7346125996,16.5284602755,0.002772369,0.1847826087,0.27272728,0,59,5.2430843902344304E-5,2.0324514E-5,2.0571053E-5,182,1,1,200,1,0.005
232442911,philhampton,10,2008,233,177,3,42,40.5467564533,40-49,662,5,2,2,4,4,2,2,7,3.2954380883,0,0.001717851,0.0833333333,1,0,59,5.762615675352128E-5,2.0324514E-5,2.0571053E-5,25,6,0,199,0,0
233303806,aquiottawa,10,2130,30,109,0,15,29.1376394847,20-29,458,5,7,23,30,30,7,23,6,2.6017378711,27.4585500705,0.0122501939,0.1540229885,0.32971016,0,59,6.99377173969577E-5,5.4198706E-5,5.485614E-5,77,4,0,200,0,0
233426838,SaskNDPYouth,10,828,377,263,13,31,46.2476343275,40-49,646,5,87,87,174,174,87,87,7,2.4055032585,2634.0536909136,0.1070679044,0.1091289615,0.2987097,0,59,3.560108737089446E-4,5.9618574E-4,6.034175E-4,25,112,0,199,0,0
233749323,MaggiePriceless,10,90603,10582,9471,439,25,72.0509208238,70-79,899,10,99,102,201,201,99,102,6,2.2972483707,16425.914743513,0.1195131558,0.0440298507,0.2768315,0,59,3.8827249115342473E-4,6.774838E-4,6.857017E-4,77,33,0,203,0,0
233948870,RajShermanMLA,10,3439,5491,408,185,14,57.5339100366,50-59,779,6,144,31,175,175,144,31,6,2.7005792904,6760.9142827597,0.1055275984,0.0646305419,0.12536913,0,59,8.094191701647597E-4,9.823516E-4,9.874105E-4,175,74,0,200,0,0
234517520,BdotROYdot,10,139,31,30,1,11,16.7720395459,10-19,338,3,0,2,2,2,0,2,7,3.1592471951,0,0,0.5,0.5,0,604,4.766339181938244E-5,0,6.8570175E-6,175,1,1,130,1,0.0076923077
234909466,opticverve,10,11629,264,307,3,831,45.6540875309,40-49,692,7,12,12,24,24,12,12,7,2.8653149891,214.0185842707,0.0209952747,0.0778985507,0.23161764,0,59,2.3163684803978598E-4,8.80729E-5,8.914123E-5,77,5,0,198,0,0
234910661,spencersi,10,777,33,27,1,1,28.496994591,20-29,491,5,2,0,2,2,2,0,0,0,0,0.0022445511,0,0,0,19,5.567758012109505E-5,2.0324514E-5,0,77,0,0,199,0,0
234985641,Moerockin,10,1576,145,173,4,0,38.3755697529,30-39,584,5,18,29,47,47,18,29,6,2.6734250543,211.4580079174,0.0206642285,0.170212766,0.3634424,0,59,1.1377438788844997E-4,1.2872192E-4,1.3028333E-4,182,10,1,200,1,0.005
235029133,CharlenePDobie,10,235,254,433,15,0,30.6538837119,30-39,567,4,12,16,28,28,12,16,7,2.8131788559,112.0367997159,0.0144475429,0.1018518519,0.43382353,0,59,1.1528069324941121E-4,8.80729E-5,8.914123E-5,182,3,0,199,0,0
236036725,ReyesSerpi14,10,3232,218,269,0,119,39.8141805249,30-39,646,6,1,2,3,3,1,2,1,1,0,8.273692819691865E-5,0.1666666667,1,221,546,2.2297922269865863E-4,1.3549677E-5,1.3714035E-5,225,23,0,198,0,0
236548706,DiegosaurusRex,10,4580,233,518,4,12,42.7971954091,40-49,662,6,1,13,14,14,1,13,7,2.9558291093,1.2881222297,0.0028295016,0.1648351648,0.22435898,0,59,5.193430382475664E-5,1.3549677E-5,1.3714035E-5,175,7,0,200,0,0
236600104,mabweinberger,10,613,510,76,14,2,47.0280041087,40-49,680,4,29,7,36,36,29,7,7,3.0191889935,100.0092360956,0.0274329853,0.1420634921,0.2956989,0,59,1.512160798449316E-4,2.0324514E-4,2.0571053E-4,182,16,0,200,0,0
236601329,MATTEO_F27,10,1377,383,1662,0,90,31.7099749175,30-39,567,5,0,2,2,2,0,2,6,3.4285714286,0,0,0.5,1,42,506,4.766339181938244E-5,0,6.8570175E-6,197,0,0,198,0,0
237052663,holtom2000,10,2721,76,147,1,16,31.814438919,30-39,624,6,3,4,7,7,3,4,7,2.9471397538,0.2836372662,0.0049731267,0.119047619,0.6666667,0,59,5.7938435932592385E-5,2.7099353E-5,2.742807E-5,175,5,0,200,0,0
237166854,ElisaJasso,10,2465,232,223,0,7,41.7938931684,40-49,675,6,2,2,4,4,2,2,5,3.125,15.5,1.6908911076522195E-4,0,0,31,107,2.811523778832337E-4,2.0324514E-5,2.0571053E-5,108,21,0,200,0,0
237248191,Gray_is_good,10,10792,1060,1750,19,367,55.0089813209,50-59,742,8,4,10,14,14,4,10,7,3.0528602462,163.3474062939,0.0014563315,0.0549450549,0.14545454,0,59,8.603154436717366E-5,3.3874192E-5,3.4285087E-5,77,5,0,200,0,0
237404095,dardsa,10,1447,25,231,0,20,27.6692733765,20-29,442,5,0,19,19,19,0,19,6,2.6666666667,0,0,0.3391812865,0.50584793,0,92,4.766339181938244E-5,0,6.8570175E-6,175,2,1,200,1,0.005
237781463,veroseblanche,10,2758,360,595,4,5,39.3406856696,30-39,594,5,3,5,8,8,3,5,7,2.8530050688,51.1652863364,0.0053695586,0.1071428571,0.33333334,0,59,6.106105216490711E-5,2.7099353E-5,2.742807E-5,145,0,0,200,0,0
237901118,Robert_Johnston,10,348,223,468,12,1,34.270300744,30-39,552,3,14,10,24,24,14,10,6,2.887038378,41.0584697507,0.0156813794,0.1268115942,0.30409357,0,59,1.3633106322569937E-4,1.0162257E-4,1.02855265E-4,77,0,20,200,15,0.075
238744876,symphily,10,56975,2208,1685,159,249,54.9971290237,50-59,846,9,53,45,98,98,53,45,6,2.5568428675,1977.6128697975,0.048968155,0.0469177362,0.21157219,0,59,2.1940814418751263E-4,3.6584126E-4,3.7027895E-4,182,285,0,201,0,0
239409320,kevinkindred,10,4712,1467,491,50,210,49.6717275373,40-49,785,8,44,27,71,71,44,27,6,2.6567704562,787.3290661474,0.0542159225,0.1215291751,0.32256895,0,59,2.7294586389957045E-4,3.0486772E-4,3.085658E-4,147,9,0,200,0,0
239489739,SirLoinn,10,15592,103,90,4,7737,37.2378453381,30-39,701,8,11,1,12,12,11,1,7,3.481173063,0.9254011478,0.0132199299,0.2727272727,0.45454547,0,59,7.55892952962017E-5,8.129806E-5,8.228421E-5,77,22,0,241,0,0
239649168,LauraCBarker,10,225,130,84,4,0,40.6633462871,40-49,529,3,13,8,21,21,13,8,7,3.0459811731,20.9664763551,0.01537489,0.2166666667,0.5625,0,59,9.978152080275625E-5,9.484774E-5,9.599824E-5,182,2,1,197,1,0.0050761421
239778295,jus_catalano,10,3440,190,587,3,4,42.1706133818,40-49,648,6,0,1,1,1,0,1,1,1,0,0,0,0,205,523,4.766339181938244E-5,0,6.8570175E-6,209,0,0,200,0,0
239993455,taylornoakes,10,5105,268,371,10,9,46.8901991964,40-49,675,6,11,12,23,23,11,12,7,2.7527154236,24.4329043318,0.0206655354,0.2114624506,0.4502924,0,59,8.759817569900803E-5,8.129806E-5,8.228421E-5,25,9,5,205,5,0.0243902439
240054606,SherryDowson,10,1674,211,767,1,80,29.0489215104,20-29,592,6,45,123,168,168,45,123,6,2.2729905865,7523.0934486252,0.0528737678,0.0824422583,0.21702072,0,59,1.9474382576444778E-4,3.1164257E-4,3.154228E-4,182,13,0,200,0,0
240318436,bmyska,10,6708,1502,1799,21,5655,53.372587411,50-59,751,7,74,102,176,176,74,102,7,2.4507603186,11978.718998189,0.0361652323,0.0499675325,0.23243861,0,59,4.1387973567384885E-4,5.081129E-4,5.142763E-4,175,209,0,202,0,0
240348122,JordanP90,10,15410,229,498,5,52,48.925794826,40-49,767,7,18,53,71,71,18,53,6,2.5126719768,492.932640283,0.0278020044,0.1931589537,0.39153007,0,59,1.4136813931924693E-4,1.2872192E-4,1.3028333E-4,175,86,0,201,0,0
240679098,mclennonld,10,74,13,51,0,5,12.5541969358,10-19,123,2,2,12,14,14,2,12,7,3.0358435916,1.1244963884,0.0027798387,0.2472527473,0.46212122,0,59,5.640722037314309E-5,2.0324514E-5,2.0571053E-5,147,1,1,77,1,0.012987013
240707282,nocomment84,10,89,58,175,1,1,20.6432112834,20-29,375,3,27,59,86,86,27,59,6,2.5506879073,156.9124878547,0.0541608575,0.1916552668,0.4780886,0,59,1.7778386251709137E-4,1.8969548E-4,1.9199649E-4,25,4,4,90,4,0.0444444444
240712291,rsmollisonread,10,8515,559,740,8,314,55.64468706,50-59,629,7,3,6,9,9,3,6,7,2.9496741492,3.5336146126,0.003847168,0.1944444444,0.42857143,0,59,5.4818561744242345E-5,2.7099353E-5,2.742807E-5,175,0,0,201,0,0
240760525,JoelWWood,10,12719,821,789,42,2243,55.3175322659,50-59,753,8,35,26,61,61,35,26,7,2.7505430847,1699.111568425,0.0320173967,0.0784153005,0.15943877,0,59,2.3269316328228707E-4,2.4389417E-4,2.4685264E-4,175,38,0,200,0,0
240966724,ecoutepasca,10,2791,217,1763,1,59,44.4026671094,40-49,649,6,14,94,108,108,14,94,7,2.3609703114,661.2983206949,0.0213017584,0.2472308757,0.4546602,0,59,1.0430233130849295E-4,1.0162257E-4,1.02855265E-4,25,7,0,200,0,0
241797395,rustygreen59,10,13412,4098,4416,63,288,57.3023584694,50-59,774,8,128,169,297,297,128,169,6,2.2451122375,13949.4935164245,0.1190304883,0.0436004186,0.21513103,0,59,3.978966332262108E-4,8.7395415E-4,8.845553E-4,77,43,0,199,0,0
241985595,El_iiisa,10,46128,1005,99,105,578,41.46080188,40-49,799,9,3,1,4,4,3,1,5,3.1666666667,0,2.65020683248631E-4,0.25,0.6666667,58,182,1.3356859152595236E-4,2.7099353E-5,2.742807E-5,166,13,0,201,0,0
242038643,tammyrobert,10,6184,1616,927,76,11,54.8007209915,50-59,760,7,26,41,67,67,26,41,6,2.5944967415,1327.996445589,0.0233312482,0.0997286296,0.27636054,0,59,1.7792429833167679E-4,1.8292063E-4,1.8513948E-4,25,92,0,201,0,0
242123168,PhotogShawn,10,2599,209,522,0,11,43.8948207972,40-49,640,6,39,108,147,147,39,108,6,2.2614047791,2021.9081682917,0.0528873973,0.0780449166,0.20777085,0,59,1.6483272903446497E-4,2.7099354E-4,2.742807E-4,77,27,0,200,0,0
242377253,Airseir,10,1778,113,63,7,39,44.882435546,40-49,547,5,0,0,0,0,0,0,0,0,0,0,0,0,37,117,4.766339181938244E-5,0,0,34,1,0,200,0,0
242394505,ChrisQuines,10,9295,350,680,13,1478,54.0124904298,50-59,744,7,35,66,101,101,35,66,6,2.4779145547,1180.1891159942,0.0310815451,0.1063366337,0.29229915,0,59,1.8064560633830961E-4,2.4389417E-4,2.4685264E-4,175,35,0,207,0,0
242571362,fowlerkp,10,884,48,279,0,10,20.5307614406,20-29,513,5,4,16,20,20,4,16,7,2.6267197683,0.2327234749,0.0196601125,0.2684210526,0.675,0,59,7.093076784904651E-5,3.3874192E-5,3.4285087E-5,25,6,0,199,0,0
242846644,Cherylstad,10,745,228,117,12,2,43.3844433517,40-49,562,5,44,22,66,66,44,22,6,2.5876176684,572.1848430078,0.0494857515,0.1137529138,0.3044898,0,59,2.0226328757053281E-4,3.0486772E-4,3.085658E-4,182,14,3,200,3,0.015
242867688,TeamAdam76,10,13557,1113,1121,19,947,52.8354703739,50-59,756,8,35,46,81,81,35,46,7,2.5680666184,3278.8762848684,0.0195487602,0.0445987654,0.21187943,0,59,1.9088162450462459E-4,2.4389417E-4,2.4685264E-4,175,36,0,204,0,0
242975599,jeanoudy,10,4696,299,680,4,28,43.4090228885,40-49,694,7,55,117,172,172,55,117,6,2.2483707458,2353.2438065584,0.0845281475,0.105127159,0.30172062,0,59,1.9723606433257163E-4,3.7939096E-4,3.8399297E-4,77,9,0,198,0,0
243216737,MrFranchement,10,307,68,161,4,2,19.5909914693,10-19,307,4,4,4,8,8,4,4,7,2.8544532947,0.534006578,0.0094327117,0.2142857143,0.73333335,0,59,7.493219255686415E-5,3.3874192E-5,3.4285087E-5,145,0,1,199,1,0.0050251256
243225102,UFCW401,10,829,280,203,4,0,46.7080863238,40-49,596,5,62,49,111,111,62,49,6,2.5579290369,4159.4768170427,0.0698266512,0.1122850123,0.280139,0,59,2.942088319102415E-4,4.268148E-4,4.2513508E-4,182,67,8,200,8,0.04
243323605,BJSiekierski,10,908,168,188,11,4,46.2520842135,40-49,616,5,17,27,44,44,17,27,6,2.5861694424,65.92418814,0.0405850763,0.2367864693,0.4751067,0,59,2.636385417972067E-4,1.2194709E-4,1.2342632E-4,175,20,2,200,2,0.01
243346390,garrattguy,10,1083,39,124,0,4,34.8511336283,30-39,542,6,3,20,23,23,3,20,7,2.670166546,2.1580701052,0.0032034321,0.2964426877,0.53571427,0,59,5.5838276562134E-5,2.7099353E-5,2.742807E-5,175,5,2,201,2,0.0099502488
243620340,fgriebenow,10,1790,610,1975,2,94,46.7248499692,40-49,657,6,1,5,6,6,1,5,10,5.8812454743,150.5628280288,1.5584411420357073E-4,0.1666666667,0.4,0,59,1.8561525158315001E-4,1.3549677E-5,1.3714035E-5,131,0,0,200,0,0
243636449,Al_J_70,10,2842,298,659,6,28,37.9557605773,30-39,639,6,17,53,70,70,17,53,6,2.3667632151,915.7456618755,0.0248263469,0.1339544513,0.33962265,0,59,1.0422293146621101E-4,1.2194709E-4,1.2342632E-4,147,1,0,200,0,0
244085908,LizzyM_TO,10,6421,384,546,0,721,47.9389378076,40-49,697,7,25,46,71,71,25,46,6,2.3899348298,713.5190659062,0.0325009363,0.0873239437,0.294686,0,59,1.634685598894243E-4,1.761458E-4,1.7828245E-4,77,21,0,200,0,0
244170872,blabalade,10,141313,1828,2006,41,2840,47.2994853493,40-49,786,10,1,2,3,3,1,2,7,3.744750181,8.0263961639,2.483936031275135E-4,0,0,0,59,5.486052017836622E-5,1.3549677E-5,1.3714035E-5,145,2,0,201,0,0
244299485,greenmarcel,10,2113,79,58,0,26,27.0760765394,20-29,600,6,19,11,30,30,19,11,6,2.6527878349,57.7148784393,0.0326592298,0.1781609195,0.40942028,0,59,1.1257930987997226E-4,1.3549677E-4,1.3714035E-4,77,1,2,200,2,0.01
244650352,Chuckw12,10,1000,7,47,0,6,13.8612966293,10-19,217,5,0,4,4,4,0,4,7,3.0329352153,0,0,0.3333333333,0.5,0,377,4.766339181938244E-5,0,6.8570175E-6,175,1,0,200,0,0
244680936,thefamousmrX,10,2743,86,425,2,14,31.4696006383,30-39,596,6,2,6,8,8,2,6,7,2.8837798697,2.2439823364,0.002140412,0.2321428571,0.42857143,0,59,5.333230697121133E-5,2.0324514E-5,2.0571053E-5,175,0,0,199,0,0
244695832,cakeis_not_alie,10,11778,378,307,16,16,56.2308913398,50-59,743,8,2,2,4,4,2,2,7,3.4029688631,0.5130972578,0.0017429143,0.0833333333,0.083333336,0,59,5.249015926433383E-5,2.0324514E-5,2.0571053E-5,175,2,0,201,0,0
244816624,pau1234la,10,3833,245,497,3,389,42.8478660992,40-49,682,6,20,36,56,56,20,36,7,2.659666908,173.5131266974,0.0188337087,0.1525974026,0.4831309,0,59,1.2388437857548628E-4,1.422716E-4,1.4399737E-4,25,29,0,200,0,0
245030913,jenccrane,10,3022,604,1289,12,8,46.3203693208,40-49,665,6,74,139,213,213,74,139,6,2.3106444605,4141.011789058,0.1208616208,0.10647533,0.30809844,0,59,5.600712151547358E-4,5.081129E-4,5.142763E-4,175,25,9,200,8,0.04
245095160,Erasmus111,10,3551,69,121,6,145,43.0131365875,40-49,609,6,6,6,12,12,6,6,7,2.8902968863,3.2269268133,0.0099607957,0.25,0.47777778,0,59,8.381461569755585E-5,4.742387E-5,4.799912E-5,77,11,1,200,1,0.005
245212504,mikelondoncan,10,663,340,358,11,2696,49.8237850801,40-49,747,7,58,64,122,122,58,64,6,2.4569152788,1505.7180623392,0.1057255157,0.1266766021,0.29649967,0,59,3.332004914999518E-4,3.9971547E-4,4.0456402E-4,25,47,0,199,0,0
245839288,carolyn1775,10,471,37,162,0,0,21.3573355193,20-29,607,4,0,2,2,2,0,2,7,2.9348534202,0,0,0.5,1,0,661,4.766339181938244E-5,0,6.8570175E-6,147,0,0,199,0,0
245901552,ClayoquotKid,10,2989,247,200,8,5,46.1918031863,40-49,645,6,4,4,8,8,4,4,7,3.2679217958,50.1834079264,0.0015706642,0.0178571429,0.1,0,59,7.372397263304893E-5,3.3874192E-5,3.4285087E-5,182,14,0,200,0,0
246233323,Mashiy_Amahle,10,796,87,350,1,6,31.702255561,30-39,590,5,1,3,4,4,1,3,9,4.8175235337,0,9.91792649757776E-5,0.25,0.6666667,0,59,7.455257925577865E-5,1.3549677E-5,1.3714035E-5,131,9,0,200,0,0
246305835,eco_images,10,3907,530,420,29,0,46.218526425,40-49,697,6,9,8,17,17,9,8,7,2.7523533671,25.9452584726,0.0137767787,0.0477941176,0.33333334,0,59,7.692037967317524E-5,6.7748384E-5,6.8570174E-5,77,2,0,200,0,0
246538797,jamesjcowan,10,7511,93,142,1,56,38.5943112848,30-39,595,7,0,1,1,1,0,1,2,1.5,0,0,0,0,0,184,4.766339181938244E-5,0,6.8570175E-6,77,0,0,202,0,0
246619351,east_TO,10,24,2,14,0,0,17.489025987,10-19,62,1,0,1,1,1,0,1,7,3.4813608397,0,0,0,0,0,564,4.766339181938244E-5,0,6.8570175E-6,175,0,0,27,0,0
246823640,1girlonthehill,10,819,144,279,3,4,29.2849033492,20-29,551,5,42,84,126,126,42,84,6,2.4272266474,290.9983730445,0.0923181487,0.1803174603,0.4836422,0,59,2.4453977726313406E-4,2.9131805E-4,2.9485175E-4,25,8,3,200,3,0.015
247034441,lovi_cynthia,10,2944,73,129,0,1,32.488963239,30-39,700,6,0,0,0,0,0,0,0,0,0,0,0,0,230,579,4.766339181938244E-5,0,0,234,10,0,199,0,0
247127083,ejshillington,10,316,209,224,6,1,40.2839603796,40-49,573,4,45,38,83,83,45,38,7,2.6955104996,375.2890576932,0.0637540348,0.1168086982,0.42627534,0,59,2.1431624567220907E-4,3.1164257E-4,3.154228E-4,182,20,4,200,4,0.02
247228394,MiddlesbroughGC,10,66,156,361,0,11,32.1442748525,30-39,400,3,0,0,0,0,0,0,0,0,0,0,0,0,177,380,4.766339181938244E-5,0,0,177,5,0,67,0,0
247404995,michelineless,10,1438,81,273,7,4,25.6013855861,20-29,381,6,12,31,43,43,12,31,7,2.4341057205,24.5490057552,0.0179706688,0.238648948,0.5344538,0,59,7.670308379952542E-5,8.80729E-5,8.914123E-5,25,0,2,200,2,0.01
247447586,LarisaCardee12,10,1887,253,360,2,690,40.2527139515,40-49,625,6,1,1,2,2,1,1,2,1.6666666667,0,8.44770929948927E-5,0,0,100,225,2.205056735505623E-4,1.3549677E-5,1.3714035E-5,237,2,0,201,0,0
247478131,heron09,10,4561,63,183,1,251,35.2310246004,30-39,524,7,19,40,59,59,19,40,6,2.4290369298,221.0384408883,0.0371714252,0.1583869082,0.34574467,0,59,1.062406174621098E-4,1.3549677E-4,1.3714035E-4,77,5,3,205,3,0.0146341463
247609737,Natalie_Rizzo,10,856,254,270,8,18,40.9107166048,40-49,584,5,3,9,12,12,3,9,7,3.0130340333,22.8554163674,0.002454388,0.1136363636,0.2361111,0,59,6.227034636752734E-5,2.7099353E-5,2.742807E-5,25,7,0,199,0,0
247875083,HaShilthSa,10,1167,411,166,11,12,45.8005998149,40-49,607,5,19,13,32,32,19,13,6,2.7411296162,169.1017526153,0.0090816712,0.0977822581,0.16137566,0,59,1.1774925370115508E-4,1.3549677E-4,1.3714035E-4,77,16,0,198,0,0
248039154,polisKennedy,10,3019,387,833,11,104,43.0830516731,40-49,668,6,12,31,43,43,12,31,6,2.4656046343,1237.5803635528,0.0224891554,0.0974529347,0.26559138,0,59,1.0595225814986759E-4,8.80729E-5,8.914123E-5,77,6,0,200,0,0
248412992,firstcircle12,10,1780,270,337,3,241,46.9893277989,40-49,661,5,43,44,87,87,43,44,6,2.3892107169,1090.3598938202,0.0689483055,0.0689655172,0.32938775,0,59,1.728144667722414E-4,2.9809287E-4,3.0170876E-4,77,79,1,207,1,0.0048309179
248838169,ODLCPresident,10,5806,833,1957,17,236,51.893808708,50-59,699,7,93,143,236,236,93,143,5,2.2118030413,13295.8247228967,0.1174870603,0.0811756221,0.23794188,0,59,4.163121077738762E-4,6.3683477E-4,6.445596E-4,182,33,1,202,1,0.004950495
249122012,Jacopo2111,10,435,35,315,0,2,24.0026182388,20-29,492,4,0,1,1,1,0,1,7,4.3571428571,0,0,0,0,42,461,4.766339181938244E-5,0,6.8570175E-6,197,0,0,200,0,0
249128266,je67an,10,7094,642,584,19,72,48.8575474301,40-49,736,7,105,100,205,205,105,100,6,2.3428674873,8444.1368343959,0.1151720059,0.0450263032,0.29433963,0,59,3.2720841413882295E-4,7.181328E-4,7.2684383E-4,77,78,1,199,1,0.0050251256
249244100,GEEOFF_G,10,408,7,45,0,1,18.5688256103,10-19,447,4,0,2,2,2,0,2,8,4.095548317,0,0,0.5,0.5,0,638,4.766339181938244E-5,0,6.8570175E-6,175,0,0,43,0,0
249264319,ErikJohnline,10,589,77,150,3,0,43.9252429774,40-49,577,5,10,12,22,22,10,12,7,3.1469949312,89.5269471205,0.0048880353,0.1017316017,0.45054945,0,59,1.192144750186411E-4,7.452322E-5,7.542719E-5,77,16,1,200,1,0.005
249410426,MaieBahy,10,580,70,143,2,1,20.1427683108,20-29,449,3,0,0,0,0,0,0,0,0,0,0,0,0,71,164,4.766339181938244E-5,0,0,63,0,0,200,0,0
249809370,alicebmcgregor,10,17658,335,622,5,184,40.8978547526,40-49,716,8,42,66,108,108,42,66,6,2.434467777,821.7535886069,0.0633891894,0.1516960886,0.28342682,0,59,1.789495822822106E-4,2.9131805E-4,2.9485175E-4,77,41,2,208,1,0.0048076923
249956868,OrnellaSofia91,10,6141,313,779,6,21,46.5387265868,40-49,680,6,28,81,109,109,28,81,6,2.3450398262,2339.7754696656,0.0523031469,0.1367652056,0.3366456,0,59,1.4098040346550314E-4,1.9647031E-4,1.9885351E-4,25,72,0,212,0,0
250089059,nwohashtag,10,137382,10227,6203,324,8,57.5456635897,50-59,891,9,12,3,15,15,12,3,7,3.1712527154,22691.6824432548,0.0054895676,0.0333333333,0.07575758,0,59,1.4089936300272724E-4,8.80729E-5,8.228421E-5,77,14,1,201,1,0.0049751244
250140570,JennC902,10,798,100,191,0,5,38.1326106593,30-39,517,5,25,25,50,50,25,25,7,2.7878349022,89.6777784061,0.0192950487,0.1526530612,0.73333335,0,59,1.7972401643435087E-4,1.761458E-4,1.7828245E-4,147,8,0,199,0,0
250154970,As_In_Speech,10,1639,48,57,1,0,29.4639035671,20-29,568,6,2,5,7,7,2,5,6,2.8924692252,30.9045080115,0.0012343175,0.1666666667,0.45,0,59,8.12511092710663E-5,2.0324514E-5,2.0571053E-5,77,4,2,200,2,0.01
250164587,as_LSL,10,173,32,71,0,25,13.4410238165,10-19,84,3,3,7,10,10,3,7,7,2.9283128168,46.8765622221,0.0078124207,0.1,0.3809524,0,59,1.102174769483891E-4,2.7099353E-5,2.742807E-5,175,1,0,177,0,0
250170548,Teresa_Kelly,10,1600,250,304,7,4,42.133772062,40-49,565,6,11,18,29,29,11,18,7,2.7360608255,100.5042081968,0.0132030504,0.0665024631,0.22807017,0,59,9.397526805562031E-5,8.129806E-5,8.228421E-5,25,0,1,200,1,0.005
250282374,susanicoleberry,10,1694,257,426,10,12,46.2459594549,40-49,653,5,32,53,85,85,32,53,6,2.4026068067,35297.8203339786,0.047582932,0.087254902,0.3137666,0,59,2.722003255126501E-4,2.2356966E-4,2.2628158E-4,77,9,1,200,1,0.005
250510775,OPSEUSisters,10,1980,556,280,9,11,48.5559878536,40-49,689,6,74,22,96,96,74,22,7,2.8808834178,819.2494977619,0.0679670362,0.1176535088,0.25617284,0,59,3.009658051163739E-4,5.081129E-4,5.142763E-4,182,61,0,200,0,0
250941432,knitram24,10,10889,273,824,1,278,31.887213259,30-39,576,8,31,134,165,165,31,134,6,2.2519913106,1199.0047000127,0.0471742437,0.1099778271,0.22205882,0,59,1.276580144381683E-4,2.1679483E-4,2.1942456E-4,25,5,1,199,1,0.0050251256
251009806,cairowire,10,49857,30125,172,525,81934,64.3893482106,60-69,916,9,8,1,9,9,8,1,1,1,216.7186560182,0.0040754167,0.0277777778,0.05357143,0,33,6.064085369799902E-4,6.0973543E-5,4.799912E-5,77,17,0,202,0,0
251116380,BradButtMP,10,3434,1659,738,91,3,53.6810325023,50-59,683,5,65,34,99,99,65,34,7,2.8316437364,738.7906007844,0.0876135154,0.1398680684,0.23775649,0,59,4.401619185059589E-4,4.4713932E-4,4.5256317E-4,175,22,7,200,7,0.035
251176847,DianeTremblayH,10,1262,293,398,11,2,32.2171677604,30-39,661,5,9,11,20,20,9,11,7,2.7965242578,179.5691813,0.0110024821,0.1394736842,0.43956044,0,59,1.120641132597454E-4,6.7748384E-5,6.8570174E-5,182,9,0,200,0,0
251384738,CarolynARebeyka,10,762,235,572,1,8,40.0302802664,40-49,583,5,30,65,95,95,30,65,6,2.5524981897,791.5655873578,0.0288035974,0.1230683091,0.36106235,0,59,1.723606271720497E-4,2.1001999E-4,2.1256754E-4,25,19,14,200,14,0.07
251402067,RouthierCaron,10,4607,1222,408,16,54,45.3966178838,40-49,740,7,15,10,25,25,15,10,7,2.8816075308,152.2355682031,0.014597517,0.145,0.2809524,0,59,1.3662309745816371E-4,1.0839741E-4,1.02855265E-4,145,7,0,200,0,0
251962604,dan_f_fletcher,10,1210,184,248,0,102,35.6902481522,30-39,512,4,0,0,0,0,0,0,0,0,0,0,0,0,108,245,4.766339181938244E-5,0,0,99,2,0,199,0,0
252265794,timparent,10,6680,687,641,18,25,46.8546937479,40-49,713,7,5,14,19,19,5,14,7,3.113685735,14.4978802683,0.0051646164,0.149122807,0.2809524,0,59,9.018654342640736E-5,4.064903E-5,4.1142106E-5,175,5,0,200,0,0
252274047,Roberto59xx,10,296,94,821,0,2,14.4175789717,10-19,299,4,0,6,6,6,0,6,7,3.1208830981,0,0,0.2333333333,0.26666668,0,335,4.766339181938244E-5,0,6.8570175E-6,182,0,0,200,0,0
252401073,RoyalShipyard,10,22923,150,52,4,0,43.5584777351,40-49,596,6,2,0,2,2,2,0,0,0,0,0.0038885645,0.5,1,0,52,5.2833146878540675E-5,2.0324514E-5,0,77,2,0,201,0,0
252507111,Zwelo,10,9629,405,324,1,18,50.5530131421,50-59,737,7,0,2,2,2,0,2,10,5.8820123055,0,0,0.5,1,0,234,4.766339181938244E-5,0,6.8570175E-6,131,21,0,201,0,0
252770855,roubaix_NS,10,4013,166,411,4,905,41.0409012424,40-49,629,7,4,8,12,12,4,8,7,2.6372194062,4.7678733754,0.0129129866,0.1590909091,0.64285713,0,59,6.821352879038516E-5,3.3874192E-5,3.4285087E-5,147,0,1,200,1,0.005
252824869,JackFonsec,10,101,63,111,3,1,40.5727609415,40-49,461,2,3,9,12,12,3,9,7,2.8732802317,46.7536475233,0.0044616137,0.2121212121,0.625,0,59,6.64203382874008E-5,2.7099353E-5,2.742807E-5,175,14,1,103,1,0.0097087379
253079226,rootsconscious,10,3538,499,815,14,24,43.9741812913,40-49,665,6,10,22,32,32,10,22,6,2.7758870384,78.3543482961,0.0064466448,0.1340725806,0.27076924,0,59,7.480298409846294E-5,7.452322E-5,7.542719E-5,77,4,0,199,0,0
253086457,TOTigerLilly,10,18539,1221,2000,35,1075,46.0400669655,40-49,753,8,11,21,32,32,11,21,6,2.8034033309,208.6281259561,0.0083848795,0.0907258065,0.2642857,0,59,1.450297659283901E-4,8.129806E-5,8.228421E-5,77,16,0,201,0,0
253147396,CoryBMorgan,10,12050,5156,4623,100,26,62.1463692974,60-69,787,8,101,97,198,198,101,97,7,2.4985517741,19047.9899535492,0.0556743677,0.0442239655,0.21412769,0,59,4.895424156787512E-4,6.910335E-4,6.994158E-4,175,189,1,200,1,0.005
253233038,svulliez,10,1041,212,354,15,11,42.0118216633,40-49,640,5,10,16,26,26,10,16,6,2.6871832006,557.7244562609,0.013130721,0.1584615385,0.3642857,0,59,9.15874425173324E-5,7.452322E-5,7.542719E-5,77,6,0,200,0,0
253382876,OccupyCoscienza,10,11735,617,971,14,1366,47.8975036571,40-49,748,8,35,58,93,93,35,58,6,2.3356263577,5378.0273179764,0.0533072523,0.0856708742,0.3275862,0,59,1.5742458311550808E-4,2.4389417E-4,2.4685264E-4,77,16,0,200,0,0
253776118,The_IronSock,10,6472,402,674,5,86,47.1647764562,40-49,733,7,0,0,0,0,0,0,0,0,0,0,0,0,124,274,4.766339181938244E-5,0,0,117,2,0,201,0,0
253866852,KatjaKanada,10,1582,183,245,8,122,44.9090216843,40-49,605,5,6,13,19,19,6,13,7,2.9112961622,19.0067746266,0.0054537378,0.1695906433,0.4,0,59,7.498609617004601E-5,4.742387E-5,4.799912E-5,182,6,0,200,0,0
253910519,j_sonier,10,8179,103,965,1,212,42.8283931884,40-49,700,7,3,46,49,49,3,46,6,2.4927588704,75.360728432,0.0103646867,0.2895408163,0.5280193,0,59,8.20550292257383E-5,2.7099353E-5,2.742807E-5,175,1,1,201,1,0.0049751244
254190800,Quayfox,10,210,84,66,7,12,41.1031334658,40-49,548,6,1,1,2,2,1,1,7,3.8316437364,0,7.668391277979204E-4,0,0,0,59,8.161773385101934E-5,1.3549677E-5,1.3714035E-5,77,1,0,194,0,0
254210313,spinale60,10,58,16,125,0,0,16.3840887228,10-19,91,2,0,1,1,1,0,1,7,4.3571428571,0,0,0,0,42,438,4.766339181938244E-5,0,6.8570175E-6,197,0,0,63,0,0
254749458,ezpe98_,10,8021,59,160,0,1,30.4733237673,30-39,659,6,2,16,18,18,2,16,7,2.8573497466,0.9080100085,0.0032188501,0.385620915,0.6372549,0,59,5.239925599145893E-5,2.0324514E-5,2.0571053E-5,175,1,4,200,4,0.02
255190986,NikkiNDP,10,668,120,145,10,4,27.2727410321,20-29,486,5,30,37,67,67,30,37,6,2.4540188269,226.4448577465,0.0605208338,0.1198552691,0.43466222,0,59,1.467446438651015E-4,2.1001999E-4,2.1256754E-4,25,1,2,200,2,0.01
255486202,Nathi2zn,10,223,16,110,0,28,28.9771283645,20-29,498,4,0,6,6,6,0,6,9,4.8074556641,0,0,0.2333333333,0.4,0,402,4.766339181938244E-5,0,6.8570175E-6,131,0,0,197,0,0
255817854,glamrgirll,10,150,33,258,0,3,13.4129683904,10-19,256,4,0,3,3,3,0,3,7,3.6601520087,0,0,0.1666666667,0.16666667,0,64,4.766339181938244E-5,0,6.8570175E-6,175,0,0,19,0,0
255872340,DarrellBellaart,10,1542,965,1394,37,10,50.8651821674,50-59,611,5,11,10,21,21,11,10,7,2.9333816075,117.9060486566,0.0101527947,0.0238095238,0.11363637,0,59,1.0711199218478373E-4,8.129806E-5,8.228421E-5,182,5,0,200,0,0
255917337,annemariebenoit,10,5718,612,1326,10,79,47.6091501656,40-49,604,7,45,86,131,131,45,86,6,2.2881969587,8648.7680508876,0.0531402743,0.066881973,0.24254446,0,59,1.8801203949574905E-4,3.1164257E-4,3.154228E-4,77,10,1,199,1,0.0050251256
256096579,Sumranb,10,2229,233,375,2,2,45.7228310988,40-49,642,6,12,25,37,37,12,25,7,2.8812454743,26.5854395655,0.027717981,0.204954955,0.3951613,0,59,1.3918798618623492E-4,8.80729E-5,8.914123E-5,175,15,1,200,1,0.005
256124395,Westcoastmaven,10,1161,31,72,2,6,25.1682105011,20-29,524,3,5,11,16,16,5,11,6,2.7556118755,0.1357411881,0.0101519448,0.3041666667,0.69871795,0,59,6.485449815752487E-5,4.064903E-5,4.1142106E-5,175,1,0,200,0,0
256215901,Colton_Ness,10,4360,432,1055,5,341,44.6177432265,40-49,688,6,20,60,80,80,20,60,6,2.5032585083,266.1601413001,0.0287851601,0.1658227848,0.345545,0,59,1.4141195987009612E-4,1.422716E-4,1.4399737E-4,175,2,4,200,4,0.02
256803631,SKCDP,10,5967,415,820,10,111,47.7914839014,40-49,685,7,57,100,157,157,57,100,6,2.3740043447,3185.485880658,0.0911113696,0.0975012249,0.31509435,0,59,2.778471461228237E-4,3.9294062E-4,3.9770702E-4,25,57,0,201,0,0
256956387,ManitoulinHerbs,10,632,462,728,10,1,42.6362652882,40-49,586,5,2,4,6,6,2,4,7,3.0119478639,71.7723492413,0.0045333444,0.0666666667,0.25,0,59,7.044251805362986E-5,2.0324514E-5,2.0571053E-5,77,1,0,200,0,0
257144050,ZachFleish,10,1024,249,484,3,5,38.201197464,30-39,593,5,6,9,15,15,6,9,6,2.7233888487,407.5049887425,0.009852017,0.1523809524,0.38181818,0,59,9.578683768001603E-5,4.742387E-5,4.799912E-5,25,3,0,200,0,0
257144150,EVCoffeehouse,10,697,637,1028,31,20,42.7274484595,40-49,653,5,13,20,33,33,13,20,6,2.6965966691,1138.4252905817,0.0059819597,0.0880681818,0.24505928,0,59,1.6386782475212325E-4,9.484774E-5,9.599824E-5,175,9,0,199,0,0
257252508,franky_koivu,10,251,29,106,1,0,23.4659001519,20-29,435,3,1,2,3,3,1,2,7,2.9413468501,0.0159151194,0.0050763996,0,0,0,59,5.2959838971500805E-5,1.3549677E-5,1.3714035E-5,182,6,1,200,1,0.005
257570388,jay9mac,10,670,28,101,1,35,19.0141349221,10-19,504,5,1,1,2,2,1,1,7,3.2664735699,0,2.0709727631973735E-4,0.5,1,0,59,5.364831216723839E-5,1.3549677E-5,1.3714035E-5,147,7,0,200,0,0
257644524,wapimaskwa69,10,21891,1312,1506,45,10,50.3709057233,50-59,775,8,89,87,176,176,89,87,6,2.3877624909,15742.2634704427,0.0777704982,0.0314935065,0.14801066,0,59,4.0696237645272335E-4,6.0973543E-4,6.171316E-4,175,69,0,201,0,0
257709728,cnmwilson,10,852,86,86,0,1,26.9160217135,20-29,520,5,21,10,31,31,21,10,7,2.9996379435,32.1883629964,0.0185894613,0.1344086022,0.36775362,0,59,1.3866922494087258E-4,1.4904643E-4,1.5085438E-4,182,7,0,199,0,0
257761286,danolsonbc,10,3043,212,401,16,20,28.7642825579,20-29,616,6,21,40,61,61,21,40,6,2.518826937,129.9364908195,0.0358288454,0.1483606557,0.35661423,0,59,1.228833023370506E-4,1.4904643E-4,1.5085438E-4,182,1,0,199,0,0
257771123,sens_adnan,10,34728,654,151,25,45,53.1334695934,50-59,795,8,4,2,6,6,4,2,7,3.2976104272,2766.106006281,0.0016560602,0.0333333333,0.06666667,0,59,9.913041366742995E-5,3.3874192E-5,2.742807E-5,175,55,0,201,0,0
258151604,bpond72,10,962,47,78,1,1,34.3340402442,30-39,652,6,0,1,1,1,0,1,8,3.4618168657,0,0,0,0,0,97,4.766339181938244E-5,0,6.8570175E-6,175,18,1,200,1,0.005
258405050,crawfordndp,10,178,263,208,18,0,40.2023985297,40-49,481,3,33,58,91,91,33,58,6,2.528602462,743.5161493276,0.058855573,0.2003663004,0.41405407,0,59,1.8669093307535354E-4,2.303445E-4,2.3313859E-4,25,10,0,186,0,0
258497039,MND1980,10,6027,344,927,7,98,47.4517234414,40-49,700,7,6,15,21,21,6,15,6,2.7646632875,98.7826373545,0.0126887387,0.1738095238,0.5285714,0,59,8.070491885408806E-5,4.742387E-5,4.799912E-5,145,2,0,201,0,0
258549215,sjaroszuk,10,2508,482,944,12,40,55.0438518436,50-59,673,6,46,87,133,133,46,87,6,2.3254887762,3865.4151437187,0.0542009286,0.0809409888,0.25091577,0,59,2.8211009257221196E-4,3.1841738E-4,3.222798E-4,175,20,1,200,1,0.005
258982963,BDJB87,10,826,78,143,2,2,31.2173428104,30-39,572,4,1,1,2,2,1,1,8,4.0959449674,0,1.5416786538863424E-4,0,0,0,59,7.757414937310466E-5,1.3549677E-5,1.3714035E-5,77,0,0,200,0,0
259345056,TakeAHikeEh,10,1396,1245,1212,29,52,31.0754668046,30-39,655,6,9,10,19,19,9,10,6,2.6419261405,211.6699628597,0.0175737967,0.0438596491,0.26666668,0,59,9.492412955596955E-5,6.7748384E-5,6.8570174E-5,77,5,0,200,0,0
259377867,DreweinLieu,10,2576,185,308,3,32,45.9638698402,40-49,674,6,24,35,59,59,24,35,7,2.5456191166,683.1620460623,0.0557036894,0.1531268264,0.41161618,0,59,2.005269487760967E-4,1.6937095E-4,1.7142543E-4,175,17,3,200,3,0.015
259606419,StigNasty,10,7289,104,191,1,50,41.0891969493,40-49,684,6,17,11,28,28,17,11,6,2.8808834178,20.9682093433,0.0219381401,0.164021164,0.36758894,0,59,9.190967429460314E-5,1.2194709E-4,1.2342632E-4,77,6,1,200,1,0.005
260048608,rpfahlman,10,2363,631,1390,17,766,44.2834107359,40-49,648,6,112,214,326,326,112,214,6,2.1897175959,12723.7021621688,0.1226932264,0.0619348749,0.1988377,0,59,4.1685601831406414E-4,7.655567E-4,7.74843E-4,77,27,3,200,3,0.015
260197400,Reddwulf,10,646,95,146,0,1,26.6971233884,20-29,546,5,30,35,65,65,30,35,7,2.6288921072,509.7119316689,0.0406842257,0.1403846154,0.35239363,0,59,1.8761306706089752E-4,2.1001999E-4,2.1256754E-4,25,12,1,200,1,0.005
260295017,ralamoureux,10,289,66,60,6,0,20.7279913363,20-29,225,4,10,7,17,17,10,7,7,2.6162201303,64.2434048138,0.0182250608,0.1838235294,0.50641024,0,59,8.368717141195763E-5,7.452322E-5,7.542719E-5,182,0,4,199,4,0.0201005025
260423578,Lynne_Rodier,10,6777,1020,1778,26,169,37.5188410478,30-39,669,7,26,45,71,71,26,45,6,2.547429399,3127.5493890121,0.0301251426,0.061167002,0.2294686,0,59,1.8532254321403617E-4,1.8292063E-4,1.8513948E-4,145,1,1,200,1,0.005
260558566,robnagai,10,1082,535,1168,8,3,53.6640847811,50-59,640,4,75,140,215,215,75,140,6,2.2476466329,2598.2604368551,0.1103433355,0.1240817214,0.31389463,0,59,3.294460544808057E-4,5.148877E-4,5.211333E-4,182,13,0,200,0,0
260559024,paulfaoro,10,523,641,422,24,1,46.5856834778,40-49,616,4,70,47,117,117,70,47,7,2.6097031137,403.0514233391,0.0895376076,0.1354258768,0.37184873,0,59,3.5626863304963254E-4,4.8101353E-4,4.8684824E-4,182,18,0,199,0,0
261474668,azertyworld,10,3491,242,242,13,29,43.118811957,40-49,646,6,3,5,8,8,3,5,6,2.7588703838,0.2907913301,0.0115048765,0.125,0.6,0,59,6.0239521434135545E-5,2.7099353E-5,2.742807E-5,77,1,0,200,0,0
261539076,gayhuckabee,10,6161,735,1532,15,1497,47.8927161567,40-49,704,7,2,11,13,13,2,11,7,2.7860246198,10.062724333,0.0010682594,0.141025641,0.24545455,0,59,5.3727773515387365E-5,2.0324514E-5,2.0571053E-5,77,2,0,200,0,0
261857919,JacksonUTE,10,9182,306,634,3,0,45.7122704789,40-49,697,7,66,153,219,219,66,153,6,2.1922519913,5857.2656358535,0.1209359054,0.1075572871,0.29416448,0,59,3.1018448515486433E-4,4.5391417E-4,4.5942017E-4,25,64,2,201,2,0.0099502488
261988359,mckmat,10,442,41,78,0,34,19.7818442177,10-19,464,4,1,3,4,4,1,3,7,3.2063721941,0,4.000049756176372E-4,0.25,0.6666667,0,59,5.2295193539682E-5,1.3549677E-5,1.3714035E-5,77,0,0,200,0,0
261999441,philippejohnson,10,321,168,600,2,1,41.7078792649,40-49,537,4,37,90,127,127,37,90,6,2.4047791455,876.8949625704,0.0563346979,0.1474190726,0.34961864,0,59,1.781277364177958E-4,2.5744384E-4,2.6056665E-4,25,46,1,200,1,0.005
262280216,OntarioCStores,10,1925,498,831,6,8,44.4305588824,40-49,640,5,20,55,75,75,20,55,6,2.4866039102,776.0868624261,0.0191907469,0.1300900901,0.29096046,0,59,1.6166912680876263E-4,1.422716E-4,1.4399737E-4,175,11,0,199,0,0
262284222,Dantonsmaxim,10,1750,27,48,0,0,32.5468758595,30-39,563,5,4,7,11,11,4,7,6,2.8233164374,0.2613465647,0.0058789586,0.2181818182,0.6964286,0,59,5.8819633793098875E-5,3.3874192E-5,3.4285087E-5,77,14,0,200,0,0
262323897,MeierMac,10,6000,309,385,5,240,41.7113688141,40-49,608,7,29,48,77,77,29,48,6,2.4829833454,1282.0816564209,0.0335839142,0.0746753247,0.27423468,0,59,1.2867183261384857E-4,2.0324514E-4,2.0571053E-4,77,9,1,199,1,0.0050251256
262426668,IanNelson1988,10,805,216,474,0,141,41.6158210608,40-49,556,5,0,0,0,0,0,0,0,0,0,0,0,0,255,662,4.766339181938244E-5,0,0,260,12,0,201,0,0
262476027,spiderrico38,10,1698,45,52,0,26,32.0591002198,30-39,562,6,15,19,34,34,15,19,7,2.622013034,162.7143233561,0.011835974,0.1354723708,0.46195653,0,59,1.1434399115459304E-4,1.0839741E-4,1.0971228E-4,175,7,3,197,3,0.0152284264
262520354,msmely,10,6182,56,97,1,78,36.5278288174,30-39,664,7,1,1,2,2,1,1,7,3.5398262129,0.4129552963,0.0014978747,0,0,0,59,5.044169472368018E-5,1.3549677E-5,1.3714035E-5,77,1,0,200,0,0
262537913,blogforequality,10,368,179,178,7,7,38.828483638,30-39,553,4,5,8,13,13,5,8,7,3.0206372194,24.3517431429,0.0021642577,0.0384615385,0.10714286,0,59,6.928534760254828E-5,4.064903E-5,4.1142106E-5,77,1,0,200,0,0
262540645,Usual5uspect,10,1868,460,477,6,54,45.9354010143,40-49,628,6,30,64,94,94,30,64,7,2.6451846488,342.9197776435,0.0191673474,0.109929078,0.35990676,0,59,1.5846025427331646E-4,2.1001999E-4,2.1256754E-4,175,12,0,199,0,0
263691341,bluecanadaca,10,2275,517,527,15,7,50.0114586131,50-59,715,6,43,49,92,92,43,49,7,2.7172338885,720.3607462218,0.0273793724,0.0794314381,0.32362154,0,59,2.8860612455029354E-4,2.9809287E-4,3.0170876E-4,175,77,14,200,14,0.07
263759179,OctaveDreumont,10,17428,1010,296,1,737,52.1844704443,50-59,772,8,3,0,3,3,3,0,0,0,0,2.575730669676588E-4,0,0,58,144,1.6266577270049508E-4,2.7099353E-5,0,166,23,0,201,0,0
263831999,amneetbali,10,2724,341,140,3,100,41.5292524667,40-49,699,6,20,32,52,52,20,32,7,2.6028240406,943.0886819544,0.0369098546,0.2130467572,0.51280487,0,59,1.8127550517413506E-4,1.422716E-4,1.3714035E-4,25,25,1,200,1,0.005
264003758,NadineMBailey,10,3753,490,362,20,14,40.3131845574,40-49,676,6,42,20,62,62,42,20,7,2.8367125272,348.263228426,0.0649190588,0.1560021153,0.39937943,0,59,2.0029349367124986E-4,2.9131805E-4,2.9485175E-4,25,14,0,200,0,0
264138087,joshdneufeld,10,1851,969,537,31,232,54.1870984997,50-59,704,5,10,11,21,21,10,11,7,2.9174511224,1051.2175386342,0.0062753382,0.1357142857,0.4945055,0,59,1.3924817241588346E-4,7.452322E-5,7.542719E-5,77,145,2,200,2,0.01
264267429,JerryPrag,10,5470,148,61,9,2,49.9250468739,40-49,676,7,26,8,34,34,26,8,7,2.9272266474,55.0905033973,0.0360166839,0.188057041,0.34623656,0,59,1.432333041149408E-4,1.8292063E-4,1.8513948E-4,77,76,0,201,0,0
265200837,MissLyU,10,706,32,62,1,33,25.1763578192,20-29,517,5,0,0,0,0,0,0,0,0,0,0,0,0,82,178,4.766339181938244E-5,0,0,73,4,0,200,0,0
265476888,Corythewelder,10,1411,320,634,12,2,41.7694107561,40-49,602,5,45,71,116,116,45,71,6,2.3989862419,4896.6975754261,0.072331651,0.0726386807,0.27738655,0,59,2.2254607212289425E-4,3.1164257E-4,3.154228E-4,182,12,0,200,0,0
265604273,CityThink,10,3198,466,600,12,14,55.7138042887,50-59,680,6,9,20,29,29,9,20,7,2.7595944967,118.7428369302,0.0074836585,0.1687192118,0.345,0,59,9.057217910287469E-5,6.7748384E-5,6.8570174E-5,175,11,0,201,0,0
265649438,addryherrera,10,1117,113,211,0,65,33.4545935821,30-39,561,4,0,0,0,0,0,0,0,0,0,0,0,0,262,689,4.766339181938244E-5,0,0,269,6,0,200,0,0
265828682,Boxcar1717,10,5674,228,971,1,289,43.3449417851,40-49,681,7,9,31,40,40,9,31,7,2.698769008,170.9966241105,0.0089843241,0.0942307692,0.22365591,0,59,8.602536913671804E-5,6.7748384E-5,6.8570174E-5,25,16,1,200,1,0.005
266048357,CampaignLife,10,1686,660,364,28,3,48.8233876454,40-49,707,5,11,45,56,56,11,45,7,2.6198406951,7388.4347516598,0.0072073482,0.2068181818,0.38588235,0,59,1.4832659002935602E-4,8.129806E-5,8.228421E-5,175,28,2,200,2,0.01
266225680,fyrwulf13,10,673,30,94,0,25,14.675146986,10-19,497,4,5,16,21,21,5,16,7,2.7143374366,2.3717021038,0.0078135968,0.2595238095,0.4239766,0,59,5.9234061335984105E-5,4.064903E-5,4.1142106E-5,25,1,1,200,1,0.005
266313062,paulaucanada,10,454,37,56,0,28,21.0849268865,20-29,471,4,1,1,2,2,1,1,8,4.348660391,0,9.181363544465002E-5,0,0,0,59,8.160949617324042E-5,1.3549677E-5,1.3714035E-5,175,4,0,198,0,0
266620548,camdearlove,10,6037,879,853,47,23,52.456033047,50-59,740,7,85,119,204,204,85,119,6,2.3015930485,5879.7179877017,0.1270517025,0.0977977398,0.2953811,0,59,3.7962309647565526E-4,5.826361E-4,5.8284646E-4,25,34,0,200,0,0
266734397,FaisalHass,10,358,39,109,1,1,25.0043972898,20-29,390,4,6,30,36,36,6,30,7,2.7936278059,14.9228008401,0.0053832357,0.2674603175,0.5075269,0,59,6.63882980200286E-5,4.742387E-5,4.799912E-5,25,10,2,200,2,0.01
266965724,katiesmith1963,10,1153,62,334,0,25,28.4822890935,20-29,569,5,13,69,82,82,13,69,6,2.4170890659,240.5029902248,0.0228705645,0.1963264077,0.36502346,0,59,1.0661362779371589E-4,9.484774E-5,9.599824E-5,25,4,0,200,0,0
267184794,Orange_Tory,10,3184,196,324,6,40,43.0665312897,40-49,661,6,29,51,80,80,29,51,6,2.5311368573,301.4500198967,0.0469257373,0.140664557,0.30645162,0,59,1.8764018343142702E-4,2.0324514E-4,2.0571053E-4,25,14,3,200,3,0.015
267298033,gideonsheps,10,153,56,70,2,0,40.2708631403,40-49,377,2,0,0,0,0,0,0,0,0,0,0,0,0,115,256,4.766339181938244E-5,0,0,105,4,0,154,0,0
267441787,OriginalRecords,10,12221,1025,307,1,407,32.1791667175,30-39,633,7,0,1,1,1,0,1,1,1,0,0,0,0,190,411,4.766339181938244E-5,0,6.8570175E-6,192,3,0,199,0,0
267529750,APsalmanD,10,2390,311,393,4,38,47.447385356,40-49,632,6,53,83,136,136,53,83,6,2.4431571325,1112.2949446948,0.0600161492,0.0694444444,0.30693507,0,59,1.8206614341201129E-4,3.6584126E-4,3.7027895E-4,77,63,0,200,0,0
267696181,scottmforrest,10,29,9,112,0,9,17.3447509203,10-19,79,2,1,1,2,2,1,1,8,3.557204924,0,0.0016085687,0,0,0,59,6.670014922082607E-5,1.3549677E-5,1.3714035E-5,25,1,0,33,0,0
267813818,alissagolob,10,1484,515,204,14,13,48.2572197634,40-49,695,6,17,13,30,30,17,13,7,3.0228095583,2128.0522628897,0.0054850001,0.0827586207,0.19367589,0,59,1.544911355086227E-4,1.2194709E-4,1.2342632E-4,175,64,1,200,1,0.005
267858450,abeidzagar,10,55,2,26,0,0,19.0555777336,10-19,116,2,1,1,2,2,1,1,2,1.5,0,8.271798374069241E-5,0,0,233,601,2.4481546444683235E-4,1.3549677E-5,1.3714035E-5,251,3,0,73,0,0
267881942,JeanBPe,10,409,107,329,3,2,26.4217324907,20-29,509,4,7,16,23,23,7,16,7,2.5800144823,17.6988207962,0.0275647085,0.1758893281,0.6041667,0,59,1.7288605167146498E-4,5.4198706E-5,5.485614E-5,175,0,0,200,0,0
268054084,mattmfuchs,10,786,196,299,7,27,26.6096286526,20-29,549,5,23,34,57,57,23,34,7,2.6430123099,252.1343369801,0.0306391311,0.1563283208,0.42621952,0,59,2.2024174707798252E-4,1.6259612E-4,1.6456842E-4,147,6,0,200,0,0
268412615,LaurierInst,10,390,339,94,30,0,44.3273283442,40-49,548,2,21,15,36,36,21,15,7,2.8301955105,126.7223957617,0.042781711,0.1976190476,0.3655914,0,59,2.0438548365635985E-4,1.4904643E-4,1.5085438E-4,175,3,0,200,0,0
268488125,omero65,10,80,33,249,0,1,16.1701478478,10-19,102,3,0,1,1,1,0,1,7,4.3571428571,0,0,0,0,42,479,4.766339181938244E-5,0,6.8570175E-6,197,0,0,88,0,0
268535351,bonsjl,10,2968,453,553,7,29,44.0207674109,40-49,651,6,18,25,43,43,18,25,7,2.7541636495,1899.0133161689,0.0225474344,0.1356589147,0.297479,0,59,1.4930600739616578E-4,1.2872192E-4,1.3028333E-4,77,11,2,200,2,0.01
268538413,ActivistKent,10,698,770,630,17,71,49.8867243982,40-49,743,7,82,67,149,149,82,67,7,2.536929761,3119.2226893331,0.0677971728,0.0787683657,0.22086306,0,59,3.139682852197922E-4,5.6231156E-4,5.6913245E-4,25,147,3,200,3,0.015
268539428,Miss782,10,742,185,745,2,46,36.58765911,30-39,513,5,13,41,54,54,13,41,6,2.3902968863,2055.8006399739,0.0197357222,0.1020265549,0.242741,0,59,1.1181545098246223E-4,9.484774E-5,9.599824E-5,77,4,0,200,0,0
268602677,OtayRanchTweets,10,7765,968,1048,30,49,50.0213429148,50-59,726,7,0,0,0,0,0,0,0,0,0,0,0,0,239,616,4.766339181938244E-5,0,0,243,7,0,200,0,0
268785157,JamieDCrane,10,200,118,107,5,0,31.8597245267,30-39,349,2,30,25,55,55,30,25,6,2.6057204924,137.3631466885,0.0231254483,0.1939393939,0.6302294,0,59,1.8316030435829521E-4,2.1001999E-4,2.1256754E-4,147,8,1,200,1,0.005
268896921,A_Man_From_TO,10,1347,389,1186,7,23,44.786716739,40-49,624,5,65,138,203,203,65,138,6,2.2976104272,32542.6032910546,0.0604567668,0.0815246549,0.20846182,0,59,2.3076409574664252E-4,4.4713932E-4,4.5256317E-4,182,50,0,200,0,0
268906600,Lizzsicle,10,361,20,131,0,6,19.5834285614,10-19,351,4,3,22,25,25,3,22,6,2.670166546,3.6246217164,0.0085465179,0.2683333333,0.47035572,0,59,5.909109216459501E-5,2.7099353E-5,2.742807E-5,25,1,2,200,2,0.01
269485235,ReverendBlair,10,17792,424,585,15,139,46.9307334104,40-49,742,8,60,89,149,149,60,89,6,2.4094858798,1233.9029865637,0.1012255585,0.1252494105,0.29397407,0,59,2.5475225853169916E-4,4.1326514E-4,4.1827807E-4,77,19,0,200,0,0
269643383,nicpwall,10,990,134,521,1,9,34.4094453909,30-39,520,5,11,37,48,48,11,37,6,2.5329471398,268.2260939885,0.0113269161,0.2074468085,0.3931475,0,59,8.438657935044257E-5,8.129806E-5,8.228421E-5,175,1,3,200,3,0.015
269963819,Danthenewsman,10,2153,293,204,16,0,45.6739900237,40-49,643,5,12,18,30,30,12,18,6,2.6951484432,405.4540306853,0.0187155809,0.1540229885,0.34666666,0,59,1.2612313122272787E-4,8.80729E-5,8.914123E-5,175,7,1,200,1,0.005
270191765,stephenmaarhuis,10,1952,172,509,2,37,47.0179662691,40-49,643,6,33,72,105,105,33,72,7,2.5532223027,2279.2281010869,0.0202834116,0.0924908425,0.23271665,0,59,2.41057114439754E-4,2.303445E-4,2.3313859E-4,182,53,0,202,0,0
270523420,schultzphoto,10,579,42,174,0,73,28.4145185783,20-29,423,4,1,1,2,2,1,1,8,3.7023895728,0,0.0041882386,0.5,1,0,59,5.351726810400683E-5,1.3549677E-5,1.3714035E-5,175,0,0,200,0,0
270657179,jkatebee,10,762,219,519,5,86,40.5065320003,40-49,587,5,7,14,21,21,7,14,7,2.9138305576,96.5111866904,0.0067905003,0.1214285714,0.33809525,0,59,8.104114333797419E-5,5.4198706E-5,5.485614E-5,25,10,0,200,0,0
270885775,RhinoCanada,10,847,230,113,30,7,34.4332720547,30-39,527,3,12,17,29,29,12,17,7,2.8153511948,134.2750663092,0.0129217301,0.104679803,0.24891774,0,59,9.540047528208383E-5,8.80729E-5,8.914123E-5,77,11,0,200,0,0
271117979,arun_smith,10,11325,603,983,13,19,56.6629788164,50-59,738,8,47,115,162,162,47,115,6,2.3175235337,3560.2894502529,0.0852170115,0.1375661376,0.31403175,0,59,2.8122527811179696E-4,3.2519223E-4,3.2913685E-4,25,121,0,205,0,0
271183691,unionjason,10,990,126,211,0,2,43.3242953307,40-49,594,5,33,54,87,87,33,54,6,2.5333091962,1867.193445828,0.0372484096,0.1001069233,0.29289618,0,59,1.9173821240341346E-4,2.303445E-4,2.3313859E-4,182,74,0,200,0,0
271229421,shelleyshell4,10,3643,89,306,1,33,41.6677233727,40-49,565,5,8,19,27,27,8,19,7,2.7592324403,366.0646188958,0.012455254,0.1239316239,0.26190478,0,59,9.321574098242672E-5,6.0973543E-5,6.171316E-5,77,9,2,200,2,0.01
271251442,drmarcspooner,10,2446,734,385,26,407,51.2567334714,50-59,709,6,56,45,101,101,56,45,7,2.6853729182,1339.8037047711,0.075877271,0.1077227723,0.3178795,0,59,3.1164833628914544E-4,3.8616578E-4,3.9085E-4,25,55,2,200,2,0.01
271550357,muggsmunny,10,6265,519,679,1,147,42.8933542146,40-49,670,7,0,1,1,1,0,1,8,4.0492218603,0,0,0,0,0,287,4.766339181938244E-5,0,6.8570175E-6,175,6,0,200,0,0
271646800,simonkinglaw,10,15330,523,1011,8,1523,45.1710837155,40-49,743,8,26,41,67,67,26,41,7,2.5807385952,677.1805141369,0.0364708156,0.1488014473,0.28853384,0,59,1.8290911008774118E-4,1.8292063E-4,1.8513948E-4,175,7,0,201,0,0
271649526,politicalicia,10,1185,291,501,6,1,32.144071653,30-39,552,5,36,71,107,107,36,71,6,2.4500362056,2308.7590446777,0.0512910258,0.1173514371,0.32518798,0,59,1.9938704043888125E-4,2.5066902E-4,2.5370964E-4,25,1,2,200,2,0.01
271681559,brianwhiteNDP,10,544,455,441,25,2,60.4043096485,60-69,600,4,68,67,135,135,68,67,6,2.4522085445,4796.4630537435,0.1204122225,0.1381426202,0.3952185,0,59,3.5114004022314394E-4,4.6746383E-4,4.7313422E-4,25,4,4,201,4,0.0199004975
271762869,happytovote,10,4448,402,959,9,27,40.0403812244,40-49,650,7,19,58,77,77,19,58,7,2.5343953657,2215.7886598542,0.0160416598,0.1119275461,0.28342408,0,59,1.238526949468107E-4,1.3549677E-4,1.3714035E-4,175,3,1,199,1,0.0050251256
271942095,CanadianRods,10,86,8,28,0,0,25.4195909365,20-29,348,2,0,5,5,5,0,5,7,2.7658342381,0,0,0.45,0.6,0,559,4.766339181938244E-5,0,6.8570175E-6,175,1,0,87,0,0
271946531,deniseprafuse,10,415,331,134,14,2,36.9917486616,30-39,593,4,47,12,59,59,47,12,6,2.7690079652,127.0732485021,0.0453502421,0.1949152542,0.4871454,0,59,2.55959301476239E-4,3.2519223E-4,3.2913685E-4,147,52,0,200,0,0
271950800,novagrown,10,2250,333,857,7,3,33.8392547819,30-39,524,6,45,109,154,154,45,109,6,2.2639391745,2479.1504072044,0.0675381034,0.1019438078,0.28153154,0,59,2.0711165347151087E-4,3.1164257E-4,3.154228E-4,147,1,1,200,1,0.005
272046992,adritorresn,10,3426,214,316,0,3,43.9224188546,40-49,699,6,2,2,4,4,2,2,1,1,0,1.6551228476954845E-4,0.0833333333,1,186,403,3.177448371356425E-4,2.0324514E-5,2.0571053E-5,193,41,0,200,0,0
272124058,MyCatIsFat,10,42,6,55,0,0,16.5674566246,10-19,206,2,1,21,22,22,1,21,7,2.6256335988,0.0074626866,0.0014239977,0.3528138528,0.61904764,0,59,4.928906953295478E-5,1.3549677E-5,1.3714035E-5,25,0,0,43,0,0
272130077,Upstream_Ag,10,4352,69,294,0,0,17.8608619166,10-19,572,6,0,2,2,2,0,2,7,3.4100615273,0,0,0.5,0.5,0,125,4.766339181938244E-5,0,6.8570175E-6,175,0,0,200,0,0
272141036,dbmeaford,10,2104,60,110,1,2,38.9195069725,30-39,655,5,13,26,39,39,13,26,6,2.6198406951,25.7470713467,0.0352351387,0.2260458839,0.42513368,0,59,1.0538787783193792E-4,9.484774E-5,9.599824E-5,175,6,1,200,1,0.005
272185225,fsorbara,10,4661,296,525,3,15,43.0717423642,40-49,665,7,44,68,112,112,44,68,7,2.5340333092,470.3370662506,0.0636314672,0.1483268983,0.3647059,0,59,2.3029603532499042E-4,3.0486772E-4,3.085658E-4,175,18,1,200,1,0.005
272498805,williamefwilson,10,6493,1194,198,31,3,48.3668106557,40-49,713,7,58,9,67,67,58,9,7,2.8928312817,191.5360724855,0.075991784,0.1454093171,0.22420634,0,59,2.715905323877985E-4,3.9971547E-4,4.0456402E-4,175,8,0,206,0,0
272517144,NikSpohr,10,1366,395,419,26,1,42.8924676799,40-49,649,5,74,81,155,155,74,81,6,2.3982621289,1832.7890628142,0.1079160691,0.166359447,0.37850142,0,59,2.9305530251899035E-4,5.081129E-4,5.142763E-4,25,46,0,200,0,0
272578794,kentprestage,10,771,99,111,3,3,23.7733517783,20-29,470,5,7,10,17,17,7,10,7,2.6252715424,14.1122361613,0.0054122969,0.1580882353,0.6545454,0,59,7.27753821685204E-5,5.4198706E-5,5.485614E-5,175,0,7,199,7,0.0351758794
272583709,EnzodellaRocca,10,2578,518,1403,13,57,42.4464565386,40-49,585,6,10,32,42,42,10,32,6,2.6230992035,2230.909142988,0.0140346952,0.1550522648,0.2912913,0,59,9.13597362110194E-5,7.452322E-5,7.542719E-5,175,5,1,200,1,0.005
272632742,cmoon55,10,2063,375,878,11,24,41.677524275,40-49,565,6,59,120,179,179,59,120,6,2.3352643012,4590.1084748147,0.0922575967,0.1116376875,0.33425125,0,59,2.779235738085971E-4,4.064903E-4,4.1142106E-4,182,6,0,200,0,0
272946124,bdlabourcouncil,10,671,235,73,6,0,41.4234774698,40-49,542,5,60,15,75,75,60,15,6,2.7784214337,612.1804509697,0.0528653998,0.1340540541,0.3059228,0,59,2.3435133831942116E-4,4.1326514E-4,4.1827807E-4,182,26,1,200,1,0.005
273032886,federaljournal,10,95,71,17,0,0,21.7711964982,20-29,173,2,2,11,13,13,2,11,6,2.6086169442,1.9645377555,0.0078134369,0.3012820513,0.530303,0,59,5.7196891905481836E-5,2.0324514E-5,2.0571053E-5,175,4,0,102,0,0
273123542,macdonellmike,10,2499,699,607,4,161,44.1841807882,40-49,684,6,11,4,15,15,11,4,7,3.2480086894,14.4837154795,0.0115627642,0.1904761905,0.3525641,0,59,1.0120387543280122E-4,8.129806E-5,8.228421E-5,147,8,1,200,1,0.005
273160093,darcymurray,10,3633,260,771,6,1,39.5906018223,30-39,576,7,13,38,51,51,13,38,7,2.5014482259,1094.0247562702,0.0176696806,0.1870588235,0.34994462,0,59,1.1551263063148121E-4,9.484774E-5,9.599824E-5,25,13,0,199,0,0
273201959,Wetaskijen,10,20420,713,1048,22,344,40.310449396,40-49,749,8,78,124,202,202,78,124,7,2.4293989862,8100.3898751998,0.0602527018,0.0632973745,0.2083878,0,59,4.222105887467034E-4,5.352122E-4,5.4170436E-4,175,30,3,202,3,0.0148514851
273280868,RobinVan,10,4253,380,495,11,20,39.067235921,30-39,673,7,30,35,65,65,30,35,6,2.4033309196,470.6938666964,0.0591872849,0.1209134615,0.35291398,0,59,1.859412467136589E-4,2.1001999E-4,2.1256754E-4,77,2,2,200,2,0.01
273281448,DewdneyNDP,10,1016,303,579,14,72,43.13786505,40-49,558,5,42,73,115,115,42,73,6,2.4493120927,1498.4087724433,0.061306985,0.1327231121,0.36320892,0,59,1.7246789187228714E-4,2.9131805E-4,2.9485175E-4,182,11,1,200,1,0.005
273283728,djvanbc,10,12,79,678,0,3,29.7246350936,20-29,462,5,3,0,3,3,3,0,0,0,0,0.0078404171,0.3333333333,0.6666667,0,3,5.976658347444207E-5,2.7099353E-5,0,182,0,0,2,0,0
273505322,Travel_Duder,10,1727,39,80,0,42,24.208201338,20-29,566,5,0,0,0,0,0,0,0,0,0,0,0,0,52,137,4.766339181938244E-5,0,0,46,1,0,200,0,0
273537714,darshisel,10,488,230,202,2,0,32.6930612011,30-39,560,4,10,17,27,27,10,17,7,2.8750905141,3158.9847346262,0.0123969504,0.1381766382,0.30952382,0,59,9.663770585973491E-5,7.452322E-5,7.542719E-5,182,4,2,198,2,0.0101010101
273590984,MargaretRadon,10,257,37,174,0,5,36.1301230417,30-39,493,4,13,45,58,58,13,45,6,2.443519189,226.3378506594,0.0167318786,0.1975196612,0.45420906,0,59,8.888197335721147E-5,9.484774E-5,9.599824E-5,175,18,0,200,0,0
273683993,Blubdha,10,49320,869,1892,27,861,45.9217954798,40-49,761,9,31,53,84,84,31,53,6,2.4703113686,1416.3547094213,0.0281076068,0.091222031,0.21899039,0,59,1.2940152605708086E-4,2.1679483E-4,2.1942456E-4,77,23,0,201,0,0
273703828,MilesKrauter,10,2216,205,548,6,9,41.0621506741,40-49,651,6,29,58,87,87,29,58,6,2.4290369298,405.4166937147,0.0469553784,0.1524993317,0.32111803,0,59,1.4314425482489504E-4,2.0324514E-4,2.0571053E-4,25,27,0,200,0,0
273760106,Peter_Ormond,10,1256,902,1229,57,2,45.5057756053,40-49,632,5,17,40,57,57,17,40,6,2.5456191166,935.7822523228,0.0187948149,0.1296992481,0.3379791,0,59,1.8057276982575958E-4,1.2194709E-4,1.2342632E-4,175,3,1,200,1,0.005
273791831,gwenomahony,10,599,714,207,35,0,51.2069558925,50-59,716,4,95,22,117,117,95,22,7,2.7092686459,2287.0790087848,0.1081610516,0.142351901,0.2810891,0,59,4.896389650704982E-4,6.5038446E-4,6.582737E-4,182,217,0,200,0,0
274012183,elizsamuels,10,3410,543,545,12,261,63.7768909121,60-69,689,6,54,54,108,108,54,54,6,2.4663287473,1370.8472886318,0.0679076355,0.1573208723,0.34719563,0,59,3.8184174521311E-4,3.726161E-4,3.7713596E-4,175,53,5,200,5,0.025
274058279,alexpensato,10,8185,447,2000,6,1972,41.0018912233,40-49,693,7,29,125,154,154,29,125,6,2.2599565532,1653.9102977586,0.0676708392,0.1224429166,0.2719355,0,59,1.9937936632812437E-4,2.0324514E-4,2.0571053E-4,175,2,0,200,0,0
274074495,teampalerider,10,3968,81,109,1,1,31.0699598428,30-39,611,6,12,21,33,33,12,21,6,2.4666908038,115.0417413953,0.0297917055,0.2045454545,0.5183333,0,59,8.485207580962188E-5,8.80729E-5,8.914123E-5,25,4,7,200,7,0.035
274111805,gordaEATS,10,8595,584,375,3,114,38.9264391813,30-39,758,7,0,0,0,0,0,0,0,0,0,0,0,0,174,376,4.766339181938244E-5,0,0,173,5,0,199,0,0
274114074,JMandryk,10,1143,203,425,4,0,23.0818072788,20-29,597,5,37,79,116,116,37,79,6,2.3685734975,1564.6767581621,0.0688195192,0.1296851574,0.30924413,0,59,1.8147357396146237E-4,2.5744384E-4,2.6056665E-4,25,9,2,197,2,0.0101522843
274185412,placido97,10,2170,76,80,0,101,39.5070911753,30-39,625,5,1,1,2,2,1,1,1,1,0,8.095914281419891E-5,0,0,236,608,3.177448371356425E-4,1.3549677E-5,1.3714035E-5,242,5,0,199,0,0
274300708,NDPLakeshore,10,368,152,177,5,0,33.0455350851,30-39,460,4,61,63,124,124,61,63,6,2.4456915279,624.1808491797,0.0859681925,0.2031864673,0.4180198,0,59,2.5224608424077497E-4,4.2003999E-4,4.2513508E-4,25,12,4,199,4,0.0201005025
274325886,RedLangara,10,876,245,348,15,1,42.5757019823,40-49,562,5,20,28,48,48,20,28,6,2.6806661839,589.3809157966,0.0243574454,0.0531914894,0.21839081,0,59,1.598972925505072E-4,1.422716E-4,1.4399737E-4,182,16,1,200,1,0.005
274353837,Democracyeh101,10,1,288,904,98,0,31.2077714654,30-39,327,3,11,42,53,53,11,42,6,2.4319333816,312.1788416602,0.0294058746,0.1331640058,0.32694542,0,59,1.1346266690960936E-4,8.129806E-5,8.228421E-5,77,0,0,1,0,0
274590266,MATTLEKUISABITC,10,2239,89,58,0,91,37.0192513244,30-39,675,6,0,1,1,1,0,1,8,3.6178067318,0,0,0,0,0,685,4.766339181938244E-5,0,6.8570175E-6,182,5,0,200,0,0
274743250,LauraMorie,10,928,266,620,1,15,41.09068688,40-49,493,5,19,43,62,62,19,43,6,2.518826937,503.6372214945,0.0212627953,0.092014807,0.25422832,0,59,1.1694634809447569E-4,1.3549677E-4,1.3714035E-4,77,8,2,199,2,0.0100502513
275038599,AppalledBC,10,7908,264,521,27,17,45.8079534761,40-49,691,7,31,44,75,75,31,44,6,2.4576393917,256.5454570863,0.0488850346,0.1652252252,0.33234128,0,59,1.3038531941355968E-4,2.1679483E-4,2.1942456E-4,77,14,1,200,1,0.005
275122386,Philajj,10,14168,342,488,1,117,37.6932858604,30-39,737,7,0,0,0,0,0,0,0,0,0,0,0,0,227,567,4.766339181938244E-5,0,0,231,37,0,200,0,0
275185937,TeriMooring,10,3173,669,1095,18,8,51.4266246938,50-59,723,7,85,122,207,207,85,122,6,2.338884866,7566.3616433818,0.0903953495,0.0783265325,0.24244605,0,59,3.724773310043742E-4,5.826361E-4,5.8284646E-4,182,158,0,201,0,0
275295586,wwwwwayne,10,135,6,22,0,2,11.8833382982,10-19,66,2,2,4,6,6,2,4,7,3.0854453295,1.006381231,0.0015134194,0.2,0.35,0,59,5.4343165623959634E-5,2.0324514E-5,2.0571053E-5,77,1,0,139,0,0
275342624,Poet_Moglica,10,1233,987,1985,59,1413,46.8400754539,40-49,639,5,28,71,99,99,28,71,6,2.4279507603,4996.2665618454,0.0465110668,0.1149247578,0.29929578,0,59,2.0868344201092494E-4,1.9647031E-4,1.9885351E-4,175,95,0,200,0,0
275374424,WendyGuenther,10,7122,403,1432,11,4041,47.9215375462,40-49,677,7,17,25,42,42,17,25,7,2.7791455467,161.8430172642,0.0117160863,0.0975609756,0.33497536,0,59,1.1549507612843227E-4,1.2194709E-4,1.2342632E-4,175,4,0,199,0,0
275699060,TroyMorgan1977,10,4165,237,515,4,2,54.9298875006,50-59,726,7,62,105,167,167,62,105,6,2.4315713251,3584.9789518189,0.0575357575,0.0766178486,0.267754,0,59,2.4460870450616836E-4,4.268148E-4,4.319921E-4,175,574,0,226,0,0
275757458,planet_556,10,121,5,46,0,1,16.7341444214,10-19,45,3,1,4,5,5,1,4,7,3.264301231,4.6303305652,0.0079038789,0.3,0.6666667,0,59,2.029197978693939E-4,1.3549677E-5,1.3714035E-5,175,0,0,124,0,0
275787002,dom_aud,10,89,43,300,0,32,14.8037212654,10-19,402,3,4,52,56,56,4,52,6,2.5177407676,191.7929726371,0.0078483683,0.2652597403,0.4622926,0,59,7.335584677256708E-5,3.3874192E-5,3.4285087E-5,25,0,0,93,0,0
276002311,chadw18,10,1684,98,115,1,21,41.9591512064,40-49,629,6,18,26,44,44,18,26,7,2.8718320058,92.9913244175,0.0129971772,0.1025369979,0.505698,0,59,1.2102018269760923E-4,1.2872192E-4,1.3028333E-4,175,4,0,199,0,0
276026459,avatar1dory,10,3260,181,465,1,376,40.3308774703,40-49,653,6,0,1,1,1,0,1,7,4.3571428571,0,0,0,0,42,429,4.766339181938244E-5,0,6.8570175E-6,197,14,0,200,0,0
276057216,grassrootspeace,10,740,364,744,10,14,37.4241421615,30-39,589,5,2,3,5,5,2,3,7,3.6408679928,5526,1.6551228476954845E-4,0.05,0.33333334,0,657,2.0325362258877993E-4,2.0324514E-5,2.0571053E-5,278,2,0,200,0,0
276097793,kjmccauley,10,1382,296,505,4,14,39.5834713993,30-39,640,5,31,46,77,77,31,46,7,2.5865314989,333.3957851901,0.0225583983,0.0994531784,0.36979592,0,59,1.802299211028725E-4,2.1679483E-4,2.1942456E-4,175,2,3,199,3,0.0150753769
276143180,TRStephen,10,711,12,35,0,0,22.0257161153,20-29,551,4,2,4,6,6,2,4,7,2.91564084,0,0.0015792747,0.2,1,0,59,5.2277877003322544E-5,2.0324514E-5,2.0571053E-5,147,0,0,200,0,0
276232257,JBumstead87,10,3521,644,1883,16,295,48.1599429698,40-49,689,7,54,120,174,174,54,120,6,2.4388124547,6528.8077232309,0.0494099781,0.080360109,0.18152435,0,59,3.0652272547177233E-4,3.726161E-4,3.7713596E-4,175,35,0,200,0,0
276518876,gonzopolecon,10,3706,187,350,1,320,45.7441099525,40-49,676,6,37,61,98,98,37,61,6,2.4004344678,2037.54199249,0.0644673028,0.1222385862,0.3286385,0,59,1.741761174723619E-4,2.5744384E-4,2.6056665E-4,77,59,0,201,0,0
276661061,larryrousseau,10,360,212,243,5,2,40.6141769129,40-49,572,3,42,49,91,91,42,49,6,2.4395365677,1870.8736856501,0.059895281,0.0985347985,0.35,0,59,2.3350155747288312E-4,2.9131805E-4,2.9485175E-4,182,15,9,200,9,0.045
276713213,s_guilbeault,10,6970,10103,246,253,2,59.9117238826,50-59,770,7,96,14,110,110,96,14,6,2.6759594497,1600.8486967411,0.1168215124,0.1272727273,0.1931716,0,59,5.920024948918689E-4,6.571593E-4,6.445596E-4,145,22,0,200,0,0
276761716,artymccomish,10,2135,259,1074,3,8,52.4161517125,50-59,630,6,26,71,97,97,26,71,6,2.5343953657,399.659848333,0.0384554364,0.1381013746,0.32929826,0,59,1.8268983135793617E-4,1.8292063E-4,1.8513948E-4,175,7,1,200,1,0.005
277132286,rightsprung,10,8699,666,862,21,99,50.5659124743,50-59,730,7,68,102,170,170,68,102,6,2.2639391745,2890.3440364195,0.081086328,0.0660285416,0.25199032,0,59,2.3900853029889868E-4,4.6746383E-4,4.7313422E-4,77,31,0,201,0,0
277145358,johnrbolton1,10,2635,391,488,6,0,45.8926032095,40-49,672,6,25,33,58,58,25,33,7,2.7367849385,3873.7668006916,0.0157323975,0.0949788264,0.35829958,0,59,1.6018393462963724E-4,1.761458E-4,1.7828245E-4,175,23,0,199,0,0
277174042,CUPECETA,10,3908,527,558,19,13,40.172156018,40-49,707,6,92,90,182,182,92,90,6,2.3939174511,3637.3455059054,0.1155339972,0.1034849129,0.23860182,0,59,4.250733100349996E-4,6.3006E-4,6.3770264E-4,182,7,0,199,0,0
277218508,DrunkPatMartin,10,160,146,323,1,0,21.6424000631,20-29,383,3,4,28,32,32,4,28,6,2.6962346126,148.0485859635,0.0058771306,0.2348790323,0.41133004,0,59,9.281798909597938E-5,3.3874192E-5,3.4285087E-5,175,0,7,160,7,0.04375
277263155,ElectionCDA,10,24697,6774,7377,81,0,40.5326925749,40-49,732,8,67,7,74,74,67,7,6,2.9145546705,6263.8758348273,0.0768468482,0.0973713439,0.16501035,0,59,2.852756762273407E-4,4.60689E-4,4.6627718E-4,77,31,1,202,1,0.004950495
277316485,KHildebrand78,10,533,113,264,6,2,43.2946289585,40-49,624,5,11,22,33,33,11,22,7,2.7624909486,116.5510258839,0.0049286369,0.09375,0.33549783,0,59,8.181064537491584E-5,8.129806E-5,8.228421E-5,182,51,0,200,0,0
278242487,Mandey_Mars,10,733,58,88,0,0,26.4405641651,20-29,492,4,0,1,1,1,0,1,1,1,0,0,0,0,0,331,4.766339181938244E-5,0,6.8570175E-6,25,4,0,200,0,0
278363507,Suedhodges,10,1261,137,187,2,33,27.5260588257,20-29,548,5,9,17,26,26,9,17,6,2.6013758146,70.1579447844,0.0151878196,0.1030769231,0.35947713,0,59,8.187248160321189E-5,6.7748384E-5,6.8570174E-5,182,0,0,200,0,0
278398693,MarianneLaRoche,10,945,256,276,11,9,38.5085342307,30-39,594,5,5,5,10,10,5,5,7,3.2320782042,12.2417622543,0.0015453673,0.2222222222,0.43055555,0,59,6.504326912147868E-5,4.064903E-5,4.1142106E-5,182,2,0,200,0,0
278714842,giacomotermine,10,644,91,280,0,20,23.2995553574,20-29,524,5,0,1,1,1,0,1,7,4.3571428571,0,0,0,0,42,465,4.766339181938244E-5,0,6.8570175E-6,197,0,0,200,0,0
278774007,Barbspeaking,10,122,113,157,2,0,44.7475603426,40-49,440,3,13,17,30,30,13,17,7,2.9844315713,58.7066022574,0.0087191831,0.1183908046,0.40263158,0,59,1.144504425762127E-4,9.484774E-5,9.599824E-5,182,4,1,123,1,0.0081300813
278940186,allforjury,10,26445,982,2001,13,79,39.7222842945,30-39,769,8,1,6,7,7,1,6,7,2.9880521361,0.25161163,4.1089306688619137E-4,0.2380952381,0.53333336,0,59,5.016171577845109E-5,1.3549677E-5,1.3714035E-5,175,1,0,210,0,0
279108883,onthebeat1,10,370,311,273,13,0,46.1147331969,40-49,575,3,21,39,60,60,21,39,6,2.5119478639,288.6014905893,0.0533434724,0.2228813559,0.47215685,0,59,1.905485401674579E-4,1.4904643E-4,1.5085438E-4,175,16,4,200,4,0.02
279142381,stoughtonfreak,10,1464,158,184,2,100,41.7051408975,40-49,631,5,18,19,37,37,18,19,7,2.9453294714,371.515204909,0.0111295562,0.0690690691,0.39210525,0,59,1.330721997845683E-4,1.2872192E-4,1.3028333E-4,25,13,3,200,3,0.015
279237257,wakeupjohnston,10,1549,44,83,0,14,38.0126228516,30-39,548,5,3,1,4,4,3,1,8,4.2476466329,1.0488626754,0.0034716657,0.1666666667,0.25,0,59,6.114806138290744E-5,2.7099353E-5,2.742807E-5,77,2,0,200,0,0
279479906,DGCNoonan,10,416,203,1304,2,58,35.910854511,30-39,555,4,26,132,158,158,26,132,6,2.2784214337,4403.723264792,0.0524489578,0.1744739176,0.35104808,0,59,1.7359435276389438E-4,1.8292063E-4,1.8513948E-4,25,7,1,200,1,0.005
279623396,moeyd64,10,2997,157,474,1,42,39.9733369115,30-39,595,7,46,110,156,156,46,110,6,2.2338884866,4742.0851528804,0.0728013354,0.1231596361,0.29921773,0,59,2.44363933302269E-4,3.1841738E-4,3.222798E-4,77,5,3,203,3,0.0147783251
280235035,thinkinthebox,10,562,40,53,1,4,24.08152026,20-29,473,4,2,1,3,3,2,1,8,4.1640115858,0.026072738,0.0023730702,0.1666666667,0.16666667,0,59,5.04083291895682E-5,2.0324514E-5,2.0571053E-5,77,1,0,199,0,0
280269477,mmireault,10,725,294,783,6,7,43.0485953728,40-49,592,5,18,68,86,86,18,68,7,2.4826212889,121.019368129,0.0292320487,0.2447332421,0.54808855,0,59,1.1899329659839842E-4,1.2872192E-4,1.3028333E-4,25,8,0,200,0,0
280801747,AMarkwart,10,6595,150,314,2,0,39.181597548,30-39,633,6,3,1,4,4,3,1,7,3.4800868936,6.8911767953,0.001307275,0,0,0,59,7.483017471431036E-5,2.7099353E-5,2.0571053E-5,182,1,0,200,0,0
280951231,eurotopics_fr,10,11020,1479,713,84,1,53.3774550507,50-59,733,6,3,0,3,3,3,0,0,0,0,4.1474712942571036E-4,0,0,0,17,9.278644186408935E-5,2.7099353E-5,0,145,1,0,201,0,0
281145999,GlobalExistence,10,5218,123,1,2,0,17.9399049764,10-19,601,7,1,1,2,2,1,1,10,6.395365677,2949,8.276672900211444E-5,0.5,0.5,0,59,1.7939960757894132E-4,1.3549677E-5,1.3714035E-5,62,0,0,200,0,0
281276278,canadian_stew,10,2530,109,239,0,66,38.9703801408,30-39,625,6,19,21,40,40,19,21,6,2.5785662563,353.4154802266,0.0266675125,0.0884615385,0.25738916,0,59,1.0674363711825577E-4,1.3549677E-4,1.3714035E-4,77,21,0,200,0,0
281534403,Buck_Tweets,10,15613,378,410,18,1691,46.2098047605,40-49,751,8,7,6,13,13,7,6,7,2.8645908762,19.5823761465,0.0095065757,0.0512820513,0.23809524,0,59,6.787954573966565E-5,5.4198706E-5,5.485614E-5,25,16,0,201,0,0
281590472,maryann_wilhelm,10,963,95,336,0,1,31.2109481292,30-39,561,5,15,54,69,69,15,54,6,2.4771904417,490.9323514544,0.0177885927,0.1707161125,0.3392857,0,59,1.1795495596886707E-4,1.0839741E-4,1.0971228E-4,25,12,0,201,0,0
281604944,ICADCISD,10,693,280,373,10,2,37.9129674221,30-39,615,5,6,11,17,17,6,11,7,2.9275887038,1336.9750252125,0.0079349442,0.1066176471,0.29545453,0,59,1.0512222933402647E-4,4.742387E-5,4.799912E-5,25,18,0,200,0,0
281629828,AmandaGAdams,10,3385,932,859,25,136,57.8412341,50-59,678,6,17,31,48,48,17,31,6,2.6151339609,973.2395480017,0.0248956964,0.1329787234,0.31009957,0,59,1.3437045286489083E-4,1.2194709E-4,1.2342632E-4,182,7,0,200,0,0
281630899,ChaachaaS,10,1358,840,102,6,20,41.7332881306,40-49,707,6,0,0,0,0,0,0,0,0,0,0,0,0,76,172,4.766339181938244E-5,0,0,68,42,0,199,0,0
281661071,iyer_a,10,1356,190,682,2,4,46.538943956,40-49,580,5,7,62,69,69,7,62,7,2.4652425778,116.0011303479,0.0063053533,0.2078005115,0.35668957,0,59,6.941512795404367E-5,5.4198706E-5,5.485614E-5,175,2,1,200,1,0.005
281758264,cailynch,10,135,53,128,0,4,25.5297025087,20-29,365,3,4,7,11,11,4,7,6,2.7682838523,47.5304652416,0.0092828504,0.1909090909,0.43055555,0,59,6.525846540353826E-5,3.3874192E-5,3.4285087E-5,182,3,0,140,0,0
281891570,Dont_h8_Kate,10,87,53,351,1,1,23.3449308091,20-29,215,3,0,14,14,14,0,14,7,2.9174809989,0,0,0.2472527473,0.34065935,0,586,4.766339181938244E-5,0,6.8570175E-6,182,0,0,99,0,0
282034400,jamesflogan,10,93,10,36,0,2,19.9219742554,10-19,142,3,6,12,18,18,6,12,7,2.8059377263,69.0134873222,0.0107974976,0.1633986928,0.48076922,0,59,8.821821542752787E-5,4.742387E-5,4.799912E-5,147,3,0,93,0,0
282626087,ridersplus,10,1513,1325,1802,25,41,47.0534953141,40-49,658,6,1,4,5,5,1,4,7,3.734974656,3.0981112,1.0780144306318418E-4,0.1,0.16666667,0,59,5.377151501825335E-5,1.3549677E-5,1.3714035E-5,175,9,0,200,0,0
282699689,CorImmobile,10,718,50,167,1,6,56.6860574666,50-59,434,4,1,11,12,12,1,11,7,2.8562635771,0.1749400456,0.0028295016,0.3257575758,0.57272726,0,59,5.193430382475664E-5,1.3549677E-5,1.3714035E-5,175,0,0,200,0,0
282822705,SA_Labour_News,10,4866,2219,83,29,1,55.7900311222,50-59,720,2,8,0,8,8,8,0,0,0,0,0.0042907729,0.0178571429,0.017857144,0,39,2.1298384134997664E-4,6.0973543E-5,0,131,3,0,200,0,0
282915772,DiegoCar96,10,1139,180,425,0,11,36.3128942647,30-39,568,5,8,43,51,51,8,43,6,2.4315713251,1604.5679823561,0.015790687,0.1941176471,0.37262157,0,59,1.0096772617321665E-4,6.0973543E-5,6.171316E-5,25,9,0,200,0,0
283200587,jabcan,10,8,5,2,0,0,11.7341444214,10-19,15,0,0,0,0,0,0,0,0,0,0,0,0,0,237,610,4.766339181938244E-5,0,0,240,0,0,8,0,0
283258239,LukewSavage,10,5785,543,1987,7,120,47.2361493565,40-49,685,6,54,165,219,219,54,165,6,2.2744388125,9771.125126838,0.1075874374,0.1478153408,0.31006792,0,59,3.077720482091868E-4,3.726161E-4,3.7713596E-4,25,30,11,200,11,0.055
283292134,tuesdaymudds,10,1458,43,79,0,8,31.1832926036,30-39,454,6,5,10,15,15,5,10,7,2.9637943519,44.3871546067,0.0025528506,0.1238095238,0.24358974,0,59,6.506007266276719E-5,4.064903E-5,4.1142106E-5,182,6,0,202,0,0
283301194,Haggisman57,10,6969,1597,2004,22,15,48.5756439288,40-49,705,7,58,88,146,146,58,88,7,2.5108616944,6620.4344668895,0.0394432306,0.0710439301,0.24910583,0,59,3.213646215516236E-4,3.9971547E-4,4.0456402E-4,175,22,1,201,1,0.0049751244
283368566,OwnYourVote,10,286,73,414,0,0,22.9428163389,20-29,335,5,6,44,50,50,6,44,7,2.5086893555,145.4952151785,0.0113346118,0.186122449,0.31969696,0,59,6.915809372300911E-5,4.742387E-5,4.799912E-5,25,2,1,199,1,0.0050251256
283402937,maremelen,10,8023,287,546,0,1,51.0239127464,50-59,717,7,3,5,8,8,3,5,9,4.8124547429,4491.3267248693,2.756877584459373E-4,0.0714285714,0.25,0,59,1.2555242474873016E-4,2.7099353E-5,2.742807E-5,131,42,0,202,0,0
283590835,tek_heretik,10,1832,109,110,0,0,24.5727773356,20-29,626,6,13,15,28,28,13,15,6,2.5847212165,248.2730192186,0.0242241003,0.0687830688,0.4047619,0,59,9.335603682203758E-5,9.484774E-5,9.599824E-5,77,2,0,200,0,0
284234387,thenowsports,10,3398,531,1143,31,4,45.0667559341,40-49,642,7,8,27,35,35,8,27,6,2.774076756,431.2952456282,0.0087684753,0.1428571429,0.30418718,0,59,9.947480393656858E-5,6.0973543E-5,6.171316E-5,182,1,0,200,0,0
284439426,CPiou,10,38227,1387,1015,56,175,43.0869191161,40-49,783,9,13,13,26,26,13,13,6,2.8106444605,3020.8726872458,0.0136508976,0.1446153846,0.32619047,0,59,1.0239478491415578E-4,9.484774E-5,9.599824E-5,145,5,0,201,0,0
284630825,ashboxlive,10,9353,536,840,12,819,55.3421447573,50-59,713,7,35,64,99,99,35,64,6,2.3356263577,2185.0145705146,0.0628067806,0.0823541538,0.28645834,0,59,2.5475756406415626E-4,2.4389417E-4,2.4685264E-4,175,14,4,201,4,0.0199004975
284833045,Melissa_gza,10,544,219,1144,0,66,36.2694831906,30-39,542,4,1,3,4,4,1,3,2,1.25,3,8.095914281419891E-5,0.0833333333,0.33333334,48,133,1.1615009511706267E-4,1.3549677E-5,1.3714035E-5,127,30,0,200,0,0
285103806,StephenBrown3,10,444,330,144,27,4,46.8213042358,40-49,622,4,19,10,29,29,19,10,6,3.0459811731,127.1294146554,0.02319857,0.131773399,0.20153846,0,59,2.975005486152416E-4,1.3549677E-4,1.3714035E-4,25,15,0,200,0,0
285233916,_MauricioArroyo,10,10262,343,327,0,539,35.5275771217,30-39,743,7,3,3,6,6,3,3,3,1.8888888889,46,2.501044045017455E-4,0,0,79,175,4.632592184453325E-4,2.7099353E-5,2.742807E-5,106,12,0,202,0,0
285236048,Abrar494,10,28083,696,213,1,191,37.5683114376,30-39,770,8,0,0,0,0,0,0,0,0,0,0,0,0,243,631,4.766339181938244E-5,0,0,247,3,0,201,0,0
285624977,jtrygges,10,124460,4592,4568,144,3,48.6480582373,40-49,893,10,11,12,23,23,11,12,7,2.9869659667,1187.3675398312,0.0052522871,0.0375494071,0.25757575,0,59,1.0632613569448744E-4,8.129806E-5,8.228421E-5,77,5,0,201,0,0
285734431,ajssinc,10,3594,236,195,11,21,46.2823503514,40-49,639,6,18,21,39,39,18,21,6,2.5785662563,2533.5528512242,0.0258883743,0.1477732794,0.32580644,0,59,1.3863148719935414E-4,1.2872192E-4,1.3028333E-4,77,10,1,200,1,0.005
285771480,nstdenis,10,10370,525,773,14,378,47.9651495184,40-49,721,7,68,129,197,197,68,129,6,2.226647357,2821.7191702546,0.0943449861,0.1007458821,0.28576568,0,59,2.739917903532178E-4,4.6746383E-4,4.7313422E-4,77,41,1,202,1,0.004950495
285796366,jdumes98,10,368,108,181,1,1,36.145735691,30-39,542,4,7,14,21,21,7,14,7,3.0130340333,9.7754757485,0.0049639869,0.2047619048,0.43382353,0,59,6.504252125925483E-5,5.4198706E-5,5.485614E-5,175,18,1,200,1,0.005
286424432,RichardFantin,10,14533,947,1754,35,63,45.1796803701,40-49,760,7,91,152,243,243,91,152,6,2.2049239681,9810.9484657086,0.1040172762,0.0602659593,0.19817452,0,59,3.2589208843674506E-4,6.2328513E-4,6.308456E-4,77,32,0,202,0,0
286985249,VE3ZKS,10,11945,335,956,8,218,36.2594207255,30-39,711,8,66,168,234,234,66,168,6,2.3095582911,4390.113170241,0.110839959,0.1485638825,0.26588792,0,59,3.9535514175585853E-4,4.5391417E-4,4.5942017E-4,25,28,9,201,8,0.039800995
287260619,AlbertaGrl,10,15562,1804,950,48,542,53.1277142341,50-59,781,8,110,155,265,265,110,155,6,2.3845039826,10819.7232431677,0.0565574993,0.0569897084,0.16718417,0,59,5.178295591897452E-4,7.5200706E-4,7.6112896E-4,175,211,4,201,4,0.0199004975
287303720,VancouverBlues,10,3879,211,726,3,10,44.7090036214,40-49,685,6,20,53,73,73,20,53,6,2.4290369298,405.4267392173,0.0178132272,0.1506849315,0.28059396,0,59,9.879776304950324E-5,1.422716E-4,1.4399737E-4,182,15,1,200,1,0.005
287752788,Rabnew,10,5358,250,468,4,17,50.7551004128,50-59,704,7,62,103,165,165,62,103,6,2.3559015206,2115.3994443163,0.056587526,0.1036585366,0.24597496,0,59,2.0151145128346516E-4,4.268148E-4,4.319921E-4,77,135,0,202,0,0
287905776,BlaineBadiuk,10,1019,79,162,0,16,29.7301391003,20-29,488,5,9,13,22,22,9,13,7,2.7472845764,6.199891443,0.0201247168,0.196969697,0.40522876,0,59,8.125376393117074E-5,6.7748384E-5,6.8570174E-5,25,0,2,200,2,0.01
287936925,Oilfieldredneck,10,506,103,129,2,10,36.8896434166,30-39,687,6,17,21,38,38,17,21,7,2.8497465605,29.6781968889,0.0113575957,0.1287339972,0.6699605,0,59,1.1387951040817255E-4,1.2194709E-4,1.2342632E-4,175,7,1,194,1,0.0051546392
288044870,salruffolo,10,34,10,63,0,3,21.250867533,20-29,92,2,1,12,13,13,1,12,7,2.9775524982,0.225838313,3.037257349848907E-4,0.3076923077,0.49242425,0,59,5.005217629447892E-5,1.3549677E-5,1.3714035E-5,182,2,0,37,0,0
288372843,goinkforward,10,1373,72,173,0,34,37.8461134199,30-39,551,5,8,17,25,25,8,17,7,2.8131788559,73.5992943429,0.0098656282,0.15,0.30789474,0,59,7.300356681574346E-5,6.0973543E-5,6.171316E-5,175,4,1,199,1,0.0050251256
288567673,RainerLoveiam,10,3231,432,332,2,6,48.230480265,40-49,563,6,0,0,0,0,0,0,0,0,0,0,0,0,246,642,4.766339181938244E-5,0,0,250,0,0,200,0,0
288578583,KarlaCisnerosH,10,4461,324,189,0,3,42.2694169997,40-49,657,5,4,4,8,8,4,4,4,2.2222222222,30,3.294380011102103E-4,0.0178571429,0.16666667,79,175,5.870663701713763E-4,3.3874192E-5,3.4285087E-5,106,4,0,201,0,0
288961010,CitizensAGroup,10,7062,24,14,3,0,18.5879680788,10-19,624,7,1,1,2,2,1,1,9,5.3971759594,2949,8.66338507538549E-5,0.5,0.5,0,59,1.3983506063912148E-4,1.3549677E-5,1.3714035E-5,62,0,0,200,0,0
289078608,Itsviriidiana,10,1708,256,655,0,9,37.3422959344,30-39,612,5,1,1,2,2,1,1,2,1.6666666667,0,8.44770929948927E-5,0,0,100,225,2.205056735505623E-4,1.3549677E-5,1.3714035E-5,237,2,0,200,0,0
289770017,keevinkreetsch,10,6553,211,255,2,178,41.6824928802,40-49,685,6,0,0,0,0,0,0,0,0,0,0,0,0,28,102,4.766339181938244E-5,0,0,26,2,0,201,0,0
289858647,ait_meziane,10,1583,242,1639,0,70,29.5000831133,20-29,541,6,1,1,2,2,1,1,8,3.8425054308,0,1.1806537768213724E-4,0,0,0,59,5.496718643948958E-5,1.3549677E-5,1.3714035E-5,145,0,0,201,0,0
289911123,michetisseyre,10,4111,138,58,5,38,37.3985280227,30-39,673,7,38,15,53,53,38,15,7,2.6448225923,132.0132481289,0.0623495567,0.1883164006,0.42600423,0,59,1.8232881745738463E-4,2.642187E-4,2.674237E-4,25,24,1,200,1,0.005
290895809,CPoliticalScene,10,401,61,18,2,0,25.2735839662,20-29,527,2,8,5,13,13,8,5,7,3.046705286,3.9828591081,0.0078387865,0.1602564103,0.24242425,0,59,6.812581850667914E-5,6.0973543E-5,6.171316E-5,77,4,0,200,0,0
290913188,unclejoejoe,10,599,29,96,1,4,22.9768779741,20-29,492,5,3,7,10,10,3,7,7,2.9652425778,36.9626165785,0.0011577016,0.2222222222,0.375,0,59,5.752789835053838E-5,2.7099353E-5,2.742807E-5,182,4,0,200,0,0
291142267,CDM4Sarnia,10,2415,48,35,3,618,24.0609325951,20-29,401,6,4,2,6,6,4,2,7,3.2686459088,0.9680757017,0.0058123794,0.1333333333,0.6666667,0,59,6.16832071804268E-5,3.3874192E-5,3.4285087E-5,175,0,0,195,0,0
291497597,Marchand_Phil,10,893,153,337,4,24,40.3414901881,40-49,556,5,22,58,80,80,22,58,7,2.566980449,28.1722899366,0.0372343491,0.2273734177,0.5491552,0,59,1.220641944918111E-4,1.5582128E-4,1.577114E-4,25,28,5,200,5,0.025
291626846,AnnieClaireBO,10,2705,462,861,24,15,45.8133060801,40-49,659,6,13,43,56,56,13,43,7,2.717595945,1158.7477006105,0.0468864776,0.199025974,0.4478261,0,59,3.1127691233935313E-4,9.484774E-5,9.599824E-5,175,19,3,200,3,0.015
291757755,joelplouffe,10,2815,884,1575,28,368,50.1336741267,50-59,678,6,17,25,42,42,17,25,6,2.6560463432,3559.5348730121,0.0233622017,0.0830429733,0.2137931,0,59,1.7095100093612802E-4,1.2194709E-4,1.2342632E-4,77,12,0,200,0,0
292184671,ShafiqStarr,10,22673,412,275,0,3768,36.6912841353,30-39,748,8,0,0,0,0,0,0,0,0,0,0,0,0,109,246,4.766339181938244E-5,0,0,100,24,0,200,0,0
292246560,AndWant,10,119,42,102,0,0,22.3552215192,20-29,266,3,8,19,27,27,8,19,7,2.7150615496,259.9955413412,0.0157922715,0.1125356125,0.34502923,0,59,8.248658570897066E-5,6.0973543E-5,6.171316E-5,25,2,0,147,0,0
292357569,Adam_Dee_Em,10,3858,669,1660,35,153,45.0609757178,40-49,657,7,27,75,102,102,27,75,6,2.3341781318,3950.4810303673,0.0360785518,0.0895942535,0.22473684,0,59,1.3396214318873005E-4,1.8969548E-4,1.9199649E-4,175,1,4,199,4,0.0201005025
292624934,AB_CutRock,10,12941,926,1992,12,80,32.6989626776,30-39,681,7,26,52,78,78,26,52,7,2.557204924,435.963543449,0.0191411948,0.1035631036,0.37028658,0,59,1.5386527361476473E-4,1.8292063E-4,1.8513948E-4,175,2,0,199,0,0
292743375,MacRachelle,10,84,50,183,0,45,23.338554923,20-29,323,2,3,2,5,5,3,2,8,3.849384504,1.227274336,0.0044249993,0.1,0.6666667,0,59,7.416342496447085E-5,2.7099353E-5,2.742807E-5,175,9,0,80,0,0
293106824,anicaribaforada,10,1382,193,241,1,2,37.9739072654,30-39,634,5,1,1,2,2,1,1,1,1,0,8.095914281419891E-5,0,0,172,374,3.177448371356425E-4,1.3549677E-5,1.3714035E-5,171,30,0,200,0,0
293223633,1967canadian,10,14167,510,612,13,311,41.0820211313,40-49,754,8,46,53,99,99,46,53,7,2.5010861694,1340.0177696137,0.029745246,0.0706039992,0.4481132,0,59,2.303584162222901E-4,3.1841738E-4,3.222798E-4,175,78,0,201,0,0
293313896,RobertRoss4,10,13315,564,2001,6,0,48.7254027004,40-49,741,6,25,43,68,68,25,43,6,2.4898624185,683.4582077968,0.0167369138,0.1242317823,0.35836735,0,59,1.367460182884567E-4,1.761458E-4,1.7828245E-4,175,132,8,201,8,0.039800995
293488070,jannovision,10,2465,171,529,3,499,41.3721179483,40-49,594,5,18,54,72,72,18,54,6,2.3769007965,169.4601477598,0.0429486357,0.174687011,0.37900788,0,59,1.0888739516375002E-4,1.2872192E-4,1.3028333E-4,25,16,0,200,0,0
293866044,MalcolmFrench,10,5646,429,288,17,4,49.05923779,40-49,712,7,79,62,141,141,79,62,6,2.434467777,893.8723228675,0.1278361764,0.122289767,0.36040404,0,59,3.6466441305548186E-4,5.419871E-4,5.485614E-4,25,65,2,200,2,0.01
294031719,MRXblogs,10,13590,824,3,60,0,46.3534839474,40-49,713,3,2,0,2,2,2,0,0,0,0,0.0029888238,0.5,0.5,0,37,5.8282345237403514E-5,2.0324514E-5,0,175,2,0,200,0,0
294110720,alicialeals,10,6904,296,211,1,582,42.9537719057,40-49,699,7,2,2,4,4,2,2,5,3.125,33,1.673109193403676E-4,0,0,31,107,3.128657940415099E-4,2.0324514E-5,2.0571053E-5,108,20,0,200,0,0
294174645,katheaney,10,788,422,937,11,2,41.9224914021,40-49,634,5,65,157,222,222,65,157,6,2.2255611875,3881.7586716136,0.1058850661,0.1241082712,0.31274188,0,59,3.0970539478541553E-4,4.4713932E-4,4.5256317E-4,25,16,4,199,4,0.0201005025
294536929,fransmehlape,10,925,80,559,1,2,42.9903965262,40-49,590,5,0,5,5,5,0,5,10,5.8798407528,0,0,0.15,0.25,0,236,4.766339181938244E-5,0,6.8570175E-6,131,3,0,199,0,0
294786747,Elii_Vasquez,10,934,201,495,0,33,38.1273192428,30-39,582,5,0,1,1,1,0,1,1,1,0,0,0,0,65,155,4.766339181938244E-5,0,6.8570175E-6,265,5,0,196,0,0
295529527,angelbug66,10,1672,47,296,0,198,27.0394143716,20-29,467,6,0,3,3,3,0,3,7,3.5363735071,0,0,0.1666666667,0.16666667,0,398,4.766339181938244E-5,0,6.8570175E-6,175,0,0,199,0,0
295707178,BCaramento,10,8957,371,350,8,98,46.0599482084,40-49,736,7,23,33,56,56,23,33,6,2.4981897176,276.9569879101,0.0276162309,0.0909090909,0.33109245,0,59,1.0829394841640164E-4,1.6259612E-4,1.6456842E-4,77,18,0,201,0,0
296350580,KevinROKeefe,10,598,93,89,3,0,42.1771487323,40-49,407,3,19,11,30,30,19,11,6,2.7907313541,32.663672679,0.0254937965,0.1252873563,0.43333334,0,59,1.0436715500158385E-4,1.3549677E-4,1.3714035E-4,77,20,5,200,5,0.025
296553072,maboudib,10,309,103,115,1,0,36.5251431312,30-39,491,4,26,25,51,51,26,25,6,2.5126719768,724.4339474032,0.0342714846,0.1423529412,0.41428572,0,59,1.748897876072264E-4,1.8292063E-4,1.8513948E-4,182,36,3,200,2,0.01
296553576,Erin_M_OToole,10,1102,915,206,19,4,59.7808503915,50-59,703,5,56,18,74,74,56,18,7,2.7299058653,676.7921557348,0.0865197182,0.1075527582,0.22062147,0,59,4.6477916258038943E-4,3.8616578E-4,3.9085E-4,175,31,3,200,3,0.015
296939494,MaiE_89,10,33223,1356,553,45,0,48.2651589019,40-49,783,8,2,1,3,3,2,1,1,1,1.8766033633,6.561853903814539E-4,0,0,0,33,5.650996499971534E-4,2.0324514E-5,2.0571053E-5,77,1,0,201,0,0
297239016,a_w_young,10,9832,686,1844,17,437,58.1037090682,50-59,744,7,54,79,133,133,54,79,6,2.3595220854,6492.4693660398,0.0687854048,0.0956937799,0.24858586,0,59,2.3243250213802926E-4,3.726161E-4,3.7713596E-4,77,17,0,200,0,0
297458940,Mahlabanemp,10,14007,181,85,1,15,44.4501154886,40-49,716,8,0,1,1,1,0,1,11,6.7383279045,0,0,0,0,0,239,4.766339181938244E-5,0,6.8570175E-6,131,24,0,194,0,0
297483708,albertasoapbox,10,2464,337,381,12,4,45.4673863345,40-49,669,6,36,40,76,76,36,40,7,2.6672700941,2117.5554724392,0.0206563341,0.0715789474,0.41915837,0,59,2.100383117782418E-4,2.5066902E-4,2.5370964E-4,175,141,2,199,2,0.0100502513
297568021,bush_wendy,10,2158,366,253,9,52,44.9928845077,40-49,653,6,11,13,24,24,11,13,6,2.6285300507,237.7198994442,0.0176792316,0.0489130435,0.18333334,0,59,8.900309842598016E-5,8.129806E-5,8.228421E-5,77,10,0,200,0,0
297715869,vanessaamtz,10,18056,359,520,0,4450,33.104555263,30-39,705,8,2,2,4,4,2,2,6,3.9375,1,1.6558888883575875E-4,0,0,31,107,2.866419931951024E-4,2.0324514E-5,2.0571053E-5,108,21,0,201,0,0
297765305,AndrewCMcAvoy,10,1063,191,575,9,4,48.6838123487,40-49,497,5,25,112,137,137,25,112,7,2.4297610427,1275.1338948415,0.0271417228,0.1768999571,0.32979664,0,59,1.3130871096617952E-4,1.761458E-4,1.7828245E-4,25,4,1,200,1,0.005
298364997,MbusoHlangu,10,2201,79,94,1,26,41.7782798203,40-49,564,6,0,1,1,1,0,1,1,1,0,0,0,0,0,573,4.766339181938244E-5,0,6.8570175E-6,131,0,2,201,2,0.0099502488
298540272,AngryAccountant,10,1295,155,323,0,42,27.6321892287,20-29,594,5,1,5,6,6,1,5,7,3.1169442433,0.3360913536,0.0010692841,0.2333333333,0.5,0,59,5.130180567038874E-5,1.3549677E-5,1.3714035E-5,25,3,0,200,0,0
298598869,earthchild93,10,4284,200,443,0,47,32.1467204455,30-39,699,6,0,3,3,3,0,3,7,3.079985523,0,0,0.3333333333,0.6666667,0,388,4.766339181938244E-5,0,6.8570175E-6,182,0,0,200,0,0
299108280,kafflut,10,7486,491,799,7,187,51.8270320983,50-59,691,7,2,8,10,10,2,8,9,4.8091962346,5691.3728060464,1.8718177880320175E-4,0.1111111111,0.25,0,59,9.771529151638073E-5,2.0324514E-5,2.0571053E-5,131,22,0,198,0,0
299444560,calg_kiaguy,10,3232,76,70,0,9,45.6522195804,40-49,682,6,15,2,17,17,15,2,7,3.1622013034,17.2715001507,0.0151473395,0.1213235294,0.22083333,0,59,8.915324418747317E-5,1.0839741E-4,1.0971228E-4,77,70,0,215,0,0
299738128,ArnaldoBeni,10,37,6,40,0,0,13.8378558686,10-19,115,2,0,2,2,2,0,2,7,3.5381831343,0,0,0,0,0,336,4.766339181938244E-5,0,6.8570175E-6,175,1,0,45,0,0
300070934,ALiberalCase,10,6417,603,723,17,26,54.7210883442,50-59,742,7,46,55,101,101,46,55,6,2.5039826213,1743.523893505,0.0549783011,0.1361386139,0.33982685,0,59,2.4636841389183753E-4,3.1841738E-4,3.222798E-4,175,42,0,199,0,0
300388340,ChoiceZnewZ,10,85687,3385,3223,181,1725,55.6593990668,50-59,868,10,12,22,34,34,12,22,7,2.8229543809,236.9471506071,0.00927259,0.0650623886,0.2012987,0,59,8.302007744577336E-5,8.80729E-5,8.914123E-5,182,16,0,201,0,0
300400577,TartsnTattoos,10,3467,300,387,6,45,40.9976642984,40-49,636,6,3,5,8,8,3,5,7,2.7577842143,123.9965367375,0.0077405484,0.0535714286,0.3,0,59,6.589045459181106E-5,2.7099353E-5,2.742807E-5,25,5,0,199,0,0
300670811,thomas_falcone,10,2495,361,790,5,4,40.4968785652,40-49,640,6,28,73,101,101,28,73,6,2.377986966,1620.2503155139,0.0466601036,0.0974257426,0.25243244,0,59,1.6739006799203727E-4,1.9647031E-4,1.9885351E-4,175,1,0,200,0,0
300756828,sebaguadrini,10,188,20,53,2,1,26.7223666063,20-29,518,3,0,1,1,1,0,1,7,4.3571428571,0,0,0,0,42,493,4.766339181938244E-5,0,6.8570175E-6,197,1,0,194,0,0
300888596,BencivengaPierf,10,7046,636,605,2,14,45.867190475,40-49,719,7,1,3,4,4,1,3,5,2.6153846154,0,8.27370687256753E-5,0.25,0.6666667,42,307,8.096442488080379E-5,1.3549677E-5,1.3714035E-5,197,5,0,200,0,0
300958574,RaymanBhuller,10,1397,273,323,7,0,41.8304825279,40-49,687,6,2,0,2,2,2,0,0,0,0,8.547181803027121E-4,0,0,0,16,7.11866131187818E-5,2.0324514E-5,0,182,0,1,201,1,0.0049751244
301125514,Gekkebus,10,4411,185,387,2,146,47.4326728089,40-49,662,7,12,19,31,31,12,19,7,2.801955105,40.6828884611,0.0099280943,0.1204301075,0.37662336,0,59,9.091973876447096E-5,8.80729E-5,8.914123E-5,175,10,0,203,0,0
301253362,Declan_iRiSh21,10,5065,366,481,0,1299,42.7514505372,40-49,702,7,4,5,9,9,4,5,2,1.2857142857,20.5,3.329761209484409E-4,0.0416666667,0.25,18,88,4.3728090441764637E-4,3.3874192E-5,3.4285087E-5,39,13,0,200,0,0
301266288,RosannaLopez101,10,23328,1036,1504,28,4,49.7818857305,40-49,736,8,24,40,64,64,24,40,6,2.5445329471,3577.0607900643,0.0305728711,0.0843253968,0.24242425,0,59,2.279984064087906E-4,1.6937095E-4,1.7142543E-4,175,14,0,199,0,0
301678700,lefty749,10,678,25,140,0,25,17.0376144503,10-19,391,5,0,1,1,1,0,1,7,4.3571428571,0,0,0,0,42,442,4.766339181938244E-5,0,6.8570175E-6,197,0,0,200,0,0
302659496,nucks99,10,1606,94,211,3,9,40.4416572366,40-49,616,6,11,16,27,27,11,16,7,2.7661115134,25.6002307412,0.0106849922,0.103988604,0.53333336,0,59,9.327364709193476E-5,8.129806E-5,8.228421E-5,175,2,0,192,0,0
302886061,Shimoshee,10,815,84,160,0,0,33.9890218508,30-39,582,5,0,1,1,1,0,1,1,1,0,0,0,0,0,650,4.766339181938244E-5,0,6.8570175E-6,25,3,0,200,0,0
302951386,JoelBReed,10,3982,406,468,7,1,42.8877202295,40-49,715,7,13,24,37,37,13,24,7,2.9083997104,97.134927172,0.0139081995,0.1749249249,0.37586206,0,59,1.781859468445233E-4,9.484774E-5,9.599824E-5,175,8,1,201,1,0.0049751244
303289107,Dino_Zorzi,10,111,104,913,0,36,23.9225101923,20-29,267,4,28,237,265,265,28,237,6,2.1918899348,5159.0879603352,0.0258621402,0.1427815895,0.24781051,0,59,1.1894984738260601E-4,1.9647031E-4,1.9885351E-4,25,1,0,126,0,0
303358010,jkervel,10,1135,98,318,1,150,36.3231148446,30-39,562,5,3,11,14,14,3,11,6,2.746198407,63.9881189428,0.0027460457,0.1318681319,0.3272727,0,59,1.148313666975474E-4,2.7099353E-5,2.742807E-5,182,2,0,200,0,0
303665229,Rod_McCallum,10,26386,823,1994,20,11,55.7281179412,50-59,773,8,48,117,165,165,48,117,6,2.3167994207,1675.4713121666,0.0547567931,0.1134146341,0.2531898,0,59,1.7398640022285233E-4,3.3196708E-4,3.3599386E-4,77,111,0,201,0,0
303944876,RefilweI,10,1655,89,139,0,6,45.8875095985,40-49,668,6,1,2,3,3,1,2,9,4.8157132513,0,1.0620179378829457E-4,0.1666666667,0.5,0,59,7.30458828426335E-5,1.3549677E-5,1.3714035E-5,131,33,0,199,0,0
305330589,gelagaffe,10,887,172,239,2,235,44.3606971045,40-49,615,6,38,44,82,82,38,44,6,2.518102824,532.8973119782,0.0445583413,0.0686540199,0.41060606,0,59,1.4120813860818182E-4,2.642187E-4,2.674237E-4,77,193,4,199,4,0.0201005025
305555549,vallaniel,10,284,46,215,0,49,18.8292025845,10-19,507,4,0,3,3,3,0,3,8,3.6156351792,0,0,0,0,0,310,4.766339181938244E-5,0,6.8570175E-6,182,3,0,201,0,0
305929470,Rgme7,10,3303,386,914,1,138,40.6057491672,40-49,679,6,3,3,6,6,3,3,4,2.3333333333,30,2.4654801887926563E-4,0,0,79,175,5.01488717781488E-4,2.7099353E-5,2.742807E-5,106,1,0,200,0,0
306007299,YMCAGP,10,232,245,190,3,6,39.7071941617,30-39,619,4,2,3,5,5,2,3,7,3.8645908762,2958.8970419895,3.227185355963594E-4,0,0,0,59,8.542995554057189E-5,2.0324514E-5,2.0571053E-5,175,79,0,200,0,0
306360991,YourMomBot,10,224334,13976,14336,138,7,66.2963699182,60-69,857,11,2,2,4,4,2,2,7,3.1998551774,3.2510894393,0.0020930977,0,0,0,59,6.46778709310878E-5,2.0324514E-5,2.0571053E-5,77,2,0,201,0,0
306487463,teachingchrisb,10,486,168,232,8,1,40.0380239336,40-49,602,5,12,22,34,34,12,22,7,2.774076756,2063.1346209586,0.0129450379,0.179144385,0.57608694,0,59,1.5300608383902876E-4,8.80729E-5,8.914123E-5,25,10,0,198,0,0
307938640,jesselafleur,10,754,155,105,4,1,41.0276907234,40-49,592,5,51,36,87,87,51,36,6,2.585083273,200.5456092941,0.0635162533,0.1801657311,0.38384485,0,59,1.9933412157680652E-4,3.522916E-4,3.565649E-4,25,8,1,200,1,0.005
307963985,RayMartin2,10,1,4,0,0,0,,,4,0,0,0,0,0,0,0,0,0,0,0,0,0,3,66,4.766339181938244E-5,0,0,2,0,0,2,0,0
308613286,WiscLimnology,10,1179,519,343,36,1,49.7872919404,40-49,628,4,7,2,9,9,7,2,8,3.8993482983,0,0.0021650067,0.2777777778,0.95238096,0,59,9.669020097838866E-5,5.4198706E-5,5.485614E-5,77,13,0,200,0,0
308821251,CanadaMarxists,10,421,258,8,11,12,35.9064774872,30-39,597,3,15,0,15,15,15,0,0,0,0,0.0130223707,0.1904761905,0.33333334,0,18,9.3310276340411E-5,1.0839741E-4,0,182,6,0,199,0,0
309095245,NajdAldowish,10,43608,1377,348,0,1859,38.2394303384,30-39,770,9,1,1,2,2,1,1,3,2,4,7.92005701980554E-5,0,0,22,162,8.817727671970712E-5,1.3549677E-5,6.8570175E-6,126,4,0,204,0,0
309147403,mcintyreslady,10,402,30,143,0,29,18.7602446323,10-19,436,4,2,4,6,6,2,4,7,3.2947139754,122.7951100703,0.0042824232,0.1,0.3,0,59,6.918361416885171E-5,2.0324514E-5,2.0571053E-5,182,2,0,200,0,0
309558781,KellyRek,10,64514,2535,2766,131,26276,47.0013892037,40-49,813,9,1,6,7,7,1,6,7,2.9355539464,120.9129615286,8.920259293877522E-5,0.119047619,0.26666668,0,59,5.9347895355559455E-5,1.3549677E-5,1.3714035E-5,77,20,0,201,0,0
309963708,miros_quiroga,10,4244,270,326,0,22,38.1046115192,30-39,662,6,0,0,0,0,0,0,0,0,0,0,0,0,256,665,4.766339181938244E-5,0,0,261,3,0,198,0,0
310425304,bernie8859,10,869,12,42,0,3,23.5544698802,20-29,333,4,3,3,6,6,3,3,7,2.9500362056,0,0.0083695551,0.2,0.9166667,0,59,5.880986855821122E-5,2.7099353E-5,2.742807E-5,25,4,0,200,0,0
310831037,algonquinwoman,10,647,51,79,0,19,27.1668441077,20-29,555,5,3,2,5,5,3,2,7,3.3892107169,9.8832051462,0.0043316872,0.2,0.4,0,59,5.260954412437561E-5,2.7099353E-5,2.742807E-5,77,1,0,200,0,0
310855387,antiharper101,10,16371,620,267,19,282,42.1192901846,40-49,741,8,114,55,169,169,114,55,6,2.4507603186,1541.6916304726,0.1025084473,0.103021978,0.27829725,0,59,3.01908758038795E-4,7.791064E-4,7.88557E-4,77,50,1,204,1,0.0049019608
310942227,SteveRickettsSP,10,3019,111,194,4,2,51.0979300475,50-59,687,6,7,16,23,23,7,16,7,2.8062997828,184.3318362054,0.0046708498,0.2252964427,0.45526317,0,59,6.87315163677469E-5,5.4198706E-5,5.485614E-5,175,24,0,200,0,0
310961831,databassist,10,2786,43,40,3,7,41.8184544807,40-49,626,6,2,3,5,5,2,3,7,3.2708182476,3.7605758295,0.004736787,0.2,0.5833333,0,59,7.354415757931976E-5,2.0324514E-5,2.0571053E-5,25,2,0,200,0,0
311177662,LaniganDarin,10,1105,105,217,2,11,42.1892546556,40-49,607,5,3,17,20,20,3,17,7,2.8790731354,8.5419506484,0.0033026332,0.1973684211,0.35620916,0,59,5.563976888906825E-5,2.7099353E-5,2.742807E-5,25,7,3,199,3,0.0150753769
311286748,jaystor,10,2523,174,450,3,3,47.6949774463,40-49,668,6,51,89,140,140,51,89,6,2.377262853,571.0300244601,0.1218482914,0.1619732785,0.39057547,0,59,3.4363396860455467E-4,3.522916E-4,3.565649E-4,25,22,22,200,22,0.11
311736093,pop2cas,10,2953,102,609,3,9,43.1651375705,40-49,696,7,18,57,75,75,18,57,6,2.4974656046,425.8853130321,0.0186065925,0.1144144144,0.28024548,0,59,1.0735341815798342E-4,1.2872192E-4,1.3028333E-4,182,3,0,201,0,0
312146395,DrummaboySwagg,10,4337,131,125,2,469,32.3918587751,30-39,711,6,1,1,2,2,1,1,1,1,0,8.095914281419891E-5,0,0,70,161,3.177448371356425E-4,1.3549677E-5,1.3714035E-5,109,48,0,200,0,0
312176922,MelodieCardin,10,318,129,180,6,1,24.9357394721,20-29,539,4,1,7,8,8,1,7,7,3.0706010138,3.3828225187,0.0034130631,0.3392857143,0.5,0,59,5.611101222090455E-5,1.3549677E-5,1.3714035E-5,175,1,0,200,0,0
312194762,CTVLondon,10,8182,6727,1814,146,25,61.4069702593,60-69,784,7,39,21,60,60,39,21,6,2.9395365677,3831.6165239673,0.027196095,0.0782485876,0.17715079,0,59,3.2884189213249333E-4,2.7099354E-4,2.674237E-4,175,159,0,201,0,0
312195939,CTVWindsor,10,4450,2465,1335,51,2,56.3334602135,50-59,757,6,27,18,45,45,27,18,7,2.7302679218,8961.1393615391,0.0202088523,0.0621212121,0.16761364,0,59,2.940329721944734E-4,1.8969548E-4,1.9199649E-4,175,99,0,201,0,0
312660421,OSConservatives,10,586,359,1131,8,1,45.55281812,40-49,623,4,35,117,152,152,35,117,6,2.3457639392,9279.3085458763,0.0267528085,0.1077901708,0.23930427,0,59,2.195347184170175E-4,2.4389417E-4,2.4685264E-4,175,43,0,201,0,0
313145702,RanRinBC,10,6696,537,820,10,354,64.5543240145,60-69,752,8,37,43,80,80,37,43,7,2.6075307748,3951.9673283246,0.0205799598,0.0735759494,0.22327045,0,59,2.3179784550544233E-4,2.5744384E-4,2.6056665E-4,182,97,0,200,0,0
313310001,MattLyte,10,561,84,188,1,46,26.7520904528,20-29,477,5,3,7,10,10,3,7,7,2.8823316437,2.6928870722,0.0049363026,0.2111111111,0.5952381,0,59,5.8209857304332896E-5,2.7099353E-5,2.742807E-5,77,1,0,200,0,0
313332496,DemocracyWatchr,10,1484,891,193,30,5,52.2330493996,50-59,698,5,115,45,160,160,115,45,6,2.5514120203,1962.468767534,0.1151343004,0.1149764151,0.16852562,0,59,5.437411725011777E-4,7.8588125E-4,7.88557E-4,77,138,0,200,0,0
313799444,TibidyUS,10,341006,6928,7628,104,0,43.1962457974,40-49,762,6,1,1,2,2,1,1,7,3.3515568429,0,7.677704589948865E-4,0,0,0,59,5.0417019413641886E-5,1.3549677E-5,1.3714035E-5,77,1,0,201,0,0
313900607,bose_anu,10,2040,35,59,2,3,25.3416601519,20-29,468,5,7,21,28,28,7,21,6,2.6745112238,23.0338174551,0.0244624677,0.2526455026,0.64718616,0,59,1.1335369795173876E-4,5.4198706E-5,5.485614E-5,25,1,0,200,0,0
314719703,shawna_dennis,10,6482,1061,1493,20,323,46.5103798364,40-49,725,7,58,124,182,182,58,124,6,2.3971759594,6581.2656226563,0.0545852254,0.0686054277,0.19454083,0,59,2.6453709756443257E-4,3.9971547E-4,4.0456402E-4,175,30,1,200,1,0.005
315042301,rparmar958,10,1576,117,494,1,29,28.3496541761,20-29,470,6,10,43,53,53,10,43,7,2.4808110065,361.5207930245,0.0218100479,0.1977503628,0.3949495,0,59,1.2771889978784409E-4,7.452322E-5,7.542719E-5,182,1,3,200,3,0.015
315934722,DowntownJason,10,3872,1203,695,29,417,49.8871390865,40-49,721,7,7,2,9,9,7,2,7,3.3167994207,5.608549549,0.0032657122,0.2222222222,0.39285713,0,59,7.777070887449832E-5,5.4198706E-5,5.485614E-5,25,24,0,200,0,0
315943388,arsenic101,10,7296,729,908,9,214,40.4352860756,40-49,674,6,48,62,110,110,48,62,6,2.4275887038,460.7929195335,0.0699151719,0.0760633862,0.37942886,0,59,1.955954923553815E-4,3.3196708E-4,3.3599386E-4,77,6,3,200,3,0.015
316046746,MarkyMark_12,10,1299,47,85,0,3,30.5870176192,30-39,580,5,0,1,1,1,0,1,7,3.6659428158,0,0,0,0,0,590,4.766339181938244E-5,0,6.8570175E-6,175,5,0,200,0,0
316143899,QaqishPolitico,10,2011,388,353,15,11,44.9651789863,40-49,637,6,21,22,43,43,21,22,6,2.5459811731,333.2448958798,0.0452951679,0.0941306755,0.31084657,0,59,1.6068910329753314E-4,1.4904643E-4,1.5085438E-4,175,15,0,200,0,0
316633277,Oneiros444,10,514,32,192,0,10,26.1313346705,20-29,494,4,0,1,1,1,0,1,7,4.3571428571,0,0,0,0,42,486,4.766339181938244E-5,0,6.8570175E-6,197,3,0,197,0,0
316750387,goIslandSouth,10,4095,1407,570,48,6,52.1619047685,50-59,710,7,12,11,23,23,12,11,7,3.0445329471,38.5535933778,0.0070076454,0.1996047431,0.32857144,0,59,1.0219745783167482E-4,8.80729E-5,8.914123E-5,182,40,0,200,0,0
316910129,hashonomy_gus,10,215479,2531,0,141,0,48.0280261767,40-49,793,10,7,0,7,7,7,0,0,0,0,0.0120003126,0.2857142857,0.5,0,38,6.814525974121383E-5,5.4198706E-5,0,77,4,0,201,0,0
317932423,trudatted,10,118,57,210,4,2,34.6420704299,30-39,352,3,3,6,9,9,3,6,7,2.9790007241,3447.5880703765,0.0033976791,0.125,0.43333334,0,59,7.90331083840645E-5,2.7099353E-5,2.742807E-5,77,4,0,123,0,0
318358273,KgotsoBops,10,3893,152,132,1,1,45.4313022915,40-49,697,6,0,0,0,0,0,0,0,0,0,0,0,0,234,602,4.766339181938244E-5,0,0,238,18,0,200,0,0
318568724,FredOliver245,10,4907,73,61,0,74,16.897913174,10-19,561,7,15,10,25,25,15,10,6,2.8620564808,42.8011944731,0.0154797497,0.1033333333,0.28362572,0,59,8.720535971060324E-5,1.0839741E-4,1.0971228E-4,77,0,0,200,0,0
319742258,RanaldH,10,121,1,6,0,0,11.0632857838,10-19,21,3,0,1,1,1,0,1,7,3.2616720955,0,0,0,0,0,186,4.766339181938244E-5,0,6.8570175E-6,77,0,0,122,0,0
320522568,natasha_ryg,10,670,122,328,0,186,38.0130699006,30-39,594,4,1,4,5,5,1,4,7,3.1541244573,1.561327846,8.095914281419891E-5,0.2,0.41666666,0,265,5.785622515748288E-5,1.3549677E-5,1.3714035E-5,77,7,0,200,0,0
320842763,shell871,10,35834,288,446,8,38,57.0188116438,50-59,787,8,0,3,3,3,0,3,7,3.450597177,0,0,0,0,0,630,4.766339181938244E-5,0,6.8570175E-6,175,2,0,201,0,0
320990339,justlynnp,10,596,33,13,2,1,30.9229650813,30-39,451,5,11,2,13,13,11,2,7,2.9837074584,3.3787065107,0.0155411468,0.3333333333,0.5641026,0,59,9.704881490669868E-5,8.129806E-5,8.228421E-5,182,7,0,200,0,0
321099097,Mary_OGrady,10,3996,382,293,7,1,51.8086514616,50-59,692,7,17,18,35,35,17,18,7,2.7204923968,1077.523841356,0.026423359,0.0789915966,0.26630434,0,59,1.4263580237381946E-4,1.2194709E-4,1.2342632E-4,175,30,0,199,0,0
321349799,LarissaJSmit,10,347,266,546,1,0,24.4476666357,20-29,567,4,13,26,39,39,13,26,7,2.7758870384,5314.1989567648,0.013033097,0.1396761134,0.3218391,0,59,1.2500804425140969E-4,9.484774E-5,9.599824E-5,175,12,1,187,1,0.0053475936
321750520,anita_tweets,10,1432,159,166,7,9,31.2294765521,30-39,573,5,7,16,23,23,7,16,6,2.744750181,151.477325006,0.014003548,0.1205533597,0.3625,0,59,7.623850863294941E-5,5.4198706E-5,5.485614E-5,182,2,0,200,0,0
321871451,northernck,10,9374,474,757,10,60,41.0417266452,40-49,729,7,75,128,203,203,75,128,6,2.2302679218,2133.9501512664,0.0956783128,0.0928400722,0.3315106,0,59,2.445759468030478E-4,5.148877E-4,5.211333E-4,77,41,1,200,1,0.005
321968555,MahassenF,10,2888,87,351,0,20,20.9988320141,20-29,569,6,11,41,52,52,11,41,6,2.4913106445,74.8596957516,0.0134607577,0.1361236802,0.30197445,0,59,7.633357834172137E-5,8.129806E-5,8.228421E-5,77,1,0,200,0,0
322164578,gabaribeau,10,3426,307,751,6,3,45.3394716435,40-49,635,6,8,29,37,37,8,29,7,2.6332367849,3400.4031686464,0.011413987,0.1493993994,0.31494254,0,59,7.72447472818277E-5,6.0973543E-5,6.171316E-5,175,2,1,200,1,0.005
322620521,Chile01_4Mayor,10,76,17,60,0,1,17.7993678902,10-19,250,2,0,1,1,1,0,1,7,3.0441549041,0,0,0,0,0,321,4.766339181938244E-5,0,6.8570175E-6,25,0,0,91,0,0
322814071,BrianDijkema,10,1940,245,304,6,51,45.4049328065,40-49,617,6,2,6,8,8,2,6,7,3.1944243302,0.7157339507,5.859675495890959E-4,0.3214285714,0.42857143,0,59,5.354576328368363E-5,2.0324514E-5,2.0571053E-5,175,11,0,200,0,0
322835810,allan_pollock,10,2391,373,930,8,18,40.7587202439,40-49,582,6,2,3,5,5,2,3,7,3.2154236061,6.6097941381,0.0027348116,0.1,0.33333334,0,59,6.22861517406724E-5,2.0324514E-5,2.0571053E-5,182,2,0,200,0,0
323202135,sagnello83,10,1289,49,196,0,1,29.6415652721,20-29,715,6,0,1,1,1,0,1,7,4.3571428571,0,0,0,0,42,477,4.766339181938244E-5,0,6.8570175E-6,197,1,0,199,0,0
324029056,rubrecht73,10,39,13,74,0,0,22.7243430455,20-29,130,2,2,2,4,4,2,2,8,3.5177407676,1.2952280288,6.772534057016214E-4,0.1666666667,0.33333334,0,59,5.500510770459899E-5,2.0324514E-5,2.0571053E-5,182,1,0,45,0,0
324468091,GTALEAF,10,7536,22,1,1,0,17.1916240162,10-19,635,7,1,1,2,2,1,1,8,4.3979000724,2761,8.100815567777819E-5,0.5,0.5,0,59,1.6652357755289444E-4,1.3549677E-5,1.3714035E-5,62,0,0,200,0,0
324506143,skmoyls,10,150,94,337,5,2,32.2092433481,30-39,434,3,1,10,11,11,1,10,6,2.7762490949,6.3974911636,0.0025856599,0.2545454545,0.42222223,0,59,5.629578801767496E-5,1.3549677E-5,1.3714035E-5,182,0,0,156,0,0
324607535,johnnewton23,10,65,19,39,0,0,17.7349986435,10-19,229,2,2,3,5,5,2,3,7,3.0459811731,2.8922483239,7.332084072236874E-4,0.25,0.5,0,59,5.400022177298512E-5,2.0324514E-5,2.0571053E-5,182,0,1,85,1,0.0117647059
324871858,arc185,10,2284,435,2001,5,26,40.3996923869,40-49,621,6,37,140,177,177,37,140,6,2.3385228096,2142.6323722677,0.0624252278,0.1514830508,0.3243774,0,59,1.9064614175062796E-4,2.5744384E-4,2.6056665E-4,147,4,2,200,2,0.01
325022623,PrairieStorm2,10,16566,1143,1242,25,260,42.4993358977,40-49,765,8,75,88,163,163,75,88,6,2.4569152788,6442.5803840739,0.0435666214,0.0465803227,0.23284493,0,59,3.443075445290567E-4,5.148877E-4,5.211333E-4,175,131,0,201,0,0
325119794,RubyDagger,10,320,51,150,1,2,39.7294165207,30-39,476,5,0,3,3,3,0,3,7,3.2034020992,0,0,0.3333333333,0.33333334,0,624,4.766339181938244E-5,0,6.8570175E-6,25,0,0,200,0,0
325165914,ing_rogi,10,8370,846,693,6,1865,37.6139454274,30-39,714,7,0,1,1,1,0,1,7,4.3571428571,0,0,0,0,42,473,4.766339181938244E-5,0,6.8570175E-6,197,0,0,200,0,0
325315594,Beaches_E_York,10,813,848,2001,26,514,31.8320682343,30-39,530,5,10,39,49,49,10,39,6,2.518102824,391.695164754,0.0147458587,0.1832482993,0.37134147,0,59,8.751165785224712E-5,7.452322E-5,7.542719E-5,175,1,0,200,0,0
325566756,GenesiisBone,10,9155,216,239,0,177,40.346721334,40-49,711,7,0,0,0,0,0,0,0,0,0,0,0,0,153,343,4.766339181938244E-5,0,0,151,6,0,201,0,0
325941616,SantiagoGuajard,10,8000,178,161,0,125,,,710,6,0,0,0,0,0,0,0,0,0,0,0,0,24,98,4.766339181938244E-5,0,0,21,3,0,201,0,0
326235711,quito_maggi,10,1807,600,597,17,43,62.7837172238,60-69,682,6,69,96,165,165,69,96,6,2.4268645909,1727.6329493576,0.0791969905,0.1015890613,0.30420354,0,59,3.293544084242488E-4,4.7423868E-4,4.7999123E-4,175,108,0,200,0,0
326461319,ktownareacouncl,10,1368,121,72,8,9,35.3307603168,30-39,560,6,29,21,50,50,29,21,6,2.5872556119,756.0254675744,0.0382144595,0.14,0.35206258,0,59,2.4685205820987186E-4,2.0324514E-4,2.0571053E-4,182,23,1,200,1,0.005
326540264,ps92264,10,11314,384,1657,2,33,45.60137817,40-49,713,8,4,18,22,22,4,18,7,2.7968863143,2624.3570407001,0.0057521935,0.1515151515,0.3496732,0,59,6.439001404130299E-5,3.3874192E-5,3.4285087E-5,175,15,0,201,0,0
326603518,urbngreen,10,2764,1050,2000,31,48,44.7201538081,40-49,632,6,13,36,49,49,13,36,6,2.574583635,217.1322831867,0.0238536138,0.1109693878,0.2936508,0,59,9.023132042872428E-5,9.484774E-5,9.599824E-5,182,2,0,200,0,0
326900818,eastknow,10,3572,896,1860,16,1,46.2007850497,40-49,633,5,4,18,22,22,4,18,7,2.9808110065,57.5579749495,7.242376871439832E-4,0.1147186147,0.22875817,0,59,7.773395349880019E-5,3.3874192E-5,3.4285087E-5,182,7,0,200,0,0
326960437,aniello_nazaria,10,40560,1537,1153,32,12411,47.9347475722,40-49,856,9,2,0,2,2,2,0,0,0,0,1.584011403961108E-4,0,0,42,126,8.142496256965301E-5,2.0324514E-5,0,197,12,0,201,0,0
327108918,TransitionKW,10,283,94,77,3,1,38.0322054185,30-39,429,3,2,1,3,3,2,1,7,3.2614047791,0.0760079863,0.0011187392,0.1666666667,0.16666667,0,59,6.761548160265924E-5,2.0324514E-5,2.0571053E-5,77,8,0,200,0,0
327135990,RobbynLanning,10,555,22,94,0,1,23.3244460531,20-29,470,4,2,3,5,5,2,3,7,3.2248370746,0,0.0022580197,0.5,0.55,0,59,5.334674074290384E-5,2.0324514E-5,2.0571053E-5,182,1,0,198,0,0
327471759,FaustoDeMaria,10,964,504,471,1,2,42.6752380491,40-49,602,5,5,4,9,9,5,4,5,2.5384615385,19.3333333333,4.122923241696673E-4,0.0972222222,0.23809524,42,307,6.099168727981912E-4,4.064903E-5,2.742807E-5,197,8,0,200,0,0
327740140,la_cornish,10,3200,434,528,12,35,40.6823333022,40-49,661,6,32,31,63,63,32,31,6,2.5108616944,428.3055359144,0.0544925393,0.120327701,0.29742908,0,59,2.0370270490765443E-4,2.2356966E-4,2.2628158E-4,77,8,0,200,0,0
327747513,John_Acton,10,1056,68,133,0,0,27.1905627017,20-29,366,5,12,28,40,40,12,28,6,2.5394641564,259.8026943192,0.0108188244,0.1115384615,0.32142857,0,59,7.90805803212703E-5,8.80729E-5,8.914123E-5,182,1,1,199,1,0.0050251256
328112301,robert_kiley,10,2924,678,1071,27,67,48.514550343,40-49,681,6,41,78,119,119,41,78,6,2.338884866,6280.4954681382,0.0498165622,0.0969235152,0.25,0,59,3.035186307403867E-4,2.845432E-4,2.8799474E-4,175,30,0,200,0,0
328243230,FM_Aubin,10,7210,482,586,9,7,55.9422992306,50-59,709,7,23,25,48,48,23,25,7,2.6524257784,227.5888286493,0.0310983235,0.0970744681,0.3235887,0,59,1.7684262906204892E-4,1.6259612E-4,1.6456842E-4,175,11,1,201,1,0.0049751244
328838034,MaeganEllioElf,10,2630,66,99,0,43,28.2601304302,20-29,603,5,0,2,2,2,0,2,7,3.3427433949,0,0,0.5,1,0,104,4.766339181938244E-5,0,6.8570175E-6,182,2,0,200,0,0
329606884,acciesfc,10,7919,2033,32,32,0,56.7846568908,50-59,761,6,1,0,1,1,1,0,0,0,0,7.92005701980554E-5,0,0,224,557,8.817727671970712E-5,1.3549677E-5,0,229,67,0,201,0,0
330268057,curtis_v5,10,1813,160,284,0,47,51.4708749581,50-59,600,5,1,2,3,3,1,2,11,6.8024602026,2763,8.095914281419891E-5,0,0,0,250,1.380466301787866E-4,1.3549677E-5,1.3714035E-5,131,5,0,200,0,0
330494760,seekingmolly,10,14411,2962,2943,110,126,43.7287275554,40-49,742,8,8,10,18,18,8,10,6,2.9768283852,47.2728083011,0.0029669915,0.0522875817,0.24545455,0,59,8.213558573050637E-5,6.0973543E-5,6.171316E-5,77,1,0,198,0,0
331272785,WhseMark,10,2655,262,413,8,7,46.6808075544,40-49,616,6,17,24,41,41,17,24,6,2.6477190442,219.4644328009,0.0180870907,0.0804878049,0.25498575,0,59,9.923918845003345E-5,1.2194709E-4,1.2342632E-4,182,9,1,200,1,0.005
331376866,manny_ottawa,10,8808,538,298,9,45,54.517388754,50-59,757,7,54,33,87,87,54,33,6,2.5984793628,785.4549359678,0.0477314681,0.1148088746,0.25942028,0,59,2.884082002157898E-4,3.726161E-4,3.7027895E-4,175,137,2,200,2,0.01
331666614,AndreaMicieli,10,2074,431,686,8,63,48.036823562,40-49,669,6,62,99,161,161,62,99,6,2.3964518465,1731.584763143,0.0585079575,0.1202639752,0.3275862,0,59,3.00330853134401E-4,4.268148E-4,4.319921E-4,175,117,1,200,1,0.005
331678517,IBEW_KateWalsh,10,1278,410,309,11,0,45.876482838,40-49,629,5,35,33,68,68,35,33,6,2.5615496017,4357.1944671947,0.0381791687,0.1022827041,0.34202898,0,59,1.9058748367879963E-4,2.4389417E-4,2.4685264E-4,182,35,0,200,0,0
331776617,SamSolar1,10,3059,3005,2964,4,0,43.97357971,40-49,654,5,8,7,15,15,8,7,6,2.6477190442,45.2475441184,0.0170429785,0.0428571429,0.25,0,59,7.001369691181646E-5,6.0973543E-5,6.171316E-5,77,21,0,200,0,0
331840766,adoresubtract,10,173,53,120,1,79,18.128616344,10-19,409,3,1,2,3,3,1,2,6,3.1788559015,0.4995752955,0.0016214835,0,0,0,59,5.182712670445942E-5,1.3549677E-5,1.3714035E-5,182,0,0,181,0,0
332063391,BlueRaveFinn,10,26112,467,488,21,904,38.619343337,30-39,748,8,2,9,11,11,2,9,7,2.9326574946,2950.0844285366,0.0014974074,0.1363636364,0.30555555,0,59,5.6080880697048246E-5,2.0324514E-5,2.0571053E-5,77,5,0,201,0,0
332354960,guslitsas,10,1385,200,292,2,13,31.7137270393,30-39,577,5,3,5,8,8,3,5,7,3.0912382332,4.6577378271,0.0025431565,0.0892857143,0.45,0,59,5.945968662237535E-5,2.7099353E-5,2.742807E-5,175,2,0,200,0,0
332884767,Quig40,10,8769,511,938,16,64,35.8318456672,30-39,713,7,35,56,91,91,35,56,7,2.5061549602,3182.3056625861,0.0285858506,0.0728937729,0.26271185,0,59,1.9079485430595022E-4,2.4389417E-4,2.4685264E-4,175,11,0,200,0,0
333016219,nsynd,10,271,240,163,8,2,37.504995475,30-39,548,4,64,49,113,113,64,49,6,2.4996379435,3892.6117845368,0.0778315487,0.1349557522,0.29622552,0,59,3.5473210022641096E-4,4.403645E-4,4.4570613E-4,147,23,0,200,0,0
333705888,KyoNETca,10,213,13,67,0,1,27.3528721417,20-29,272,4,1,2,3,3,1,2,7,3.2480086894,0,0.0036251983,0.3333333333,0.33333334,0,59,5.1343015620857445E-5,1.3549677E-5,1.3714035E-5,77,4,0,200,0,0
333746459,DJ_Cons,10,5572,119,18,4,4,30.5788810859,30-39,731,7,13,3,16,16,13,3,7,3.1806661839,33.1855711543,0.0192216226,0.1541666667,0.26666668,0,59,1.1147390167318667E-4,9.484774E-5,9.599824E-5,175,9,3,200,3,0.015
334261912,mikenkosi,10,1846,43,62,0,549,24.7172009554,20-29,480,6,0,1,1,1,0,1,2,1.5,0,0,0,0,0,550,4.766339181938244E-5,0,6.8570175E-6,131,0,0,200,0,0
334322696,Clovechok,10,2020,266,206,12,14,43.6445645976,40-49,629,6,20,13,33,33,20,13,7,2.8595220854,1779.7472158648,0.0185028287,0.1268939394,0.36413044,0,59,1.674836923684882E-4,1.422716E-4,1.4399737E-4,182,8,0,200,0,0
334800870,thefirstrobg,10,46,13,140,0,0,18.3140902219,10-19,63,2,1,12,13,13,1,12,7,2.8845039826,1.9139340357,4.927208345531415E-4,0.2884615385,0.49242425,0,59,5.184628581660265E-5,1.3549677E-5,1.3714035E-5,175,0,0,48,0,0
335421914,HelmiCharif,10,39,158,50,18,0,24.9811733207,20-29,507,1,34,11,45,45,34,11,7,2.8913830558,31.9340883349,0.0569172865,0.197979798,0.5159664,0,59,1.6021760817440088E-4,2.3711934E-4,2.3999561E-4,25,1,0,40,0,0
335470110,GabeRyan,10,1783,204,205,2,7,38.7935023764,30-39,584,5,16,16,32,32,16,16,7,2.9261404779,17.4069196697,0.0120177511,0.2046370968,0.49,0,59,1.058530660366511E-4,1.1517225E-4,1.16569296E-4,147,4,0,200,0,0
335516271,Siphophendu76,10,16585,567,253,6,23,50.9698296145,50-59,748,8,10,5,15,15,10,5,9,4.8113685735,6908.3790611252,9.841319562039735E-4,0.0904761905,0.25555557,0,59,6.59195366018567E-4,7.452322E-5,6.171316E-5,131,13,0,198,0,0
335566521,anabelng97,10,2579,145,183,0,110,40.6477760551,40-49,663,5,1,1,2,2,1,1,1,1,0,8.095914281419891E-5,0,0,99,224,3.177448371356425E-4,1.3549677E-5,1.3714035E-5,90,20,0,200,0,0
335931975,merlo_m,10,183,18,162,0,4,12.7974302053,10-19,237,3,0,1,1,1,0,1,7,4.3571428571,0,0,0,0,42,448,4.766339181938244E-5,0,6.8570175E-6,197,1,0,187,0,0
335955769,arshadfilms,10,1298,251,394,1,20,36.1716840354,30-39,535,4,1,3,4,4,1,3,7,2.8975380159,0.11069486,0.0050763996,0,0,0,59,5.2959838971500805E-5,1.3549677E-5,1.3714035E-5,175,1,0,200,0,0
336185834,JeffBuchananNDP,10,293,245,179,22,5,45.6104831247,40-49,581,4,48,42,90,90,48,42,7,2.5818247647,5643.0090957969,0.0497066721,0.1210986267,0.32266864,0,59,2.1809761823658828E-4,3.3196708E-4,3.2913685E-4,25,33,0,200,0,0
336246602,SewWhoCares,10,5682,125,163,2,40,42.6537642842,40-49,647,7,17,20,37,37,17,20,7,2.7451122375,28.0727433763,0.0230341389,0.1118618619,0.42028984,0,59,9.144401924651327E-5,1.2194709E-4,1.2342632E-4,77,8,1,200,1,0.005
336274506,Coop_MB,10,1062,585,703,16,4,,,641,5,28,55,83,83,28,55,7,2.6918899348,937.5140446691,0.0292270946,0.1531002057,0.3766827,0,59,2.507197504201048E-4,1.9647031E-4,1.9885351E-4,175,45,0,198,0,0
337174475,CAS_OFL,10,2582,347,910,6,11,49.869811634,40-49,608,6,69,150,219,219,69,150,6,2.2588703838,6114.412813882,0.0680073064,0.0796782707,0.21623388,0,59,3.206160192709462E-4,4.7423868E-4,4.7999123E-4,182,63,1,203,1,0.0049261084
337213102,MoabiMo,10,2106,146,570,0,143,46.6735759779,40-49,641,6,1,3,4,4,1,3,9,4.8131788559,0,1.0620179378829457E-4,0.25,0.6666667,0,59,7.30458828426335E-5,1.3549677E-5,1.3714035E-5,131,23,0,202,0,0
337998923,KATEINTORONTO,10,219,23,112,0,216,16.1900646495,10-19,204,4,2,16,18,18,2,16,6,2.7208544533,12.7305639006,6.94946624654594E-4,0.3006535948,0.54044116,0,59,5.107519430239479E-5,2.0324514E-5,2.0571053E-5,25,1,0,200,0,0
338004749,ali_naka,10,10828,830,511,6,626,57.9450771943,50-59,765,8,7,5,12,12,7,5,8,3.9829833454,39851.9186338275,6.737708412706027E-4,0.0606060606,0.26190478,0,59,5.774201448360003E-4,5.4198706E-5,4.799912E-5,131,46,0,201,0,0
338114847,ElkWatch1,10,2429,121,484,1,29,37.2222240815,30-39,594,6,9,49,58,58,9,49,6,2.4978276611,179.684210728,0.0318763008,0.1675741077,0.33591837,0,59,1.0361023470115676E-4,6.7748384E-5,6.8570174E-5,25,5,2,199,1,0.0050251256
338157932,scottiehalland,10,635,69,237,3,200,23.0364538226,20-29,498,5,12,28,40,40,12,28,7,2.7483707458,106.7275637379,0.010500442,0.1147435897,0.39417988,0,59,1.0262717733452055E-4,8.80729E-5,8.914123E-5,175,0,0,200,0,0
338871019,YaredMehzenta,10,299,117,191,0,0,25.5708993252,20-29,534,4,12,29,41,41,12,29,6,2.5811006517,56.9805611402,0.0197898809,0.2073170732,0.50403225,0,59,8.245629116679215E-5,8.80729E-5,8.914123E-5,25,6,1,200,1,0.005
339722887,SnowHydro,10,6186,789,1000,44,422,57.6278483931,50-59,727,7,18,19,37,37,18,19,7,3.0246198407,1761.6873100728,0.0083676802,0.0728228228,0.25666666,0,59,2.390435228252991E-4,1.2872192E-4,1.3028333E-4,77,131,0,202,0,0
339785419,OpenQInc,10,432,215,617,4,8,37.1166953363,30-39,492,4,0,0,0,0,0,0,0,0,0,0,0,0,217,538,4.766339181938244E-5,0,0,221,2,0,200,0,0
340124841,bbcgregory,10,1113,151,596,2,323,46.2724186075,40-49,607,6,4,17,21,21,4,17,7,2.9706734251,5944.3098140564,0.001467916,0.130952381,0.28308824,0,59,7.591028552709937E-5,3.3874192E-5,3.4285087E-5,182,4,0,200,0,0
340284566,cormierk2,10,173,20,109,0,2,27.5447732415,20-29,421,3,0,2,2,2,0,2,8,3.7817589577,0,0,0,0,0,243,4.766339181938244E-5,0,6.8570175E-6,175,2,0,183,0,0
340435047,ebrunds,10,5037,159,162,2,247,39.4133216255,30-39,681,6,4,8,12,12,4,8,7,2.9898624185,0.0676262034,0.0069701609,0.2878787879,0.51111114,0,59,6.676226150891884E-5,3.3874192E-5,3.4285087E-5,25,2,0,200,0,0
340616852,rojas_lily,10,7225,505,450,0,179,43.5858389173,40-49,730,7,3,1,4,4,3,1,3,2,0,2.555161286769973E-4,0.25,1,50,135,3.614559404769375E-4,2.7099353E-5,2.742807E-5,188,59,0,201,0,0
341105081,JDanAiken,10,2912,295,698,8,2,44.4636232987,40-49,639,6,11,24,35,35,11,24,7,2.6984069515,43.7348053898,0.0109086185,0.1941176471,0.46296296,0,59,1.0242504812903435E-4,8.129806E-5,8.228421E-5,175,14,3,200,3,0.015
341378383,RamoncinTienda,10,383,91,220,2,5,40.7430875361,40-49,519,4,0,0,0,0,0,0,0,0,0,0,0,0,145,328,4.766339181938244E-5,0,0,141,8,0,199,0,0
341526196,tweetishcitizen,10,5187,250,661,2,113,40.2714519526,40-49,641,7,50,101,151,151,50,101,6,2.2871107893,1072.4869240835,0.0717238829,0.106004415,0.31096137,0,59,1.7530939970532378E-4,3.4551675E-4,3.497079E-4,77,6,0,199,0,0
341540678,cupejfd,10,68,83,95,4,0,31.493335909,30-39,418,2,13,12,25,25,13,12,7,2.9221578566,7.0180410392,0.0187689985,0.1566666667,0.6791667,0,59,9.004969375328692E-5,9.484774E-5,9.599824E-5,182,1,0,70,0,0
341729835,Menantum,10,12324,407,425,4,822,47.1437376028,40-49,704,8,2,2,4,4,2,2,7,2.9112961622,1.079226056,0.0058417577,0,0,0,59,5.5830089088477405E-5,2.0324514E-5,2.0571053E-5,182,2,0,203,0,0
341813644,clintupham,10,12363,609,380,19,1055,41.4049834748,40-49,767,8,49,57,106,106,49,57,7,2.7038377987,1382.2865222408,0.026015232,0.0774483378,0.40243256,0,59,2.3201485954789074E-4,3.387419E-4,3.4285086E-4,175,129,0,202,0,0
341876717,MaryRitaHolland,10,1021,574,633,35,7,48.5678779758,40-49,683,5,100,99,199,199,100,99,7,2.4837074584,6706.8318128206,0.1069135875,0.1159332014,0.26394215,0,59,4.444066010836806E-4,6.8425864E-4,6.9255877E-4,25,265,1,200,1,0.005
342281222,cjlanarchist,10,1986,181,634,2,106,34.0993134283,30-39,560,6,25,62,87,87,25,62,6,2.3385228096,676.8045191869,0.0392476821,0.1435445068,0.3280051,0,59,1.286136561248453E-4,1.761458E-4,1.7828245E-4,182,1,0,200,0,0
343060871,joshuakhenry,10,1750,120,118,1,0,34.9793700033,30-39,604,6,1,2,3,3,1,2,8,3.9989138306,0,4.557664343488496E-4,0.5,0.5,0,59,5.101329526438932E-5,1.3549677E-5,1.3714035E-5,175,4,1,201,1,0.0049751244
343114987,bdalima,10,185,52,195,0,3,16.1543343879,10-19,358,4,6,33,39,39,6,33,6,2.6629254164,27.0876140857,0.0105245623,0.2624831309,0.5178253,0,59,9.059576860848508E-5,4.742387E-5,4.799912E-5,25,0,0,196,0,0
344167318,TeamHeadwaters,10,6857,1010,1462,33,66,54.2701481792,50-59,754,7,35,78,113,113,35,78,6,2.3776249095,1925.5146903604,0.0536775838,0.0862831858,0.22357723,0,59,2.140921970819285E-4,2.4389417E-4,2.4685264E-4,77,57,0,201,0,0
344802896,fsrana74,10,5812,434,354,12,1801,54.7624525085,50-59,692,7,0,0,0,0,0,0,0,0,0,0,0,0,250,651,4.766339181938244E-5,0,0,255,3,1,201,1,0.0049751244
345527274,_myjae,10,28060,1196,754,5,120,39.171473713,30-39,784,8,0,1,1,1,0,1,4,2.6,0,0,0,0,22,169,4.766339181938244E-5,0,6.8570175E-6,126,6,0,200,0,0
345933469,tylerkgray,10,1017,185,273,3,5,41.1919752805,40-49,622,5,7,15,22,22,7,15,7,2.7617668356,40.4641337593,0.0070918474,0.1666666667,0.45833334,0,59,7.435005081877636E-5,5.4198706E-5,5.485614E-5,25,14,1,200,1,0.005
345983663,TabbyLavalamp,10,2716,88,243,3,8,41.1074925409,40-49,627,6,2,4,6,6,2,4,7,3.1386676322,2.9257958652,0.0016759031,0.1,0.41666666,0,59,5.599984242825853E-5,2.0324514E-5,2.0571053E-5,175,5,0,200,0,0
346389807,paulinaarnold9,10,1644,200,174,0,22,41.1674818576,40-49,634,5,3,3,6,6,3,3,3,1.8888888889,40,2.5366105848668644E-4,0.0333333333,0.33333334,79,175,4.2854421477014383E-4,2.7099353E-5,2.742807E-5,106,2,0,201,0,0
346844032,arcaneevilmind,10,5597,56,83,2,11,26.0797409336,20-29,657,6,2,5,7,7,2,5,7,2.9641564084,0.3464171044,0.0020456276,0.1904761905,0.26666668,0,59,5.030414035429619E-5,2.0324514E-5,2.0571053E-5,25,1,3,201,3,0.0149253731
347213984,flu9,10,1203,560,706,4,301,43.838933323,40-49,566,5,6,8,14,14,6,8,6,2.670166546,545.6338716779,0.0154262057,0.032967033,0.17857143,0,59,7.291293021413079E-5,4.742387E-5,4.799912E-5,175,12,9,229,9,0.03930131
347214904,HappyP63,10,2768,137,391,6,5,40.6365756625,40-49,514,5,21,36,57,57,21,36,6,2.5575669804,255.7676246579,0.0358422417,0.1127819549,0.38620198,0,59,1.2626207139442738E-4,1.4904643E-4,1.5085438E-4,182,2,0,200,0,0
347451746,CedrycB,10,1041,193,1092,1,0,41.9284611216,40-49,635,5,0,0,0,0,0,0,0,0,0,0,0,0,80,176,4.766339181938244E-5,0,0,71,13,0,201,0,0
349946938,angryaesthete,10,6820,387,1569,8,1242,43.8149933161,40-49,698,7,47,154,201,201,47,154,6,2.2737146995,3426.0313526136,0.0605292934,0.1020149254,0.23534629,0,59,2.1977265795577216E-4,3.2519223E-4,3.2913685E-4,25,5,0,200,0,0
351211110,PamFAQMP,10,1590,712,829,13,9,38.760891326,30-39,688,6,86,103,189,189,86,103,6,2.2422157857,4106.992532485,0.1101204274,0.0412867275,0.24167143,0,59,3.018875720892116E-4,5.8941095E-4,5.9656054E-4,77,25,1,199,1,0.0050251256
351220065,PatrickFAQMP,10,540,433,725,8,0,36.2506299671,30-39,609,4,60,102,162,162,60,102,6,2.273352643,3342.8187128868,0.0889901928,0.069664903,0.25364077,0,59,2.948059820320658E-4,4.1326514E-4,4.1827807E-4,175,14,1,200,1,0.005
351783729,JorgeBiza,10,1531,120,412,0,0,37.2133704759,30-39,623,5,0,0,0,0,0,0,0,0,0,0,0,0,173,375,4.766339181938244E-5,0,0,172,9,0,199,0,0
351834645,Jsmithreporting,10,1742,318,307,14,1,47.4487495647,40-49,690,5,10,8,18,18,10,8,7,2.9076755974,300.9142883459,0.0144696098,0.0555555556,0.16666667,0,59,1.2449973238038185E-4,7.452322E-5,7.542719E-5,77,11,0,200,0,0
352090345,iwolftail,10,34728,366,686,8,451,44.2829710261,40-49,726,8,8,15,23,23,8,15,7,2.6661839247,56.4659075414,0.0069683792,0.1067193676,0.37142858,0,59,7.603497334265627E-5,6.0973543E-5,6.171316E-5,175,22,0,201,0,0
352383848,710_VOCM,10,5223,1157,1168,10,16,50.4594123865,50-59,704,6,9,14,23,23,9,14,7,3.0351194786,13.8708150478,0.0054045087,0.2173913043,0.503268,0,59,8.936056640883224E-5,6.7748384E-5,6.8570174E-5,147,23,0,200,0,0
352556797,ghost_station,10,3903,327,566,2,945,33.3005923404,30-39,588,6,10,18,28,28,10,18,6,2.7143374366,1986.8004584871,0.0116435422,0.0648148148,0.19883041,0,59,1.0702212358907449E-4,7.452322E-5,7.542719E-5,147,0,0,200,0,0
352579799,marklaventure,10,894,121,158,1,2,45.4547276453,40-49,672,5,41,38,79,79,41,38,6,2.7081824765,409.2333167488,0.0328964881,0.1199285946,0.48693877,0,59,2.2967280852961988E-4,2.845432E-4,2.8799474E-4,147,461,0,200,0,0
353076763,FredBuky,10,28,11,123,0,11,19.082265271,10-19,110,2,0,1,1,1,0,1,10,5.8863554108,0,0,0,0,0,404,4.766339181938244E-5,0,6.8570175E-6,131,1,0,31,0,0
353274458,isamaraaguirre,10,5052,260,667,0,58,41.4385281369,40-49,669,6,1,1,2,2,1,1,5,3.1111111111,0,8.629398748422644E-5,0,0,79,175,1.7241345328047235E-4,1.3549677E-5,1.3714035E-5,106,3,0,201,0,0
353398631,njellan,10,930,144,313,0,140,45.4887677406,40-49,608,6,20,42,62,62,20,42,6,2.5897900072,916.900919609,0.0138024499,0.0954521417,0.23980497,0,59,1.1950237203520745E-4,1.422716E-4,1.4399737E-4,182,27,0,200,0,0
353766801,fdemattia,10,96,43,101,1,0,17.3253851037,10-19,113,2,0,1,1,1,0,1,6,3.3571428571,0,0,0,0,42,497,4.766339181938244E-5,0,6.8570175E-6,197,1,0,101,0,0
354054080,KerimeRodriguez,10,2169,137,184,0,221,39.1784781635,30-39,518,4,0,0,0,0,0,0,0,0,0,0,0,0,185,396,4.766339181938244E-5,0,0,187,5,0,200,0,0
354248645,HarrisAJackson,10,19923,1221,1993,30,20,35.1404781526,30-39,781,8,115,165,280,280,115,165,6,2.2436640116,8888.9001368791,0.1301334361,0.0722606247,0.22004701,0,59,3.56705329487536E-4,7.8588125E-4,7.9541403E-4,77,14,0,199,0,0
354303434,gvsans1,10,481,30,79,0,1,21.8706007466,20-29,507,4,0,1,1,1,0,1,7,4.3571428571,0,0,0,0,42,504,4.766339181938244E-5,0,6.8570175E-6,197,0,0,200,0,0
354691591,DouglasMusk,10,120,10,116,0,0,20.3725785081,20-29,308,3,0,7,7,7,0,7,7,2.9001085776,0,0,0.2857142857,0.45238096,0,333,4.766339181938244E-5,0,6.8570175E-6,175,4,0,136,0,0
355514339,mgirard32,10,5604,1238,756,81,59,50.1458288981,50-59,735,7,13,22,35,35,13,22,6,2.5883417813,388.5028407368,0.0150187342,0.0899159664,0.22615385,0,59,9.867115234335568E-5,9.484774E-5,9.599824E-5,175,35,0,200,0,0
356262824,GregT_theMetis,10,1899,257,386,8,15,47.7086980623,40-49,647,6,37,32,69,69,37,32,6,2.6100651702,610.9334981211,0.0418496563,0.0773657289,0.22040816,0,59,1.911564038623013E-4,2.5744384E-4,2.6056665E-4,182,45,2,200,2,0.01
356303383,Maryann_Chichak,10,1245,402,527,12,12,41.2902353504,40-49,604,5,30,44,74,74,30,44,7,2.527878349,1194.7701722291,0.0244278063,0.0901517956,0.3705314,0,59,1.8103549596621955E-4,2.1001999E-4,2.1256754E-4,175,6,1,200,1,0.005
356527590,TrueNL,10,2564,361,481,2,19,40.6251683389,40-49,679,6,22,44,66,66,22,44,6,2.3950036206,4258.1728135482,0.0265620109,0.1298368298,0.32530612,0,59,1.421304015435052E-4,1.5582128E-4,1.577114E-4,147,6,0,200,0,0
356667158,VickyVerdugo,10,7262,341,211,0,892,34.6470540901,30-39,695,6,5,4,9,9,5,4,5,2.625,16,4.417312202366687E-4,0.0833333333,0.6,31,107,4.1188433600545843E-4,4.064903E-5,3.4285087E-5,108,35,0,201,0,0
356944119,jeffmccrossin,10,289,85,286,2,4,23.4784974654,20-29,510,4,4,18,22,22,4,18,6,2.5963070239,36.8587410553,0.0066072611,0.1926406926,0.3859649,0,59,6.594585203626761E-5,3.3874192E-5,3.4285087E-5,77,3,2,198,2,0.0101010101
357040607,isela_bermeo,10,1880,252,881,0,7,34.8900984536,30-39,589,5,0,1,1,1,0,1,6,3.4705882353,0,0,0,0,31,686,4.766339181938244E-5,0,6.8570175E-6,108,0,0,200,0,0
358112947,htimS_ahsataN,10,72,49,209,1,19,24.713065295,20-29,239,3,3,20,23,23,3,20,7,2.8139029689,17.5767579796,0.0016533681,0.1699604743,0.2868421,0,59,5.4754585293063186E-5,2.7099353E-5,2.742807E-5,25,1,0,77,0,0
358291440,kingcambie,10,7036,66,104,1,5,48.6244836633,40-49,708,7,10,7,17,17,10,7,7,2.9471397538,19.4857798274,0.0211831172,0.2205882353,0.3952381,0,59,1.0465466299885706E-4,7.452322E-5,7.542719E-5,175,15,0,200,0,0
359784067,Kauwhaka,10,2083,334,80,10,98,45.5923955925,40-49,642,6,21,18,39,39,21,18,7,3.0202751629,18.5517421333,0.0143728041,0.1518218623,0.60923076,0,59,1.2167963318640312E-4,1.4904643E-4,1.5085438E-4,175,16,0,201,0,0
359788259,mangoparent,10,6739,890,1757,21,6,37.1456580178,30-39,709,7,40,135,175,175,40,135,6,2.2440260681,3479.2994703793,0.0476226182,0.1003284072,0.23632897,0,59,1.719815854014823E-4,2.7776835E-4,2.811377E-4,77,15,1,200,1,0.005
360129829,rkn429,10,22401,559,552,26,2498,47.2733396845,40-49,740,8,49,54,103,103,49,54,6,2.4786386676,1003.8982828028,0.052808793,0.0656767561,0.3505747,0,59,1.7946135247282725E-4,3.387419E-4,3.4285086E-4,77,82,0,201,0,0
360293509,GrettaGonzalez1,10,7407,417,632,0,2592,44.6100977589,40-49,714,7,5,5,10,10,5,5,5,2.5625,9,4.417312202366687E-4,0.1111111111,0.6,31,107,4.095322267529512E-4,4.064903E-5,3.4285087E-5,108,17,0,201,0,0
360789009,annickschulz,10,919,71,256,3,12,36.2407483308,30-39,377,5,4,9,13,13,4,9,7,2.8855901521,278.4677904179,0.0104296323,0.1923076923,0.5555556,0,59,2.149792333035062E-4,3.3874192E-5,3.4285087E-5,182,0,1,200,1,0.005
360938067,DuckFexter,10,4155,1102,740,17,41,43.6281985048,40-49,719,7,45,54,99,99,45,54,6,2.528602462,21143.4906431844,0.0263333781,0.0213358071,0.103246756,0,59,2.8382138780817123E-4,3.1164257E-4,3.154228E-4,147,46,0,200,0,0
361195351,bsichel,10,1946,470,749,20,40,49.100544193,40-49,673,6,39,81,120,120,39,81,6,2.3501086169,5141.5928349736,0.0551777501,0.1069327731,0.2875383,0,59,2.601041560847611E-4,2.7099354E-4,2.6056665E-4,147,30,0,200,0,0
361313270,TransCanada,10,2688,2901,436,83,1,59.9660526271,50-59,783,6,38,14,52,52,38,14,7,2.8971759594,514.3075409184,0.0197730899,0.1052036199,0.17730497,0,59,2.3643053233133216E-4,2.642187E-4,2.674237E-4,175,44,0,201,0,0
361620746,middlesexfarmer,10,1207,403,161,11,5,41.7743998244,40-49,622,5,2,1,3,3,2,1,8,4.0684286749,0,2.2423303880861098E-4,0.1666666667,0.5,0,59,7.341325823514111E-5,2.0324514E-5,2.0571053E-5,175,8,0,198,0,0
362254851,FalseCreekScott,10,2241,301,697,13,21,49.3547362342,40-49,596,6,20,27,47,47,20,27,6,2.8341781318,144.9937730041,0.0133074968,0.1142460685,0.3669355,0,59,1.3369884601323136E-4,1.422716E-4,1.4399737E-4,182,2,2,200,2,0.01
362903520,bctweetster,10,28,9,145,0,1,21.7744561261,20-29,317,3,1,23,24,24,1,23,7,2.783852281,1.9140375181,6.286103338361156E-4,0.2463768116,0.3786232,0,59,4.95773834142679E-5,1.3549677E-5,1.3714035E-5,182,2,0,43,0,0
363064080,ShayneSangster,10,2524,133,385,4,5,41.7950352123,40-49,560,6,47,103,150,150,47,103,6,2.2748008689,1546.8635608543,0.0912075519,0.1391946309,0.38229588,0,59,2.4219972196376114E-4,3.2519223E-4,3.2913685E-4,25,13,2,211,2,0.009478673
363464356,SFNDP,10,425,101,75,6,1,27.3985795911,20-29,491,2,30,26,56,56,30,26,7,2.7045619117,151.1227657374,0.048741939,0.1912337662,0.4460888,0,59,1.8230685169825684E-4,2.1001999E-4,2.1256754E-4,25,0,1,200,1,0.005
364402840,CdnEnginerd,10,2096,174,518,1,199,51.3855310201,50-59,592,6,3,18,21,21,3,18,7,2.8349022448,7.0189624319,0.0022574033,0.2666666667,0.41842106,0,59,5.7052602948813296E-5,2.7099353E-5,2.742807E-5,25,1,0,200,0,0
365551227,iJeremyG,10,163,41,161,0,2,38.8165229034,30-39,178,3,10,32,42,42,10,32,6,2.5202751629,26.9450870439,0.0143317654,0.1986062718,0.5342742,0,59,8.692122129538655E-5,7.452322E-5,7.542719E-5,182,0,1,170,1,0.0058823529
365592531,Matante_Loulou,10,320,35,181,0,5,27.0515352589,20-29,471,4,0,16,16,16,0,16,7,2.7922547955,0,0,0.3,0.45416668,0,272,4.766339181938244E-5,0,6.8570175E-6,175,2,1,197,1,0.0050761421
365865551,townsitebrewing,10,649,819,252,44,7,47.9837247792,40-49,677,5,0,0,0,0,0,0,0,0,0,0,0,0,263,690,4.766339181938244E-5,0,0,270,11,0,200,0,0
366565098,ravenkitteh33,10,4720,1126,2002,30,45,34.2665081431,30-39,702,7,42,58,100,100,42,58,6,2.490224475,996.3109215313,0.0434846173,0.077979798,0.3395029,0,59,1.5523652669037732E-4,2.9131805E-4,2.9485175E-4,77,4,0,198,0,0
366947456,smilesomiles,10,2696,834,866,12,12,44.7832619272,40-49,683,6,2,2,4,4,2,2,7,3.433743664,0,5.144805765353265E-4,0.0833333333,1,0,59,5.811587227291043E-5,2.0324514E-5,2.0571053E-5,147,6,0,193,0,0
367333161,Dkrupski,10,12157,1777,1976,52,478,41.5515479354,40-49,753,8,51,58,109,109,51,58,7,2.471397538,1747.8283465395,0.0353949238,0.0755181787,0.37425596,0,59,2.4366760029853745E-4,3.522916E-4,3.565649E-4,175,53,0,202,0,0
367562844,ehamilt,10,1417,357,340,4,17,43.5227792129,40-49,613,6,43,44,87,87,43,44,6,2.4511223751,4561.5648834917,0.0554584712,0.0486500936,0.2747456,0,59,2.2504201579775186E-4,2.9809287E-4,2.9485175E-4,182,13,1,200,1,0.005
367973796,Minhoto15,10,2494,127,300,2,4,40.6994683573,40-49,631,6,3,7,10,10,3,7,7,2.9326574946,3.9628036843,0.0051310853,0.1666666667,0.5,0,59,6.011737798060573E-5,2.7099353E-5,2.742807E-5,175,5,0,200,0,0
368397883,Andrea40p,10,2233,206,335,2,73,41.0963220415,40-49,639,6,3,7,10,10,3,7,7,3.2711803041,172.0268010151,8.126577824421333E-4,0.0555555556,0.16666667,0,59,8.117791064459893E-5,2.7099353E-5,2.742807E-5,147,8,1,199,1,0.0050251256
369074216,MCTOASTandPDOC,10,5366,354,134,1,737,32.753821985,30-39,704,6,0,1,1,1,0,1,8,4.268548679,0,0,0,0,0,649,4.766339181938244E-5,0,6.8570175E-6,175,8,0,200,0,0
369212454,Ottawa_Steve,10,6225,269,446,1,66,42.7822841859,40-49,653,6,12,18,30,30,12,18,7,2.7375090514,1994.0148876917,0.0212108934,0.1827586207,0.39333335,0,59,1.1227035259341633E-4,8.80729E-5,8.914123E-5,175,5,3,199,3,0.0150753769
369234021,StopSmrtMeterBC,10,5679,659,2001,21,114,48.4256218869,40-49,700,7,19,54,73,73,19,54,6,2.5887038378,863.1480890908,0.0151728871,0.1348934551,0.2593446,0,59,1.1424421807168414E-4,1.3549677E-4,1.3714035E-4,182,20,0,200,0,0
369585237,KevinLafayette,10,604,15,43,0,36,26.76069826,20-29,496,4,1,3,4,4,1,3,7,3.3406951484,0.0580693816,5.182802726811215E-4,0.1666666667,0.6666667,0,59,5.1809677959373304E-5,1.3549677E-5,1.3714035E-5,175,5,0,200,0,0
369901017,JenStDen,10,550,178,320,12,6,45.3576405232,40-49,567,5,4,13,17,17,4,13,6,2.9594496741,8.9825097631,0.0037276764,0.1397058824,0.3525641,0,59,6.614313702337624E-5,3.3874192E-5,3.4285087E-5,182,2,0,200,0,0
370168544,DominicTerry,10,5167,294,362,5,9,46.4759519143,40-49,689,6,13,40,53,53,13,40,6,2.5438088342,168.2024769718,0.0135301012,0.1814223512,0.34505087,0,59,9.62631078880659E-5,9.484774E-5,9.599824E-5,175,5,0,200,0,0
370198217,canucksim,10,2292,66,78,4,5,33.8868142316,30-39,572,4,2,0,2,2,2,0,0,0,0,3.5724103197550526E-4,0,0,0,27,5.350254463310334E-5,2.0324514E-5,0,175,1,0,200,0,0
370349512,shaun__kirk,10,252,37,48,0,2,22.2569158128,20-29,459,4,1,1,2,2,1,1,9,5.2670043415,0,8.095914281419891E-5,0,0,0,653,1.0633321402051042E-4,1.3549677E-5,1.3714035E-5,175,12,0,200,0,0
370384969,DonMartinYEG,10,280,2244,1760,39,203,53.5255824205,50-59,757,8,113,108,221,221,113,108,6,2.3323678494,15088.4965261208,0.0679285861,0.0291649527,0.17595048,0,59,4.4714768787621357E-4,7.7233155E-4,7.817E-4,175,37,0,101,0,0
370391157,Erick_RuizGarza,10,926,82,163,0,82,38.2655784083,30-39,589,5,1,1,2,2,1,1,5,3.2222222222,0,8.451525587974923E-5,0,0,79,175,1.8975606405723553E-4,1.3549677E-5,1.3714035E-5,106,17,0,200,0,0
370748126,RobinSanks,10,1053,192,282,2,0,33.3687953756,30-39,692,6,0,5,5,5,0,5,7,3.2062975027,0,0,0.25,0.35,0,570,4.766339181938244E-5,0,6.8570175E-6,175,0,0,200,0,0
370852503,ARIApensions,10,1365,662,1997,14,3,46.5128037093,40-49,656,5,29,82,111,111,29,82,6,2.4362780594,3268.9071009494,0.0427036711,0.0951678952,0.23483026,0,59,1.6939902130422188E-4,2.0324514E-4,2.0571053E-4,182,5,0,199,0,0
371094771,I_LuvTO2,10,17678,829,1220,17,23,42.1526756903,40-49,769,8,91,122,213,213,91,122,6,2.2769732078,6931.1757816292,0.1110260448,0.0709761715,0.23434222,0,59,3.3382666133636546E-4,6.2328513E-4,6.308456E-4,175,97,1,203,1,0.0049261084
371356803,mariana_ml8,10,12471,467,675,1,968,44.8570950427,40-49,732,7,8,8,16,16,8,8,4,1.9375,179,6.959385845260264E-4,0.0458333333,0.3392857,31,107,7.892844543804866E-4,6.0973543E-5,6.171316E-5,108,10,0,201,0,0
371988156,ndp_bta,10,1341,958,15,1,17,43.4443365088,40-49,728,6,1,0,1,1,1,0,0,0,0,7.92005701980554E-5,0,0,190,410,8.817727671970712E-5,1.3549677E-5,0,192,168,0,200,0,0
373057989,evolutionNM,10,109,56,152,0,1,29.1618119926,20-29,400,3,0,10,10,10,0,10,7,2.9641693811,0,0,0.3111111111,0.45555556,0,703,4.766339181938244E-5,0,6.8570175E-6,175,2,0,109,0,0
373244712,chris_gallaway,10,404,236,305,3,126,42.1350040108,40-49,568,4,50,67,117,117,50,67,6,2.5133960898,1011.5578868869,0.0617008399,0.0964485706,0.34578946,0,59,2.5261258945776443E-4,3.4551675E-4,3.497079E-4,25,38,3,200,3,0.015
373581418,reason911,10,8366,225,307,3,21,32.2497048834,30-39,742,8,15,22,37,37,15,22,6,2.7766111513,183.9250609426,0.013285096,0.0810810811,0.20767196,0,59,9.631072278585202E-5,1.0839741E-4,1.0971228E-4,175,15,0,200,0,0
373687322,karl_wells,10,7161,2394,75,30,15,53.797487726,50-59,754,6,24,2,26,26,24,2,8,3.4518464881,9.9227149263,0.0200378555,0.2492307692,0.45652175,0,59,2.5095779691170373E-4,1.6937095E-4,1.7142543E-4,147,12,0,199,0,0
373761917,Complete_Future,10,9,3,3,0,0,14.1277897566,10-19,53,0,0,1,1,1,0,1,7,3.7339847991,0,0,0,0,0,626,4.766339181938244E-5,0,6.8570175E-6,77,0,0,10,0,0
373797156,rgrottola,10,117,93,481,2,0,30.307698249,30-39,436,3,0,1,1,1,0,1,7,4.3571428571,0,0,0,0,42,458,4.766339181938244E-5,0,6.8570175E-6,197,1,0,124,0,0
374074082,KeelenSimpson,10,4958,514,881,11,11,,,687,7,20,31,51,51,20,31,7,2.7031136857,854.4874060479,0.0169567743,0.0784313725,0.1981982,0,59,1.371705830167468E-4,1.422716E-4,1.4399737E-4,77,4,0,200,0,0
374184788,NicholasBrake,10,213,59,122,0,3,20.1950660534,20-29,355,4,1,1,2,2,1,1,7,3.2903692976,0,9.313841764261912E-4,0,0,0,59,5.1738693639318724E-5,1.3549677E-5,1.3714035E-5,175,1,0,194,0,0
374328572,EmmaPyke13,10,809,243,1643,2,2,29.0152288496,20-29,475,5,58,221,279,279,58,221,6,2.1672700941,2443.2654283482,0.1011916904,0.1401330548,0.295444,0,59,2.5411358740215533E-4,3.9971547E-4,4.0456402E-4,25,3,2,200,2,0.01
374545627,brenda_slomka,10,4622,344,332,11,21,46.7994772621,40-49,684,6,17,21,38,38,17,21,7,2.6918899348,856.9426371524,0.0281819105,0.0995732575,0.30153847,0,59,1.89626607725212E-4,1.2194709E-4,1.2342632E-4,175,33,2,200,2,0.01
374637511,traceyselkirk,10,3775,207,252,6,7,41.6489096747,40-49,657,7,27,24,51,51,27,24,6,2.716147719,297.1760676259,0.0186138347,0.1349019608,0.3805121,0,59,1.388382003826541E-4,1.8969548E-4,1.9199649E-4,182,16,0,198,0,0
374643582,kyallskNDP,10,1202,250,226,10,9,45.8088404864,40-49,628,5,39,31,70,70,39,31,7,2.7874728458,456.5304810323,0.0439015122,0.1267080745,0.3647059,0,59,1.8310562487704863E-4,2.7099354E-4,2.674237E-4,25,32,5,199,5,0.0251256281
374735534,honkey_blueye,10,251,8,37,0,5,32.6099289204,30-39,474,4,1,10,11,11,1,10,6,2.6810282404,0.5036258866,4.944802895028022E-4,0.2454545455,0.34444445,0,59,5.014170018274901E-5,1.3549677E-5,1.3714035E-5,175,16,7,200,7,0.035
375016355,MichelinLABNDP,10,208,120,118,2,58,32.0818716181,30-39,476,3,19,17,36,36,19,17,7,3.0372918175,130.0871450612,0.017817079,0.1206349206,0.5367965,0,59,1.796503196987491E-4,1.3549677E-4,1.3714035E-4,147,3,0,200,0,0
375290882,mattlensen,10,324,225,322,0,35,38.6302482791,30-39,638,6,35,43,78,78,35,43,6,2.6198406951,604.1202545173,0.0351022326,0.1212121212,0.37980434,0,59,1.705911610241687E-4,2.4389417E-4,2.4685264E-4,25,24,1,193,1,0.0051813472
375303986,wcacym,10,3579,108,124,3,561,43.40351791,40-49,533,6,1,1,2,2,1,1,8,3.8280231716,0,1.6788740581051494E-4,0,0,0,59,5.5834440583732855E-5,1.3549677E-5,1.3714035E-5,25,1,0,201,0,0
375634441,CamF57,10,1157,144,206,4,17,40.2180120302,40-49,652,5,44,47,91,91,44,47,6,2.3982621289,332.5407637785,0.0498765695,0.1511599512,0.38799173,0,59,1.5013608711762598E-4,3.0486772E-4,3.085658E-4,77,4,4,200,4,0.02
375883305,NataaliaGzz,10,1325,167,243,0,52,38.6575009724,30-39,548,5,0,2,2,2,0,2,6,3.3529411765,0,0,0.5,0.5,31,242,4.766339181938244E-5,0,6.8570175E-6,108,2,0,200,0,0
376020156,DevaRamkelawan,10,8057,72,130,2,3,36.2311261946,30-39,608,6,6,7,13,13,6,7,7,2.8732802317,18.073543267,0.0067599177,0.0833333333,0.3392857,0,59,6.204965900504863E-5,4.742387E-5,4.799912E-5,77,3,0,200,0,0
376164050,Sangi8,10,984,288,200,8,30,41.8377173681,40-49,555,5,1,1,2,2,1,1,7,3.2614047791,0,5.872923876603538E-4,0.5,0.5,0,59,4.8901388496818935E-5,1.3549677E-5,1.3714035E-5,77,12,0,200,0,0
376439236,RamonaJennex,10,338,217,99,15,31,45.2704872725,40-49,589,4,39,29,68,68,39,29,7,2.9293989862,234.5779676211,0.0310007332,0.1479367867,0.48182625,0,59,2.2244549280584994E-4,2.7099354E-4,2.742807E-4,147,58,0,200,0,0
376541246,HBoyd01,10,5955,330,423,5,531,45.2329653931,40-49,703,7,4,0,4,4,4,0,0,0,0,0.001563842,0.5,0.9166667,0,13,7.095704519629466E-5,3.3874192E-5,0,175,3,0,200,0,0
377118977,alicecardoza,10,2939,143,181,0,272,39.0255916975,30-39,626,5,1,1,2,2,1,1,4,2.7777777778,0,8.455341595097537E-5,0,0,79,175,1.789155843356482E-4,1.3549677E-5,1.3714035E-5,106,8,0,200,0,0
377360638,AlexandraEstey,10,938,110,247,4,159,41.4192255536,40-49,575,5,2,11,13,13,2,11,7,2.801230992,10.1576307424,0.0084757879,0.2179487179,0.5090909,0,59,7.080076206559941E-5,2.0324514E-5,2.0571053E-5,175,8,4,199,2,0.0100502513
378648614,tausunni,10,7355,176,165,5,0,49.4075872975,40-49,733,6,6,5,11,11,6,5,7,3.3740043447,18.1399331739,0.002389619,0.0818181818,0.5,0,59,9.615326759978417E-5,4.742387E-5,4.799912E-5,77,32,1,200,1,0.005
378826663,CaptainWalbran,10,4013,521,1294,12,283,44.7767744598,40-49,665,7,37,118,155,155,37,118,6,2.2827661115,2770.5014470971,0.0677095915,0.1049853372,0.2534539,0,59,2.0191994892625696E-4,2.5744384E-4,2.6056665E-4,25,15,0,198,0,0
378956312,retrosuv,10,2337,70,100,0,3,43.2214821999,40-49,658,6,10,7,17,17,10,7,7,2.9290369298,16.6550501985,0.0088609741,0.1654411765,0.5833333,0,59,9.031189331286911E-5,7.452322E-5,7.542719E-5,175,10,0,200,0,0
379008073,zb_armstrong,10,9366,763,1055,30,83,61.6170741252,60-69,752,7,76,114,190,190,76,114,6,2.3613323678,9466.4653477027,0.1007590245,0.0983013088,0.27606413,0,59,4.5963670793337406E-4,5.216625E-4,5.2799034E-4,175,73,2,203,2,0.0098522167
379207097,kylefarq,10,12223,704,1349,36,36,46.6016112725,40-49,762,8,64,72,136,136,64,72,6,2.4243301955,1962.2804951915,0.0711005426,0.1033224401,0.21500966,0,59,2.6199365907896965E-4,4.403645E-4,4.4570613E-4,77,85,1,200,1,0.005
379516665,CarletonMadman,10,4330,135,139,1,186,37.0267687677,30-39,638,6,10,9,19,19,10,9,7,2.754525706,122.3455502652,0.0311549213,0.1286549708,0.46969697,0,59,2.4048878703295402E-4,7.452322E-5,7.542719E-5,25,2,0,198,0,0
379529949,Dorion12,10,4720,409,677,2,1341,44.9537016748,40-49,673,7,20,32,52,52,20,32,6,2.7639391745,625.1723537839,0.0124426278,0.0595776772,0.24294356,0,59,1.0621271109185506E-4,1.422716E-4,1.4399737E-4,77,3,0,201,0,0
380016963,oectasudelem,10,687,80,58,2,1,33.5762212052,30-39,524,4,5,1,6,6,5,1,7,3.2657494569,0,0.0024999499,0.1666666667,0.35,0,59,5.7865969301728714E-5,4.064903E-5,4.1142106E-5,182,4,0,200,0,0
380125395,_DanWard,10,929,189,569,1,119,40.4994162798,40-49,589,5,5,19,24,24,5,19,6,2.6853729182,2709.4012908122,0.0118317671,0.1702898551,0.30952382,0,59,6.908611453022117E-5,4.064903E-5,4.1142106E-5,182,3,0,200,0,0
380392388,FelipeFaria99,10,538,124,790,2,49,36.2452364995,30-39,487,5,6,51,57,57,6,51,6,2.4793627806,32.5765952174,0.0130488673,0.248433584,0.46823528,0,59,6.772622778090585E-5,4.742387E-5,4.799912E-5,25,2,1,200,1,0.005
380539792,onebellerose,10,203,71,117,1,2,31.5553076279,30-39,509,3,1,1,2,2,1,1,7,3.274076756,0,8.255588616195072E-4,0,0,0,59,4.924888481966134E-5,1.3549677E-5,1.3714035E-5,25,2,0,198,0,0
380564154,Ra6_Ricardo,10,418,36,58,0,11,36.1379233372,30-39,577,4,0,0,0,0,0,0,0,0,0,0,0,0,33,110,4.766339181938244E-5,0,0,30,15,0,201,0,0
380664031,Jamestoupin,10,11190,179,253,0,1250,40.9052058035,40-49,674,8,1,3,4,4,1,3,7,3.4851556843,1.6528032718,3.431011641623441E-4,0,0,0,59,5.114257224874049E-5,1.3549677E-5,1.3714035E-5,175,2,0,201,0,0
381058048,apoliq,10,2758,289,766,3,107,40.6076171495,40-49,642,6,52,114,166,166,52,114,6,2.2943519189,3590.8485835485,0.0764842787,0.0734209566,0.19634986,0,59,2.495438932801198E-4,3.590664E-4,3.6342192E-4,77,32,2,200,2,0.01
381136617,GatewayCaveMan,10,633,175,1764,0,0,23.7823634456,20-29,580,5,19,213,232,232,19,213,6,2.1625633599,1114.3834997925,0.039664918,0.1545193312,0.26654264,0,59,1.2099866091234533E-4,1.3549677E-4,1.3714035E-4,175,2,0,200,0,0
381211913,abdiazizwiz,10,5664,143,171,3,167,45.6653498469,40-49,699,7,2,1,3,3,2,1,7,3.6035481535,46.4103804995,0.0043019263,0,0,0,59,5.7772982553023164E-5,2.0324514E-5,2.0571053E-5,175,54,0,201,0,0
381219762,GarettSpelliscy,10,4661,564,991,5,18,47.0445794082,40-49,691,7,75,158,233,233,75,158,6,2.2125271542,5346.316671566,0.1024084657,0.0981574663,0.26785713,0,59,4.003522116675245E-4,5.148877E-4,5.211333E-4,25,90,5,200,5,0.025
382207006,mkeenan204,10,4544,140,280,1,29,40.3770976066,40-49,601,6,5,17,22,22,5,17,7,2.6636495293,22.4619305775,0.0116307272,0.1883116883,0.39215687,0,59,6.388417288397307E-5,4.064903E-5,4.1142106E-5,25,2,0,199,0,0
382223500,KevinDSamuel,10,720,14,43,0,0,23.3574994993,20-29,402,5,1,2,3,3,1,2,7,3.4228819696,0.0454545455,3.7804315197871065E-4,0.1666666667,0.16666667,0,59,5.1980067023554784E-5,1.3549677E-5,1.3714035E-5,182,2,1,200,1,0.005
382346402,PoCoGlenn,10,165,153,231,3,7,31.725265355,30-39,541,4,3,5,8,8,3,5,7,3.1737871108,2959.5621781563,0.0020277878,0.1071428571,0.4,0,59,6.864008438877726E-5,2.7099353E-5,2.742807E-5,182,9,0,168,0,0
382437160,payolabella,10,3343,312,680,0,140,42.6508424236,40-49,650,6,4,5,9,9,4,5,5,2.5625,0.5,3.642516048603226E-4,0.125,0.85,31,107,3.922186008621939E-4,3.3874192E-5,3.4285087E-5,108,49,0,201,0,0
382516525,Buswell_FedNDP,10,4707,198,228,2,44,45.4417105982,40-49,702,6,69,77,146,146,69,77,6,2.41564084,1608.4573312325,0.1202722083,0.141284837,0.3623226,0,59,3.0813832525747477E-4,4.7423868E-4,4.7999123E-4,25,75,26,200,21,0.105
382579638,mindulgenza,10,824,156,412,2,4,23.5722530926,20-29,500,4,0,1,1,1,0,1,7,4.3571428571,0,0,0,0,42,476,4.766339181938244E-5,0,6.8570175E-6,197,1,0,200,0,0
383397053,Dwhitney0405,10,3155,364,293,1,879,42.0387308286,40-49,686,6,3,2,5,5,3,2,3,1.8571428571,11,2.5190276274122974E-4,0.05,0.33333334,18,88,3.4874522306972786E-4,2.7099353E-5,2.742807E-5,39,21,0,195,0,0
383973753,ColinScott_NL,10,814,105,308,0,167,40.1219570139,40-49,572,5,8,28,36,36,8,28,7,2.6176683563,79.7914352057,0.0057031565,0.1857142857,0.3155242,0,59,6.98705629583226E-5,6.0973543E-5,6.171316E-5,147,6,0,200,0,0
383995541,NancyBalcom,10,102,39,142,2,2,36.4615602835,30-39,337,3,7,27,34,34,7,27,7,2.6846488052,81.4231997633,0.0152845668,0.2397504456,0.52910054,0,59,8.276774275492574E-5,5.4198706E-5,5.485614E-5,175,1,0,110,0,0
384018933,MeganDykeman,10,981,277,446,10,36,43.4491896477,40-49,580,5,11,20,31,31,11,20,7,2.8359884142,47.0673950278,0.0075660151,0.1301075269,0.44285715,0,59,9.093720697429293E-5,8.129806E-5,8.228421E-5,182,16,0,199,0,0
384052706,_nospacesplease,10,8412,88,73,1,95,29.9012434977,20-29,637,6,1,2,3,3,1,2,7,3.3345401883,0.1,2.7239675740739337E-4,0,0,0,59,5.028769873533167E-5,1.3549677E-5,1.3714035E-5,175,0,0,200,0,0
384112877,WWJonCD,10,1168,65,213,0,110,24.1163843042,20-29,494,4,0,2,2,2,0,2,7,3.2497285559,0,0,0,0,0,227,4.766339181938244E-5,0,6.8570175E-6,182,1,0,199,0,0
384357977,NWVoyageur,10,2837,114,154,2,24,31.16472171,30-39,586,6,19,21,40,40,19,21,7,2.8218682114,55.6441826133,0.0156541573,0.1442307692,0.5769231,0,59,1.2171690644025449E-4,1.3549677E-4,1.3714035E-4,175,12,0,199,0,0
384560587,GreenOffOn,10,404,341,336,2,0,40.7294799496,40-49,525,3,0,0,0,0,0,0,0,0,0,0,0,0,126,278,4.766339181938244E-5,0,0,118,10,0,200,0,0
384614410,StewartKiff,10,229,235,423,2,7,29.3580785899,20-29,486,4,20,46,66,66,20,46,7,2.594858798,2902.384077774,0.0207963122,0.1128205128,0.27764705,0,59,1.6383863740970276E-4,1.422716E-4,1.4399737E-4,175,4,1,199,1,0.0050251256
384688216,BonnieBouvier,10,1126,165,637,3,92,25.8202023855,20-29,454,5,19,44,63,63,19,44,6,2.5528602462,244.3278253538,0.0159968497,0.0901177675,0.23034227,0,59,9.808170883900077E-5,1.3549677E-4,1.3714035E-4,77,0,0,199,0,0
385234313,ms_lagace,10,342,89,93,0,286,31.1694141796,30-39,532,4,0,3,3,3,0,3,7,3.5407166124,0,0,0.5,1,0,566,4.766339181938244E-5,0,6.8570175E-6,77,1,0,199,0,0
387245373,DavidRustSmith,10,530,269,324,12,26,48.227199838,40-49,631,5,4,6,10,10,4,6,7,2.9782766112,87.2310397341,0.0024154893,0.0111111111,0.033333335,0,59,7.076714960371385E-5,3.3874192E-5,3.4285087E-5,25,4,0,200,0,0
387368681,wzebedee,10,583,61,36,1,42,26.5050455206,20-29,500,4,21,12,33,33,21,12,6,2.7708182476,86.7070357473,0.0284193573,0.1486742424,0.5,0,59,1.247336788421585E-4,1.4904643E-4,1.5085438E-4,147,7,0,200,0,0
387381118,GuyLafond,10,99,12,48,0,0,14.9088438518,10-19,92,2,0,4,4,4,0,4,7,3.1900108578,0,0,0.3333333333,0.33333334,0,277,4.766339181938244E-5,0,6.8570175E-6,182,1,0,111,0,0
387770974,CambridgeNDP,10,80,107,200,8,0,36.6408023123,30-39,411,2,48,66,114,114,48,66,7,2.4710354815,3209.9994789732,0.0682210436,0.1902654867,0.41885144,0,59,1.8444763885386655E-4,3.3196708E-4,3.3599386E-4,25,10,0,94,0,0
387970645,rmfaris,10,10368,799,1718,35,112,40.5616398083,40-49,755,8,44,124,168,168,44,124,6,2.265025344,2672.8306652234,0.0670961875,0.1064299971,0.27092063,0,59,2.151258501796478E-4,3.0486772E-4,3.085658E-4,182,26,4,200,4,0.02
388024089,felixhythlo,10,1013,107,99,0,77,40.3619505937,40-49,594,5,7,11,18,18,7,11,7,2.7979724837,11.6196769437,0.0111203693,0.0784313725,0.27272728,0,59,7.520879891906493E-5,5.4198706E-5,5.485614E-5,175,3,0,200,0,0
389029085,MA_Grondin,10,3178,17621,441,84,1644,79.1043908269,70-79,784,6,13,1,14,14,13,1,7,3.5434467777,2793.2901466951,0.0089983796,0.0714285714,0.115384616,0,59,1.945872174407132E-4,9.484774E-5,8.228421E-5,145,10,0,200,0,0
389052680,miki_lou,10,5248,200,63,4,576,46.5685720737,40-49,659,6,36,19,55,55,36,19,6,2.6705286025,259.3571405569,0.0580589276,0.132996633,0.36527294,0,59,1.666449857894223E-4,2.5066902E-4,2.5370964E-4,77,15,0,200,0,0
389061336,AaronHill_,10,220,93,192,2,6,34.8255502491,30-39,443,4,7,16,23,23,7,16,7,2.7009413469,30.3065296875,0.0078372877,0.1956521739,0.35526314,0,59,8.06240112195235E-5,5.4198706E-5,5.485614E-5,182,5,1,200,1,0.005
389463433,kellycarmichae1,10,764,60,342,2,2,34.2084644156,30-39,561,5,6,65,71,71,6,65,6,2.3055756698,125.3310516813,0.0076535841,0.1947686117,0.34134614,0,59,6.045344131772925E-5,4.742387E-5,4.799912E-5,77,4,0,200,0,0
389475975,FeffTheChef,10,7733,246,546,3,172,33.0142862706,30-39,693,7,12,31,43,43,12,31,7,2.6545981173,128.6940670781,0.0146775537,0.1107419712,0.29133064,0,59,8.040296892093943E-5,8.80729E-5,8.914123E-5,77,3,0,200,0,0
390142047,BrockCLS,10,675,320,257,10,40,45.9414638898,40-49,606,5,69,44,113,113,69,44,6,2.5680666184,873.6449623226,0.0599170277,0.0913400759,0.24432285,0,59,2.6544307447910347E-4,4.7423868E-4,4.7999123E-4,182,80,1,200,1,0.005
390225936,TheFalconer2011,10,3551,147,345,2,26,39.5707257108,30-39,619,6,42,106,148,148,42,106,6,2.3645908762,1518.0484132982,0.0934580896,0.1875344732,0.4572845,0,59,2.652747428636327E-4,2.9131805E-4,2.9485175E-4,25,10,18,200,17,0.085
390346699,s_malcolmson,10,624,173,300,4,2,40.5628624193,40-49,519,5,8,29,37,37,8,29,6,2.6140477915,704.6223329378,0.0153596886,0.1651651652,0.32580644,0,59,1.1664473576954573E-4,6.0973543E-5,6.171316E-5,182,0,1,200,1,0.005
390459554,CollinAnderson_,10,142,68,105,3,3,21.3948879621,20-29,375,3,18,34,52,52,18,34,6,2.5561187545,67.3196156633,0.0345668679,0.20173454,0.52115387,0,59,1.1776110412591159E-4,1.2872192E-4,1.3028333E-4,25,1,0,162,0,0
391321815,winfy1313,10,11917,1088,881,18,1587,44.9369241977,40-49,770,8,2,4,6,6,2,4,7,3.5800144823,2970.490087677,5.090213166743994E-4,0,0,0,59,7.52705370116932E-5,2.0324514E-5,2.0571053E-5,145,21,0,198,0,0
391381283,AndBeaulieu,10,66,37,55,1,0,28.3688147627,20-29,244,3,9,12,21,21,9,12,6,2.8102824041,58.373155055,0.0086218032,0.0833333333,0.4318182,0,59,8.082487702683208E-5,6.7748384E-5,6.8570174E-5,182,6,0,102,0,0
391997276,Itson_anon,10,3107,374,1107,8,14,45.7487941354,40-49,665,6,38,96,134,134,38,96,6,2.348660391,4596.4781867848,0.049542173,0.0872517114,0.26403508,0,59,1.7172470605030356E-4,2.642187E-4,2.674237E-4,77,9,0,200,0,0
392370247,FoE1911,10,811,29,163,0,742,28.6560756667,20-29,538,5,5,14,19,19,5,14,7,2.6727009413,4.1435439492,0.0161622091,0.2573099415,0.6571429,0,59,7.674734069390136E-5,4.064903E-5,4.1142106E-5,25,1,0,198,0,0
392401248,AlfonsoToronto,10,4911,104,92,5,1,28.5754083739,20-29,508,7,2,3,5,5,2,3,7,3.3490224475,5710.0527354367,0.0015789011,0,0,0,59,1.1980977100188417E-4,2.0324514E-5,2.0571053E-5,175,1,0,200,0,0
392880793,prab_the_man,10,2635,133,213,3,8,43.5350529348,40-49,683,6,4,4,8,8,4,4,7,3.1375814627,2.5549380204,0.002774094,0.2142857143,0.4047619,0,59,7.179489439372825E-5,3.3874192E-5,3.4285087E-5,175,8,0,200,0,0
393005812,muna_kadri,10,906,221,340,2,88,48.8388120172,40-49,678,5,39,63,102,102,39,63,7,2.640839971,914.782761867,0.0264668014,0.0759075908,0.2876457,0,59,1.903338899410683E-4,2.7099354E-4,2.742807E-4,182,137,0,200,0,0
393056809,nerdpoligirl,10,1635,95,151,2,2,24.6965205622,20-29,523,6,36,63,99,99,36,63,6,2.3823316437,200.929880245,0.0705088428,0.2063492063,0.47322297,0,59,1.9435664335389175E-4,2.5066902E-4,2.5370964E-4,25,3,13,200,12,0.06
394169629,SMaharajGlobal,10,2009,625,709,14,7,44.9411133152,40-49,651,6,6,15,21,21,6,15,7,3.1654598117,154.0031806191,0.0076529568,0.2071428571,0.2868421,0,59,7.515847392322243E-5,4.742387E-5,4.799912E-5,175,10,0,200,0,0
394245906,1loriking,10,12416,578,922,25,4,51.394742344,50-59,722,8,49,64,113,113,49,64,6,2.4076755974,2267.7434326396,0.0788955738,0.0867572693,0.22671172,0,59,2.4383340435000042E-4,3.387419E-4,3.4285086E-4,77,16,10,199,8,0.040201005
394974297,sensibleRight,10,4490,332,312,1,0,43.0371986554,40-49,683,6,5,13,18,18,5,13,7,2.5611875453,5711.3388287201,0.0123320879,0.1666666667,0.3846154,0,59,1.0567468959622605E-4,4.064903E-5,4.1142106E-5,77,17,0,200,0,0
395119352,HolmanGary,10,38,146,168,7,1,48.2657885606,40-49,536,4,35,60,95,95,35,60,7,2.5553946416,7272.2681061714,0.028708697,0.0744680851,0.26694915,0,59,1.686200230006963E-4,2.4389417E-4,2.4685264E-4,182,33,0,179,0,0
395292058,OConnorWRDSB,10,4442,343,468,10,244,48.7623548589,40-49,711,7,2,9,11,11,2,9,7,2.8874004345,24.5889097671,0.0056395781,0.0909090909,0.15277778,0,59,5.4912403507731153E-5,2.0324514E-5,2.0571053E-5,25,2,0,200,0,0
395452946,rfbest,10,38,0,0,0,0,12.8994027935,10-19,128,1,1,4,5,5,1,4,8,3.6089001447,3.0371481175,8.095914281419891E-5,0.1,0.16666667,0,244,6.508678755435881E-5,1.3549677E-5,1.3714035E-5,182,0,0,38,0,0
395470013,AKindOfAlexness,10,1004,139,316,1,118,50.9688057702,50-59,562,5,10,23,33,33,10,23,7,2.6853729182,3004.1689242572,0.0127871197,0.1373106061,0.34833333,0,59,9.440617031439062E-5,7.452322E-5,7.542719E-5,182,31,0,200,0,0
395691956,_A_Singh,10,2053,282,490,15,2,43.0178754654,40-49,638,6,42,66,108,108,42,66,6,2.453294714,470.5551767944,0.0533732928,0.151955694,0.40636158,0,59,2.3585501245815973E-4,2.9131805E-4,2.9485175E-4,175,12,2,200,2,0.01
395810455,Falconlady7,10,26702,1126,941,23,1651,37.8869336027,30-39,761,9,24,13,37,37,24,13,6,2.6567704562,267.4359514378,0.0322617841,0.1096096096,0.3723077,0,59,1.1491962864650165E-4,1.6937095E-4,1.7142543E-4,77,5,0,200,0,0
395853126,petjamwil,10,6358,378,761,5,132,43.6033604533,40-49,688,7,31,69,100,100,31,69,6,2.2715423606,1206.7152200728,0.0507947694,0.108989899,0.34697357,0,59,1.4420450226380042E-4,2.1679483E-4,2.1942456E-4,77,12,1,200,1,0.005
395856125,djboulet146,10,11,10,16,0,0,15.0668614431,10-19,30,0,2,2,4,4,2,2,7,3.4482259232,1.195532056,5.181985880188114E-4,0,0,0,59,6.230182618582913E-5,2.0324514E-5,2.0571053E-5,182,1,0,13,0,0
395911020,darealmaozedong,10,287399,3625,3285,116,0,43.4428282677,40-49,777,11,3,5,8,8,3,5,7,2.9916727009,1.9277675045,0.0039710537,0.1964285714,0.47619048,0,59,5.325899843265039E-5,2.7099353E-5,2.742807E-5,77,6,1,201,1,0.0049751244
396745864,GailRhyno,10,2834,182,320,4,595,38.5233366663,30-39,656,6,25,39,64,64,25,39,6,2.5485155684,3245.5804680862,0.0315331942,0.0915178571,0.33275262,0,59,1.2019518175794025E-4,1.761458E-4,1.7828245E-4,77,8,4,200,4,0.02
396988811,steph_pettigrew,10,145,37,120,0,17,19.2224951491,10-19,311,3,3,4,7,7,3,4,7,2.9257784214,8414.2173291299,0.001951682,0.119047619,0.35,0,59,1.3584067137100678E-4,2.7099353E-5,2.742807E-5,147,1,0,151,0,0
397288315,ChrisMcDonald__,10,1187,153,282,5,78,36.0207551348,30-39,558,5,34,59,93,93,34,59,6,2.4500362056,1031.0636843915,0.0482085246,0.1217858813,0.36235118,0,59,1.732383817071806E-4,2.3711934E-4,2.3999561E-4,25,4,0,200,0,0
397393302,rawaonca,10,168,6,67,0,38,20.7279208449,20-29,391,3,0,7,7,7,0,7,7,3.0282301846,0,0,0.3571428571,0.47619048,0,297,4.766339181938244E-5,0,6.8570175E-6,175,0,0,172,0,0
397488530,BLacey12,10,2234,173,141,2,5,44.7767696108,40-49,638,6,24,12,36,36,24,12,7,2.7820419986,151.3142886016,0.0155770059,0.1222222222,0.3505291,0,59,1.3661951114290907E-4,1.6937095E-4,1.7142543E-4,175,45,0,200,0,0
398500382,TheKeniverse,10,6212,171,357,1,652,41.9690420523,40-49,602,6,2,7,9,9,2,7,7,2.7277335264,3.6963452882,0.0092646382,0.1527777778,0.33333334,0,59,5.8813715256125196E-5,2.0324514E-5,2.0571053E-5,175,3,0,200,0,0
398848216,lmlion,10,109,17,63,0,5,18.378625537,10-19,34,3,0,1,1,1,0,1,7,4.3571428571,0,0,0,0,42,480,4.766339181938244E-5,0,6.8570175E-6,197,0,0,121,0,0
399056003,Yela_Jessica,10,7119,234,169,0,516,43.3058461707,40-49,700,6,2,2,4,4,2,2,5,2.8125,0,1.7665344078022718E-4,0.0833333333,1,31,107,1.9189631190800186E-4,2.0324514E-5,2.0571053E-5,108,19,0,201,0,0
399253284,debbiepalm44,10,12423,382,601,10,51,49.2217389423,40-49,692,8,19,40,59,59,19,40,7,2.4703113686,2767.2291301779,0.0184659105,0.0873758036,0.24622531,0,59,1.0759457400539932E-4,1.3549677E-4,1.3714035E-4,77,11,5,201,4,0.0199004975
399371605,VivianBell1,10,764,21,53,0,262,27.5854617462,20-29,407,5,0,4,4,4,0,4,7,3.1646760767,0,0,0.1666666667,0.16666667,0,264,4.766339181938244E-5,0,6.8570175E-6,77,0,1,200,1,0.005
400085464,CEPONTARIO,10,393,282,129,6,2,43.3661332871,40-49,571,3,43,20,63,63,43,20,6,2.745474294,662.4098124487,0.041430805,0.1295442908,0.32440478,0,59,1.890818454304863E-4,2.9809287E-4,3.0170876E-4,182,51,0,200,0,0
400144770,thedrachms,10,31,6,13,1,0,14.1059510478,10-19,17,0,1,3,4,4,1,3,8,3.6154124457,0,8.095914281419891E-5,0.1666666667,0.33333334,0,244,6.14943348618778E-5,1.3549677E-5,1.3714035E-5,182,0,0,33,0,0
400287995,thefakeAJ,10,1019,66,126,0,230,26.8182544104,20-29,553,5,0,1,1,1,0,1,7,3.2616720955,0,0,0,0,0,484,4.766339181938244E-5,0,6.8570175E-6,77,1,0,200,0,0
400335431,GDerch,10,342,23,30,0,9,30.2754882765,30-39,540,4,0,1,1,1,0,1,2,1.5,0,0,0,0,103,237,4.766339181938244E-5,0,6.8570175E-6,94,3,0,199,0,0
400419867,995mu,10,9989,31,29,0,468,29.7503205708,20-29,622,7,5,5,10,10,5,5,7,3.1893555395,7.7796269051,0.0109538455,0.1777777778,0.2777778,0,59,6.77807053268284E-5,4.064903E-5,4.1142106E-5,175,14,0,204,0,0
400440361,Panducky_,10,10249,168,196,1,139,42.4189219415,40-49,722,7,0,0,0,0,0,0,0,0,0,0,0,0,229,575,4.766339181938244E-5,0,0,233,6,0,200,0,0
400507156,Vesciuvio,10,94,26,88,0,6,22.3713120264,20-29,247,3,2,7,9,9,2,7,6,2.8421433744,0.2142904334,0.0042821713,0.1527777778,0.33333334,0,59,5.290351189477659E-5,2.0324514E-5,2.0571053E-5,182,2,0,125,0,0
400576533,jessedevo,10,234,19,28,0,3,18.1666066083,10-19,308,4,1,5,6,6,1,5,7,2.7433019551,0,0.0072676982,0.3333333333,0.75,0,59,5.409653606626543E-5,1.3549677E-5,1.3714035E-5,25,0,0,200,0,0
400707920,Melaniedemoor,10,9925,186,97,0,2386,44.8215266701,40-49,737,7,7,7,14,14,7,7,3,1.6666666667,39.7,6.076148887759546E-4,0.0934065934,0.44642857,58,182,2.067215040769254E-4,5.4198706E-5,5.485614E-5,166,39,0,201,0,0
400836180,PatrickS71,10,5020,244,204,9,19,45.7138968583,40-49,651,7,67,72,139,139,67,72,6,2.4279507603,521.8133141684,0.1083477634,0.1350224168,0.3780198,0,59,3.2401425263713064E-4,4.60689E-4,4.6627718E-4,25,17,1,200,1,0.005
400961934,guillamelepetit,10,568,82,359,2,60,42.5469779123,40-49,500,5,5,6,11,11,5,6,7,3.1614771904,31.962978782,0.0159951528,0.1090909091,0.375,0,59,1.3449673052815607E-4,4.064903E-5,4.1142106E-5,175,1,0,200,0,0
400968743,ErinTrafford,10,4916,951,490,24,82,39.5619165314,30-39,739,7,27,23,50,50,27,23,7,2.8283852281,252.0519250412,0.0274764898,0.1334693878,0.33214793,0,59,2.0540409144702523E-4,1.8969548E-4,1.9199649E-4,147,16,0,200,0,0
401289982,crazyboutnothin,10,681,76,165,0,83,38.4333231234,30-39,591,5,1,1,2,2,1,1,1,1,0,8.095914281419891E-5,0,0,165,363,3.177448371356425E-4,1.3549677E-5,1.3714035E-5,163,20,0,198,0,0
401614276,IAMAW2323,10,7406,392,374,2,0,38.9916248341,30-39,649,6,23,35,58,58,23,35,6,2.6723388849,621.8445682403,0.0210199582,0.1197822142,0.26969698,0,59,1.2867930224059324E-4,1.6259612E-4,1.6456842E-4,182,18,0,200,0,0
402197150,DavideCelani,10,50,12,49,0,0,12.4824719478,10-19,162,2,0,1,1,1,0,1,7,4.3571428571,0,0,0,0,42,516,4.766339181938244E-5,0,6.8570175E-6,197,1,0,51,0,0
402752738,catherinegall92,10,1303,120,285,0,787,34.3598757607,30-39,575,5,1,3,4,4,1,3,8,3.6136034732,2763,8.095914281419891E-5,0.0833333333,0.33333334,0,261,1.1615009511706267E-4,1.3549677E-5,1.3714035E-5,175,3,0,201,0,0
402792142,WatchCTVNews,10,28402,3630,115,89,0,56.3327343767,50-59,798,9,43,13,56,56,43,13,7,3.2031136857,606.820839283,0.0459516243,0.0701298701,0.11879433,0,59,5.417130423081124E-4,2.9809287E-4,3.0170876E-4,175,50,0,203,0,0
402906197,HananATTAS,10,11935,745,1102,2,68,35.3030752035,30-39,726,7,0,0,0,0,0,0,0,0,0,0,0,0,122,269,4.766339181938244E-5,0,0,115,8,0,201,0,0
403068633,prairiedog71,10,5189,391,829,8,1991,47.9321996274,40-49,691,8,41,47,88,88,41,47,7,2.8381607531,426.2493140823,0.0233237776,0.0839864159,0.38749126,0,59,2.2257200142208102E-4,2.845432E-4,2.8799474E-4,175,31,0,199,0,0
403403713,SlaveToTheDog,10,173,21,101,0,2,34.1336131876,30-39,453,4,2,6,8,8,2,6,7,2.9793627806,0.1548627002,0.0049057604,0.125,0.26666668,0,59,5.7195348072674636E-5,2.0324514E-5,2.0571053E-5,175,3,0,200,0,0
403550732,kbec10,10,117,14,66,0,0,16.7903199746,10-19,168,3,0,1,1,1,0,1,8,4.268548679,0,0,0,0,0,647,4.766339181938244E-5,0,6.8570175E-6,175,0,0,117,0,0
403738810,NoRelishPlease,10,6742,374,912,7,147,47.5192186049,40-49,717,7,17,31,48,48,17,31,7,2.7201303403,1458.3129415268,0.0117714393,0.0970744681,0.28787878,0,59,1.244525359263989E-4,1.2194709E-4,1.2342632E-4,175,14,0,201,0,0
403813939,LibFail99,10,6788,802,1030,20,102,48.3435157763,40-49,753,7,85,124,209,209,85,124,6,2.2617668356,14193.9147245043,0.0466055834,0.0464206846,0.18817668,0,59,3.615413346031156E-4,5.826361E-4,5.897035E-4,175,30,0,198,0,0
403959388,JocelynVCardoza,10,5657,160,190,0,1480,41.9719406089,40-49,684,6,0,0,0,0,0,0,0,0,0,0,0,0,78,174,4.766339181938244E-5,0,0,70,6,1,199,1,0.0050251256
404710418,alessandrobelt1,10,555,29,101,0,11,16.3875619178,10-19,501,4,0,1,1,1,0,1,7,4.3571428571,0,0,0,0,42,449,4.766339181938244E-5,0,6.8570175E-6,197,0,0,200,0,0
405722418,enricopavesi,10,21,16,112,0,0,14.6966273232,10-19,46,2,0,0,0,0,0,0,0,0,0,0,0,0,197,505,4.766339181938244E-5,0,0,201,0,0,27,0,0
408026086,danielledalzell,10,996,229,482,2,3,23.3836566375,20-29,548,6,54,90,144,144,54,90,6,2.4015206372,997.7784747148,0.1030044344,0.1383061383,0.36280322,0,59,2.8212315442765383E-4,3.726161E-4,3.7713596E-4,25,2,5,200,5,0.025
408257459,jackshope,10,1027,63,162,1,47,34.9603038601,30-39,577,5,5,14,19,19,5,14,6,2.6669080377,19.2909518959,0.0075941035,0.1140350877,0.31868133,0,59,6.468914948011563E-5,4.064903E-5,4.1142106E-5,182,12,0,200,0,0
408867671,BCummings945,10,1154,95,521,1,14,40.3798686347,40-49,571,6,15,52,67,67,15,52,6,2.4540188269,285.58497051,0.0213451263,0.1467661692,0.3337104,0,59,9.418454590943577E-5,1.0839741E-4,1.0971228E-4,77,5,3,200,3,0.015
409370463,farmersims,10,1344,705,940,16,6,44.7264287607,40-49,674,6,5,7,12,12,5,7,7,3.0687907314,5074.9998914667,0.0058732229,0.0909090909,0.2,0,59,1.5654330988223498E-4,4.064903E-5,4.1142106E-5,175,5,0,200,0,0
410334710,CBCHamilton,10,4335,6308,430,171,93,63.7842499768,60-69,788,6,31,13,44,44,31,13,7,2.8624185373,854.4878181047,0.0271262598,0.116807611,0.17195122,0,59,1.9092163644104373E-4,2.1679483E-4,2.1942456E-4,175,115,0,200,0,0
410844193,antcar83,10,1176,263,344,7,7,43.441912665,40-49,610,5,0,1,1,1,0,1,7,4.3571428571,0,0,0,0,42,456,4.766339181938244E-5,0,6.8570175E-6,197,7,0,200,0,0
410942867,dixlexus,10,346,242,481,0,16,27.7579214407,20-29,580,5,1,11,12,12,1,11,6,2.8649529327,39.6408825321,9.141109764982082E-5,0.1666666667,0.28181818,0,59,5.247659739126935E-5,1.3549677E-5,1.3714035E-5,77,44,0,195,0,0
411188145,mediaspotme,10,302,198,438,13,1,50.434818937,50-59,592,5,3,19,22,22,3,19,7,2.9359160029,317.5839541126,0.0018295035,0.158008658,0.31871346,0,59,7.070174069974186E-5,2.7099353E-5,2.742807E-5,175,35,0,200,0,0
411896865,clarissalozaano,10,15099,650,328,0,298,44.5322582768,40-49,732,7,4,4,8,8,4,4,4,2.3125,138,3.3303450664293855E-4,0,0,31,107,5.254916956376052E-4,3.3874192E-5,3.4285087E-5,108,26,0,203,0,0
412102984,Fabs978,10,591,23,286,0,288,22.3239608321,20-29,246,4,0,1,1,1,0,1,7,4.3571428571,0,0,0,0,42,428,4.766339181938244E-5,0,6.8570175E-6,197,0,0,199,0,0
412231450,ryangrinnell,10,1961,175,417,2,23,36.123365382,30-39,591,6,18,44,62,62,18,44,7,2.4884141926,114.858485007,0.0348883686,0.1901110524,0.45559666,0,59,1.0302393134549219E-4,1.2872192E-4,1.3028333E-4,25,12,0,201,0,0
413031585,xWarriorPoetx,10,6412,108,86,9,26,40.3462662186,40-49,697,6,3,3,6,6,3,3,7,2.8291093411,24.8381932859,0.0077719329,0.1,0.25,0,59,6.544504003770603E-5,2.7099353E-5,2.742807E-5,77,4,0,199,0,0
414031631,giftbm,10,2587,111,123,0,17,41.0865519419,40-49,619,6,0,1,1,1,0,1,10,5.8863554108,0,0,0,0,0,159,4.766339181938244E-5,0,6.8570175E-6,131,3,0,200,0,0
414250963,XL_TimsCoffee,10,1520,155,559,0,34,37.1443714421,30-39,623,6,1,7,8,8,1,7,7,3.1669080377,0.3129144964,2.756608438207002E-4,0.25,0.375,0,59,5.0409093606584E-5,1.3549677E-5,1.3714035E-5,147,1,0,200,0,0
414261042,SeldomSmith,10,5066,514,1474,7,34,43.7013074465,40-49,677,7,73,179,252,252,73,179,6,2.1748732802,9268.4777351629,0.0922599601,0.0769936129,0.20672739,0,59,2.567940461665304E-4,5.0133804E-4,5.074193E-4,77,5,1,200,1,0.005
414481506,anakarenva2,10,5140,247,418,0,74,33.8760308962,30-39,694,6,2,2,4,4,2,2,1,1,0,1.6551228476954845E-4,0.0833333333,1,186,403,3.177448371356425E-4,2.0324514E-5,2.0571053E-5,193,37,0,200,0,0
415126004,Rolfe_,10,1818,84,430,0,0,29.652809524,20-29,596,6,11,39,50,50,11,39,6,2.4974656046,37.1925021579,0.0216457619,0.172244898,0.3682927,0,59,7.805719482281215E-5,8.129806E-5,8.228421E-5,77,3,2,199,2,0.0100502513
415942926,JaclynDimmer,10,542,44,136,0,33,27.7115836616,20-29,435,4,2,3,5,5,2,3,7,3.1473569877,0.1209487087,0.0024396395,0.25,0.3,0,59,5.1800773854576236E-5,2.0324514E-5,2.0571053E-5,147,0,0,200,0,0
416428550,Apndp,10,1904,40394,351,452,9,63.6093600426,60-69,842,5,112,1,113,113,112,1,6,3.6153846154,1275,0.0089437848,0.0014222503,0.002091377,42,307,0.0090079754,7.655567E-4,1.2342632E-4,197,367,0,200,0,0
416434193,NFSSmith,10,16993,664,1975,12,3975,39.157000957,30-39,708,8,42,73,115,115,42,73,6,2.4047791455,541.7478235625,0.0560185223,0.1057971014,0.32021606,0,59,1.6739026021214703E-4,2.9131805E-4,2.9485175E-4,77,5,0,197,0,0
416699333,Lateralfade,10,434,6,43,0,106,16.3649968361,10-19,147,4,0,2,2,2,0,2,7,3.230184582,0,0,0,0,0,249,4.766339181938244E-5,0,6.8570175E-6,77,0,0,200,0,0
416746210,chasm_of_nicety,10,1164,28,16,0,6,26.1958164395,20-29,570,4,0,0,0,0,0,0,0,0,0,0,0,0,170,372,4.766339181938244E-5,0,0,169,1,0,200,0,0
417143096,EtanaCain,10,314,200,186,3,0,24.7505421176,20-29,520,4,70,50,120,120,70,50,6,2.6270818248,369.632809528,0.1278300027,0.1729691877,0.39758772,0,59,3.397719692621294E-4,4.8101353E-4,4.8684824E-4,25,1,1,199,1,0.0050251256
417571583,BWDenn,10,20094,748,1220,10,685,40.6758402457,40-49,690,8,2,3,5,5,2,3,7,3.2896451846,6.2414084769,0.0010800067,0,0,0,59,5.774407173803781E-5,2.0324514E-5,2.0571053E-5,77,2,0,201,0,0
417582834,yiansh,10,7755,667,1998,12,4947,47.4492897899,40-49,702,7,0,0,0,0,0,0,0,0,0,0,0,0,198,507,4.766339181938244E-5,0,0,202,1,0,199,0,0
418141269,antonio100fanti,10,126,51,195,0,5,17.5416327467,10-19,181,3,0,1,1,1,0,1,7,4.3571428571,0,0,0,0,42,464,4.766339181938244E-5,0,6.8570175E-6,197,0,0,128,0,0
418279532,KariWinfield1,10,762,128,172,5,4,40.2970557559,40-49,558,5,0,1,1,1,0,1,1,1,0,0,0,0,0,543,4.766339181938244E-5,0,6.8570175E-6,25,0,0,200,0,0
418636676,daniedario,10,5585,336,973,2,2102,44.55916726,40-49,658,7,0,2,2,2,0,2,6,3.4285714286,0,0,0.5,1,42,469,4.766339181938244E-5,0,6.8570175E-6,197,1,0,201,0,0
419186757,Jarredanderson_,10,59,38,39,0,60,26.880431177,20-29,418,3,1,0,1,1,1,0,0,0,0,9.313841764261912E-4,0,0,0,51,5.1738693639318724E-5,1.3549677E-5,0,175,4,0,70,0,0
419345513,allieegraham,10,357,130,308,0,146,37.6600167968,30-39,549,4,1,5,6,6,1,5,6,2.9272793054,31.7711682619,8.095914281419891E-5,0.2333333333,0.45,0,265,5.995784025776912E-5,1.3549677E-5,1.3714035E-5,77,8,0,200,0,0
419593686,oneredcatmedia,10,4593,173,123,5,128,42.9194042937,40-49,653,6,5,3,8,8,5,3,7,3.2737146995,0,0.0032008311,0.1785714286,0.9,0,59,7.116008865376047E-5,4.064903E-5,4.1142106E-5,147,10,0,202,0,0
420282906,brainwrinkler,10,3397,117,243,1,112,33.1230804088,30-39,627,6,8,13,21,21,8,13,7,2.6361332368,113.1307490295,0.0085905418,0.0642857143,0.2948718,0,59,7.354720813937536E-5,6.0973543E-5,6.171316E-5,77,4,0,200,0,0
420318827,DavidCarter52,10,731,292,627,25,0,45.3880224182,40-49,560,4,1,1,2,2,1,1,8,3.6002896452,2.1917128886,1.8222244305206008E-4,0,0,0,59,5.435843695344194E-5,1.3549677E-5,1.3714035E-5,145,0,1,200,1,0.005
420351613,wildwalkerwoman,10,50307,1390,799,78,1907,52.6527243275,50-59,779,9,9,6,15,15,9,6,7,3.037653874,51.9129132673,0.0064312705,0.0666666667,0.2,0,59,8.009152551735152E-5,6.7748384E-5,6.8570174E-5,77,30,0,201,0,0
420385985,LdnOntTV,10,24913,2443,2055,63,2834,48.8642303287,40-49,734,8,26,34,60,60,26,34,6,2.8320057929,3646.5652684688,0.0155961339,0.068079096,0.25604552,0,59,1.9540061740874992E-4,1.8292063E-4,1.8513948E-4,175,15,0,200,0,0
420995289,SarnoRaffaele,10,13887,282,2001,1,14300,41.4815455879,40-49,642,8,0,2,2,2,0,2,5,2.9285714286,0,0,0,0,42,444,4.766339181938244E-5,0,6.8570175E-6,197,2,0,201,0,0
421102654,CotdeloupJulien,10,8876,122,124,1,181,46.6981849334,40-49,743,7,1,1,2,2,1,1,1,1,0,8.269890653312533E-5,0,0,103,230,4.4196753707428227E-4,1.3549677E-5,1.3714035E-5,94,29,0,201,0,0
421143718,sp14spurs,10,9163,1058,1074,11,151,38.2311181092,30-39,747,7,0,0,0,0,0,0,0,0,0,0,0,0,41,123,4.766339181938244E-5,0,0,38,0,0,201,0,0
421176943,bobby_tunney,10,9742,758,2001,1,208,45.441881997,40-49,713,7,10,39,49,49,10,39,6,2.6781317886,245.409611303,0.0093990212,0.1466836735,0.26713124,0,59,7.091980429151965E-5,7.452322E-5,7.542719E-5,175,85,0,203,0,0
421369568,ShannanLittle,10,298,45,60,1,25,45.1449515977,40-49,566,4,32,25,57,57,32,25,6,2.6404779146,844.6471681859,0.0219142747,0.0792606516,0.23414634,0,59,1.6563564360305352E-4,2.2356966E-4,2.2628158E-4,182,168,1,200,1,0.005
421482494,TorontoPost,10,17501,39914,2602,11,50,42.6871724849,40-49,763,8,19,19,38,38,19,19,6,2.5430847212,284.6114863194,0.0241402937,0.0405405405,0.32163742,0,59,1.0050830200138834E-4,1.3549677E-4,1.3714035E-4,77,11,0,202,0,0
422037971,fabrizio_caneva,10,953,51,171,0,109,32.9496354078,30-39,543,5,0,1,1,1,0,1,7,4.3571428571,0,0,0,0,42,452,4.766339181938244E-5,0,6.8570175E-6,197,4,0,200,0,0
422159041,leerathje,10,647,59,138,0,64,42.3848709703,40-49,573,5,3,12,15,15,3,12,7,2.6962346126,22.3751365584,0.0110806526,0.1619047619,0.36363637,0,59,6.096150210535364E-5,2.7099353E-5,2.742807E-5,182,4,2,200,2,0.01
422899826,TDubbz90,10,29199,398,638,9,9764,55.0511759305,50-59,757,8,5,5,10,10,5,5,7,2.9250543085,23.3262551617,0.0054364648,0.0555555556,0.23333333,0,59,7.103939078699285E-5,4.064903E-5,4.1142106E-5,175,18,0,201,0,0
423033599,TimOuthit,10,3515,1181,579,46,14,40.2133038365,40-49,741,7,30,24,54,54,30,24,6,2.8323678494,297.2615913944,0.0225996435,0.1387141859,0.44744745,0,59,2.1779132209244498E-4,2.1001999E-4,2.1256754E-4,147,21,0,200,0,0
423823137,TheRealDamany,10,42684,1272,2000,18,2605,48.6395036785,40-49,766,9,75,100,175,175,75,100,6,2.3808834178,2065.9220218116,0.0773578212,0.0645977011,0.27604556,0,59,2.4046219486799377E-4,5.148877E-4,5.211333E-4,77,286,1,208,1,0.0048076923
423891063,melissajanedube,10,667,151,252,1,148,31.4264376452,30-39,527,4,1,2,3,3,1,2,7,3.0438088342,0,1.6202117079417596E-4,0.1666666667,1,0,59,7.208300543587784E-5,1.3549677E-5,1.3714035E-5,147,1,0,200,0,0
425252248,ProfCyr,10,531,229,247,3,0,40.3477441686,40-49,573,4,21,33,54,54,21,33,7,2.5510499638,200.3077739744,0.0487832585,0.1953179595,0.5070513,0,59,1.8851210262501824E-4,1.4904643E-4,1.5085438E-4,25,30,1,200,1,0.005
425385941,Alepenaa,10,8757,331,518,1,39,27.5637524662,20-29,704,7,0,0,0,0,0,0,0,0,0,0,0,0,183,392,4.766339181938244E-5,0,0,184,4,0,202,0,0
427005769,lifeaschadlee,10,61,18,30,1,0,32.8861650901,30-39,375,3,1,1,2,2,1,1,7,3.5191889935,0,3.193793603622525E-4,0,0,0,59,5.642796843016944E-5,1.3549677E-5,1.3714035E-5,182,0,0,134,0,0
427315022,B2utyDiiva,10,19453,886,298,2,1128,37.2455654704,30-39,758,8,3,2,5,5,3,2,2,1.3333333333,6,2.4649064106096335E-4,0.05,0.33333334,22,95,3.214918386573E-4,2.7099353E-5,2.742807E-5,126,9,0,203,0,0
427614581,PollardRick,10,861,212,146,5,3,35.0019450941,30-39,582,5,54,46,100,100,54,46,6,2.5517740768,580.0740197987,0.0742502676,0.1470707071,0.4151446,0,59,2.860185392219362E-4,3.726161E-4,3.7713596E-4,25,8,6,200,6,0.03
427743419,jimmydawes107,10,124,2,58,0,2,13.4493879176,10-19,83,3,0,7,7,7,0,7,7,3.0546507419,0,0,0.3571428571,0.47619048,0,185,4.766339181938244E-5,0,6.8570175E-6,77,0,0,157,0,0
427822638,dalesy17,10,209,31,121,0,20,25.5255224833,20-29,441,4,2,4,6,6,2,4,7,3.1893555395,1.616733403,0.0018920355,0.1,0.33333334,0,59,5.235169942038489E-5,2.0324514E-5,2.0571053E-5,182,7,0,200,0,0
428007272,aranzadesire,10,16157,267,676,0,329,43.1799511355,40-49,718,8,1,0,1,1,1,0,0,0,0,7.92005701980554E-5,0,0,31,106,6.792033426954478E-5,1.3549677E-5,0,108,8,0,202,0,0
428009580,apcharding,10,100,40,104,1,0,30.2446623998,30-39,281,2,3,6,9,9,3,6,7,3.0162925416,619.1379338926,0.0113863153,0.1944444444,0.30357143,0,59,6.762852449030114E-5,2.7099353E-5,2.742807E-5,25,3,0,107,0,0
428057122,ILiveHereBC,10,5722,281,514,7,68,46.82518399,40-49,686,7,34,54,88,88,34,54,6,2.4409847936,742.0145897065,0.046759419,0.1051462905,0.27249417,0,59,1.4238851569090693E-4,2.3711934E-4,2.3999561E-4,77,8,0,200,0,0
428312812,umberto_calo,10,10,8,31,0,0,12.2285441559,10-19,20,1,0,1,1,1,0,1,7,4.3571428571,0,0,0,0,42,520,4.766339181938244E-5,0,6.8570175E-6,197,0,0,12,0,0
428441121,van1go,10,759,295,167,3,0,41.924793312,40-49,553,5,0,1,1,1,0,1,11,6.8812884546,0,0,0,0,0,231,4.766339181938244E-5,0,6.8570175E-6,131,2,0,200,0,0
428464886,anthoghali,10,840,235,1979,6,226,30.4528340362,30-39,478,5,33,181,214,214,33,181,6,2.225923244,976.2536368632,0.0529740465,0.1943530341,0.35351232,0,59,1.586025310677324E-4,2.303445E-4,2.3313859E-4,25,3,0,200,0,0
428758201,sabrina_cgzz,10,60,31,99,0,2,30.6489842614,30-39,381,3,0,0,0,0,0,0,0,0,0,0,0,0,231,591,4.766339181938244E-5,0,0,235,8,0,200,0,0
429054107,matteodipaolo89,10,14199,819,1439,5,986,60.3193870473,60-69,749,8,2,5,7,7,2,5,4,2,134.1666666667,1.637353138479683E-4,0.119047619,0.35,42,307,1.9589010166672652E-4,2.0324514E-5,2.0571053E-5,197,4,0,201,0,0
429182236,awjrector,10,585,105,101,4,86,40.5500584431,40-49,615,5,18,12,30,30,18,12,7,3.0582910934,77.3735589175,0.0108553497,0.1298850575,0.5605263,0,59,1.2306511381958305E-4,1.2872192E-4,1.3028333E-4,175,17,0,199,0,0
429750913,TheNikonLad,10,2155,334,464,0,360,42.1666717566,40-49,672,6,0,1,1,1,0,1,1,1,0,0,0,0,224,558,4.766339181938244E-5,0,6.8570175E-6,229,13,0,200,0,0
430937793,coralaru,10,66,19,102,0,5,22.4776712487,20-29,239,2,0,4,4,4,0,4,7,3.1013391241,0,0,0.25,0.5,0,574,4.766339181938244E-5,0,6.8570175E-6,77,0,0,66,0,0
431108753,homelessdave0,10,9831,192,5,4,27,36.3411969619,30-39,639,7,13,0,13,13,13,0,0,0,0,0.0109609538,0.1346153846,0.21794872,0,35,8.484272754635626E-5,9.484774E-5,0,77,18,0,200,0,0
431403044,TylerMurnaghan,10,227,68,105,0,2,28.6178386285,20-29,538,3,5,13,18,18,5,13,6,2.7389572773,14.7793936536,0.0047032321,0.1830065359,0.5192308,0,59,6.451065540557523E-5,4.064903E-5,4.1142106E-5,25,4,0,199,0,0
431615200,Canuckism101,10,5451,146,209,3,11,44.9132953364,40-49,682,7,19,21,40,40,19,21,7,2.5155684287,859.3043391472,0.0155613123,0.0762820513,0.345,0,59,1.1157587514209543E-4,1.3549677E-4,1.3714035E-4,175,38,0,204,0,0
431729320,SampsonCharles,10,1815,45,10,3,6,23.7700149992,20-29,585,5,4,2,6,6,4,2,7,3.0267921796,1.8130528198,0.0059229018,0.3666666667,0.53333336,0,59,5.8884246566823024E-5,3.3874192E-5,3.4285087E-5,182,16,0,200,0,0
431971226,WhiteCoco80,10,3239,188,115,1,10,48.8017002206,40-49,702,7,21,18,39,39,21,18,7,2.9268645909,4933.6465078139,0.0160522286,0.1153846154,0.3611111,0,59,1.5127603280113946E-4,1.4904643E-4,1.5085438E-4,182,51,0,200,0,0
432866028,fnatashiac,10,592,19,33,1,19,25.4481800039,20-29,492,4,3,2,5,5,3,2,7,2.9945691528,13.6341928048,0.0021828341,0.1,0.33333334,0,59,6.743857493851875E-5,2.7099353E-5,2.742807E-5,77,2,0,199,0,0
432866135,kristaknechtle,10,758,94,212,2,10,40.8894905743,40-49,573,5,2,6,8,8,2,6,7,2.9590876177,33.1159341631,9.293923679789242E-4,0.125,0.26666668,0,59,6.079619862350586E-5,2.0324514E-5,2.0571053E-5,25,6,0,200,0,0
433357633,jrmoodie,10,169,69,407,4,6,34.6396044915,30-39,381,3,3,64,67,67,3,64,6,2.3841419261,4.0102186268,0.006175215,0.3061962913,0.52876985,0,59,5.8085713067477735E-5,2.7099353E-5,2.742807E-5,25,1,0,200,0,0
433690691,dashriprock87,10,888,59,111,0,6,25.3780120253,20-29,606,5,5,3,8,8,5,3,7,3.3030412744,10.0353372341,0.0054308562,0.0714285714,0.26666668,0,59,5.836767904533522E-5,4.064903E-5,4.1142106E-5,182,2,0,200,0,0
433809465,BrandonCorban,10,2573,162,139,0,230,40.5766236495,40-49,628,5,1,1,2,2,1,1,4,2.9375,0,8.467025341918699E-5,0,0,31,107,1.535455905525994E-4,1.3549677E-5,1.3714035E-5,108,15,0,201,0,0
433867215,JehCOh13,10,3554,401,541,3,1019,44.3188509182,40-49,710,6,36,54,90,90,36,54,6,2.4047791455,2200.1386008932,0.0367495913,0.0560549313,0.21717171,0,59,1.6072776835573363E-4,2.5066902E-4,2.5370964E-4,77,7,1,200,1,0.005
435094631,Justmax360,10,185,4,26,0,0,11.5576855183,10-19,45,3,0,1,1,1,0,1,7,3.2616720955,0,0,0,0,0,196,4.766339181938244E-5,0,6.8570175E-6,77,0,0,194,0,0
435196112,GalldinRoberts,10,1364,444,536,12,2,45.3495244123,40-49,635,5,18,22,40,40,18,22,6,2.7034757422,552.3099622157,0.0280613895,0.1179487179,0.3546798,0,59,1.3234701957703942E-4,1.2872192E-4,1.3028333E-4,182,8,0,200,0,0
435233251,Kat_Kovac,10,6684,251,346,0,3945,43.5543989882,40-49,712,7,3,5,8,8,3,5,2,1.2857142857,12.5,2.519596010555675E-4,0.0535714286,0.25,18,88,3.543654428922918E-4,2.7099353E-5,2.742807E-5,39,10,0,200,0,0
435288411,ChloeB0825,10,48,48,208,1,2,16.1384832227,10-19,227,2,0,0,0,0,0,0,0,0,0,0,0,0,247,643,4.766339181938244E-5,0,0,252,1,0,48,0,0
435290720,RajeshJantilal,10,8285,463,993,6,72,42.0677807584,40-49,678,7,4,5,9,9,4,5,10,5.8048515568,1520.5663317606,4.375993315046767E-4,0.0972222222,0.1904762,0,59,2.757370417102232E-4,3.3874192E-5,3.4285087E-5,131,0,0,200,0,0
435300845,Silvia_Moggia,10,7602,705,846,8,4000,51.4686041461,50-59,742,7,1,2,3,3,1,2,7,4.1333333333,0,8.095914281419891E-5,0.1666666667,0.5,42,420,8.289285873049163E-5,1.3549677E-5,1.3714035E-5,197,12,0,201,0,0
435707754,Mikoshoes17,10,12771,387,787,4,373,37.4013851166,30-39,695,8,60,132,192,192,60,132,6,2.2592324403,4818.9492464699,0.0672590192,0.1034576789,0.29433843,0,59,1.922535340880589E-4,4.1326514E-4,4.1827807E-4,77,28,0,201,0,0
436044943,NoraRivera18,10,7246,282,378,0,104,33.273572626,30-39,724,7,1,1,2,2,1,1,2,1.6666666667,0,8.44770929948927E-5,0,0,100,225,2.205056735505623E-4,1.3549677E-5,1.3714035E-5,237,1,0,201,0,0
436088829,ytzel_karen,10,1481,210,621,0,174,36.6330732695,30-39,600,5,0,0,0,0,0,0,0,0,0,0,0,0,32,109,4.766339181938244E-5,0,0,29,0,0,201,0,0
436242761,dmdmitchell,10,3995,481,1957,4,132,45.0681217337,40-49,625,7,46,137,183,183,46,137,6,2.2291817524,7677.2029232655,0.0499451473,0.0834684441,0.19987488,0,59,1.8193217938946568E-4,3.1841738E-4,3.222798E-4,182,54,0,200,0,0
436471536,SiceloNkosi,10,454,65,321,0,22,31.7355414602,30-39,385,4,0,2,2,2,0,2,11,6.7376040536,0,0,0,0,0,344,4.766339181938244E-5,0,6.8570175E-6,131,0,0,200,0,0
436985128,PeteHelfrich,10,974,238,442,6,5,28.4148377055,20-29,606,5,16,39,55,55,16,39,6,2.622013034,494.9194483536,0.0159921264,0.1084175084,0.28414634,0,59,1.423535670554315E-4,1.1517225E-4,1.16569296E-4,175,2,1,199,1,0.0050251256
437741566,jessmbradley,10,498,222,191,3,7,35.1120533032,30-39,572,4,1,5,6,6,1,5,7,2.9514844316,21.935676371,0.0020897685,0.1666666667,0.3,0,59,1.4316118675920816E-4,1.3549677E-5,1.3714035E-5,77,8,0,199,0,0
437851552,ninajeancordell,10,1127,120,456,2,20,32.6848124485,30-39,577,5,6,15,21,21,6,15,7,2.7947139754,12.758981484,0.0028742586,0.1261904762,0.32380953,0,59,6.185096024205822E-5,4.742387E-5,4.799912E-5,77,8,1,199,1,0.0050251256
439278917,TakeMyNeon,10,312,6,102,0,0,22.3377194215,20-29,340,4,0,1,1,1,0,1,7,3.6659428158,0,0,0,0,0,609,4.766339181938244E-5,0,6.8570175E-6,175,2,0,200,0,0
439313680,michaelcwheeler,10,3441,974,801,23,348,50.2301778141,50-59,694,6,18,49,67,67,18,49,6,2.509775525,3510.1018644996,0.0290359662,0.158525554,0.34837663,0,59,1.2619805406455475E-4,1.2872192E-4,1.3028333E-4,25,21,1,200,1,0.005
439656017,vale8705,10,8443,194,361,2,529,29.4774190824,20-29,745,8,1,2,3,3,1,2,7,4.1333333333,0,8.095914281419891E-5,0.1666666667,0.5,42,568,8.289285873049163E-5,1.3549677E-5,1.3714035E-5,197,4,0,200,0,0
441973833,TwitTwitCat,10,1185,94,171,1,37,40.8432314519,40-49,542,5,8,14,22,22,8,14,6,2.8146270818,216.9451390228,0.0060791274,0.0974025974,0.33333334,0,59,9.12361161779746E-5,6.0973543E-5,6.171316E-5,77,6,0,200,0,0
442175344,Zebedee4Council,10,4181,217,181,17,100,45.7266493084,40-49,691,6,30,0,30,30,30,0,0,0,0,0.0296288431,0.291954023,0.48735633,0,26,1.7059488706466807E-4,2.1001999E-4,0,147,3,0,200,0,0
442832919,LeblancMiguel,10,3187,105,380,2,8,45.3729994594,40-49,602,6,12,50,62,62,12,50,6,2.4044170891,164.9406628038,0.0315913347,0.2239555791,0.43326345,0,59,9.962045426440421E-5,8.80729E-5,8.914123E-5,175,6,0,200,0,0
443655020,CoyoteDreams,10,3948,206,252,4,892,33.1905498315,30-39,648,7,13,19,32,32,13,19,6,2.6600289645,419.8086277258,0.0106374616,0.0846774194,0.22644928,0,59,9.590306345271391E-5,9.484774E-5,9.599824E-5,77,3,0,200,0,0
444129933,Ayoulaland,10,6729,62,168,1,17,27.3037309732,20-29,690,7,0,0,0,0,0,0,0,0,0,0,0,0,159,357,4.766339181938244E-5,0,0,157,0,0,199,0,0
444262205,BravoFourTwenty,10,7251,376,691,1,782,46.3599743796,40-49,735,7,47,52,99,99,47,52,6,2.444243302,562.3377826558,0.0597135339,0.0834879406,0.4107143,0,59,1.6425415939895694E-4,3.2519223E-4,3.2913685E-4,77,43,1,200,1,0.005
444909298,ChrisMcLd,10,2835,602,276,9,643,46.32867375,40-49,695,6,26,17,43,43,26,17,7,2.8830557567,463.8118823136,0.0151578819,0.1478405316,0.5788177,0,59,1.885179222016299E-4,1.8292063E-4,1.8513948E-4,175,29,0,201,0,0
445052037,Silky_Goon_14,10,785,248,206,0,636,42.7523744966,40-49,641,5,2,2,4,4,2,2,3,1.8571428571,0,1.7090505595144666E-4,0.0833333333,1,18,88,1.822445046150632E-4,2.0324514E-5,2.0571053E-5,39,31,0,200,0,0
447487582,MelanieKiers,10,111,25,134,0,7,20.4960834153,20-29,330,3,1,2,3,3,1,2,8,3.7559739319,0,1.7896312015230702E-4,0.1666666667,0.5,0,59,5.175019435976361E-5,1.3549677E-5,1.3714035E-5,175,6,0,111,0,0
447760535,Bzzengetwa,10,5813,189,359,1,10,45.6700754422,40-49,674,6,1,2,3,3,1,2,10,5.8041274439,0.6111111111,8.29872052796843E-5,0,0,0,59,5.804565185450687E-5,1.3549677E-5,1.3714035E-5,131,1,0,203,0,0
448607351,johncbarthur,10,27,9,127,0,2,15.0766692467,10-19,73,2,1,19,20,20,1,19,7,2.7378711079,7.9407905587,2.1041117984525552E-4,0.35,0.64912283,0,59,5.0123537606209666E-5,1.3549677E-5,1.3714035E-5,175,1,1,38,1,0.0263157895
449187138,lunapiena19,10,11766,274,213,1,978,48.3945645031,40-49,727,8,1,2,3,3,1,2,7,4.1333333333,0,8.095914281419891E-5,0.1666666667,0.5,42,437,8.289285873049163E-5,1.3549677E-5,1.3714035E-5,197,59,0,201,0,0
450868260,OshawaNDP,10,394,166,196,6,1,40.0963869933,40-49,566,3,57,73,130,130,57,73,7,2.4348298335,1068.3699962995,0.0706608855,0.1254025045,0.38557422,0,59,1.9299964772669047E-4,3.9294062E-4,3.9770702E-4,25,20,0,200,0,0
450948816,nellyardito,10,396,33,119,0,3,25.8312492066,20-29,292,4,0,1,1,1,0,1,7,4.3571428571,0,0,0,0,42,436,4.766339181938244E-5,0,6.8570175E-6,197,0,0,199,0,0
450981938,mcmarteau,10,508,95,832,0,195,17.3261177536,10-19,378,4,1,17,18,18,1,17,7,2.7628530051,11.7654790181,0.0072676982,0.3104575163,0.4852941,0,59,5.409653606626543E-5,1.3549677E-5,1.3714035E-5,175,1,0,200,0,0
451342293,Julian141096,10,5856,182,168,0,433,41.3636717895,40-49,684,6,1,1,2,2,1,1,1,1,0,8.095914281419891E-5,0,0,99,224,3.177448371356425E-4,1.3549677E-5,1.3714035E-5,90,10,0,199,0,0
452532683,jeelleaime,10,358,72,200,0,3,16.0397957794,10-19,311,2,30,76,106,106,30,76,6,2.4029688631,739.6219578131,0.0611920072,0.1752021563,0.42938873,0,59,1.8432734036347644E-4,2.1001999E-4,2.1256754E-4,25,5,4,200,4,0.02
453969676,vittorio_rago,10,116,108,127,0,0,26.3207133292,20-29,368,3,1,2,3,3,1,2,6,3.0769230769,0,8.635150752408161E-5,0.1666666667,1,42,307,1.3440100104600392E-4,1.3549677E-5,1.3714035E-5,197,0,0,127,0,0
454114632,smell3roses,10,6168,178,364,4,16,35.2921382426,30-39,644,7,53,71,124,124,53,71,6,2.423968139,1611.3167389357,0.0621990875,0.0666797797,0.29137355,0,59,1.7948236484276476E-4,3.6584126E-4,3.7027895E-4,77,16,2,202,2,0.0099009901
454472178,AgLocal30048,10,1212,89,171,0,23,40.4385886832,40-49,575,5,23,37,60,60,23,37,6,2.4312092686,554.9191958003,0.0225444958,0.1251412429,0.29000926,0,59,1.3481422818380616E-4,1.6259612E-4,1.6456842E-4,182,37,0,200,0,0
454937559,CAPE_ACEP,10,2153,414,658,9,1,46.1268205419,40-49,659,4,60,132,192,192,60,132,6,2.2309920348,8757.0495183775,0.0796937341,0.085651178,0.22929086,0,59,2.736088575396638E-4,4.1326514E-4,4.1827807E-4,77,37,2,200,2,0.01
455831687,rafinhaahtg,10,738,540,1441,1,24,30.9094133087,30-39,459,4,0,0,0,0,0,0,0,0,0,0,0,0,19,89,4.766339181938244E-5,0,0,17,1,0,200,0,0
456984469,ACFO_TO,10,9139,879,1695,15,2,45.9048573275,40-49,651,8,14,37,51,51,14,37,6,2.6412020275,327.7068537963,0.0073078613,0.1090196078,0.25604552,0,59,1.0504350777663188E-4,1.0162257E-4,9.599824E-5,175,19,0,200,0,0
458031230,FWangabo,10,132,28,170,0,0,19.4529828025,10-19,215,3,0,0,0,0,0,0,0,0,0,0,0,0,176,379,4.766339181938244E-5,0,0,176,1,0,139,0,0
458617533,LindaWatson25,10,1635,47,42,0,4,16.143613449,10-19,526,6,2,4,6,6,2,4,7,3.3895727734,0,3.2459929469415885E-4,0.2,0.75,0,59,6.195135710800537E-5,2.0324514E-5,2.0571053E-5,25,7,1,200,1,0.005
458878672,DavidMZoulfy,10,1488,112,218,0,18,41.9582026763,40-49,638,6,0,0,0,0,0,0,0,0,0,0,0,0,38,118,4.766339181938244E-5,0,0,35,19,0,201,0,0
459643341,THEOJONA,10,3328,154,335,0,9,40.7552681113,40-49,625,6,3,4,7,7,3,4,9,4.811006517,3353.2985401287,3.6057127630241754E-4,0.119047619,0.6666667,0,59,3.230612663119275E-4,2.7099353E-5,2.742807E-5,131,2,0,199,0,0
459697389,AlanForseth,10,6009,317,573,9,145,46.3496200253,40-49,687,6,39,59,98,98,39,59,6,2.4963794352,6209.8587913008,0.0399517419,0.086892489,0.29672298,0,59,2.4517807979088644E-4,2.7099354E-4,2.742807E-4,182,9,0,200,0,0
459762459,AndreaBeal2,10,240,58,90,0,13,27.1090673999,20-29,502,4,6,17,23,23,6,17,7,2.734974656,2531.8867357125,0.0157484127,0.1660079051,0.39542484,0,59,1.2329759874092917E-4,4.742387E-5,4.799912E-5,25,4,7,192,7,0.0364583333
459764228,Douglas_VH,10,1253,231,498,5,184,41.4163738851,40-49,602,5,6,22,28,28,6,22,7,2.6462708182,26.7162285508,0.0072343523,0.2195767196,0.44466403,0,59,6.475355221591128E-5,4.742387E-5,4.799912E-5,175,5,0,199,0,0
459870543,Strangekitty_ca,10,4520,989,2000,17,95,48.5305673818,40-49,637,6,2,4,6,6,2,4,7,3.1745112238,4.6679777842,0.0018447321,0.1,0.33333334,0,59,6.085904803780391E-5,2.0324514E-5,2.0571053E-5,182,0,0,200,0,0
460387180,AntonioMGiovann,10,365,44,137,0,278,28.2617502317,20-29,496,4,1,2,3,3,1,2,7,4.1333333333,0,8.095914281419891E-5,0.1666666667,0.5,42,568,8.289285873049163E-5,1.3549677E-5,1.3714035E-5,197,8,0,200,0,0
460413702,SarahAndrews22,10,237,30,100,0,2,16.1096378685,10-19,210,4,11,35,46,46,11,35,7,2.604634323,19.761280874,0.0204900531,0.2183574879,0.5315315,0,59,9.108263905771299E-5,8.129806E-5,8.228421E-5,25,2,7,200,6,0.03
460837678,CoryCassel,10,2539,538,1058,20,98,48.4082265611,40-49,660,6,18,45,63,63,18,45,6,2.5524981897,4347.474641131,0.0127129338,0.1054787506,0.27391306,0,59,1.1784348988104354E-4,1.2872192E-4,1.3028333E-4,182,9,1,200,1,0.005
461555430,mikeoscarkilo,10,618,35,119,0,3,23.5648372925,20-29,500,4,0,1,1,1,0,1,7,3.5678610206,0,0,0,0,0,618,4.766339181938244E-5,0,6.8570175E-6,182,1,0,200,0,0
462273510,scmackay,10,163,18,132,0,3,32.5632776993,30-39,497,4,1,15,16,16,1,15,6,2.6828385228,0.5868790641,0.0016814425,0.3291666667,0.49583334,0,59,4.8447291007325935E-5,1.3549677E-5,1.3714035E-5,175,10,0,187,0,0
462908677,NLNDPCaucus,10,955,896,366,23,1,48.3592206401,40-49,692,5,64,20,84,84,64,20,6,2.5999275887,1086.360496857,0.0607203861,0.1313826736,0.25472838,0,59,2.825551874916025E-4,4.403645E-4,4.4570613E-4,147,163,0,200,0,0
463146897,RosieMarconi,10,261,85,271,1,13,31.5454500526,30-39,272,4,1,2,3,3,1,2,7,4,28,8.271798374069241E-5,0,0,42,433,1.482576645138908E-4,1.3549677E-5,1.3714035E-5,197,1,0,197,0,0
464090660,Keyna938,10,59285,569,196,1,125,39.8093402378,30-39,810,9,0,0,0,0,0,0,0,0,0,0,0,0,120,267,4.766339181938244E-5,0,0,113,15,0,201,0,0
465993103,olpesu,10,5761,92,308,0,5,26.6557942726,20-29,397,7,0,0,0,0,0,0,0,0,0,0,0,0,196,502,4.766339181938244E-5,0,0,200,3,0,202,0,0
466566898,d2mac420,10,4699,702,1038,7,288,33.6788321258,30-39,697,7,71,112,183,183,71,112,6,2.2845763939,4485.9958411463,0.0829937032,0.071458596,0.28603604,0,59,2.2737132368058695E-4,4.8778835E-4,4.937053E-4,77,7,0,199,0,0
466603103,Zircorn,10,1297,172,441,1,70,32.3820615268,30-39,400,5,0,1,1,1,0,1,8,3.9037278321,0,0,0,0,0,194,4.766339181938244E-5,0,6.8570175E-6,77,2,0,200,0,0
466660837,albertocubeddu,10,1029,129,410,0,1,24.4969911935,20-29,581,5,0,1,1,1,0,1,7,4.3571428571,0,0,0,0,42,441,4.766339181938244E-5,0,6.8570175E-6,197,0,0,200,0,0
466738569,humanfrogger,10,192,6,33,0,0,19.9447164089,10-19,424,4,0,2,2,2,0,2,7,3.2439377488,0,0,0.5,0.5,0,696,4.766339181938244E-5,0,6.8570175E-6,175,1,2,197,2,0.0101522843
466765912,GrittyGorg,10,5324,319,500,8,100,48.4753624884,40-49,707,6,24,49,73,73,24,49,6,2.5865314989,382.7276755701,0.024266108,0.1000761035,0.32015306,0,59,1.2195094191141128E-4,1.6937095E-4,1.7142543E-4,175,17,1,200,1,0.005
467013270,BobMunroeLawyer,10,2201,1987,1871,39,12,50.6817244542,50-59,687,5,22,20,42,42,22,20,6,2.5220854453,2151.983920913,0.0204165217,0.0214866434,0.121212125,0,59,1.2973313872764936E-4,1.5582128E-4,1.577114E-4,175,12,0,200,0,0
467023623,aggiecoolchick,10,1965,479,163,18,109,50.715103587,50-59,668,6,0,0,0,0,0,0,0,0,0,0,0,0,216,537,4.766339181938244E-5,0,0,220,10,0,200,0,0
467121804,MarkShaw24,10,3247,94,185,2,3,48.3659365813,40-49,703,7,30,47,77,77,30,47,7,2.6484431571,421.8376976072,0.0255181889,0.1044087491,0.2896104,0,59,1.359365655359322E-4,2.1001999E-4,2.1256754E-4,182,192,1,202,1,0.004950495
467198533,SalvaBorrelli,10,438,69,345,0,35,28.8411297026,20-29,488,4,0,1,1,1,0,1,7,4.3571428571,0,0,0,0,42,423,4.766339181938244E-5,0,6.8570175E-6,197,0,0,200,0,0
467212067,markcheck99,10,2969,668,2000,6,62,37.816370527,30-39,592,6,35,99,134,134,35,99,6,2.3794351919,2533.0371043141,0.0401073727,0.1068903602,0.29686868,0,59,1.6214998736544404E-4,2.4389417E-4,2.4685264E-4,77,0,0,200,0,0
467576758,RussDiabo,10,7937,2725,333,58,2,60.3244448205,60-69,780,7,131,38,169,169,131,38,6,2.6216509776,7600.4513308931,0.0972700041,0.0934770358,0.14150943,0,59,0.001112576,8.9427864E-4,8.982693E-4,77,200,3,200,3,0.015
467578012,beetolley,10,838,539,1051,13,6,44.5104356191,40-49,602,5,30,66,96,96,30,66,6,2.3508327299,2025.0181827841,0.0371296163,0.1180921053,0.30945674,0,59,1.587586460721764E-4,2.1001999E-4,2.1256754E-4,77,9,2,199,2,0.0100502513
468777003,ZoSchultz,10,807,288,242,0,327,40.9810827431,40-49,606,5,1,0,1,1,1,0,0,0,0,8.457303901214821E-5,0,0,18,87,1.0790605793223872E-4,1.3549677E-5,0,39,12,0,198,0,0
468782243,PublishSphere,10,2185,125,420,2,26,39.8824063906,30-39,558,6,15,16,31,31,15,16,7,2.7132512672,64.7209929795,0.0166710709,0.1258064516,0.27333334,0,59,8.6234652742196E-5,1.0839741E-4,1.0971228E-4,77,7,1,200,1,0.005
469422478,ChrisGoodsir,10,903,259,400,6,9,43.3880243838,40-49,670,5,25,57,82,82,25,57,7,2.518102824,557.3089331542,0.0206839397,0.1198434207,0.31864408,0,59,1.3489342644276093E-4,1.761458E-4,1.7828245E-4,182,12,0,200,0,0
469492470,RobMiyashiro1,10,1010,281,270,13,15,47.49049435,40-49,605,5,12,9,21,21,12,9,7,3.0170166546,20.2084446274,0.0084672116,0.1071428571,0.32380953,0,59,9.341215815456603E-5,8.80729E-5,8.914123E-5,175,1,0,200,0,0
469733877,justmarkermcd,10,1247,66,190,0,141,32.0176803326,30-39,577,5,1,7,8,8,1,7,7,3.0771180304,0.1318759567,0.0011127834,0.2321428571,0.45238096,0,59,5.1386237885896697E-5,1.3549677E-5,1.3714035E-5,175,3,0,200,0,0
469818825,northrunnnercan,10,13770,803,1300,11,3805,39.4622736519,30-39,685,8,13,20,33,33,13,20,6,2.6321506155,554.4780981924,0.0196521884,0.0776515152,0.33809525,0,59,9.061788882695352E-5,9.484774E-5,9.599824E-5,77,0,0,200,0,0
470062345,52ideas,10,504,83,232,5,2,23.8456188121,20-29,482,4,16,34,50,50,16,34,6,2.6897175959,3030.5148833745,0.0174875748,0.1759183673,0.36178863,0,59,9.840580347942997E-5,1.1517225E-4,1.16569296E-4,175,2,1,199,1,0.0050251256
470534505,AlisonLJL,10,1460,231,398,2,151,41.6704895808,40-49,609,5,13,18,31,31,13,18,7,2.9272266474,310.9995287049,0.0138399235,0.0827956989,0.23571429,0,59,9.032649717021539E-5,9.484774E-5,9.599824E-5,182,4,0,200,0,0
470567215,BeaconHillNDP,10,46,29,6,3,0,21.7029491949,20-29,229,2,4,1,5,5,4,1,1,1,0.1428571429,0.0050263194,0.3,0.4,0,31,6.446053256169715E-5,3.3874192E-5,3.4285087E-5,25,1,0,46,0,0
470691248,BTDiasCAW1459,10,472,16,45,0,7,18.1833835818,10-19,137,4,3,5,8,8,3,5,7,2.9232440261,0.1797739574,0.0064754311,0.2142857143,0.73333335,0,59,6.0219210592681023E-5,2.7099353E-5,2.742807E-5,182,0,0,200,0,0
471078603,msthorpe43,10,1848,129,241,3,0,42.0013362876,40-49,677,6,25,31,56,56,25,31,6,2.6491672701,348.2069705051,0.0373504184,0.1175324675,0.31358886,0,59,1.5727705689071143E-4,1.761458E-4,1.7828245E-4,77,12,0,200,0,0
472148776,JeffMarshallNL,10,6701,659,677,8,714,48.1792912223,40-49,746,7,23,32,55,55,23,32,7,2.9312092686,1630.9819147424,0.0264860997,0.0973063973,0.26788124,0,59,1.6266715299123683E-4,1.6259612E-4,1.6456842E-4,147,37,3,200,3,0.015
472286193,ChrisKirouac,10,52880,488,819,10,11425,56.9173203255,50-59,748,9,60,81,141,141,60,81,6,2.4250543085,2101.5609891485,0.0621013234,0.0818135765,0.31111112,0,59,1.9553454996635731E-4,4.1326514E-4,4.1827807E-4,77,49,0,204,0,0
472515859,LiberalCanuck,10,64816,2547,1585,66,6151,57.7863497949,50-59,890,9,38,48,86,86,38,48,6,2.4960173787,938.7974837266,0.0477217811,0.0911080711,0.3023183,0,59,1.6005033502945672E-4,2.642187E-4,2.674237E-4,77,48,0,205,0,0
473449200,g_e13,10,4746,169,532,6,131,40.6040228277,40-49,622,7,34,101,135,135,34,101,6,2.414916727,853.8211573875,0.0403925251,0.1066887783,0.2810134,0,59,1.461154929053179E-4,2.3711934E-4,2.3999561E-4,77,11,1,200,1,0.005
473471904,SusieGolzlin,10,746,48,102,1,7,34.6907661808,30-39,574,5,1,2,3,3,1,2,8,4.267366136,2763,8.095914281419891E-5,0,0,0,653,1.380466301787866E-4,1.3549677E-5,1.3714035E-5,175,14,0,199,0,0
473754564,f_desanctis,10,3647,4796,238,72,443,59.2230190674,50-59,763,7,13,3,16,16,13,3,5,2.6923076923,1294.6666666667,0.0012593963,0.0625,0.102564104,42,307,0.0100966858,9.484774E-5,4.799912E-5,197,34,0,201,0,0
473974224,adamyahn,10,704,170,592,1,0,36.1845802553,30-39,551,5,5,19,24,24,5,19,7,2.8602461984,83.0849334484,0.0051922084,0.1195652174,0.2777778,0,59,7.05879565980577E-5,4.064903E-5,4.1142106E-5,175,5,2,200,2,0.01
474200156,jadapussy,10,1479,130,101,1,31,45.5642873728,40-49,566,5,1,1,2,2,1,1,7,3.3301955105,0.1155895238,0.0041882386,0,0,0,59,5.351726810400683E-5,1.3549677E-5,1.3714035E-5,175,7,0,200,0,0
474403411,shanerloops,10,2216,79,236,1,211,40.2328595771,40-49,596,6,2,12,14,14,2,12,7,3.0597393193,5.427986767,0.0011223047,0.1373626374,0.20512821,0,59,5.158625808038056E-5,2.0324514E-5,2.0571053E-5,182,25,0,200,0,0
474484479,DonoYEG,10,2432,244,387,0,197,45.8562908386,40-49,689,6,15,21,36,36,15,21,7,2.8417813179,287.7398474313,0.0134796982,0.130952381,0.35042736,0,59,9.51202079081401E-5,1.0839741E-4,1.0971228E-4,175,35,0,201,0,0
474546826,CharleyCanucky,10,23006,688,1614,6,581,41.7450497176,40-49,784,9,23,79,102,102,23,79,6,2.4370021723,898.0202286314,0.0223872723,0.1155115512,0.2568322,0,59,1.480593140811334E-4,1.6259612E-4,1.6456842E-4,175,71,35,203,35,0.1724137931
475308891,iChinadian,10,13272,447,210,22,0,41.5462941251,40-49,735,8,10,5,15,15,10,5,7,3.0528602462,374.4156474633,0.0108531168,0.0428571429,0.16666667,0,59,9.245065600102279E-5,7.452322E-5,7.542719E-5,175,11,0,201,0,0
475390714,Qsmooth9,10,181,25,157,0,2,21.350774671,20-29,460,3,0,1,1,1,0,1,8,3.6178067318,0,0,0,0,0,217,4.766339181938244E-5,0,6.8570175E-6,182,1,0,186,0,0
475865837,l4zyl3m0n,10,5485,459,641,7,849,36.1118227971,30-39,694,7,72,83,155,155,72,83,6,2.4967414917,1511.0548076697,0.0745452158,0.0966066192,0.35611215,0,59,2.130002382639281E-4,4.945632E-4,4.937053E-4,77,31,0,200,0,0
476004139,BrianGibson13,10,18983,998,865,34,3779,41.6402508181,40-49,768,8,43,39,82,82,43,39,6,2.4923968139,4152.0747799926,0.0464877815,0.0552544414,0.27101448,0,59,2.625240856080111E-4,2.9809287E-4,3.0170876E-4,175,98,0,201,0,0
477043749,AnnTByrne,10,154,1,5,0,0,10.6708586376,10-19,21,3,0,0,0,0,0,0,0,0,0,0,0,0,156,347,4.766339181938244E-5,0,0,154,0,0,156,0,0
477801802,5haneKennedy,10,770,9098,4922,22,3,44.7138785611,40-49,678,5,23,31,54,54,23,31,6,2.7958001448,3720.5080214819,0.0093867623,0.0660377358,0.26325756,0,59,1.4511410323467724E-4,1.6259612E-4,1.6456842E-4,182,11,0,201,0,0
479934668,papaditea,10,43,17,140,0,0,17.998421978,10-19,58,2,0,2,2,2,0,2,5,2.9285714286,0,0,0,0,42,460,4.766339181938244E-5,0,6.8570175E-6,197,0,0,59,0,0
480689717,PVincent20,10,29939,638,1975,1,1895,45.8417085937,40-49,667,9,3,12,15,15,3,12,7,2.8428674873,5718.739676092,0.0054319665,0.1857142857,0.35897437,0,59,1.0311238441332296E-4,2.7099353E-5,2.742807E-5,145,1,2,203,2,0.0098522167
480897676,shortstuff521,10,615,11,156,0,385,29.7198114896,20-29,495,5,1,9,10,10,1,9,7,3.1864590876,0.2325503465,1.8211700485552387E-4,0.2222222222,0.3472222,0,59,4.988932499506788E-5,1.3549677E-5,1.3714035E-5,182,3,3,201,3,0.0149253731
481033058,CraigerPequeno,10,1624,326,1211,0,154,45.6697253793,40-49,634,6,56,196,252,252,56,196,6,2.1495293266,5770.8237306344,0.0646792943,0.0873173971,0.20775925,0,59,1.8934718628824433E-4,3.8616578E-4,3.9085E-4,77,15,10,199,6,0.0301507538
482120673,68fredaye,10,102,11,88,0,1,15.2685444292,10-19,55,3,1,8,9,9,1,8,7,2.8808834178,0.125,2.442570493397829E-4,0.1805555556,0.30357143,0,59,5.131034281192482E-5,1.3549677E-5,1.3714035E-5,182,2,0,111,0,0
482572130,PPaglietta,10,63,14,90,0,8,49.5792970982,40-49,284,3,0,1,1,1,0,1,7,4.3571428571,0,0,0,0,42,475,4.766339181938244E-5,0,6.8570175E-6,197,3,0,158,0,0
483324946,PufffffyJ,10,222,45,364,0,0,19.1417207919,10-19,443,3,0,14,14,14,0,14,7,3.0394498733,0,0,0.2527472527,0.36813188,0,275,4.766339181938244E-5,0,6.8570175E-6,25,4,0,200,0,0
483577756,daphlipside,10,4622,183,209,4,278,30.2941068949,30-39,680,7,45,31,76,76,45,31,6,2.5199131064,634.6654452684,0.0592478388,0.1689473684,0.31841493,0,59,1.8383631878008427E-4,3.1164257E-4,3.154228E-4,77,10,2,199,2,0.0100502513
484182357,CaitlynBaikie,10,492,135,222,1,6,26.115435179,20-29,529,4,4,10,14,14,4,10,7,3.0391020999,13.603389312,0.0037545622,0.1373626374,0.3181818,0,59,7.720633038721953E-5,3.3874192E-5,3.4285087E-5,147,11,0,199,0,0
484317938,YoTonyCPC,10,209,95,261,3,1,37.9208880195,30-39,450,4,29,82,111,111,29,82,6,2.4355539464,1622.3484510349,0.0280334813,0.0844389844,0.22818102,0,59,1.1175678922017885E-4,2.0324514E-4,2.0571053E-4,77,6,2,198,2,0.0101010101
484793295,TomBirch63,10,1753,134,103,5,0,45.5868547028,40-49,639,6,27,26,53,53,27,26,7,2.6071687183,1285.7249873407,0.0224579054,0.06095791,0.3505291,0,59,1.5680871807428914E-4,1.8969548E-4,1.9199649E-4,182,71,0,205,0,0
485043632,1_Car_Guy,10,17056,922,2000,16,1130,39.1541407478,30-39,763,8,27,79,106,106,27,79,6,2.4261404779,1758.4738397554,0.0259864992,0.1219227314,0.26666668,0,59,1.6148385261020095E-4,1.8969548E-4,1.9199649E-4,147,14,0,200,0,0
485425161,SparksLiam,10,229,67,257,0,3,14.0694883297,10-19,433,3,4,27,31,31,4,27,7,2.6864590876,22.639825535,0.0054374257,0.2010752688,0.35449734,0,59,6.138590838972434E-5,3.3874192E-5,3.4285087E-5,175,6,0,200,0,0
485464541,StevenChaulk,10,640,41,190,0,37,21.8187557995,20-29,475,5,2,15,17,17,2,15,7,2.7574221579,22.094069453,0.0011879695,0.2095588235,0.3809524,0,59,5.6854633720454966E-5,2.0324514E-5,2.0571053E-5,175,1,1,200,1,0.005
486194640,DarbyCar,10,13565,309,108,7,16,40.8029469368,40-49,767,8,79,29,108,108,79,29,6,2.60391021,3747.1904803815,0.0837543528,0.1204569055,0.2776907,0,59,2.5604664435180955E-4,5.419871E-4,5.485614E-4,77,159,1,201,1,0.0049751244
486939116,PDJ1969,10,25,19,18,0,3,23.2769884598,20-29,159,1,0,1,1,1,0,1,7,3.5425262396,0,0,0,0,0,385,4.766339181938244E-5,0,6.8570175E-6,25,0,0,26,0,0
487315919,nano4nia,10,20884,558,403,1,210,45.9416719375,40-49,779,8,2,2,4,4,2,2,2,1.3333333333,0,1.6729007086290762E-4,0.0833333333,1,22,95,2.688948648460337E-4,2.0324514E-5,2.0571053E-5,126,11,0,201,0,0
488821862,Jatcorrupted,10,3182,70,160,1,28,37.4044669421,30-39,565,6,8,15,23,23,8,15,7,2.7346125996,212.7300860408,0.0032380195,0.1185770751,0.35833332,0,59,7.866487406525594E-5,6.0973543E-5,6.171316E-5,182,10,0,200,0,0
489449994,moozkwe,10,807,28,67,0,10,17.1667768297,10-19,208,5,2,1,3,3,2,1,7,3.0908761767,0.4273901549,0.0030900928,0,0,0,59,5.2722332699693696E-5,2.0324514E-5,2.0571053E-5,182,0,1,200,1,0.005
489501722,dottBentivoglio,10,48,4,22,0,0,15.6632200445,10-19,89,2,0,1,1,1,0,1,7,4.3571428571,0,0,0,0,42,485,4.766339181938244E-5,0,6.8570175E-6,197,0,0,53,0,0
489914230,BonyMaroniPony,10,7273,246,581,2,30,42.6459889318,40-49,696,8,51,131,182,182,51,131,6,2.2624909486,9558.1956548718,0.0533130086,0.077165928,0.20469873,0,59,2.0768879380622923E-4,3.522916E-4,3.565649E-4,182,54,0,227,0,0
490376149,JarvisGoogoo,10,4789,327,313,2,908,43.5992395419,40-49,705,7,5,13,18,18,5,13,7,2.8743664012,9714.5423823591,0.0067968434,0.0947712418,0.21428572,0,59,1.6357679488986974E-4,4.064903E-5,4.1142106E-5,147,11,0,200,0,0
491033105,MikeBennz,10,130,45,119,1,14,24.1107155389,20-29,426,3,1,2,3,3,1,2,8,3.9352387844,0.5,8.095914281419891E-5,0,0,0,632,6.954204197483528E-5,1.3549677E-5,1.3714035E-5,175,12,0,133,0,0
492059038,Newbie50001,10,6,1,44,0,0,10.6708586376,10-19,21,3,0,2,2,2,0,2,8,3.6015200869,0,0,0,0,0,61,4.766339181938244E-5,0,6.8570175E-6,182,0,0,6,0,0
492378961,HeatherRenwick,10,60,7,29,0,1,16.3161565335,10-19,127,2,0,7,7,7,0,7,6,2.786102063,0,0,0.3571428571,0.54761904,0,621,4.766339181938244E-5,0,6.8570175E-6,182,1,0,66,0,0
492513725,HFontaine1,10,410,80,387,2,0,26.3460406254,20-29,444,4,19,58,77,77,19,58,7,2.5014482259,28.0478075053,0.0336597823,0.2313738893,0.568306,0,59,1.0498288274678514E-4,1.3549677E-4,1.3714035E-4,25,3,0,200,0,0
493389719,mmecorrie,10,722,32,129,2,1,43.4577865367,40-49,548,5,5,15,20,20,5,15,7,2.8721940623,18.5055779453,0.0030690101,0.1657894737,0.28104576,0,59,5.8189710446008326E-5,4.064903E-5,4.1142106E-5,175,8,3,200,3,0.015
493463871,feralfrank,10,655,40,122,0,7,21.8821895874,20-29,552,4,9,24,33,33,9,24,6,2.7309920348,37.4778605956,0.01296238,0.1297348485,0.2923077,0,59,7.552452926271993E-5,6.7748384E-5,6.8570174E-5,77,2,0,200,0,0
493595072,ChrisWilson630,10,4,53,14,1,0,34.1303205934,30-39,371,1,7,13,20,20,7,13,7,3.0901520637,119.6618676847,0.005296155,0.1868421053,0.35833332,0,59,9.505218721750643E-5,5.4198706E-5,5.485614E-5,182,11,0,12,0,0
493690182,enzymepudding,10,773,72,282,1,74,35.7843141649,30-39,532,5,3,21,24,24,3,21,6,2.6698044895,234.1886595129,0.0116657377,0.1974637681,0.32900432,0,59,6.483542940008954E-5,2.7099353E-5,2.742807E-5,175,3,0,200,0,0
494320156,grecoce,10,315,72,198,1,0,32.8369344337,30-39,445,4,19,31,50,50,19,31,7,2.6437364229,67.9668501752,0.0258694212,0.1869387755,0.42510122,0,59,1.1452919081476563E-4,1.3549677E-4,1.3714035E-4,25,3,3,200,3,0.015
494331490,Rhino_Bob,10,14373,237,214,6,218,51.1225700937,50-59,756,8,14,13,27,27,14,13,7,2.914916727,559.6766742374,0.0116144566,0.0541310541,0.14761905,0,59,1.1387848162785523E-4,1.0162257E-4,1.02855265E-4,25,48,0,203,0,0
494598289,BurseyScott,10,298,59,330,0,17,17.0283351606,10-19,281,4,1,8,9,9,1,8,7,3.1042722665,0.4094699344,1.9907242192401247E-4,0.1666666667,0.2857143,0,59,5.067532749684356E-5,1.3549677E-5,1.3714035E-5,175,0,0,199,0,0
494617573,Dogpk,10,3241,83,276,0,336,33.4417928417,30-39,575,6,3,9,12,12,3,9,7,2.7722664736,1.2396342733,0.0029240932,0.2803030303,0.5090909,0,59,5.4605276988870096E-5,2.7099353E-5,2.742807E-5,147,9,0,200,0,0
495058610,macleodmarkd,10,2589,275,216,7,14,42.707532328,40-49,693,6,9,17,26,26,9,17,6,2.5329471398,169.537707171,0.0142025287,0.1861538462,0.43095237,0,59,8.026745557328481E-5,6.7748384E-5,6.8570174E-5,175,4,0,200,0,0
495438775,tgoodtrack,10,47,26,102,1,2,19.5489054847,10-19,89,2,0,10,10,10,0,10,7,2.8791169019,0,0,0.2333333333,0.3,0,340,4.766339181938244E-5,0,6.8570175E-6,77,0,0,60,0,0
495905313,HarpersCanada1,10,980,62,6,1,7,21.4514281702,20-29,599,4,10,5,15,15,10,5,7,3.1755973932,4.3721260226,0.0106041144,0.2285714286,0.2809524,0,59,8.903384834376514E-5,7.452322E-5,7.542719E-5,77,9,2,199,2,0.0100502513
496172900,desrochersric,10,2561,286,1156,0,69,41.9387848711,40-49,657,6,32,147,179,179,32,147,6,2.2697320782,897.7071545607,0.043543602,0.1474797564,0.2922595,0,59,1.458985731642772E-4,2.2356966E-4,2.2628158E-4,25,26,0,200,0,0
496253544,KcwhyteC,10,1130,35,68,0,80,24.1670129837,20-29,395,6,6,11,17,17,6,11,7,2.7295438088,9.6838650702,0.0111391544,0.2095588235,0.5448718,0,59,6.941552946227174E-5,4.742387E-5,4.799912E-5,182,0,2,200,2,0.01
496326186,northgasm,10,373,116,217,6,18,41.8589772063,40-49,540,4,5,11,16,16,5,11,7,3.1589427951,10.6752281541,0.0017504254,0.1083333333,0.33636364,0,59,6.724745642210805E-5,4.064903E-5,4.1142106E-5,77,9,0,200,0,0
496657261,CanadaFred,10,1014,34,51,0,11,19.7998252028,10-19,398,5,1,2,3,3,1,2,7,3.1368573497,0,3.349521486516443E-4,0.5,0.5,0,59,4.951570763288058E-5,1.3549677E-5,1.3714035E-5,77,1,2,200,2,0.01
497084291,savingthepeace,10,2487,110,134,1,7,45.3222712404,40-49,619,6,26,40,66,66,26,40,6,2.6640115858,685.471239817,0.0183985085,0.0643356643,0.21565656,0,59,1.2030744999199942E-4,1.8292063E-4,1.8513948E-4,182,29,0,201,0,0
497484572,etobian,10,2841,118,80,3,5,42.5516891495,40-49,700,6,27,11,38,38,27,11,7,2.9761042723,53.0866838052,0.0298517695,0.2183499289,0.29871976,0,59,1.1489861359501357E-4,1.8969548E-4,1.9199649E-4,77,5,0,198,0,0
497499405,Ou812I,10,6632,245,222,8,22,38.6854261331,30-39,715,7,36,35,71,71,36,35,7,2.8030412744,2348.3061263932,0.0194185307,0.0770623742,0.37688735,0,59,2.3260535092007467E-4,2.5066902E-4,2.5370964E-4,175,26,0,201,0,0
497523433,gabriellellis_,10,2080,275,249,1,1639,41.0561598256,40-49,635,5,2,2,4,4,2,2,2,1.3333333333,4,1.6371514892060646E-4,0,0,49,134,4.125104515726263E-4,2.0324514E-5,2.0571053E-5,181,14,0,199,0,0
497731840,Avalon709,10,37593,316,499,8,2497,38.3540813231,30-39,742,9,45,59,104,104,45,59,6,2.4735698769,2164.7630224329,0.0481199832,0.0794436146,0.20631579,0,59,2.2220117136180156E-4,3.1164257E-4,3.154228E-4,147,51,0,203,0,0
497942005,BhekideDon,10,167,26,106,0,2,20.1501951519,20-29,338,3,0,0,0,0,0,0,0,0,0,0,0,0,254,660,4.766339181938244E-5,0,0,259,11,0,167,0,0
498230889,TimSanchez2,10,3509,77,345,1,23,41.0511004525,40-49,610,6,14,69,83,83,14,69,6,2.4196234613,198.595681506,0.0392592163,0.2131942404,0.42292646,0,59,1.2794607081434008E-4,1.0162257E-4,1.02855265E-4,175,9,2,200,2,0.01
498813813,Sufiyanzxc,10,6226,191,188,0,970,43.9066659906,40-49,711,7,2,2,4,4,2,2,1,1,0,1.6551228476954845E-4,0.0833333333,1,47,131,3.177448371356425E-4,2.0324514E-5,2.0571053E-5,44,51,0,200,0,0
498846820,CarloSantaroni,10,13050,885,1345,3,1854,58.7827182932,50-59,770,8,2,3,5,5,2,3,6,3.3846153846,132,1.8527274168575204E-4,0.05,0.33333334,42,307,0.0038843471,2.0324514E-5,2.0571053E-5,197,36,0,201,0,0
498909753,JoanneDNLIB,10,1471,331,492,9,4,47.9641699016,40-49,677,5,24,39,63,63,24,39,7,2.774076756,471.8614821028,0.0151730902,0.0837173579,0.22979797,0,59,1.442260888548029E-4,1.6937095E-4,1.7142543E-4,147,40,0,199,0,0
499467984,NYC_Jenn,10,744,95,228,4,13,34.4430771877,30-39,555,5,2,15,17,17,2,15,7,2.7230267922,13.3865691918,0.0018672155,0.3088235294,0.5625,0,59,5.4245173966234084E-5,2.0324514E-5,2.0571053E-5,25,7,1,200,1,0.005
499819985,dghartley1959,10,4047,258,957,3,168,47.5137530355,40-49,681,7,12,35,47,47,12,35,7,2.5202751629,105.5508299965,0.0129756353,0.1147086031,0.30588236,0,59,7.638524724902901E-5,8.80729E-5,8.914123E-5,77,8,0,201,0,0
500291384,Sisuelsker,10,513,42,839,1,0,18.1783228893,10-19,235,4,2,62,64,64,2,62,6,2.4431571325,194.5723032758,0.0032977761,0.2671130952,0.43918562,0,59,6.216372766599816E-5,2.0324514E-5,2.0571053E-5,25,0,0,200,0,0
500476225,italiasoto12,10,1131,78,79,0,7,33.1310085766,30-39,611,4,1,1,2,2,1,1,1,1,0,8.095914281419891E-5,0,0,236,608,3.177448371356425E-4,1.3549677E-5,1.3714035E-5,242,2,0,201,0,0
501188833,sheila_info,10,2606,417,1074,4,28,48.2524272218,40-49,624,6,55,123,178,178,55,123,6,2.3015930485,3752.3060817572,0.068533472,0.0813178442,0.22615923,0,59,2.2459212253493396E-4,3.7939096E-4,3.8399297E-4,77,9,2,200,2,0.01
501433802,ClaudineJacques,10,5398,691,2001,20,150,53.4223720324,50-59,728,6,76,82,158,158,76,82,6,2.41564084,1496.407835685,0.1068775884,0.1282351044,0.2880645,0,59,2.9869598207179186E-4,5.216625E-4,5.2799034E-4,25,143,17,225,17,0.0755555556
501454405,metacanada,10,80,37,72,1,7,33.2922720092,30-39,411,3,3,10,13,13,3,10,7,2.6401158581,307.9377468229,0.0059026741,0.2179487179,0.45454547,0,59,7.780714837160024E-5,2.7099353E-5,2.0571053E-5,175,2,1,90,1,0.0111111111
501642872,Xophir,10,386,51,206,0,33,30.3063404614,30-39,504,4,1,1,2,2,1,1,9,4.821506155,0,9.91792649757776E-5,0,0,0,59,7.455257925577865E-5,1.3549677E-5,1.3714035E-5,131,1,0,200,0,0
501910165,DenisSalter,10,340,119,543,3,2,22.3899236917,20-29,378,4,3,14,17,17,3,14,7,2.7317161477,0.8366289471,0.0099952365,0.2426470588,0.50549453,0,59,6.147023863961511E-5,2.7099353E-5,2.742807E-5,25,1,0,199,0,0
502283898,doggoneriding,10,80,25,77,1,1,23.3139917514,20-29,205,2,0,1,1,1,0,1,8,3.6706478465,0,0,0,0,0,212,4.766339181938244E-5,0,6.8570175E-6,175,0,0,85,0,0
503355006,GiacPell,10,19,14,104,0,2,15.5958307248,10-19,48,2,0,1,1,1,0,1,7,4.3571428571,0,0,0,0,42,490,4.766339181938244E-5,0,6.8570175E-6,197,0,0,38,0,0
503693698,reddogcw,10,6026,148,385,2,5327,45.3032563061,40-49,648,7,16,24,40,40,16,24,6,2.5427226647,350.5660814655,0.0352756979,0.1006410256,0.33618233,0,59,1.1042910311019089E-4,1.1517225E-4,1.16569296E-4,77,11,0,201,0,0
503827583,Relayer76,10,1390,134,165,2,11,44.8760453484,40-49,663,5,45,51,96,96,45,51,6,2.4648805214,758.1815140791,0.055838893,0.1155701754,0.26894736,0,59,1.8282535629366952E-4,3.1164257E-4,3.154228E-4,77,45,2,200,2,0.01
506427392,JanMagee,10,6936,1111,1089,17,1587,56.0329671533,50-59,781,8,3,7,10,10,3,7,7,2.7476466329,3.2516380551,0.0067568973,0.1333333333,0.4047619,0,59,6.234267249164483E-5,2.7099353E-5,2.742807E-5,175,27,0,201,0,0
507494424,SteveSlep,10,603,185,580,4,6,39.1058783143,30-39,561,5,52,120,172,172,52,120,6,2.283852281,1577.9965643856,0.0947233567,0.1430708554,0.41931987,0,59,2.528662159290488E-4,3.590664E-4,3.6342192E-4,25,16,4,199,4,0.0201005025
507983064,jaberntson,10,732,31,128,1,89,30.838633305,30-39,600,5,0,1,1,1,0,1,7,3.2721679334,0,0,0,0,0,115,4.766339181938244E-5,0,6.8570175E-6,25,1,0,199,0,0
508876374,margiebarkley,10,389,32,71,0,5,21.5248991517,20-29,492,4,1,5,6,6,1,5,7,3.1864590876,0.0911962736,0.001539653,0.2,0.2,0,59,5.0604489860584434E-5,1.3549677E-5,1.3714035E-5,77,2,0,199,0,0
508937190,redroadproject,10,346,280,475,3,42,43.8151940434,40-49,615,4,4,5,9,9,4,5,7,3.2262853005,5884.765208517,0.0016437799,0.0277777778,0.15,0,59,1.314952493431275E-4,3.3874192E-5,3.4285087E-5,147,35,0,200,0,0
509220744,polichika,10,340,34,144,0,2,17.2898741783,10-19,409,4,2,9,11,11,2,9,7,2.906589428,5.8423880659,3.711944204056812E-4,0.2,0.3181818,0,59,5.1848350596370195E-5,2.0324514E-5,2.0571053E-5,175,1,1,200,1,0.005
509338885,BillStephenson2,10,212,18,78,0,2,23.629628699,20-29,215,3,7,21,28,28,7,21,6,2.6035481535,10.6397661974,0.0158515717,0.1970899471,0.5547619,0,59,7.552636467577328E-5,5.4198706E-5,5.485614E-5,182,1,1,200,1,0.005
510302643,ossiegrimm,10,6324,337,487,6,22,34.8250935111,30-39,648,7,19,21,40,40,19,21,7,2.5604634323,6422.8332253321,0.0159011871,0.0788461538,0.27384615,0,59,1.478627038463726E-4,1.3549677E-4,1.3714035E-4,147,28,2,198,2,0.0101010101
510704849,JimRovers,10,678,579,1299,1,0,40.8193285457,40-49,537,4,2,8,10,10,2,8,7,2.8511947864,14.3596100029,0.0011682303,0.1111111111,0.32142857,0,59,5.500466402731978E-5,2.0324514E-5,2.0571053E-5,182,15,0,199,0,0
510831727,nolansnolan,10,113,16,184,0,16,12.6209713021,10-19,115,4,2,2,4,4,2,2,8,3.5010861694,0.1895951658,0.0015994004,0.1666666667,0.6666667,0,59,5.615523397694327E-5,2.0324514E-5,2.0571053E-5,175,0,0,147,0,0
510938208,CheSsieZ,10,4275,322,308,0,2013,44.4347020468,40-49,721,6,0,0,0,0,0,0,0,0,0,0,0,0,238,615,4.766339181938244E-5,0,0,241,31,0,199,0,0
510942432,mrsinisterlefty,10,6195,206,136,9,10,37.937147249,30-39,709,7,48,42,90,90,48,42,6,2.4786386676,228.842515444,0.0726414032,0.136329588,0.33602485,0,59,1.8888839870620156E-4,3.3196708E-4,3.3599386E-4,77,31,1,200,1,0.005
511399796,hellis6,10,455,152,477,0,7,31.2870794745,30-39,521,5,4,30,34,34,4,30,7,2.5651701665,150.9486128832,0.0053989108,0.2040998217,0.35632184,0,59,5.9901872694509954E-5,3.3874192E-5,3.4285087E-5,77,3,0,200,0,0
513600622,talivaiaso,10,1403,81,310,2,141,26.4684739637,20-29,536,5,4,10,14,14,4,10,7,3.0999275887,1.4591384564,0.0021341463,0.2252747253,0.6181818,0,59,6.103432289919932E-5,3.3874192E-5,3.4285087E-5,25,9,0,200,0,0
513739938,chuddles11,10,19242,1074,1966,19,84,54.5727484911,50-59,678,8,123,174,297,297,123,174,6,2.3084721217,15263.4418391763,0.0907302455,0.0411661662,0.17284295,0,59,4.089437707458739E-4,8.4007997E-4,8.5027015E-4,77,19,0,201,0,0
513742574,Trevor_Horne,10,244,137,377,0,36,27.9512708566,20-29,498,4,39,84,123,123,39,84,6,2.3696596669,950.7552267933,0.0535787928,0.1226842596,0.37248996,0,59,1.5707130951409635E-4,2.7099354E-4,2.742807E-4,25,3,1,200,1,0.005
514048301,politican83,10,597,223,1997,1,0,21.161690392,20-29,516,4,5,57,62,62,5,57,6,2.4681390297,28.3153071358,0.0186794161,0.2445795875,0.39392167,0,59,7.031159388137841E-5,4.064903E-5,4.1142106E-5,175,0,0,200,0,0
514845467,JayIMG,10,6352,308,889,8,2,36.8402716976,30-39,709,7,30,50,80,80,30,50,6,2.6281679942,743.6432326492,0.0354731686,0.1810126582,0.42396313,0,59,1.5224106280783137E-4,2.1001999E-4,2.1256754E-4,175,31,0,201,0,0
515056851,Eric_Doherty,10,1142,275,309,9,15,48.91828636,40-49,637,5,19,24,43,43,19,24,6,2.8091962346,2536.7832743211,0.0142495278,0.0913621262,0.21969697,0,59,1.2623577057767492E-4,1.3549677E-4,1.3714035E-4,182,29,0,200,0,0
515638983,MacIntyreCheryl,10,1236,105,112,2,284,41.9420795721,40-49,594,5,39,26,65,65,39,26,6,2.5731354091,123.0747628426,0.0413151891,0.1483173077,0.35510203,0,59,1.297693904387281E-4,2.7099354E-4,2.742807E-4,77,13,1,200,1,0.005
515678286,BobBrentTO,10,3133,590,2000,4,1279,47.5569077987,40-49,646,7,5,25,30,30,5,25,7,2.6223750905,4356.3388454521,0.0048063718,0.1287356322,0.24666667,0,59,6.459135782918468E-5,4.064903E-5,4.1142106E-5,175,2,1,199,1,0.0050251256
515735777,ufcw1400women,10,521,234,238,4,27,40.8455900292,40-49,488,4,33,29,62,62,33,29,6,2.6774076756,233.1542799985,0.0368684252,0.1213643575,0.40418118,0,59,1.6017132092962255E-4,2.303445E-4,2.3313859E-4,182,7,3,200,3,0.015
515986093,LondonWestNDP,10,463,193,260,6,1,42.7136741577,40-49,543,5,77,93,170,170,77,93,7,2.4681390297,2153.1014775573,0.0954677358,0.1464323007,0.35883015,0,59,3.2539548349141E-4,5.284374E-4,5.348474E-4,25,52,1,200,1,0.005
516577522,d_iandi,10,70,40,228,0,3,26.8561285478,20-29,402,3,0,1,1,1,0,1,7,4.3571428571,0,0,0,0,42,466,4.766339181938244E-5,0,6.8570175E-6,197,3,0,124,0,0
516626578,qmoineville,10,311,33,35,0,50,33.3945048556,30-39,558,4,2,2,4,4,2,2,1,1,0,1.6551228476954845E-4,0.0833333333,1,110,248,3.177448371356425E-4,2.0324514E-5,2.0571053E-5,101,39,0,201,0,0
516634980,zak_f_r,10,925,156,382,1,19,30.4523663338,30-39,478,4,26,74,100,100,26,74,7,2.4424330196,281.693653486,0.0544718677,0.196969697,0.43924052,0,59,1.4926478194578677E-4,1.8292063E-4,1.8513948E-4,25,6,0,198,0,0
516647086,antonluca_cuoco,10,2003,305,399,6,1,45.7677389791,40-49,643,6,0,1,1,1,0,1,7,4.3571428571,0,0,0,0,42,447,4.766339181938244E-5,0,6.8570175E-6,197,0,0,200,0,0
516778243,CollinRogers140,10,1752,171,309,4,97,45.3540874377,40-49,678,6,25,33,58,58,25,33,7,2.6354091238,1052.5724336926,0.0288929922,0.0986085904,0.31848854,0,59,2.485481416937784E-4,1.761458E-4,1.7828245E-4,182,128,0,200,0,0
517159398,Crimethought,10,13,21,0,0,29,31.1984222593,30-39,535,5,8,0,8,8,8,0,0,0,0,0.0087176504,0.1785714286,0.2857143,0,2,6.616197573966478E-5,6.0973543E-5,0,77,9,0,4,0,0
517545022,KT4education,10,2979,219,302,9,35,44.0244222895,40-49,651,6,7,12,19,19,7,12,7,2.9876900797,52.8736430085,0.0050843749,0.134502924,0.5,0,59,7.88783190913143E-5,5.4198706E-5,5.485614E-5,175,9,0,200,0,0
517664013,CarolAnnAudet,10,1935,93,155,1,11,36.5947001977,30-39,570,6,8,9,17,17,8,9,7,2.924692252,7.9794605576,0.0089184628,0.2095588235,0.35238096,0,59,9.30178268167877E-5,6.0973543E-5,6.171316E-5,77,2,1,198,1,0.0050505051
518015895,Seb_Zein,10,1458,150,282,1,80,41.2998864264,40-49,625,6,8,20,28,28,8,20,6,2.6730629978,74.3981809097,0.0054228856,0.1124338624,0.32368422,0,59,8.202438180832092E-5,6.0973543E-5,6.171316E-5,175,7,1,199,1,0.0050251256
518046429,RZaichkowski,10,969,172,276,0,10,48.8076891516,40-49,588,5,23,43,66,66,23,43,7,2.4775524982,1364.0648746328,0.0468980206,0.1515151515,0.40980574,0,59,1.6786747445045655E-4,1.6259612E-4,1.6456842E-4,25,30,0,200,0,0
518466616,ka_a_ate,10,2216,81,170,0,726,31.5057894798,30-39,589,6,0,2,2,2,0,2,7,3.3300760043,0,0,0,0,0,293,4.766339181938244E-5,0,6.8570175E-6,147,5,0,199,0,0
520343845,schiavo_enzo,10,399,34,209,0,3,19.1982493069,10-19,190,4,0,1,1,1,0,1,7,4.3571428571,0,0,0,0,42,445,4.766339181938244E-5,0,6.8570175E-6,197,0,0,199,0,0
521004803,gjoelittle,10,298,127,637,0,2,20.229313987,20-29,481,4,7,34,41,41,7,34,7,2.631788559,64.9455296491,0.0049371923,0.143902439,0.3244207,0,59,7.294964769663126E-5,5.4198706E-5,5.485614E-5,175,0,0,200,0,0
521005895,alexanderwils16,10,558,123,559,2,66,47.3040985581,40-49,391,5,31,88,119,119,31,88,6,2.4105720492,4476.3491538127,0.0540840867,0.1860133884,0.43057504,0,59,1.9553505856030352E-4,2.1679483E-4,2.1942456E-4,25,4,2,200,2,0.01
521879347,DiscourseMag,10,227,560,530,10,8,42.3419703412,40-49,574,3,28,59,87,87,28,59,6,2.3971759594,5715.635951177,0.032629223,0.1253675488,0.27022132,0,59,1.947990979534607E-4,1.9647031E-4,1.9885351E-4,77,39,1,200,1,0.005
522452889,NadineLumley,10,11677,567,206,9,4669,55.674403645,50-59,743,8,126,50,176,176,126,50,6,2.4692251991,2080.36955422,0.1004010082,0.1093181818,0.2126763,0,59,3.4777302792856664E-4,8.6040446E-4,8.708412E-4,77,178,0,203,0,0
522620461,lisagrandetang,10,662,43,116,0,40,27.3431726878,20-29,527,5,4,8,12,12,4,8,7,2.9775524982,25.1617795887,0.0013623523,0.053030303,0.19642857,0,59,6.361088547348706E-5,3.3874192E-5,3.4285087E-5,77,1,0,199,0,0
523556031,Brian_Pallister,10,134,712,321,15,4,43.7713056787,40-49,640,3,24,12,36,36,24,12,7,2.8131788559,609.6556406439,0.0142970027,0.0873015873,0.17204301,0,59,1.6170594052749676E-4,1.6937095E-4,1.7142543E-4,175,23,2,136,2,0.0147058824
523802059,luca_sansalone,10,17,17,112,0,0,14.088501825,10-19,27,1,0,1,1,1,0,1,7,4.3571428571,0,0,0,0,42,416,4.766339181938244E-5,0,6.8570175E-6,197,1,0,19,0,0
523914621,TadeusLeones,10,1057,125,260,1,5,20.0453392272,20-29,562,5,12,28,40,40,12,28,6,2.4797248371,34.7480579088,0.0327208963,0.1737179487,0.5515873,0,59,9.423006402147548E-5,8.80729E-5,8.914123E-5,77,0,1,200,1,0.005
524730862,tabithatb,10,599,152,734,1,10,33.7962623317,30-39,557,5,67,189,256,256,67,189,6,2.2628530051,1230.7591367269,0.1142303313,0.1544883578,0.35348257,0,59,3.182857362150027E-4,4.60689E-4,4.6627718E-4,25,33,6,200,6,0.03
524754019,MaryPChipman,10,3175,377,595,3,3196,46.0445760287,40-49,656,6,37,64,101,101,37,64,6,2.3678493845,1724.4304109927,0.0588785416,0.08,0.29985118,0,59,1.659288791154606E-4,2.5744384E-4,2.6056665E-4,77,47,6,200,5,0.025
524868951,BVT23,10,3093,225,76,3,12,46.4640794836,40-49,670,6,3,2,5,5,3,2,9,4.8157132513,0,2.776754810931658E-4,0.3,0.6666667,0,59,1.21270613648251E-4,2.7099353E-5,2.742807E-5,131,6,0,198,0,0
524901955,CFLancop,10,27915,721,555,17,23,40.1916862195,40-49,748,9,11,6,17,17,11,6,7,3.1879073135,11.1637507665,0.0111898839,0.1139705882,0.45454547,0,59,9.371788103366185E-5,8.129806E-5,8.228421E-5,175,10,0,201,0,0
525061568,MampaneElizabe1,10,64,6,21,0,1,11.8833382982,10-19,5,2,0,1,1,1,0,1,10,5.8863554108,0,0,0,0,0,683,4.766339181938244E-5,0,6.8570175E-6,131,0,0,69,0,0
526913370,AMoses4,10,1410,37,36,0,0,41.4841198394,40-49,540,2,6,5,11,11,6,5,6,2.7346125996,9.7143211236,0.0139411871,0.0545454545,0.4,0,59,6.639694588261844E-5,4.742387E-5,4.799912E-5,77,21,0,200,0,0
528006485,TrentDryad,10,338,10,16,0,0,12.3207895825,10-19,443,3,3,9,12,12,3,9,7,2.725923244,1.1543115119,0.0037851547,0.3106060606,0.5,0,59,5.463960908410178E-5,2.7099353E-5,2.742807E-5,25,4,1,200,1,0.005
529786217,dylanxpowell,10,6929,451,384,9,4216,49.2718965787,40-49,723,7,9,7,16,16,9,7,6,2.8482983345,484.6491390968,0.0054983208,0.0541666667,0.102564104,0,59,9.864314175346251E-5,6.7748384E-5,6.8570174E-5,77,4,0,201,0,0
531034033,parkhayoung01,10,12895,1049,955,1,229,48.1143540913,40-49,749,7,2,3,5,5,2,3,1,1,4,1.6729007086290762E-4,0.05,0.33333334,22,95,2.985780977871486E-4,2.0324514E-5,2.0571053E-5,126,5,0,201,0,0
531177590,RussBosch,10,6135,1019,1077,18,1661,50.336854896,50-59,738,7,44,80,124,124,44,80,7,2.5887038378,3266.536986317,0.0242994971,0.0677943876,0.2658228,0,59,2.6384218844153947E-4,3.0486772E-4,3.085658E-4,175,61,0,200,0,0
531546807,Quebecois100,10,1029,37,88,0,2,31.067455906,30-39,485,5,2,3,5,5,2,3,7,2.8631426503,0,0.0087015979,0.15,1,0,59,5.663946277297581E-5,2.0324514E-5,2.0571053E-5,145,13,0,200,0,0
531801809,charlie_019,10,628,39,171,0,0,24.4209964351,20-29,450,4,0,2,2,2,0,2,7,3.1842200507,0,0,0,0,0,124,4.766339181938244E-5,0,6.8570175E-6,145,1,0,200,0,0
532276157,MrGeorgeKoura,10,171,43,69,1,4,23.6082632848,20-29,402,3,1,6,7,7,1,6,7,2.801230992,0,0.0072676982,0.3333333333,0.8,0,59,5.409653606626543E-5,1.3549677E-5,1.3714035E-5,25,27,0,178,0,0
532841420,stkenzie,10,3988,96,152,3,210,40.4235960572,40-49,581,7,12,20,32,32,12,20,6,2.6154960174,372.3163405294,0.0141698121,0.1491935484,0.3123077,0,59,9.4264734119583E-5,8.80729E-5,8.914123E-5,77,8,0,185,0,0
533469634,Sellomabena,10,223,27,93,0,0,23.5340663659,20-29,460,3,0,1,1,1,0,1,10,5.8863554108,0,0,0,0,0,401,4.766339181938244E-5,0,6.8570175E-6,131,0,0,200,0,0
534742830,teamfinfree,10,1042,611,238,14,367,47.7113498689,40-49,688,5,7,3,10,10,7,3,7,3.0260680666,4987.6248517641,0.0040407124,0.1,0.15277778,0,59,1.4049995811822575E-4,5.4198706E-5,3.4285087E-5,25,25,0,188,0,0
534790063,MarilynGMurray,10,557,31,157,0,0,13.4129683904,10-19,341,5,9,34,43,43,9,34,6,2.5883417813,392.631578829,0.0187361647,0.1987818383,0.3536036,0,59,7.462472958844113E-5,6.7748384E-5,6.8570174E-5,182,0,1,200,1,0.005
534827153,usernamehere,10,856,357,301,2,41,44.5112222834,40-49,592,5,2,17,19,19,2,17,7,2.9554670529,27.5660952658,0.0018666861,0.1666666667,0.251634,0,59,5.619429137904601E-5,2.0324514E-5,2.0571053E-5,175,7,1,200,1,0.005
534885047,MA_Valiquette,10,11,15,125,0,15,12.5541969358,10-19,13,2,0,2,2,2,0,2,7,2.9457111835,0,0,0,0,0,553,4.766339181938244E-5,0,6.8570175E-6,145,0,1,18,1,0.0555555556
534946806,FelixMapleFudge,10,1441,39,150,0,7,25.3068388551,20-29,519,5,0,1,1,1,0,1,7,3.3492580528,0,0,0,0,0,702,4.766339181938244E-5,0,6.8570175E-6,147,1,0,200,0,0
535486548,bionicliberal,10,9333,362,333,3,3,51.7499606333,50-59,704,7,90,89,179,179,90,89,6,2.3511947864,3345.2599691171,0.1011651122,0.0448496642,0.27888355,0,59,3.206840546334862E-4,6.165103E-4,6.171316E-4,77,278,1,243,1,0.0041152263
535729333,badmonta,10,16272,1183,1471,8,7084,54.0486951184,50-59,766,8,1,2,3,3,1,2,7,4.1333333333,0,8.095914281419891E-5,0.1666666667,0.5,42,420,8.289285873049163E-5,1.3549677E-5,1.3714035E-5,197,6,0,201,0,0
536296801,kamstago,10,24,23,107,1,3,36.76967617,30-39,357,3,0,2,2,2,0,2,7,3.2859211003,0,0,0.5,0.5,0,299,4.766339181938244E-5,0,6.8570175E-6,175,0,0,81,0,0
537739100,ravenloon56,10,138,7,22,0,0,22.9931610247,20-29,354,3,1,1,2,2,1,1,8,3.8272990587,0,1.949569655161013E-4,0,0,0,59,5.564737153375284E-5,1.3549677E-5,1.3714035E-5,175,8,0,166,0,0
537833387,ejrosenau,10,1239,307,451,14,209,45.5633583006,40-49,597,5,55,84,139,139,55,84,6,2.3595220854,2611.8112404083,0.0876589747,0.1155249713,0.3653626,0,59,2.4653449860664466E-4,3.7939096E-4,3.8399297E-4,182,51,0,200,0,0
538475365,bconnolly00,10,10098,154,141,4,1146,49.5283703024,40-49,704,8,23,14,37,37,23,14,7,2.8950036206,99.9648814563,0.0238109902,0.1111111111,0.23678161,0,59,1.3128386310979636E-4,1.6259612E-4,1.6456842E-4,182,84,0,202,0,0
539701822,omarpenap,10,399,114,171,0,75,38.0582145028,30-39,549,4,0,0,0,0,0,0,0,0,0,0,0,0,107,241,4.766339181938244E-5,0,0,98,1,0,200,0,0
541052393,BrendaWardle,10,5440,691,1733,3,120,38.1799200176,30-39,702,7,6,10,16,16,6,10,9,4.81173063,47.2647674221,5.298334413318267E-4,0.1083333333,0.21428572,0,59,2.5355152493012945E-4,4.742387E-5,4.799912E-5,131,9,0,200,0,0
541203859,Jdelarosa97,10,1864,252,185,0,30,40.3086872479,40-49,687,5,0,0,0,0,0,0,0,0,0,0,0,0,130,290,4.766339181938244E-5,0,0,122,19,0,199,0,0
541252471,AndreaLoken,10,8183,449,181,15,289,40.5290533606,40-49,738,7,59,23,82,82,59,23,7,2.7559739319,980.1512923147,0.0525820518,0.0888286661,0.23963134,0,59,2.2778240297581366E-4,4.064903E-4,4.1142106E-4,182,91,1,200,1,0.005
542169141,altaMike,10,669,89,165,0,32,44.0168845782,40-49,569,5,8,18,26,26,8,18,7,2.7791455467,145.3641856136,0.0044521097,0.0923076923,0.24509804,0,59,8.589565499196057E-5,6.0973543E-5,6.171316E-5,175,13,0,200,0,0
543655428,aimta1751,10,315,113,421,0,0,38.2954206467,30-39,470,4,13,23,36,36,13,23,7,2.7013034033,3157.0575757774,0.022901455,0.1436507937,0.39692307,0,59,9.868217958057631E-5,9.484774E-5,9.599824E-5,182,13,1,200,1,0.005
543799267,TorranceCoste,10,1264,278,411,4,36,60.3534667141,60-69,660,6,36,51,87,87,36,51,6,2.4540188269,2348.0055607569,0.0330454433,0.0765838011,0.23276836,0,59,2.0578680677758057E-4,2.5066902E-4,2.5370964E-4,77,107,2,200,1,0.005
543895677,NootkaRose1,10,1034,110,196,1,3,38.9288542779,30-39,600,5,29,49,78,78,29,49,6,2.4384503983,1385.8026062692,0.0541115595,0.1103896104,0.33473095,0,59,1.5444103304038806E-4,2.0324514E-4,2.0571053E-4,77,20,2,200,2,0.01
544603490,life_in_BC,10,402,80,241,0,0,23.4733256319,20-29,499,5,4,16,20,20,4,16,6,2.9000724113,8.375469786,0.0039111596,0.2394736842,0.36842105,0,59,7.14438684184626E-5,3.3874192E-5,3.4285087E-5,182,0,3,200,3,0.015
544681213,sebronmorg,10,159,23,38,0,0,19.3050316901,10-19,424,3,3,12,15,15,3,12,7,2.7002172339,6.3453353174,0.0036673847,0.1857142857,0.49242425,0,59,5.7223178759151176E-5,2.7099353E-5,2.742807E-5,25,2,4,164,4,0.0243902439
545144439,sarah_jordison,10,325,69,201,0,65,37.9824574936,30-39,467,4,6,28,34,34,6,28,6,2.6640115858,39.1837478711,0.0102965489,0.2513368984,0.4643678,0,59,8.99992190515151E-5,4.742387E-5,4.799912E-5,175,8,1,200,1,0.005
546275216,MauroMast,10,6345,5830,511,2,1104,47.340184436,40-49,744,7,0,1,1,1,0,1,7,4.3571428571,0,0,0,0,42,427,4.766339181938244E-5,0,6.8570175E-6,197,6,0,200,0,0
546450813,JohnCairns5,10,1030,95,182,1,56,42.5712749632,40-49,635,5,6,16,22,22,6,16,7,2.698044895,38.4674648208,0.0047919151,0.1515151515,0.375,0,59,6.0644830485389094E-5,4.742387E-5,4.799912E-5,175,28,0,200,0,0
546924171,trailerguy2002,10,256,14,42,0,0,20.3921776731,20-29,441,3,0,0,0,0,0,0,0,0,0,0,0,0,116,259,4.766339181938244E-5,0,0,107,0,0,201,0,0
547069308,Shawn_M_Hayward,10,60,28,66,0,1,25.2018778388,20-29,176,2,0,3,3,3,0,3,7,3.533840029,0,0,0.3333333333,0.6666667,0,213,4.766339181938244E-5,0,6.8570175E-6,147,1,0,75,0,0
547095100,stewarwd,10,667,218,363,0,18,39.342785173,30-39,580,5,4,5,9,9,4,5,7,2.6538740043,5.1842611454,0.0168639253,0.0694444444,0.45,0,59,6.80747129659357E-5,3.3874192E-5,3.4285087E-5,147,17,0,200,0,0
547938518,MarksGonePublic,10,2942,202,328,5,12,46.4325605815,40-49,658,6,0,2,2,2,0,2,7,3.4002895404,0,0,0.5,0.5,0,583,4.766339181938244E-5,0,6.8570175E-6,182,3,0,200,0,0
548635608,gryan81,10,63,20,46,0,0,32.3585434912,30-39,398,3,2,3,5,5,2,3,7,3.3001448226,0,0.0019983168,0.15,0.8333333,0,59,7.20438802966001E-5,2.0324514E-5,2.0571053E-5,147,9,0,101,0,0
549359236,JohnnyManitoba,10,1285,144,843,0,5,24.5073801263,20-29,513,5,15,61,76,76,15,61,7,2.5633598841,1649.1873648523,0.0170146395,0.1364912281,0.29109064,0,59,1.3588499904866694E-4,1.0839741E-4,1.0971228E-4,175,8,0,200,0,0
549746151,gaianicity,10,239,51,160,0,0,31.9123587935,30-39,413,4,2,8,10,10,2,8,7,3.1346850109,2.879819944,4.591382065456254E-4,0.1777777778,0.25,0,59,5.574020297325367E-5,2.0324514E-5,2.0571053E-5,77,3,0,199,0,0
550132483,NickVanDutch,10,33,42,46,2,0,,,142,1,1,14,15,15,1,14,7,2.7722664736,7.615860045,4.033220376751704E-4,0.2904761905,0.50549453,0,59,5.295077054919467E-5,1.3549677E-5,1.3714035E-5,25,0,0,35,0,0
550250082,SheilaGunnReid,10,43993,2192,1113,70,9725,56.2634633675,50-59,852,9,141,138,279,279,141,138,7,2.5724112962,14679.8411684813,0.0621190881,0.0378793739,0.1612133,0,59,7.170380690741379E-4,9.6202706E-4,9.736965E-4,175,1123,2,209,2,0.009569378
551934259,acjames76,10,170,25,39,0,1,16.1872417212,10-19,195,3,4,8,12,12,4,8,7,3.0438088342,36.0019357238,0.0032533727,0.1666666667,0.28181818,0,59,6.810183589579238E-5,3.3874192E-5,3.4285087E-5,77,0,0,173,0,0
552119609,legant66,10,9362,263,362,5,1,38.7428871638,30-39,678,8,8,8,16,16,8,8,6,2.7950760319,14.1865964814,0.0218698798,0.1625,0.34615386,0,59,8.215174767533219E-5,6.0973543E-5,6.171316E-5,175,20,0,207,0,0
552220775,andrearomo98,10,2664,138,305,0,21,40.495211387,40-49,627,5,2,2,4,4,2,2,4,2.4444444444,0,1.7088556491040878E-4,0.0833333333,1,79,175,2.938352311770198E-4,2.0324514E-5,2.0571053E-5,106,7,0,201,0,0
552494270,wastedsundays,10,229,13,39,0,1,27.9495641806,20-29,420,4,0,1,1,1,0,1,8,3.7202316323,0,0,0,0,0,614,4.766339181938244E-5,0,6.8570175E-6,175,4,0,200,0,0
552765716,BTW_MK1,10,22133,569,779,2,1149,53.7754720493,50-59,783,8,0,0,0,0,0,0,0,0,0,0,0,0,163,361,4.766339181938244E-5,0,0,160,12,0,201,0,0
552866595,CB_Labour,10,561,375,447,5,30,41.26635214,40-49,622,5,61,66,127,127,61,66,6,2.4732078204,2338.3784407009,0.0576089192,0.0688038995,0.27294305,0,59,2.618679680683341E-4,4.2003999E-4,4.2513508E-4,182,32,6,200,6,0.03
553009426,ceripenner,10,472,63,132,1,13,23.3161753536,20-29,513,4,5,15,20,20,5,15,6,2.6202027516,7.4501635507,0.007609108,0.2078947368,0.4227941,0,59,6.501036541709378E-5,4.064903E-5,4.1142106E-5,175,0,0,200,0,0
554476689,st3v3turn3r,10,2109,221,265,7,29,46.7069803913,40-49,658,6,18,21,39,39,18,21,7,2.9283128168,64.1083910511,0.0131075563,0.1012145749,0.4604743,0,59,1.5126006255282892E-4,1.2872192E-4,1.3028333E-4,175,26,0,200,0,0
554522397,AndreMa40964625,10,244,11,68,0,10,15.1510749196,10-19,151,3,0,1,1,1,0,1,7,3.5360115816,0,0,0,0,0,350,4.766339181938244E-5,0,6.8570175E-6,175,6,0,199,0,0
554800351,al_masani,10,3595,278,306,6,202,44.7964843188,40-49,653,7,10,7,17,17,10,7,7,2.8855901521,21.9288132548,0.0146097295,0.1323529412,0.28846154,0,59,9.894094508216776E-5,7.452322E-5,7.542719E-5,25,29,0,199,0,0
555378872,ckprthunderbay,10,3506,182,94,5,2,40.9118612316,40-49,583,6,1,4,5,5,1,4,7,3.1553222303,0.1026315789,4.391274938686109E-4,0.25,0.45,0,59,4.878123469641086E-5,1.3549677E-5,1.3714035E-5,147,0,0,200,0,0
556040281,robertodorado71,10,863,155,326,1,5,38.1424433029,30-39,657,5,0,0,0,0,0,0,0,0,0,0,0,0,56,141,4.766339181938244E-5,0,0,50,15,0,198,0,0
556094860,SamiaBoukarine,10,13253,122,81,0,231,34.637700771,30-39,743,7,6,4,10,10,6,4,4,2.6111111111,6.4166666667,5.302547325903833E-4,0.1555555556,0.52380955,58,182,3.939300058217485E-4,4.742387E-5,4.799912E-5,166,25,0,201,0,0
556687339,LelloucheNono,10,248,45,40,0,1,32.4616533948,30-39,538,4,1,1,2,2,1,1,2,1.5,0,8.271798374069241E-5,0,0,162,360,2.4481546444683235E-4,1.3549677E-5,1.3714035E-5,161,22,0,200,0,0
557419289,JoshGrantYoung1,10,1682,310,487,1,412,29.5474003083,20-29,533,5,6,14,20,20,6,14,7,2.5488776249,34.0386337367,0.0178927154,0.1210526316,0.3791209,0,59,7.407801759992013E-5,4.742387E-5,4.799912E-5,175,2,0,199,0,0
557444928,DDesBaillets,10,2574,587,1883,4,36,43.5533872126,40-49,627,6,52,230,282,282,52,230,6,2.1495293266,6103.0008921118,0.0974622918,0.1236086924,0.26235047,0,59,2.6484202379258584E-4,3.590664E-4,3.6342192E-4,25,22,1,201,1,0.0049751244
557449649,truthmashup,10,8530,598,636,14,340,40.8729230761,40-49,722,7,82,110,192,192,82,110,6,2.3435916003,2956.1140782503,0.0925067493,0.059882199,0.26574212,0,59,2.6847650372787795E-4,5.6231156E-4,5.6913245E-4,77,48,40,201,40,0.1990049751
558211885,PearlSawyer2,10,73,58,92,2,0,31.4498432382,30-39,309,3,17,16,33,33,17,16,7,2.9145546705,280.0111401559,0.0154706566,0.1117424242,0.3961039,0,59,1.0423110083417906E-4,1.2194709E-4,1.2342632E-4,182,10,1,101,1,0.0099009901
558827088,mike4mla,10,1228,729,1509,11,19,54.6803818435,50-59,628,5,34,72,106,106,34,72,7,2.4417089066,5991.4449905341,0.0255473301,0.0817610063,0.23343207,0,59,2.385009547481337E-4,2.3711934E-4,2.3999561E-4,182,50,0,201,0,0
559293140,BloggersonShaw,10,455,90,151,3,9,36.3268419543,30-39,502,4,3,2,5,5,3,2,8,3.877262853,20.3008335652,0.0011742575,0.25,0.4,0,59,5.440020820656601E-5,2.7099353E-5,2.742807E-5,175,20,0,200,0,0
559995442,MacDougall1165,10,1901,266,1145,1,16,40.2214381681,40-49,569,6,48,178,226,226,48,178,6,2.1618392469,6657.0767524578,0.0645402701,0.0955752212,0.21345176,0,59,2.090993634556281E-4,3.3196708E-4,3.3599386E-4,182,40,0,200,0,0
559997737,UshaSris,10,2028,130,190,2,47,47.9335547529,40-49,655,7,0,4,4,4,0,4,7,3.2200506696,0,0,0.5,0.75,0,190,4.766339181938244E-5,0,6.8570175E-6,25,16,0,202,0,0
560481476,kammornanchor,10,570,146,131,3,2,29.8060441431,20-29,535,3,5,5,10,10,5,5,7,3.1860970311,4.6242381925,0.0013297633,0.2888888889,0.35555556,0,59,6.815896132568259E-5,4.064903E-5,4.1142106E-5,182,2,0,200,0,0
560765411,36Emmet,10,155,5,9,0,1,17.4414173747,10-19,383,3,1,2,3,3,1,2,7,3.2813178856,0,4.6600286353108E-4,0.1666666667,0.5,0,59,4.997047692022001E-5,1.3549677E-5,1.3714035E-5,182,0,0,155,0,0
561560545,SYDNABEANZ,10,8922,816,851,2,13009,38.9556375935,30-39,746,7,2,1,3,3,2,1,3,2.1428571429,0,1.7090505595144666E-4,0.1666666667,1,18,88,1.822445046150632E-4,2.0324514E-5,2.0571053E-5,39,3,0,201,0,0
561976679,msimangawp,10,23309,539,1924,6,6,40.5517698828,40-49,685,9,4,10,14,14,4,10,7,3.0010861694,126837.884735894,0.0016428216,0.0274725275,0.054545455,0,59,2.018609385349103E-4,3.3874192E-5,3.4285087E-5,131,4,0,211,0,0
562049551,leftyfem,10,125,38,155,0,5,28.8746777917,20-29,433,3,3,17,20,20,3,17,7,2.6868211441,10.7946086452,0.0018694894,0.3210526316,0.5233918,0,59,5.40560785554752E-5,2.7099353E-5,2.742807E-5,25,15,2,144,2,0.0138888889
563080056,XO_reporter,10,633,744,1892,14,75,45.5909526688,40-49,611,5,21,96,117,117,21,96,6,2.3265749457,1356.0762316759,0.0396440022,0.1536251105,0.32708332,0,59,1.509149518630923E-4,1.4904643E-4,1.5085438E-4,175,13,1,199,1,0.0050251256
563357348,NKangPC,10,436,88,125,4,3,41.8831841715,40-49,576,4,8,13,21,21,8,13,7,2.8910209993,51.1118545887,0.0045070758,0.130952381,0.24632353,0,59,7.368541526320931E-5,6.0973543E-5,6.171316E-5,175,1,0,200,0,0
563759499,stanczykowski,10,2970,368,564,22,16,51.9449419308,50-59,630,6,4,13,17,17,4,13,7,3.0257060101,17.3585791912,0.0012074513,0.1360294118,0.30769232,0,59,7.24246093632757E-5,3.3874192E-5,3.4285087E-5,145,4,0,200,0,0
564212349,ElliotAustinH,10,1125,38,67,1,0,34.068912418,30-39,549,5,2,3,5,5,2,3,7,3.2248370746,0.5233355435,0.007564647,0.25,0.3,0,59,6.049853629279521E-5,2.0324514E-5,2.0571053E-5,182,2,2,199,2,0.0100502513
565405613,DCProfessor1,10,34486,1229,2000,41,5613,56.2269349874,50-59,787,9,3,4,7,7,3,4,7,3.1795800145,20.12495351,0.0011430484,0.0476190476,0.071428575,0,59,6.0766251472772335E-5,2.7099353E-5,2.742807E-5,77,34,0,201,0,0
566759589,NatalieH42,10,976,276,455,7,31,41.6433205748,40-49,589,5,48,67,115,115,48,67,6,2.5637219406,1856.0902503494,0.0454371869,0.0935163997,0.3639839,0,59,2.1314571886990282E-4,3.3196708E-4,3.3599386E-4,175,45,1,199,1,0.0050251256
567420300,LJSoul25,10,2205,110,291,0,370,35.9436516897,30-39,614,6,1,4,5,5,1,4,7,2.9243301955,24.8508174947,8.633232628938374E-5,0.2,0.33333334,0,59,6.091704764422492E-5,1.3549677E-5,1.3714035E-5,25,19,0,200,0,0
567663996,StopHarperBot,10,7599,269,0,6,0,38.1929357699,30-39,718,6,32,0,32,32,32,0,0,0,0,0.0308936,0.2006048387,0.34879032,0,14,1.1071825825436324E-4,2.2356966E-4,0,77,51,1,206,1,0.0048543689
567814795,BryanLCrockett,10,7093,477,855,15,18,62.2498752194,60-69,733,7,60,99,159,159,60,99,6,2.3504706734,2975.5800957334,0.070098132,0.0956532123,0.2830467,0,59,2.3681751687009404E-4,4.1326514E-4,4.1827807E-4,175,32,2,202,2,0.0099009901
568827242,RachelSimmet,10,742,73,168,1,70,56.9757183072,50-59,531,4,0,2,2,2,0,2,7,3.3029315961,0,0,0,0,0,633,4.766339181938244E-5,0,6.8570175E-6,77,2,0,200,0,0
569877269,sandragroves33,10,12,0,12,0,0,13.5831361568,10-19,11,0,1,6,7,7,1,6,7,2.7986965967,2978.8778125785,9.390207842745664E-5,0.1904761905,0.46666667,0,59,5.145890670769829E-5,1.3549677E-5,1.3714035E-5,25,1,0,19,0,0
570103894,MrsMcCharms,10,1090,28,67,0,75,35.7036113237,30-39,533,5,0,4,4,4,0,4,7,3.0412595005,0,0,0.25,0.41666666,0,561,4.766339181938244E-5,0,6.8570175E-6,182,5,0,200,0,0
571223926,IanASMurray,10,242,110,273,0,8,29.8776392176,20-29,480,4,5,6,11,11,5,6,7,3.0633598841,669.8260883574,0.0019612401,0.0272727273,0.14285715,0,59,1.0503640881689423E-4,4.064903E-5,4.1142106E-5,175,12,0,200,0,0
573066358,Estrella240196,10,3591,266,297,0,119,33.0056482892,30-39,685,6,2,2,4,4,2,2,1,1,1,1.6371514892060646E-4,0.0833333333,0.5,221,546,4.1251045157262634E-4,2.0324514E-5,2.0571053E-5,225,115,0,200,0,0
573835135,NailaRamirez17,10,572,257,426,0,3,32.9024465595,30-39,577,5,2,1,3,3,2,1,2,1.5,0,1.6371514892060646E-4,0.1666666667,1,221,546,3.177448371356425E-4,2.0324514E-5,2.0571053E-5,225,64,0,199,0,0
573993551,YLeget,10,4543,330,917,3,846,44.3185924498,40-49,589,7,9,26,35,35,9,26,6,2.4775524982,198.0714028428,0.011967943,0.1445378151,0.27339903,0,59,7.286735234107258E-5,6.7748384E-5,6.8570174E-5,77,9,0,199,0,0
574132457,GwynethMPrice,10,2879,83,224,1,348,26.3184609124,20-29,606,6,25,62,87,87,25,62,6,2.3769007965,661.2379957809,0.052407042,0.1327185245,0.35813493,0,59,1.4529493754226707E-4,1.761458E-4,1.7828245E-4,25,7,5,200,5,0.025
574279451,Quaker_Diane,10,24660,447,1800,6,948,36.7938828504,30-39,638,8,18,78,96,96,18,78,6,2.3497465605,331.4274612011,0.0187148315,0.1513157895,0.28557086,0,59,9.387515541961334E-5,1.2872192E-4,1.3028333E-4,77,12,0,203,0,0
574898571,JWVince,10,1978,276,370,0,30,45.0559274402,40-49,701,6,31,48,79,79,31,48,6,2.6115133961,993.3779178942,0.0193503903,0.0814670562,0.30039215,0,59,1.4388741040920354E-4,2.1679483E-4,2.1942456E-4,182,52,0,200,0,0
575511770,TedNOpitzCPC,10,292,161,442,4,2,33.3373712204,30-39,530,4,33,104,137,137,33,104,6,2.3548153512,1641.0029104084,0.0373659327,0.082492486,0.21538462,0,59,1.3846903277977388E-4,2.303445E-4,2.3313859E-4,77,15,1,197,1,0.0050761421
575591717,jtftw321,10,659,166,1130,0,32,18.9752209538,10-19,401,5,3,12,15,15,3,12,7,2.9576393917,2.3062297785,0.003175093,0.1571428571,0.21428572,0,59,5.4009591283997944E-5,2.7099353E-5,2.742807E-5,182,0,0,200,0,0
575858975,RyanChatterjee,10,1270,144,262,2,21,36.7617115225,30-39,572,5,7,13,20,20,7,13,7,2.8649529327,2429.8177369235,0.0050725267,0.0947368421,0.26666668,0,59,9.621213680893378E-5,5.4198706E-5,5.485614E-5,175,1,0,199,0,0
576037801,OriginalRedLocz,10,47,24,101,0,0,16.0442862433,10-19,144,2,0,0,0,0,0,0,0,0,0,0,0,0,222,552,4.766339181938244E-5,0,0,226,0,0,47,0,0
576337793,gmPsychologists,10,2198,215,643,5,28,43.158456149,40-49,567,6,2,16,18,18,2,16,6,2.7288196959,42.2698902223,0.0039660062,0.1862745098,0.37083334,0,59,6.046772835039218E-5,2.0324514E-5,2.0571053E-5,147,3,0,200,0,0
576539791,MikeSingleton9,10,1716,72,170,3,721,28.9861470939,20-29,583,6,3,2,5,5,3,2,8,3.6589427951,0,0.0047020962,0.3,0.8333333,0,59,6.183185249514038E-5,2.7099353E-5,2.742807E-5,175,1,0,199,0,0
577727470,ProudPolitics,10,231,167,160,7,5,42.5060959192,40-49,555,4,15,15,30,30,15,15,7,2.764301231,85.1268761653,0.0212990899,0.132183908,0.23833333,0,59,1.2086496812029212E-4,1.0839741E-4,1.0971228E-4,175,41,0,200,0,0
578995848,emlaughsallot88,10,10030,2402,2624,43,100,39.9992412489,30-39,738,8,35,70,105,105,35,70,7,2.4960173787,3893.009848948,0.0224946095,0.0749084249,0.24067733,0,59,1.7982331861127228E-4,2.4389417E-4,2.4685264E-4,175,25,0,201,0,0
579057054,JudithRegion3,10,483,235,503,4,0,41.6762847119,40-49,553,4,37,67,104,104,37,67,6,2.5209992759,779.8461908415,0.0355724813,0.1055825243,0.29117116,0,59,1.51982760050502E-4,2.5744384E-4,2.6056665E-4,182,17,0,200,0,0
581054972,PlanTheNorth,10,3090,305,188,6,0,44.8319970053,40-49,618,6,12,6,18,18,12,6,7,3.2277335264,71.1774707831,0.0075361561,0.0718954248,0.18131869,0,59,1.0278158647080011E-4,8.80729E-5,8.228421E-5,77,23,1,200,1,0.005
581131583,douglaslaforme,10,315,3,39,0,2,13.2962348455,10-19,352,4,0,1,1,1,0,1,7,2.8668114368,0,0,0,0,0,208,4.766339181938244E-5,0,6.8570175E-6,25,1,0,200,0,0
581438207,BenDayle,10,4066,97,202,2,32,31.5106776914,30-39,547,7,17,27,44,44,17,27,7,2.7031136857,317.8909689577,0.0154064025,0.0872093023,0.2328629,0,59,9.839207989837447E-5,1.2194709E-4,1.2342632E-4,77,4,8,201,8,0.039800995
581848228,TothSusan,10,6038,501,327,19,2402,42.407104991,40-49,767,8,24,19,43,43,24,19,6,2.8826937002,299.8047744382,0.0131196348,0.0764119601,0.34461537,0,59,1.40965297562334E-4,1.6937095E-4,1.7142543E-4,175,58,0,154,0,0
582298828,greeneral,10,126837,1476,0,74,0,52.8470339569,50-59,729,10,1,0,1,1,1,0,0,0,0,3.445070164023519E-4,0,0,0,20,4.918162994469943E-5,1.3549677E-5,0,175,0,0,202,0,0
582320397,alira23_,10,4118,121,185,0,563,56.4109878573,50-59,669,6,0,0,0,0,0,0,0,0,0,0,0,0,271,704,4.766339181938244E-5,0,0,279,3,0,200,0,0
582373690,OhToFreeCanada,10,1836,152,251,0,64,40.364766814,40-49,617,6,14,28,42,42,14,28,6,2.5213613324,356.8120849813,0.0221811343,0.0725900116,0.244709,0,59,9.066963788389231E-5,1.0162257E-4,1.02855265E-4,77,2,0,199,0,0
582848614,FightingNLer,10,211,108,72,7,0,33.6744266329,30-39,486,3,21,18,39,39,21,18,7,2.7744388125,66.5990362953,0.0216341495,0.2004048583,0.4344758,0,59,1.2863277812066415E-4,1.4904643E-4,1.5085438E-4,147,4,5,200,4,0.02
583002992,BrynDartCentre,10,10761,842,1741,26,1446,42.0083865196,40-49,756,8,30,76,106,106,30,76,6,2.3692976104,1862.6104695893,0.0337867154,0.1152740341,0.27401385,0,59,1.5593733043710962E-4,2.1001999E-4,2.1256754E-4,147,87,0,202,0,0
583112136,OilsandNews,10,2027,246,118,10,0,44.158929903,40-49,610,3,9,3,12,12,9,3,7,3.3692976104,104.1055426923,0.0048764596,0.0833333333,0.10909091,0,59,8.845827164567618E-5,6.7748384E-5,6.8570174E-5,175,14,0,200,0,0
583550400,RyuIkan,10,4474,117,130,1,660,32.3734617273,30-39,631,6,2,14,16,16,2,14,7,2.8555394642,0.576518735,0.0020045301,0.3041666667,0.40952381,0,59,5.2259570839632706E-5,2.0324514E-5,2.0571053E-5,25,1,2,200,2,0.01
583552935,goddessemmz,10,626,40,386,0,403,25.7959144958,20-29,454,4,0,5,5,5,0,5,7,3.4133188563,0,0,0.25,0.45,0,228,4.766339181938244E-5,0,6.8570175E-6,182,2,0,200,0,0
584984159,FarrowAD,10,2343,360,916,10,173,46.1260951785,40-49,693,6,14,47,61,61,14,47,6,2.6375814627,324.8624928659,0.0166312624,0.1415300546,0.35152635,0,59,9.244703396286734E-5,1.0162257E-4,1.02855265E-4,147,14,0,200,0,0
585434206,JillianLeBlanc4,10,125,45,122,0,53,19.3553062833,10-19,446,3,1,7,8,8,1,7,6,2.7661115134,0,0.0060064755,0.3392857143,0.71428573,0,59,5.586306243973462E-5,1.3549677E-5,1.3714035E-5,25,0,0,126,0,0
586315432,AylesL,10,4505,14768,2847,4,1418,54.0977917153,50-59,678,7,0,1,1,1,0,1,7,3.3554107854,0,0,0,0,0,326,4.766339181938244E-5,0,6.8570175E-6,25,26,0,197,0,0
586321401,TheIronRobot,10,886,63,233,1,16,28.7264168488,20-29,522,5,1,18,19,19,1,18,7,2.5510499638,4.5119243759,0.0050763996,0.2660818713,0.47712418,0,59,5.2959838971500805E-5,1.3549677E-5,1.3714035E-5,25,1,0,199,0,0
586921010,cherielle100,10,33473,1520,1999,14,830,43.8017642936,40-49,778,9,19,21,40,40,19,21,7,2.7661115134,794.6229308174,0.016970793,0.0935897436,0.34923077,0,59,1.678078206327862E-4,1.3549677E-4,1.3714035E-4,145,8,0,201,0,0
587033945,DougalFleming,10,851,37,191,1,1,35.2126092595,30-39,507,4,4,23,27,27,4,23,7,2.6151339609,89.8247938278,0.002799971,0.1851851852,0.3616601,0,59,6.287858598112956E-5,3.3874192E-5,3.4285087E-5,175,11,0,200,0,0
587138551,GwynAdam,10,9867,348,338,8,1337,36.9998928336,30-39,650,8,36,36,72,72,36,36,6,2.4866039102,383.800822028,0.0465160605,0.0794209703,0.39573172,0,59,1.3577002371964472E-4,2.5066902E-4,2.5370964E-4,77,12,1,199,1,0.0050251256
587142680,DuncanWheeler,10,6,5,44,0,2,16.5576855183,10-19,5,1,0,0,0,0,0,0,0,0,0,0,0,0,189,408,4.766339181938244E-5,0,0,191,0,0,8,0,0
587873748,SaveTheELA,10,951,741,693,27,4,57.1303143186,50-59,730,5,105,110,215,215,105,110,6,2.3942795076,35840.8593273151,0.0897629258,0.0518148229,0.14573951,0,59,6.605639403975573E-4,7.181328E-4,7.062728E-4,77,507,1,200,1,0.005
588739585,aviateur1954,10,5387,89,51,4,57,45.9547381486,40-49,724,7,7,4,11,11,7,4,7,3.3595220854,33.7612336227,0.0099126542,0.2181818182,0.8035714,0,59,8.284996629401929E-5,5.4198706E-5,5.485614E-5,145,6,0,201,0,0
588758602,RebelTarot,10,589,111,116,1,0,27.9020969071,20-29,466,4,9,6,15,15,9,6,6,2.8606082549,4.4953929162,0.0148620735,0.1714285714,0.7,0,59,7.864768157963216E-5,6.7748384E-5,6.8570174E-5,182,1,1,198,1,0.0050505051
589139597,MichelaRonzon,10,33,5,30,0,0,11.7341444214,10-19,25,0,0,1,1,1,0,1,7,4.3571428571,0,0,0,0,42,498,4.766339181938244E-5,0,6.8570175E-6,197,1,0,33,0,0
589587227,hjtcfn,10,407,17,40,0,0,25.7891091281,20-29,473,4,2,5,7,7,2,5,7,3.1068066618,10.1477065285,6.265991091685904E-4,0.0714285714,0.3,0,59,5.7209068586904636E-5,2.0324514E-5,2.0571053E-5,77,3,0,199,0,0
589746028,christianoqage,10,30,12,303,0,0,,,22,2,0,0,0,0,0,0,0,0,0,0,0,0,149,337,4.766339181938244E-5,0,0,146,0,0,33,0,0
590004017,philbenthos,10,196,55,52,5,5,29.6142894047,20-29,441,3,4,3,7,7,4,3,7,3.4033309196,100.9174546779,7.856524928211529E-4,0.1904761905,0.36666667,0,59,9.878433117246876E-5,3.3874192E-5,3.4285087E-5,25,25,0,200,0,0
590013232,PDayson,10,1313,151,545,1,73,43.30403989,40-49,551,6,36,84,120,120,36,84,6,2.3718320058,1367.0168706541,0.0443196348,0.1254201681,0.3039895,0,59,2.3627882490932464E-4,2.5066902E-4,2.5370964E-4,182,17,1,200,1,0.005
590650380,BradLeeSev,10,2604,132,286,0,199,44.3696720286,40-49,576,5,24,40,64,64,24,40,6,2.6372194062,4044.7369538948,0.019886269,0.0890376984,0.26161617,0,59,1.1588588591979941E-4,1.6937095E-4,1.7142543E-4,77,25,0,201,0,0
591150170,COPEthunderbay,10,119,31,66,0,0,17.3445602746,10-19,152,4,9,11,20,20,9,11,6,2.7592324403,44.0086938025,0.0106373667,0.1052631579,0.6,0,59,7.541086962090695E-5,6.7748384E-5,6.8570174E-5,182,0,0,160,0,0
591304445,1plus1isSTU,10,1230,95,100,0,69,37.9872929635,30-39,634,5,1,1,2,2,1,1,1,1,0,8.095914281419891E-5,0,0,139,318,3.177448371356425E-4,1.3549677E-5,1.3714035E-5,135,10,0,200,0,0
591461998,smosonyi,10,2082,272,506,6,162,44.2270687932,40-49,635,6,26,59,85,85,26,59,6,2.4123823316,1276.1846825182,0.0403860211,0.1481792717,0.35780886,0,59,1.858258910027642E-4,1.8292063E-4,1.8513948E-4,175,12,1,200,1,0.005
592444926,TatoSerret,10,1527,384,552,0,334,44.2829215129,40-49,681,5,2,3,5,5,2,3,5,2.6875,1,1.7665344078022718E-4,0.1,0.6666667,31,107,2.1307956354060242E-4,2.0324514E-5,2.0571053E-5,108,22,0,199,0,0
592824354,TheGRey23,10,1368,204,141,0,2055,43.028158936,40-49,599,5,0,0,0,0,0,0,0,0,0,0,0,0,272,706,4.766339181938244E-5,0,0,280,7,0,199,0,0
593051958,CorentinDen,10,4369,217,167,0,286,41.6240279024,40-49,694,6,0,0,0,0,0,0,0,0,0,0,0,0,13,79,4.766339181938244E-5,0,0,12,0,0,1,0,0
593274528,susanktelfer,10,192,41,53,5,8,20.8897283154,20-29,281,3,0,1,1,1,0,1,7,2.8668114368,0,0,0,0,0,677,4.766339181938244E-5,0,6.8570175E-6,25,1,0,194,0,0
593723837,Pretty_NemNem,10,9009,80,48,1,14,32.5101397357,30-39,682,6,1,1,2,2,1,1,1,1,0,8.095914281419891E-5,0,0,70,161,3.177448371356425E-4,1.3549677E-5,1.3714035E-5,109,92,0,201,0,0
594021701,ProjectBeaver,10,695,172,150,6,1,46.9179506273,40-49,625,4,22,14,36,36,22,14,6,2.5796524258,353.3970886019,0.0245818557,0.1476190476,0.3264368,0,59,1.2916309257688248E-4,1.5582128E-4,1.577114E-4,77,19,1,200,1,0.005
594531469,CanHealthyOcean,10,476,92,87,5,2,38.5334908926,30-39,517,4,8,12,20,20,8,12,7,2.7451122375,6673.0168046998,0.0140360132,0.1026315789,0.27142859,0,59,2.0527590953400455E-4,6.0973543E-5,6.171316E-5,25,24,0,200,0,0
594914912,patogrande16,10,1245,141,163,0,463,38.5668763829,30-39,604,4,1,1,2,2,1,1,1,1,0,8.095914281419891E-5,0,0,182,391,3.177448371356425E-4,1.3549677E-5,1.3714035E-5,185,6,0,199,0,0
594984816,noneofitwastrue,10,8299,155,188,2,9,35.4215654213,30-39,715,7,14,16,30,30,14,16,7,3.094858798,1384.9600176144,0.0121203805,0.1045977011,0.25889328,0,59,1.0921887386940765E-4,1.0162257E-4,1.02855265E-4,175,81,0,200,0,0
595295537,DrumWenonah,10,496,117,310,3,95,40.7657382432,40-49,489,5,8,15,23,23,8,15,6,2.8874004345,79.01618975,0.0045899755,0.0968379447,0.27916667,0,59,7.460536935336505E-5,6.0973543E-5,6.171316E-5,77,4,0,199,0,0
595590443,JakeBoudrot,10,1659,533,1991,7,26,43.6402671194,40-49,610,6,31,90,121,121,31,90,6,2.3139029689,6562.9739047308,0.0387329454,0.1137052342,0.27618045,0,59,1.5970192924096805E-4,2.1679483E-4,2.1942456E-4,175,20,0,200,0,0
595955853,CorinnaLichota,10,7,10,43,0,0,12.3207895825,10-19,30,0,1,5,6,6,1,5,7,3.112961622,3.084940962,4.06896817411253E-4,0.1333333333,0.25,0,59,5.0952050271794603E-5,1.3549677E-5,1.3714035E-5,25,0,0,8,0,0
596610030,scriven42,10,2730,209,435,0,36,42.4696267923,40-49,611,6,4,14,18,18,4,14,7,2.7566980449,57.6283799068,0.0034473952,0.0947712418,0.24175824,0,59,6.037866398347487E-5,3.3874192E-5,3.4285087E-5,175,3,2,197,2,0.0101522843
596817600,BobbyDeepak1,10,1385,287,328,6,4,48.003900699,40-49,648,5,39,52,91,91,39,52,7,2.5821868211,3768.11199039,0.0392795488,0.1262515263,0.32203752,0,59,2.6407884626311704E-4,2.7099354E-4,2.742807E-4,182,56,0,200,0,0
597453571,CTVNorthernNews,10,7095,2883,87,38,1,45.1361356716,40-49,742,7,22,10,32,32,22,10,7,3.2335264301,485.3733392674,0.0150439828,0.1088709677,0.16781609,0,59,2.6662466883911113E-4,1.5582128E-4,1.5085438E-4,175,41,0,202,0,0
598805924,JenValley1,10,2162,199,314,1,3,22.6853834503,20-29,604,6,19,43,62,62,19,43,7,2.6125995655,471.3977015325,0.0204523431,0.1134320465,0.3218816,0,59,1.166080676306606E-4,1.3549677E-4,1.3714035E-4,182,0,0,200,0,0
599375374,Oldunionist,10,1828,74,237,0,25,36.6022342711,30-39,533,6,19,50,69,69,19,50,6,2.3475742216,579.0955301988,0.0279735957,0.120630861,0.32204083,0,59,1.0788787161558765E-4,1.3549677E-4,1.3714035E-4,182,9,0,200,0,0
599962919,salmavip,10,20410,137,196,1,182,36.2033168479,30-39,719,7,0,0,0,0,0,0,0,0,0,0,0,0,160,358,4.766339181938244E-5,0,0,158,0,0,201,0,0
600839411,1310Jenn,10,558,348,1180,14,1,46.471078204,40-49,602,4,5,34,39,39,5,34,6,2.5586531499,89.0081260189,0.0111446518,0.2618083671,0.54812837,0,59,8.95384602136473E-5,4.064903E-5,4.1142106E-5,175,20,0,200,0,0
601005279,navbanga78,10,24,11,40,0,0,17.6148097219,10-19,151,2,1,2,3,3,1,2,7,3.2458363505,0,9.464896798335843E-4,0.1666666667,0.5,0,59,5.011208789723193E-5,1.3549677E-5,1.3714035E-5,182,0,0,24,0,0
601396321,CanadianDefined,10,3150,352,566,7,5,48.208190535,40-49,691,6,30,53,83,83,30,53,7,2.6285300507,893.8413175069,0.0156429756,0.0614163973,0.24927431,0,59,1.60284825332667E-4,2.1001999E-4,2.1256754E-4,175,32,0,202,0,0
602317392,Grig0rij,10,1207,31,145,0,3,35.6765471625,30-39,491,5,0,2,2,2,0,2,7,4.1333333333,0,0,0,0,42,415,4.766339181938244E-5,0,6.8570175E-6,197,0,0,201,0,0
602446013,marshall_rita,10,2282,222,459,2,296,47.1373017678,40-49,624,6,19,61,80,80,19,61,6,2.444243302,4270.4052768086,0.0238209128,0.1099683544,0.24551971,0,59,1.4484467503723226E-4,1.3549677E-4,1.3714035E-4,77,45,0,195,0,0
603053240,shouldbesaidcan,10,6491,328,520,7,8,36.562493145,30-39,709,7,62,92,154,154,62,92,7,2.5275162925,8401.9921877613,0.0285975539,0.0574229692,0.19294871,0,59,3.090027124278602E-4,4.268148E-4,4.319921E-4,175,37,0,201,0,0
603719194,Colin_m_Brown,10,2613,383,724,8,783,47.1767729134,40-49,650,6,25,50,75,75,25,50,6,2.481173063,666.0679362943,0.0280167634,0.1686486486,0.38361582,0,59,1.6846696926831937E-4,1.761458E-4,1.7828245E-4,175,26,1,200,1,0.005
603831203,DanielaGza21,10,6686,221,604,0,442,32.4896558822,30-39,671,6,2,1,3,3,2,1,2,1.5,0,1.6545491123279624E-4,0.1666666667,0.5,48,132,3.709618101857676E-4,2.0324514E-5,2.0571053E-5,127,15,0,201,0,0
604806474,EkaCoop,10,3631,249,475,6,417,45.2891110333,40-49,633,7,24,50,74,74,24,50,6,2.3935553946,618.0819241727,0.0355341846,0.0927434284,0.2688679,0,59,1.1514287955133503E-4,1.6937095E-4,1.7142543E-4,77,35,0,200,0,0
604842373,A_Wall2,10,826,59,179,1,65,41.269495477,40-49,516,5,8,17,25,25,8,17,7,2.7820419986,291.9860608488,0.0055495803,0.1316666667,0.4632353,0,59,1.222069474029509E-4,6.0973543E-5,6.171316E-5,77,27,0,200,0,0
606459721,Ale_GonzalezN,10,518,88,84,0,14,38.6437980281,30-39,572,4,1,1,2,2,1,1,2,1.5,0,8.271798374069241E-5,0,0,129,289,2.4481546444683235E-4,1.3549677E-5,1.3714035E-5,121,10,0,200,0,0
606492249,peterongilford,10,659,85,133,1,7,40.472177542,40-49,544,5,8,16,24,24,8,16,7,2.7052860246,35.5696788792,0.0076848427,0.1394927536,0.44485295,0,59,8.290662680838498E-5,6.0973543E-5,6.171316E-5,182,8,0,200,0,0
606564909,Ottawa_Andrew,10,134,37,192,1,5,33.4406210347,30-39,329,3,1,15,16,16,1,15,7,2.7719044171,1.8645041063,6.94335489414189E-4,0.2958333333,0.4857143,0,59,5.1362333157016223E-5,1.3549677E-5,1.3714035E-5,175,2,13,180,10,0.0555555556
607054668,HenryMcRandall1,10,1314,689,1992,14,1,40.8065512158,40-49,626,5,9,12,21,21,9,12,7,2.9862418537,533.8458745603,0.0035634663,0.0119047619,0.04945055,0,59,9.663633325924792E-5,6.7748384E-5,6.8570174E-5,77,0,0,200,0,0
607153498,pedrortizolvera,10,5090,307,592,0,10,41.8441921014,40-49,689,6,3,4,7,7,3,4,1,1,2.5,2.5371925759659007E-4,0.0952380952,0.5833333,50,135,3.699212185330677E-4,2.7099353E-5,2.742807E-5,188,90,0,201,0,0
607441902,mediastyle,10,74,148,137,0,2,42.6836186887,40-49,532,3,23,31,54,54,23,31,6,2.5086893555,68.2426874511,0.0478313102,0.141160028,0.50476193,0,59,1.7078100960798303E-4,1.6259612E-4,1.6456842E-4,25,7,0,82,0,0
607531851,vansopinion8ted,10,12819,317,318,11,106,37.6611022949,30-39,665,8,38,42,80,80,38,42,6,2.4891383056,1307.0552293793,0.0330302774,0.0969936709,0.2947995,0,59,1.2455285029404467E-4,2.642187E-4,2.674237E-4,77,18,0,203,0,0
607547478,raincitykitty,10,241,63,338,0,4,22.9752852521,20-29,472,4,5,24,29,29,5,24,6,2.565532223,52.244655793,0.0077584727,0.2007389163,0.41333333,0,59,7.083519965235636E-5,4.064903E-5,4.1142106E-5,25,0,0,200,0,0
607871339,lumiere022,10,38988,875,888,22,1125,43.2735884542,40-49,761,9,24,23,47,47,24,23,6,2.7541636495,348.4156491788,0.0226739761,0.1026827012,0.22119488,0,59,1.4688608060381875E-4,1.6937095E-4,1.7142543E-4,145,19,1,201,1,0.0049751244
607874997,enuff_is_enough,10,223,19,125,0,0,12.9916482201,10-19,127,4,3,10,13,13,3,10,6,2.7324402607,10.852187239,0.0038006318,0.2243589744,0.46363637,0,59,6.0153145303037334E-5,2.7099353E-5,2.742807E-5,77,0,1,200,1,0.005
608237534,corykanderson,10,295,88,169,3,2,36.8787744512,30-39,484,4,5,8,13,13,5,8,7,2.8750905141,1529.5998829089,0.0063697063,0.1025641026,0.375,0,59,9.713191175248207E-5,4.064903E-5,4.1142106E-5,175,1,0,1,0,0
608283021,cdn_media,10,1207,162,245,0,6,44.5210587772,40-49,645,6,36,69,105,105,36,69,6,2.3971759594,4578.5987113156,0.0325370124,0.1022893773,0.21121751,0,59,1.5036441776088722E-4,2.5066902E-4,2.4685264E-4,77,61,0,200,0,0
608395920,teesock,10,2305,120,331,1,438,38.4738638908,30-39,600,6,15,24,39,39,15,24,6,2.4666908038,614.8892340737,0.0270689627,0.1228070175,0.37321937,0,59,1.0308591221725976E-4,1.0839741E-4,1.0971228E-4,25,2,0,198,0,0
608450744,A_J_McDowell,10,3345,250,678,2,463,34.5754068917,30-39,633,6,36,97,133,133,36,97,6,2.3186097031,7870.7392175465,0.0517743214,0.1062314878,0.27138734,0,59,1.8318805678281316E-4,2.5066902E-4,2.5370964E-4,25,29,0,200,0,0
608835608,joan_rollins,10,1306,52,119,1,84,42.5966783529,40-49,573,6,4,9,13,13,4,9,6,2.9417089066,70.4334633696,0.0034741205,0.0769230769,0.17777778,0,59,6.594920462095741E-5,3.3874192E-5,3.4285087E-5,77,4,0,200,0,0
609463458,leftymomma,10,69,33,122,0,0,13.4129683904,10-19,362,3,14,53,67,67,14,53,6,2.527878349,13.0479043728,0.0296371641,0.2976028946,0.6091954,0,59,9.445999991963509E-5,1.0162257E-4,1.02855265E-4,25,0,1,71,1,0.014084507
609603108,RobPaulX,10,3507,95,352,0,1011,43.743790845,40-49,649,7,5,15,20,20,5,15,6,2.7241129616,38.3501791983,0.0051755746,0.1184210526,0.32380953,0,59,6.385436752226295E-5,4.064903E-5,4.1142106E-5,77,8,0,201,0,0
610195349,Vav_j,10,1960,143,405,3,226,41.666984004,40-49,584,6,17,50,67,67,17,50,6,2.452570601,285.2618853521,0.026211877,0.1196291271,0.2937255,0,59,1.0498143992883422E-4,1.2194709E-4,1.2342632E-4,175,21,0,200,0,0
611123793,NataliaGarssa,10,2031,198,228,0,126,40.1069593196,40-49,623,5,0,0,0,0,0,0,0,0,0,0,0,0,200,511,4.766339181938244E-5,0,0,204,11,0,201,0,0
611297227,GamerDad42,10,8,42,23,1,4,26.8763341249,20-29,594,5,4,4,8,8,4,4,7,3.1574945692,1.1703453511,0.0013075013,0.1607142857,0.7,0,59,7.39335239985316E-5,3.3874192E-5,3.4285087E-5,182,0,0,21,0,0
611939245,sturnerto,10,51,42,130,0,0,13.6402565805,10-19,133,2,1,7,8,8,1,7,7,3.0575669804,1.3884157353,8.197444355413436E-4,0.0892857143,0.16666667,0,59,5.109050922329693E-5,1.3549677E-5,1.3714035E-5,175,0,0,52,0,0
612496685,speakup4sci,10,2426,263,185,17,6,49.6490869365,40-49,639,6,34,14,48,48,34,14,6,2.7910934106,1515.2456431614,0.0315629752,0.0877659574,0.26190478,0,59,2.795287107280305E-4,2.3711934E-4,2.3313859E-4,77,78,1,201,1,0.0049751244
612957191,morgan_bell15,10,1335,191,188,0,723,33.4803882139,30-39,633,5,1,5,6,6,1,5,7,3.0333091962,1.3672509424,3.9931188603028713E-4,0.1333333333,0.2,0,59,5.050708100737824E-5,1.3549677E-5,1.3714035E-5,77,5,0,200,0,0
613887465,Davidtl95,10,5033,299,256,0,186,,,723,7,1,0,1,1,1,0,0,0,0,7.92005701980554E-5,0,0,114,254,8.817727671970712E-5,1.3549677E-5,0,183,25,0,200,0,0
614735915,Arciniega95,10,254,55,160,0,20,24.7157999487,20-29,395,3,0,0,0,0,0,0,0,0,0,0,0,0,55,140,4.766339181938244E-5,0,0,49,0,0,200,0,0
615325412,nb_jag,10,22,8,9,0,0,20.8948128984,20-29,119,3,1,0,1,1,1,0,0,0,0,0.0016352349,0,0,0,1,5.1696329636813506E-5,1.3549677E-5,0,25,0,0,1,0,0
616680034,morganpayoe,10,27,17,342,0,0,16.8149155262,10-19,37,2,0,0,0,0,0,0,0,0,0,0,0,0,266,693,4.766339181938244E-5,0,0,273,0,0,27,0,0
617166535,dortheactvxf,10,35,12,318,0,0,,,47,2,0,0,0,0,0,0,0,0,0,0,0,0,218,539,4.766339181938244E-5,0,0,222,0,0,36,0,0
617620300,wolfgang_depner,10,1575,87,520,2,7,42.5532780867,40-49,511,6,8,40,48,48,8,40,6,2.5731354091,90.2727891218,0.0112466137,0.1591312057,0.33397436,0,59,7.511797722587266E-5,6.0973543E-5,6.171316E-5,175,9,1,199,1,0.0050251256
618097167,CharlesTladi,10,2092,71,161,0,44,52.2389941052,50-59,649,7,5,5,10,10,5,5,9,4.8135409124,30.8873015873,4.5157854188309537E-4,0.1222222222,0.4047619,0,59,2.226022270767992E-4,4.064903E-5,4.1142106E-5,131,62,0,187,0,0
618821856,CatUdders,10,550,113,290,1,281,40.2071679808,40-49,566,4,15,32,47,47,15,32,6,2.5977552498,41.4000461161,0.0143742244,0.1720629047,0.5554435,0,59,9.222435977067807E-5,1.0839741E-4,1.0971228E-4,25,15,0,200,0,0
619105419,CindyTurner12,10,15,5,19,0,0,16.6202243016,10-19,6,1,1,0,1,1,1,0,0,0,0,8.745527913125433E-5,0,0,0,43,5.405958222211837E-5,1.3549677E-5,0,182,0,0,19,0,0
619181869,Ann__ie,10,1665,88,137,3,78,39.5286869289,30-39,589,6,9,10,19,19,9,10,7,2.9409847936,30.0933071251,0.0071801703,0.1403508772,0.4010989,0,59,7.965548274620019E-5,6.7748384E-5,6.8570174E-5,77,2,1,200,1,0.005
621918240,paola_colella,10,875,52,87,0,449,38.9691416022,30-39,618,5,1,1,2,2,1,1,7,4.3076923077,0,8.296097357145045E-5,0,0,42,307,0.0011482187,1.3549677E-5,1.3714035E-5,197,5,0,200,0,0
622402583,marycR60,10,254,2,130,0,16,16.3622864782,10-19,243,4,0,3,3,3,0,3,7,3.645674991,0,0,0.3333333333,0.33333334,0,600,4.766339181938244E-5,0,6.8570175E-6,175,1,0,200,0,0
622553460,Lulaaaaa_F,10,3589,31,26,0,19,24.0422524139,20-29,492,2,0,0,0,0,0,0,0,0,0,0,0,0,259,673,4.766339181938244E-5,0,0,264,1,0,201,0,0
623174642,EmraldKatie,10,502,36,348,0,10,26.9260191948,20-29,377,5,3,8,11,11,3,8,7,3.0684286749,0.4244258217,0.0057806617,0.2909090909,0.5888889,0,59,6.205124144410224E-5,2.7099353E-5,2.742807E-5,175,0,2,200,2,0.01
623380122,JohnWBabiak_NDP,10,32,29,140,0,1,17.0855998357,10-19,29,2,7,46,53,53,7,46,7,2.518826937,3.1819586364,0.0176784371,0.320754717,0.63691026,0,59,8.304293678486396E-5,5.4198706E-5,5.485614E-5,25,0,0,34,0,0
623856263,CdnImm,10,5778,606,1635,12,629,38.3015065376,30-39,672,7,40,99,139,139,40,99,6,2.2802317161,7988.135415327,0.0556090368,0.1052027943,0.30210266,0,59,1.642549153143387E-4,2.7776835E-4,2.811377E-4,77,24,0,201,0,0
624022720,BeautifulRed7,10,2977,176,200,3,275,46.8894994686,40-49,678,6,44,59,103,103,44,59,6,2.3740043447,1800.1283976882,0.045308895,0.1112697506,0.35652173,0,59,1.711012358327439E-4,3.0486772E-4,3.0170876E-4,77,31,0,201,0,0
624024743,Camila_b7,10,3434,294,334,0,83,42.4369001406,40-49,676,6,0,0,0,0,0,0,0,0,0,0,0,0,45,129,4.766339181938244E-5,0,0,42,8,0,201,0,0
624960049,genelle_p,10,1483,59,89,0,72,29.0285511877,20-29,578,5,1,1,2,2,1,1,8,3.5608254888,0,1.653174735819888E-4,0,0,0,59,5.457289151032183E-5,1.3549677E-5,1.3714035E-5,77,1,0,198,0,0
624961616,mrmichaelbrodie,10,349,17,105,0,43,18.325121574,10-19,330,4,1,12,13,13,1,12,7,2.6517016655,12.5185695689,2.2103843519276402E-4,0.2692307692,0.46969697,0,59,5.182167326547885E-5,1.3549677E-5,1.3714035E-5,182,0,2,199,2,0.0100502513
626190144,GenevieveLapalm,10,259,151,421,7,4,33.8516252627,30-39,485,4,32,71,103,103,32,71,6,2.4417089066,175.7410443327,0.059071274,0.2055968018,0.55297333,0,59,1.759022312552705E-4,2.2356966E-4,2.2628158E-4,25,9,3,200,3,0.015
626639419,politicalpoints,10,1986,746,621,9,1,51.2228437082,50-59,675,5,103,182,285,285,103,182,6,2.160391021,26147.7272600518,0.0956366609,0.0683098592,0.14686279,0,59,4.2873300217388937E-4,7.045832E-4,7.062728E-4,175,54,2,202,2,0.0099009901
626785167,Lesliepv,10,17276,130,160,0,18,41.4678172152,40-49,734,7,0,0,0,0,0,0,0,0,0,0,0,0,30,105,4.766339181938244E-5,0,0,28,5,0,203,0,0
627055000,DianeOrihel,10,559,228,383,7,15,53.4648848954,50-59,690,5,54,77,131,131,54,77,6,2.4326574946,16548.489013251,0.0520960377,0.0611274222,0.19904241,0,59,4.1395947049953623E-4,3.726161E-4,3.7027895E-4,77,358,4,202,4,0.0198019802
627091485,fleury_antoine,10,332,46,270,0,5,19.574179159,10-19,424,4,6,23,29,29,6,23,6,2.6632874728,143.6671275118,0.0074715087,0.2438423645,0.42923078,0,59,6.632884676267114E-5,4.742387E-5,4.799912E-5,175,1,0,199,0,0
627354853,UACanada,10,376,494,1852,3,22,44.6339218976,40-49,601,5,45,113,158,158,45,113,6,2.2787834902,5127.594093258,0.0398347143,0.0678061759,0.1731506,0,59,1.711368640717719E-4,3.1164257E-4,3.154228E-4,182,94,0,200,0,0
627496559,permajav,10,235,1274,1899,15,1,43.1514628028,40-49,590,4,3,7,10,10,3,7,7,2.952570601,6575.8170117252,0.0026098599,0.0555555556,0.1904762,0,59,5.5514374259276806E-5,2.7099353E-5,2.742807E-5,77,4,0,200,0,0
628891858,JimFare,10,790,51,64,2,3,37.8503701148,30-39,599,5,1,2,3,3,1,2,7,3.1864590876,0,0.0011387626,0.1666666667,1,0,59,5.043254489926508E-5,1.3549677E-5,1.3714035E-5,25,5,0,199,0,0
629335703,SalomeMiroux,10,3453,209,98,0,40,45.101862565,40-49,719,7,3,1,4,4,3,1,5,3.5555555556,0.5,2.6695526543041954E-4,0.1666666667,0.5,58,182,2.956048059486993E-4,2.7099353E-5,2.742807E-5,166,10,0,199,0,0
629785384,lefty_religion,10,937,387,75,6,46,44.594253291,40-49,618,6,25,21,46,46,25,21,7,2.8276611151,5817.7076429731,0.0122997287,0.1028985507,0.44827586,0,59,1.9725121992737767E-4,1.761458E-4,1.7828245E-4,175,30,0,200,0,0
630956515,RicardoGN17,10,224,77,228,0,14,39.7965416254,30-39,529,4,0,0,0,0,0,0,0,0,0,0,0,0,119,266,4.766339181938244E-5,0,0,112,2,0,200,0,0
631155719,PreyraMLA,10,280,322,163,11,3,46.6990880832,40-49,604,4,43,25,68,68,43,25,6,2.7472845764,436.4953160668,0.0370581991,0.1402546093,0.53333336,0,59,2.6318211046871235E-4,2.9809287E-4,3.0170876E-4,147,71,0,200,0,0
631886984,zioJaR,10,454,70,453,0,0,26.9313867212,20-29,434,4,0,2,2,2,0,2,6,3.4285714286,0,0,0.5,1,42,459,4.766339181938244E-5,0,6.8570175E-6,197,3,0,200,0,0
632160153,BruceMHicks,10,2261,321,109,13,0,43.2065436997,40-49,661,6,36,20,56,56,36,20,7,2.8081100652,296.2334335292,0.0812479775,0.1762987013,0.3937198,0,59,3.661100695393141E-4,2.5066902E-4,2.5370964E-4,175,3,2,200,2,0.01
632299570,Bernardo980,10,2230,1001,407,22,1,52.4456158448,50-59,704,6,48,17,65,65,48,17,6,2.7378711079,2207.7533678737,0.0382760469,0.1449519231,0.2910552,0,59,3.345723248301429E-4,3.3196708E-4,3.3599386E-4,182,30,0,200,0,0
632320063,hex_hut,10,843,328,1108,3,10,44.1934238208,40-49,509,5,4,8,12,12,4,8,7,3.1252715424,109.0921682238,0.0019391624,0.0984848485,0.3392857,0,59,9.166255793553868E-5,3.3874192E-5,3.4285087E-5,175,2,0,200,0,0
632333471,kalhiapaola,10,15721,300,254,0,734,34.694979021,30-39,737,7,1,1,2,2,1,1,1,1,0,8.095914281419891E-5,0,0,181,386,3.177448371356425E-4,1.3549677E-5,1.3714035E-5,268,5,0,200,0,0
632592632,not_Klaatu,10,1710,283,646,8,42,50.1790706012,50-59,670,6,32,44,76,76,32,44,6,2.5854453295,4631.8832185062,0.0335706767,0.0603508772,0.21631205,0,59,2.546520137273254E-4,2.2356966E-4,2.1942456E-4,77,95,0,200,0,0
634874281,KaraArdan,10,1034,92,198,0,112,42.6979624317,40-49,594,5,24,52,76,76,24,52,6,2.527878349,957.8216165686,0.0258683145,0.0757894737,0.24434389,0,59,1.0991765113447683E-4,1.6937095E-4,1.7142543E-4,77,22,0,200,0,0
634881785,PerriconeSergio,10,78,13,111,0,0,12.6209713021,10-19,24,3,0,1,1,1,0,1,7,4.3571428571,0,0,0,0,42,500,4.766339181938244E-5,0,6.8570175E-6,197,0,0,100,0,0
635864855,Terry1987jets,10,208,165,153,0,40,42.6275004429,40-49,641,6,2,2,4,4,2,2,8,3.444243302,0.3940344814,7.637219803407573E-4,0.1666666667,0.6666667,0,59,5.3967307997493266E-5,2.0324514E-5,2.0571053E-5,175,7,0,201,0,0
635921796,gaganiesingh,10,2587,59,364,0,691,31.0788890177,30-39,495,6,0,3,3,3,0,3,7,3.4411871155,0,0,0.5,1,0,623,4.766339181938244E-5,0,6.8570175E-6,25,0,0,200,0,0
637023555,NjUhuruMapapu,10,6364,237,197,2,16,51.0928724368,50-59,694,7,0,1,1,1,0,1,1,1,0,0,0,0,0,540,4.766339181938244E-5,0,6.8570175E-6,131,1,0,201,0,0
637293275,ABRestOfCaucus,10,10,10,14,1,0,17.8488841595,10-19,100,1,1,0,1,1,1,0,0,0,0,3.203613112146892E-4,0,0,0,47,5.154160665305529E-5,1.3549677E-5,0,175,0,0,10,0,0
701821014,flynnwilkins,10,80,7,18,0,12,16.6063093424,10-19,67,2,1,3,4,4,1,3,7,3.2150615496,0.1363435399,0.0037465653,0.1666666667,0.6666667,0,59,6.37432713326096E-5,1.3549677E-5,1.3714035E-5,25,2,3,83,3,0.0361445783
703722876,ThomasHall17,10,1485,143,64,2,0,47.8707444869,40-49,654,6,23,15,38,38,23,15,7,2.8729181752,18.8708148421,0.0393477576,0.1642958748,0.2907197,0,59,2.2213892657519546E-4,1.6259612E-4,1.6456842E-4,175,24,17,206,16,0.0776699029
704976138,CanPakTimes,10,3949,107,234,0,4,42.613163238,40-49,540,5,4,18,22,22,4,18,6,2.7067342505,80.1547979141,0.0107880852,0.1883116883,0.36842105,0,59,7.164325557073561E-5,3.3874192E-5,3.4285087E-5,175,9,0,203,0,0
705370724,SettlerColonial,10,6807,3322,272,64,205,66.7727600344,60-69,820,7,162,16,178,178,162,16,7,2.8884866039,4578.4696172131,0.1057790136,0.0547832159,0.09597191,0,59,0.0011052012,0.0011042986,0.0011108369,77,445,0,204,0,0
705462967,ChadatScribe_it,10,1452,48,172,0,13,32.3746235457,30-39,551,5,10,17,27,27,10,17,7,2.9319333816,259.2639754,0.0042653191,0.084045584,0.2977941,0,59,8.912643777187681E-5,7.452322E-5,7.542719E-5,182,9,0,200,0,0
705490496,kenlister1,10,362,35,90,0,9,36.9518139847,30-39,498,4,5,15,20,20,5,15,7,2.8848660391,6.2507724247,0.0091190874,0.2,0.46666667,0,59,7.617021054108036E-5,4.064903E-5,4.1142106E-5,175,9,1,200,1,0.005
706318964,Sya_Bennington,10,11229,130,119,0,1699,36.404879439,30-39,742,7,2,2,4,4,2,2,1,1,0,1.6551228476954845E-4,0.0833333333,1,47,131,3.177448371356425E-4,2.0324514E-5,2.0571053E-5,44,95,0,201,0,0
706539001,nguyenotn,10,83,22,502,0,0,,,82,2,0,0,0,0,0,0,0,0,0,0,0,0,69,160,4.766339181938244E-5,0,0,61,0,0,85,0,0
707215531,LauraZBelchi,10,5430,260,263,0,43,44.5508342618,40-49,724,7,0,0,0,0,0,0,0,0,0,0,0,0,46,130,4.766339181938244E-5,0,0,43,36,0,197,0,0
707701220,jackialvarezup,10,68,25,519,0,0,17.0763564109,10-19,55,2,0,0,0,0,0,0,0,0,0,0,0,0,215,536,4.766339181938244E-5,0,0,219,0,0,201,0,0
707859842,AlexTyrrellPVQ,10,591,124,374,11,1,35.5740317852,30-39,589,4,14,51,65,65,14,51,6,2.4551049964,600.1374794385,0.0236335882,0.1752403846,0.39668176,0,59,9.786224559800942E-5,1.0162257E-4,1.02855265E-4,25,9,1,200,1,0.005
708826764,A_W_Global_HQ,10,15805,5771,5924,113,1,58.7760765543,50-59,817,8,12,12,24,24,12,12,7,2.9167270094,2477.047331792,0.0086431879,0.0344202899,0.22727273,0,59,1.3651590326551428E-4,8.80729E-5,8.914123E-5,77,33,0,201,0,0
711063583,NDPLondon,10,551,130,129,4,1,35.96089704,30-39,513,5,48,52,100,100,48,52,7,2.5021723389,611.5514104287,0.0524884958,0.1571717172,0.35564435,0,59,2.145749687807934E-4,3.3196708E-4,3.3599386E-4,25,19,8,200,8,0.04
713308196,reesespeaksblog,10,111,4,14,0,0,20.1395213733,20-29,167,2,1,2,3,3,1,2,7,3.3942795076,0,8.925105282957938E-5,0.1666666667,1,0,59,6.118141870493022E-5,1.3549677E-5,1.3714035E-5,77,2,0,163,0,0
713387070,ToryBluest,10,1322,96,689,2,1,18.0626913353,10-19,621,6,10,78,88,88,10,78,6,2.3392469225,892.3831225982,0.0106423058,0.2157784744,0.3344733,0,59,8.695763788189494E-5,7.452322E-5,7.542719E-5,175,5,0,199,0,0
714846560,YukonNDPCaucus,10,56,99,90,5,0,29.5263939786,20-29,343,1,6,4,10,10,6,4,7,3.2827661115,7.9396967027,0.0079688067,0.2333333333,0.33333334,0,59,6.262282477452234E-5,4.742387E-5,4.799912E-5,182,1,2,59,2,0.0338983051
716082330,DomenicoJoyful,10,593,12,34,0,0,13.8452685555,10-19,414,5,0,1,1,1,0,1,7,4.3571428571,0,0,0,0,42,535,4.766339181938244E-5,0,6.8570175E-6,197,0,0,200,0,0
718634976,ThomasP94790160,10,9851,122,540,2,243,33.8783695268,30-39,574,8,4,4,8,8,4,4,8,3.8729181752,44.2589743587,0.0050116724,0.0535714286,0.13333334,0,59,1.6621982878555158E-4,3.3874192E-5,3.4285087E-5,175,0,0,201,0,0
719098436,TaliaPapadakis,10,7502,651,1975,3,73,50.1172454612,50-59,700,7,27,100,127,127,27,100,6,2.3178855902,5724.1886481416,0.032531151,0.0929883765,0.19976704,0,59,1.3717771387698277E-4,1.8969548E-4,1.9199649E-4,175,123,0,202,0,0
719102646,MervAdey,10,2571,194,572,4,44,47.210853479,40-49,674,7,45,87,132,132,45,87,7,2.3957277335,2384.6107117012,0.0445191053,0.0962294703,0.292674,0,59,1.8797659856502325E-4,3.1164257E-4,3.154228E-4,182,30,0,200,0,0
720947208,NDPptbo,10,109,139,253,6,16,40.6996320662,40-49,496,3,23,44,67,67,23,44,6,2.387038378,254.5016659588,0.0261470227,0.1605608322,0.40248227,0,59,1.0321696829314171E-4,1.6259612E-4,1.6456842E-4,25,22,3,126,3,0.0238095238
721429753,friesen_s,10,47,15,29,0,2,29.1496001911,20-29,369,2,4,5,9,9,4,5,7,3.0695148443,1.6102930264,0.0019491581,0.2638888889,0.4642857,0,59,6.096379354356095E-5,3.3874192E-5,3.4285087E-5,182,12,0,62,0,0
725359914,francisdkp,10,60,22,530,0,0,19.7346754467,10-19,62,2,0,0,0,0,0,0,0,0,0,0,0,0,192,413,4.766339181938244E-5,0,0,195,1,0,200,0,0
726646680,1837society,10,73,78,596,3,0,26.3825623574,20-29,149,2,10,71,81,81,10,71,6,2.414192614,62.3800996871,0.0200201799,0.2407407407,0.445586,0,59,1.0072984078190081E-4,7.452322E-5,7.542719E-5,25,0,0,79,0,0
726659041,fabmar78,10,1894,65,202,1,1,32.1110289037,30-39,491,6,1,1,2,2,1,1,7,4.2307692308,0,8.275709239615328E-5,0.5,0.5,42,307,1.7295027135117214E-4,1.3549677E-5,1.3714035E-5,197,0,0,200,0,0
729177630,gatemage,10,212,14,77,0,5,28.1159646332,20-29,479,4,0,0,0,0,0,0,0,0,0,0,0,0,269,698,4.766339181938244E-5,0,0,276,6,0,200,0,0
733527702,electionquebec,10,90,22,0,2,0,21.1983448627,20-29,404,3,0,0,0,0,0,0,0,0,0,0,0,0,150,338,4.766339181938244E-5,0,0,148,13,0,155,0,0
733733526,k_swartz_13,10,827,203,210,0,1002,40.8886204333,40-49,618,5,1,1,2,2,1,1,3,2,0,8.273692819691865E-5,0,0,49,134,2.229792226986586E-4,1.3549677E-5,1.3714035E-5,181,17,0,199,0,0
735219133,iloittamoloap,10,430,11,60,0,4,12.2285441559,10-19,149,4,0,1,1,1,0,1,7,4.3571428571,0,0,0,0,42,483,4.766339181938244E-5,0,6.8570175E-6,197,1,0,199,0,0
735439969,jennkfrench,10,475,178,200,0,41,43.7561639368,40-49,628,5,24,26,50,50,24,26,6,2.6727009413,434.2066932878,0.0219566983,0.0767346939,0.28024194,0,59,1.3763275931338682E-4,1.6937095E-4,1.7142543E-4,182,30,0,200,0,0
737364186,DontDoDinosaurs,10,660,106,325,2,283,37.7780670596,30-39,511,4,8,11,19,19,8,11,7,2.7889210717,25.1808711152,0.008775329,0.2046783626,0.42647058,0,59,7.369580100004807E-5,6.0973543E-5,6.171316E-5,175,6,0,200,0,0
738165294,tebza_e,10,7462,369,602,4,4,50.7662564124,50-59,741,7,0,0,0,0,0,0,0,0,0,0,0,0,154,345,4.766339181938244E-5,0,0,152,80,0,201,0,0
741354828,jdougherty7,10,423,67,118,0,424,36.4783048468,30-39,518,4,1,1,2,2,1,1,1,1,0,8.095914281419891E-5,0,0,182,391,3.177448371356425E-4,1.3549677E-5,1.3714035E-5,185,1,0,201,0,0
741495972,HunkeJosh,10,155,141,519,0,2,31.4529020784,30-39,431,3,2,2,4,4,2,2,7,3.4456915279,5712.6044078857,1.811036784367484E-4,0,0,0,59,1.486001066959678E-4,2.0324514E-5,2.0571053E-5,77,7,0,162,0,0
741637338,MonDoubleU,10,598,108,414,0,25,36.6505104589,30-39,530,5,9,57,66,66,9,57,6,2.433019551,65.9066780361,0.0152460714,0.2356643357,0.43436176,0,59,9.163618215969804E-5,6.7748384E-5,6.8570174E-5,175,7,0,199,0,0
745795364,MusingGma,10,1190,25,37,1,1138,40.9906318247,40-49,556,6,9,7,16,16,9,7,7,2.8258508327,169.4106031372,0.0070173801,0.1791666667,0.44871795,0,59,8.78618646384122E-5,6.7748384E-5,6.8570174E-5,175,15,0,201,0,0
746562397,Vale_DLG,10,2608,155,213,0,77,42.0696047324,40-49,659,6,3,2,5,5,3,2,1,1,4,2.447120443747362E-4,0.05,0.16666667,48,132,6.829870783702319E-4,2.7099353E-5,2.742807E-5,127,29,0,201,0,0
746959880,Potriote,10,1250,83,188,1,58,41.4366626297,40-49,484,5,7,31,38,38,7,31,7,2.5307748009,32.3614418056,0.0149554803,0.2304409673,0.53978497,0,59,7.35869730138247E-5,5.4198706E-5,5.485614E-5,25,14,8,201,8,0.039800995
748112826,josephcrr,10,126,26,48,0,2,29.5707366423,20-29,439,3,0,0,0,0,0,0,0,0,0,0,0,0,111,251,4.766339181938244E-5,0,0,102,16,0,190,0,0
748318784,juanma_goro,10,718,82,270,1,58,32.9194339568,30-39,477,5,1,1,2,2,1,1,2,1.5,0,8.271798374069241E-5,0,0,77,173,2.4481546444683235E-4,1.3549677E-5,1.3714035E-5,69,8,0,199,0,0
749233422,maylkfvines,10,47,16,184,0,0,14.0331813725,10-19,39,1,0,0,0,0,0,0,0,0,0,0,0,0,152,342,4.766339181938244E-5,0,0,150,0,0,48,0,0
749588269,SeaOfIntensions,10,44,11,28,0,29,22.8188779532,20-29,329,2,0,1,1,1,0,1,1,1,0,0,0,0,0,399,4.766339181938244E-5,0,6.8570175E-6,25,2,0,74,0,0
751132801,zabajames,10,1526,279,1297,1,17,44.1539043232,40-49,623,6,3,8,11,11,3,8,8,4.1013758146,20981.8534505643,3.300723983713433E-4,0.0727272727,0.17857143,0,59,3.917155228255646E-4,2.7099353E-5,2.742807E-5,131,3,0,204,0,0
751168627,EleanorSibbert,10,681,28,68,0,24,30.9191850491,30-39,498,5,10,15,25,25,10,15,6,2.726647357,357.2433967816,0.0163908885,0.1283333333,0.40808824,0,59,8.691499048221842E-5,7.452322E-5,7.542719E-5,25,31,0,200,0,0
751372069,1shelleysiemens,10,113,36,177,0,10,20.3815844315,20-29,243,3,5,29,34,34,5,29,6,2.5275162925,41.4279450993,0.0095606596,0.1488413547,0.2672414,0,59,6.003671618062799E-5,4.064903E-5,4.1142106E-5,182,8,1,136,1,0.0073529412
751402752,popsicles10,10,2783,85,99,5,461,46.7174875371,40-49,693,7,15,13,28,28,15,13,7,2.765025344,96.0502677389,0.0118133552,0.0873015873,0.4154412,0,59,1.0843605792312265E-4,1.0839741E-4,1.0971228E-4,175,57,0,201,0,0
752150724,JanellyCardiel9,10,5876,177,179,0,161,,,688,6,1,1,2,2,1,1,6,4.0625,0,8.27753643879928E-5,0,0,31,107,1.8063089552866835E-4,1.3549677E-5,1.3714035E-5,108,3,0,201,0,0
752608976,PaulTremblay9,10,11774,1675,1999,16,139,48.8358682837,40-49,723,8,17,24,41,41,17,24,7,2.6379435192,827.2231422112,0.01656775,0.1195121951,0.31505376,0,59,1.3964372397110044E-4,1.2194709E-4,1.2342632E-4,145,4,0,200,0,0
753680450,HollyBryant12,10,77,28,87,0,2,17.9543235743,10-19,238,2,1,4,5,5,1,4,7,3.2099927589,3.8333179418,9.402050707889879E-5,0.1,0.16666667,0,59,6.57605396393877E-5,1.3549677E-5,1.3714035E-5,77,3,0,91,0,0
754184833,Zonyeol,10,13984,685,651,1,154,47.4402914643,40-49,744,7,1,0,1,1,1,0,0,0,0,8.27752202971854E-5,0,0,22,94,1.3226065427434438E-4,1.3549677E-5,0,126,5,0,201,0,0
755119340,DocZA1,10,1173,594,23,7,0,46.0841272161,40-49,616,4,3,0,3,3,3,0,0,0,0,2.7331085449371485E-4,0.1666666667,0.33333334,0,41,9.981358074565651E-5,2.7099353E-5,0,131,1,0,200,0,0
756913038,lgfc2,10,1099,24,14,0,85,26.3747119243,20-29,529,4,6,4,10,10,6,4,7,3.0774800869,1.485492307,0.0117209053,0.3333333333,0.5555556,0,59,6.818423639378968E-5,4.742387E-5,4.799912E-5,77,4,6,200,6,0.03
759565674,roliescsa,10,31,5,56,0,15,17.037820455,10-19,62,2,0,0,0,0,0,0,0,0,0,0,0,0,39,119,4.766339181938244E-5,0,0,36,0,0,55,0,0
761641470,Dylan__Day,10,471,155,113,0,15,41.4313185542,40-49,532,4,1,3,4,4,1,3,7,3.4188993483,0.9053173032,1.5771308535912466E-4,0.0833333333,0.083333336,0,59,5.12218290146971E-5,1.3549677E-5,1.3714035E-5,182,19,0,201,0,0
761873688,amazinmind,10,2073,177,517,6,83,28.026407005,20-29,506,5,1,3,4,4,1,3,7,3.444243302,0.1320688503,1.980628855163712E-4,0.0833333333,0.33333334,0,59,5.135921487557082E-5,1.3549677E-5,1.3714035E-5,175,3,0,200,0,0
761875566,muslixmuslix,10,186,49,181,1,110,22.8824071271,20-29,349,3,0,2,2,2,0,2,7,3.4209192906,0,0,0.5,0.5,0,195,4.766339181938244E-5,0,6.8570175E-6,182,0,0,198,0,0
762843570,redinhamilton,10,389,52,74,0,0,30.4709897974,30-39,425,4,11,13,24,24,11,13,6,2.7758870384,86.3984514092,0.0136527423,0.1177536232,0.5285714,0,59,1.0152176197891268E-4,8.129806E-5,8.228421E-5,182,12,3,200,3,0.015
765819529,anikasparling,10,532,176,582,5,14,42.031860228,40-49,510,5,11,69,80,80,11,69,6,2.387038378,1419.6461123836,0.0187960272,0.1865506329,0.3641822,0,59,1.3902115745083972E-4,8.129806E-5,8.228421E-5,175,2,2,200,2,0.01
770671867,ChilliwackNDP1,10,10665,374,495,8,94,49.8079773092,40-49,690,8,83,107,190,190,83,107,6,2.3265749457,10694.6393007845,0.0716135956,0.0530771373,0.22153972,0,59,3.2418051288295944E-4,5.690864E-4,5.759895E-4,182,123,0,210,0,0
771576320,dan_bolduc,10,7201,2076,2244,22,1218,56.0016371747,50-59,743,7,14,16,30,30,14,16,7,3.0879797248,181.0424381697,0.0037816036,0.0609195402,0.34583333,0,59,1.4963544465864366E-4,1.0162257E-4,1.02855265E-4,145,5,0,201,0,0
771844718,rachellynnbk,10,231,7,43,0,8,13.9267607181,10-19,177,4,0,2,2,2,0,2,7,3.2920738328,0,0,0.5,1,0,510,4.766339181938244E-5,0,6.8570175E-6,182,0,0,200,0,0
772579484,Francisco_Cux,10,371,61,70,1,0,36.753743705,30-39,499,4,3,4,7,7,3,4,7,3.4446053584,4.5000286535,6.892359266349693E-4,0.119047619,0.6666667,0,59,6.82633005782637E-5,2.7099353E-5,2.742807E-5,175,14,0,200,0,0
773659566,ichannels_Mel,10,486,309,763,4,1,36.4691479697,30-39,537,5,61,160,221,221,61,160,6,2.2002172339,4713.6080302345,0.0682790827,0.0642739613,0.1889544,0,59,2.6537039723679024E-4,4.2003999E-4,4.2513508E-4,77,37,1,200,1,0.005
776270952,hempsterbc,10,7994,941,1920,9,7736,51.0764637629,50-59,679,7,60,111,171,171,60,111,6,2.2860246198,6902.4035919212,0.0595847017,0.0703474372,0.24266419,0,59,2.1164203196495068E-4,4.1326514E-4,4.1827807E-4,77,36,0,200,0,0
776399773,guayjeanfrcois,10,17,24,279,0,3,17.0376144503,10-19,35,2,0,2,2,2,0,2,7,3.3293521535,0,0,0.5,0.5,0,292,4.766339181938244E-5,0,6.8570175E-6,182,0,0,19,0,0
779084587,StuartDHunter,10,104,17,83,0,88,21.8206225161,20-29,302,3,2,7,9,9,2,7,7,2.9272266474,1.3045847794,0.0023100528,0.3333333333,0.4861111,0,59,5.0361282602211395E-5,2.0324514E-5,2.0571053E-5,175,0,1,116,1,0.0086206897
781099260,jturows,10,332,38,75,0,159,29.1533535066,20-29,447,4,2,2,4,4,2,2,7,3.2429398986,0,0.0013803827,0.25,0.6666667,0,59,5.1351185226499615E-5,2.0324514E-5,2.0571053E-5,25,11,0,199,0,0
784120867,scattiva,10,798,41,161,0,6,28.6411551981,20-29,398,5,0,1,1,1,0,1,7,4.3571428571,0,0,0,0,42,494,4.766339181938244E-5,0,6.8570175E-6,197,0,0,200,0,0
785344027,EMSimma,10,1425,147,141,8,104,42.6798623,40-49,612,5,0,2,2,2,0,2,7,3.1617806732,0,0,0.5,0.5,0,688,4.766339181938244E-5,0,6.8570175E-6,182,0,0,200,0,0
785780090,Thomjanis,10,2961,226,649,2,8,36.5126035887,30-39,597,7,41,111,152,152,41,111,6,2.3627805938,2429.321714341,0.0337530317,0.0778581387,0.2078624,0,59,1.6721848123774747E-4,2.845432E-4,2.8799474E-4,182,5,0,202,0,0
789861271,isaaclarazaa,10,105,47,51,0,12,21.7194655256,20-29,442,3,0,0,0,0,0,0,0,0,0,0,0,0,131,291,4.766339181938244E-5,0,0,123,9,0,117,0,0
791995963,philYama,10,1787,1200,1095,17,183,48.7167336769,40-49,656,6,60,60,120,120,60,60,6,2.3979000724,5616.4879175223,0.0665190862,0.0530812325,0.3141827,0,59,2.1500281926939324E-4,4.1326514E-4,4.1827807E-4,77,11,0,200,0,0
792824815,TanisCrosby,10,11,50,24,0,0,36.4759017607,30-39,453,1,21,5,26,26,21,5,7,2.9493120927,16.1244070185,0.0134096071,0.3138461538,0.6304348,0,59,1.4435135641621376E-4,1.4904643E-4,1.5085438E-4,147,56,0,15,0,0
794664236,Kevin22632969,10,702,44,161,1,1,26.5229730942,20-29,347,5,14,34,48,48,14,34,6,2.60391021,244.4752548224,0.0258747267,0.1484929078,0.42222223,0,59,1.2091837870817399E-4,1.0162257E-4,1.02855265E-4,147,1,1,200,1,0.005
794758278,PoeticDevicesX,10,1600,312,352,8,83,51.0444682035,50-59,724,6,31,35,66,66,31,35,7,2.7306299783,4237.3796515979,0.0159308273,0.0629370629,0.3243243,0,59,1.712233138068904E-4,2.1679483E-4,2.1942456E-4,182,74,0,200,0,0
795423546,nnocitob,10,277,40,78,0,0,25.8416827366,20-29,268,2,0,0,0,0,0,0,0,0,0,0,0,0,235,606,4.766339181938244E-5,0,0,239,0,0,200,0,0
796719091,Falardau,10,2026,580,1005,7,0,44.0776642775,40-49,700,6,6,13,19,19,6,13,7,3.2563359884,77.8132634725,0.0063247395,0.1754385965,0.4,0,59,7.761676971420906E-5,4.742387E-5,4.799912E-5,145,4,0,199,0,0
798193664,MaxPaaul,10,852,61,58,0,20,41.5749691504,40-49,681,5,2,1,3,3,2,1,1,1,1,1.6017852190947145E-4,0,0,103,230,4.636035825132626E-4,2.0324514E-5,1.3714035E-5,94,25,0,200,0,0
799669088,JennOwensRMT,10,76,2,11,0,2,11.0632857838,10-19,32,1,0,1,1,1,0,1,1,1,0,0,0,0,0,699,4.766339181938244E-5,0,6.8570175E-6,25,0,0,76,0,0
802387309,CU_Harmeet,10,585,224,212,5,0,41.3460959961,40-49,574,4,1,2,3,3,1,2,7,3.4963794352,0,1.0780144306318418E-4,0.1666666667,0.5,0,59,5.377151501825335E-5,1.3549677E-5,1.3714035E-5,175,0,0,200,0,0
802649408,AleanaYoung,10,1435,317,500,9,14,44.9679772784,40-49,645,5,23,36,59,59,23,36,7,2.6781317886,225.4569321653,0.0163132462,0.1502045587,0.49634147,0,59,1.4489762695665177E-4,1.6259612E-4,1.6456842E-4,25,18,1,200,1,0.005
802723027,Kimbo_Traffic,10,77,46,109,1,0,22.7138948872,20-29,398,4,0,4,4,4,0,4,7,3.2377850163,0,0,0.5,0.8333333,0,582,4.766339181938244E-5,0,6.8570175E-6,182,0,0,127,0,0
805229539,SampsoninNS,10,530,150,223,1,7,42.4700153303,40-49,612,5,46,55,101,101,46,55,6,2.5901520637,751.5402392975,0.0422170601,0.0918811881,0.38376856,0,59,2.7103095004830734E-4,3.1841738E-4,3.222798E-4,147,130,0,200,0,0
805321236,lnb1956,10,1441,74,271,2,36,36.702642471,30-39,566,6,3,15,18,18,3,15,6,2.755249819,0.4047359598,0.0037290696,0.3431372549,0.6666667,0,59,5.258474955689278E-5,2.7099353E-5,2.742807E-5,175,0,0,200,0,0
805996554,gsdenton,10,391,93,258,2,102,37.6998596942,30-39,522,3,19,44,63,63,19,44,6,2.5528602462,4326.4271693713,0.0363334123,0.1382488479,0.4121212,0,59,1.504670955211966E-4,1.3549677E-4,1.3714035E-4,25,7,0,200,0,0
811236194,stratdemwatch,10,959,116,213,2,12,41.5447118389,40-49,562,5,21,27,48,48,21,27,6,2.5622737147,1408.2109191239,0.0284550053,0.0740248227,0.39173788,0,59,1.1265851796640474E-4,1.4904643E-4,1.5085438E-4,77,22,0,200,0,0
811301882,davinci97y,10,251,24,168,0,0,25.4829680129,20-29,243,2,0,0,0,0,0,0,0,0,0,0,0,0,175,378,4.766339181938244E-5,0,0,174,0,0,200,0,0
811549418,Dar_CD,10,340,30,116,0,1,21.613817575,20-29,566,5,17,59,76,76,17,59,6,2.4207096307,171.6124863064,0.0251640063,0.2140350877,0.5019774,0,59,9.658207411444192E-5,1.2194709E-4,1.2342632E-4,25,25,3,200,3,0.015
814062072,ShitNewsNetwork,10,33,11,48,0,0,16.9066178591,10-19,41,2,3,17,20,20,3,17,6,2.622013034,4.2698186406,0.0102104097,0.2052631579,0.4375,0,59,6.124089047065194E-5,2.7099353E-5,2.742807E-5,77,0,0,32,0,0
816205286,Kenny_Bell_IQ,10,5945,303,294,5,26,49.3891752492,40-49,696,7,6,7,13,13,6,7,6,2.7827661115,659.4452779447,0.0112046329,0.0576923077,0.3809524,0,59,8.152331350834146E-5,4.742387E-5,4.799912E-5,77,23,1,200,1,0.005
817518192,C_E_McLaughlin,10,81,126,227,1,0,31.646261647,30-39,416,3,17,38,55,55,17,38,6,2.4670528602,172.3546472229,0.0202495637,0.1451178451,0.40469417,0,59,1.1254896052194579E-4,1.2194709E-4,1.2342632E-4,25,4,1,88,1,0.0113636364
818707315,sean_theguard,10,152,113,142,1,2,30.4970057597,30-39,441,3,13,13,26,26,13,13,7,2.9598117306,11.8388529233,0.0108701271,0.2,0.5906433,0,59,7.96650891726294E-5,9.484774E-5,9.599824E-5,182,2,1,182,1,0.0054945055
819665880,lcbo_worker,10,186,297,1323,4,0,45.1213047591,40-49,526,4,46,99,145,145,46,99,6,2.3139029689,6310.632287013,0.0336841373,0.0711685824,0.19150062,0,59,1.6527004927648585E-4,3.1841738E-4,3.222798E-4,182,64,0,199,0,0
821734045,good_robyn,10,704,27,67,1,10,43.1666477596,40-49,615,6,9,18,27,27,9,18,7,2.8280231716,1000.6988333604,0.0067828001,0.0883190883,0.35620916,0,59,9.524509576205387E-5,6.7748384E-5,6.8570174E-5,175,44,5,238,5,0.0210084034
821990130,NDPDESI,10,58,148,809,0,0,29.0351964688,20-29,407,3,18,26,44,44,18,26,7,2.8258508327,3518.4139538141,0.0240666137,0.1178646934,0.33743843,0,59,1.724879118400661E-4,1.2872192E-4,1.2342632E-4,25,10,0,62,0,0
825039750,NikoBkk,10,222,12,53,0,0,25.5865097623,20-29,425,4,0,1,1,1,0,1,7,4.3571428571,0,0,0,0,42,435,4.766339181938244E-5,0,6.8570175E-6,197,0,0,200,0,0
829767386,YosheLeigh1,10,127,14,68,0,0,19.3782400852,10-19,312,3,2,7,9,9,2,7,7,2.8816075308,0.4434974471,0.0027609197,0.125,0.33333334,0,59,5.234246850377027E-5,2.0324514E-5,2.0571053E-5,182,3,0,131,0,0
830316386,ToshLawKidz,10,1442,155,235,0,187,42.1157792084,40-49,563,5,1,9,10,10,1,9,7,2.9449674149,0.1376173652,0.0041882386,0.3333333333,0.54444444,0,59,5.351726810400683E-5,1.3549677E-5,1.3714035E-5,175,3,0,200,0,0
831282715,Blueliberals,10,3527,437,1996,3,18,37.8227563217,30-39,556,7,43,147,190,190,43,147,6,2.2690079652,2385.8034724079,0.0408094354,0.1169033695,0.2664877,0,59,1.8417746621092216E-4,2.9809287E-4,3.0170876E-4,175,6,0,199,0,0
831366276,ChaReboutier,10,1903,127,125,0,21,46.3379356365,40-49,688,6,6,4,10,10,6,4,4,2.6111111111,21.9166666667,5.284759873576483E-4,0.1111111111,0.5,58,182,5.646773245498568E-4,4.742387E-5,4.799912E-5,166,20,0,201,0,0
831767154,CycleTOMidtown,10,172,113,168,8,5,38.091332614,30-39,510,3,3,5,8,8,3,5,6,2.9301230992,16.5651926871,0.0016207597,0.0535714286,0.3,0,59,5.574783499695871E-5,2.7099353E-5,2.742807E-5,175,7,0,177,0,0
832349402,ndp_vinorth,10,2902,65,68,6,8,27.9838363215,20-29,359,6,25,47,72,72,25,47,7,2.5738595221,57.3380565683,0.0385512537,0.2662363067,0.4810096,0,59,1.2202599668258707E-4,1.761458E-4,1.7828245E-4,25,4,6,228,6,0.0263157895
832448934,Katiesrant,10,3636,194,101,2,278,44.4893520647,40-49,707,7,23,19,42,42,23,19,7,3.0028964518,109.9719978296,0.0140267002,0.1231126597,0.3689655,0,59,1.2437624268367176E-4,1.6259612E-4,1.6456842E-4,182,15,0,200,0,0
833513995,lfay_lorraine,10,8777,449,2001,8,1188,49.619584645,40-49,612,8,2,38,40,40,2,38,7,2.821506155,21.6526788573,4.846313978133951E-4,0.2153846154,0.33805668,0,59,5.473197840755652E-5,2.0324514E-5,2.0571053E-5,175,0,0,201,0,0
837000614,xryanhurdx,10,180,210,88,3,30,42.5664146521,40-49,553,3,2,2,4,4,2,2,1,1,0,1.6551228476954845E-4,0.0833333333,1,20,91,3.177448371356425E-4,2.0324514E-5,2.0571053E-5,18,12,0,199,0,0
838325360,EasyBreakOven,10,64,64,28,1,0,37.7839258542,30-39,467,2,1,0,1,1,1,0,0,0,0,0.0064515096,0,0,0,54,5.695780909507137E-5,1.3549677E-5,0,25,6,1,77,1,0.012987013
840565326,LelahChurch,10,58,19,380,0,0,,,31,2,0,0,0,0,0,0,0,0,0,0,0,0,36,114,4.766339181938244E-5,0,0,33,0,0,62,0,0
840925669,missmaplesleafs,10,517,41,213,1,235,26.2404633375,20-29,455,5,2,8,10,10,2,8,7,2.9851556843,1.9096305001,8.254613662580252E-4,0.1777777778,0.30555555,0,59,5.330527773290623E-5,2.0324514E-5,2.0571053E-5,77,5,0,199,0,0
841595791,MLaLongeDavey,10,71,10,32,0,0,15.3402694172,10-19,153,3,2,3,5,5,2,3,7,2.9923968139,0,0.0029612942,0.15,0.6666667,0,59,5.192199137769141E-5,2.0324514E-5,2.0571053E-5,182,4,0,106,0,0
842408154,NormaBlissett,10,262,102,92,7,3,39.572524212,30-39,444,4,31,13,44,44,31,13,7,2.8077480087,1193.7027995547,0.0241798233,0.1738900634,0.42689076,0,59,1.4384270836633714E-4,2.1679483E-4,2.1942456E-4,182,14,0,200,0,0
844099489,crazedmountie,10,2284,84,182,0,5,46.572530525,40-49,595,6,9,19,28,28,9,19,6,2.7034757422,22.7631867365,0.0137710276,0.1560846561,0.34047619,0,59,7.206354997977756E-5,6.7748384E-5,6.8570174E-5,175,2,0,202,0,0
844180087,brmf_rm,10,703,244,235,4,1,44.4930055616,40-49,630,5,40,46,86,86,40,46,6,2.4920347574,2163.8980803527,0.0299870343,0.0714090287,0.30429864,0,59,2.0309267920460674E-4,2.7776835E-4,2.811377E-4,182,46,0,200,0,0
844495087,uOSFL_EPVuO,10,150,93,130,0,10,36.4683570539,30-39,485,3,6,0,6,6,6,0,0,0,0,0.0014611753,0.1666666667,0.26666668,0,22,8.129427067434901E-5,4.742387E-5,0,175,3,2,177,2,0.011299435
844655233,TimmyChachakasn,10,1346,405,1106,6,242,45.0315333543,40-49,601,6,16,38,54,54,16,38,6,2.538377987,1358.1350300315,0.0152020675,0.0918937806,0.25035563,0,59,1.0346619775034877E-4,1.1517225E-4,1.16569296E-4,77,21,0,199,0,0
844825399,Can_Limnology,10,1556,446,713,19,40,52.0113427247,50-59,673,6,19,20,39,39,19,20,7,2.9561911658,2060.7010335881,0.0095087837,0.0661268556,0.33766234,0,59,2.1610783125503418E-4,1.3549677E-4,1.3714035E-4,77,120,1,202,1,0.004950495
845313296,giek2,10,7880,235,313,1,278,45.8093398059,40-49,699,7,1,1,2,2,1,1,9,5.75,0,8.271798374069241E-5,0,0,42,433,1.482576645138908E-4,1.3549677E-5,1.3714035E-5,197,2,0,201,0,0
846712357,ingridgcoronado,10,10498,244,190,0,65,44.4259965387,40-49,732,7,1,1,2,2,1,1,1,1,0,8.095914281419891E-5,0,0,181,386,3.177448371356425E-4,1.3549677E-5,1.3714035E-5,268,9,0,201,0,0
848955582,Jeff98926622,10,808,96,547,0,11,42.2608854146,40-49,567,5,16,57,73,73,16,57,6,2.4540188269,629.1701168473,0.014265124,0.1463089802,0.27700973,0,59,1.0605057556160164E-4,1.1517225E-4,1.16569296E-4,175,3,1,199,1,0.0050251256
849334358,kann_d,10,245,95,191,0,53,23.4511200654,20-29,424,3,2,3,5,5,2,3,7,3.20782042,0.4294028239,4.048449206894459E-4,0.15,0.25,0,59,5.3196686363861854E-5,2.0324514E-5,2.0571053E-5,25,0,0,200,0,0
851805686,jim_mochuk,10,1850,102,361,0,44,41.3085771069,40-49,548,6,19,58,77,77,19,58,6,2.4685010862,193.3734550209,0.026093693,0.1541353383,0.3962595,0,59,1.0222922980554012E-4,1.3549677E-4,1.3714035E-4,182,5,0,200,0,0
851819298,JamesSanyshyn,10,655,231,998,1,51,43.5240724488,40-49,555,5,26,79,105,105,26,79,6,2.4576393917,499.9211745827,0.0226752282,0.143956044,0.34814814,0,59,1.389045411983937E-4,1.8292063E-4,1.8513948E-4,182,26,1,200,1,0.005
852052230,richellebenoit,10,332,69,287,0,21,33.7402581819,30-39,485,4,2,9,11,11,2,9,7,2.7776973208,1.8725889935,0.0046132969,0.1727272727,0.375,0,59,5.8161393100995644E-5,2.0324514E-5,2.0571053E-5,175,6,0,200,0,0
852174248,BrookedeWaal,10,439,75,172,0,441,32.2060268269,30-39,464,4,2,7,9,9,2,7,7,2.9145546705,1326.5726298653,0.0043001662,0.0833333333,0.23809524,0,59,8.50367275234353E-5,2.0324514E-5,2.0571053E-5,175,8,1,199,1,0.0050251256
853168200,AlfonsoToschi,10,622,32,73,0,0,17.8038936714,10-19,233,4,0,1,1,1,0,1,7,4.3571428571,0,0,0,0,42,463,4.766339181938244E-5,0,6.8570175E-6,197,0,0,200,0,0
853288416,Oenema666,10,259,20,154,0,3,17.8547541134,10-19,108,4,0,11,11,11,0,11,7,2.8791169019,0,0,0.3363636364,0.42727274,0,303,4.766339181938244E-5,0,6.8570175E-6,182,0,0,199,0,0
854016014,BOURGAULTPierr2,10,824,494,999,2,0,43.6121017167,40-49,654,5,5,8,13,13,5,8,6,3.018826937,22.4349359043,0.0014356426,0.1346153846,0.42222223,0,59,7.151939512845642E-5,4.064903E-5,4.1142106E-5,145,3,0,200,0,0
855136358,TeamJPJT,10,2662,1383,611,16,0,55.8697921457,50-59,708,6,95,46,141,141,95,46,6,2.5955829109,8995.2307901781,0.0970299834,0.0580547112,0.16646464,0,59,6.387415101247769E-4,6.5038446E-4,6.3770264E-4,175,206,0,200,0,0
855205022,danyortega96,10,6428,218,344,0,3547,42.6261656043,40-49,646,7,3,3,6,6,3,3,3,2,159,2.6111032827520145E-4,0,0,31,107,3.737039260368778E-4,2.7099353E-5,2.742807E-5,108,5,0,201,0,0
855360626,trishqualtrough,10,530,70,203,0,15,38.0065553949,30-39,512,5,33,61,94,94,33,61,6,2.5590152064,677.9615453323,0.0270781939,0.0871654084,0.29904813,0,59,1.554882247325458E-4,2.303445E-4,2.3313859E-4,182,44,0,200,0,0
857278716,SkepticCritic,10,20,2,7,0,0,12.3543574036,10-19,12,1,0,3,3,3,0,3,7,3.1549040898,0,0,0.3333333333,0.5,0,258,4.766339181938244E-5,0,6.8570175E-6,77,0,0,26,0,0
857422182,beclourtcarole,10,2934,64,430,0,73,34.4604077794,30-39,456,6,3,19,22,22,3,19,7,3.0039826213,53.1646102215,0.0046251969,0.1515151515,0.22857143,0,59,5.829421973760005E-5,2.7099353E-5,2.742807E-5,175,0,0,200,0,0
857971962,NotLazyEI,10,470,258,556,3,2,33.7193667737,30-39,532,4,24,88,112,112,24,88,6,2.2541636495,837.7417620014,0.0325953415,0.1804214929,0.38101918,0,59,1.48507216437333E-4,1.6937095E-4,1.7142543E-4,175,15,4,199,4,0.0201005025
858827341,NextGenTrudeau,10,104,22,105,1,1,25.5339698189,20-29,422,4,11,42,53,53,11,42,6,2.4355539464,72.8955874487,0.0262799115,0.1843251089,0.3925803,0,59,9.602971750671488E-5,8.129806E-5,8.228421E-5,175,5,4,168,3,0.0178571429
858955286,CHINTvCanada,10,10459,445,170,1,1668,49.5678773274,40-49,704,8,1,2,3,3,1,2,7,3.4634322954,0,8.843422131905323E-5,0.1666666667,1,0,59,8.675827051917196E-5,1.3549677E-5,1.3714035E-5,175,74,0,201,0,0
859029968,patricklpc,10,3069,488,1017,7,48,47.0433089606,40-49,591,6,21,56,77,77,21,56,6,2.5608254888,622.7893511868,0.0206832397,0.1216678059,0.34116542,0,59,1.0555952801720785E-4,1.4904643E-4,1.5085438E-4,77,5,0,202,0,0
859238911,AvrilOrloff,10,248,72,130,1,1,28.4916016603,20-29,493,4,2,4,6,6,2,4,6,2.8139029689,0,0.0017088134,0.2,0.8333333,0,59,5.26380632429827E-5,2.0324514E-5,2.0571053E-5,77,1,0,199,0,0
859738734,HassanHusseini2,10,254,78,148,0,0,24.3975742065,20-29,414,4,16,33,49,49,16,33,6,2.4695872556,152.4304787737,0.0200368664,0.1411564626,0.4067227,0,59,9.636969523805602E-5,1.1517225E-4,1.16569296E-4,182,10,0,200,0,0
860099179,FremontJuan,10,452,17,44,0,7,26.2170842455,20-29,528,5,4,7,11,11,4,7,7,3.1734250543,4.8928657334,0.0014615945,0.0909090909,0.42857143,0,59,6.040383889829646E-5,3.3874192E-5,3.4285087E-5,175,2,7,200,7,0.035
860329124,grenier_emilie,10,3,0,17,0,0,10,10-19,0,0,1,18,19,19,1,18,7,2.8841419261,0.1918521872,7.284527678788755E-4,0.3771929825,0.67320263,0,59,5.1344560810521504E-5,1.3549677E-5,1.3714035E-5,25,0,0,3,0,0
860654623,Johnwboyko,10,958,276,682,1,8,52.2825664132,50-59,616,5,43,109,152,152,43,109,6,2.3406951484,3429.156907706,0.0587644273,0.075592541,0.22009854,0,59,1.7813611390726303E-4,2.9809287E-4,3.0170876E-4,77,34,0,201,0,0
860743243,ali_bidabadi,10,8668,220,83,1,1396,,,678,8,2,2,4,4,2,2,7,3.4634322954,2949,0.001073209,0.0833333333,0.5,0,59,9.198793990055333E-5,2.0324514E-5,2.0571053E-5,175,67,0,200,0,0
861446162,JimMortonMLA,10,427,259,712,7,14,44.8086149572,40-49,611,4,50,54,104,104,50,54,6,2.6125995655,726.5140297687,0.0379295376,0.0968073189,0.3985615,0,59,2.8550528309563707E-4,3.4551675E-4,3.497079E-4,147,114,0,200,0,0
861557418,vaughndobson,10,657,140,1005,0,15,25.9856630144,20-29,397,4,3,101,104,104,3,101,6,2.3269370022,26.2310243103,0.0081443633,0.2467326363,0.38089108,0,59,5.768865001645376E-5,2.7099353E-5,2.742807E-5,175,0,0,200,0,0
863009408,FixToronto,10,465,39,93,0,1,30.1147145575,30-39,456,4,0,4,4,4,0,4,7,3.1947158885,0,0,0.1666666667,0.16666667,0,352,4.766339181938244E-5,0,6.8570175E-6,175,5,1,200,1,0.005
863443381,JesusTrudeau,10,32,225,14,2,0,38.2110818857,30-39,497,2,32,2,34,34,32,2,7,3.4236060825,6.7148845883,0.0360733615,0.0900178253,0.13012478,0,59,1.9764197765880211E-4,2.2356966E-4,2.1942456E-4,175,5,0,40,0,0
863580475,AgathaMathias,10,2655,138,118,1,42,44.1538141149,40-49,700,6,4,4,8,8,4,4,4,2.3888888889,5.4166666667,3.552613791578579E-4,0.1428571429,0.6,58,182,1.4556346876402462E-4,3.3874192E-5,3.4285087E-5,166,47,0,201,0,0
863580548,mforden2,10,8622,332,455,4,743,55.3121587091,50-59,677,8,17,26,43,43,17,26,7,2.7498189718,1124.9930040514,0.0135013704,0.0658914729,0.2920228,0,59,9.150286837520722E-5,1.2194709E-4,1.16569296E-4,77,27,0,201,0,0
865633705,EnergyAlberta,10,450,148,217,2,1,33.438307458,30-39,414,6,6,6,12,12,6,6,7,3.1488052136,19.7068119131,0.0040890735,0.1818181818,0.5416667,0,59,6.976759628803376E-5,4.742387E-5,4.799912E-5,175,0,1,204,1,0.0049019608
866457756,TM4PM,10,302,58,26,2,0,29.0145245248,20-29,379,4,43,21,64,64,43,21,7,2.8370745836,136.5961129997,0.0558590732,0.1378968254,0.3090196,0,59,1.8102527434646682E-4,2.9809287E-4,3.0170876E-4,25,7,4,200,4,0.02
868595665,songsjml,10,4915,802,1974,7,168,48.551917287,40-49,641,7,4,7,11,11,4,7,6,3.0340333092,47.4850332423,0.0017419869,0,0,0,59,7.313076133296833E-5,3.3874192E-5,3.4285087E-5,25,11,0,200,0,0
870165780,MarieJazvac,10,13,8,76,0,0,14.1202465551,10-19,18,0,4,21,25,25,4,21,6,2.6618392469,0.563792765,0.0103232724,0.3533333333,0.7229437,0,59,6.231471069849715E-5,3.3874192E-5,3.4285087E-5,25,0,0,14,0,0
872059213,EC_Kosters,10,680,69,150,2,3,42.9657706808,40-49,510,5,9,5,14,14,9,5,7,3.3149891383,15.6016485515,0.0022928931,0.1593406593,0.5777778,0,59,1.1333106836933056E-4,6.7748384E-5,6.8570174E-5,77,18,1,200,1,0.005
872376937,beware1014,10,198,38,78,0,0,29.2618746632,20-29,324,2,0,0,0,0,0,0,0,0,0,0,0,0,123,270,4.766339181938244E-5,0,0,116,0,0,200,0,0
873093078,Song_Monday,10,6912,189,307,0,1457,45.565171693,40-49,730,6,1,1,2,2,1,1,1,1,0,8.095914281419891E-5,0,0,165,363,3.177448371356425E-4,1.3549677E-5,1.3714035E-5,163,36,0,201,0,0
873760831,OSSTF20,10,855,186,34,5,10,41.1676722364,40-49,562,5,17,6,23,23,17,6,6,3.0362056481,461.8410850193,0.0174796982,0.1462450593,0.47058824,0,59,1.195118200213509E-4,1.2194709E-4,1.2342632E-4,182,23,2,200,2,0.01
874224876,Man_Delobbe,10,9053,160,142,0,188,46.4407590303,40-49,713,6,4,3,7,7,4,3,3,2.1111111111,14.95,3.5891814395491375E-4,0.1428571429,0.5833333,58,182,2.930397722532368E-4,3.3874192E-5,3.4285087E-5,166,9,0,202,0,0
874887668,ninnygoat,10,341,66,233,0,71,32.5955688332,30-39,479,4,5,18,23,23,5,18,7,2.6940622737,22.2126044298,0.0061692643,0.2213438735,0.45789474,0,59,6.848381581254788E-5,4.064903E-5,4.1142106E-5,25,2,2,196,2,0.0102040816
875907876,AndersonforMLA,10,456,91,171,9,1,49.1631021303,40-49,657,6,18,31,49,49,18,31,7,2.839608979,503.3342964292,0.0142342179,0.1398809524,0.36349207,0,59,1.2994204998536743E-4,1.2872192E-4,1.3028333E-4,182,289,0,204,0,0
878546018,wjgreen_,10,4121,1180,1612,16,173,53.5059893386,50-59,703,7,1,3,4,4,1,3,8,3.2758870384,0,5.726297154501598E-4,0.25,1,0,59,5.1953197916787175E-5,1.3549677E-5,1.3714035E-5,175,1,1,201,1,0.0049751244
879209971,pdesilva1,10,3399,452,1149,10,161,46.5886525851,40-49,624,6,17,42,59,59,17,42,6,2.6926140478,605.1247843342,0.0143346216,0.0841613092,0.24529347,0,59,1.114551633154224E-4,1.2194709E-4,1.2342632E-4,77,3,1,199,1,0.0050251256
879938671,ZacharyRDM,10,6884,137,107,0,2112,53.3230134714,50-59,736,7,10,11,21,21,10,11,7,2.7299058653,139.8506160837,0.0132879288,0.0666666667,0.175,0,59,7.599121363435054E-5,7.452322E-5,7.542719E-5,77,83,0,201,0,0
884412037,local468,10,146,35,67,1,0,47.9499337746,40-49,362,2,5,12,17,17,5,12,6,2.5988414193,32.1597136501,0.0083989307,0.1948529412,0.57575756,0,59,6.021239413443988E-5,4.064903E-5,4.1142106E-5,182,1,0,152,0,0
887461274,ArthurPPrice,10,19,2,18,0,0,16.0632857838,10-19,2,1,0,1,1,1,0,1,7,3.3170466884,0,0,0,0,0,211,4.766339181938244E-5,0,6.8570175E-6,77,0,0,19,0,0
887868182,TeacherShelf,10,181,63,177,0,1,34.5782569155,30-39,402,3,10,25,35,35,10,25,6,2.8008689356,34.2621636902,0.0100881943,0.1487394958,0.45166665,0,59,7.85455456226833E-5,7.452322E-5,7.542719E-5,182,4,0,191,0,0
888682813,2013talk,10,1295,301,987,0,1,26.968191454,20-29,477,6,0,0,0,0,0,0,0,0,0,0,0,0,253,658,4.766339181938244E-5,0,0,258,0,0,196,0,0
892617242,blackmount12,10,925,146,279,0,41,38.2964191156,30-39,600,6,9,12,21,21,9,12,7,2.9174511224,147.0551792389,0.0088747755,0.0833333333,0.3974359,0,59,8.697744715556884E-5,6.7748384E-5,6.8570174E-5,175,5,0,200,0,0
893630857,AKoryStory,10,232,43,301,0,9,23.610570873,20-29,439,4,2,13,15,15,2,13,7,2.8157132513,11.4683112858,0.0010956591,0.2285714286,0.41666666,0,59,5.338789553754024E-5,2.0324514E-5,2.0571053E-5,175,5,1,199,1,0.0050251256
896015317,PaoloVautretto,10,100,7,80,0,0,14.1427289612,10-19,19,3,0,1,1,1,0,1,7,4.3571428571,0,0,0,0,42,468,4.766339181938244E-5,0,6.8570175E-6,197,0,0,112,0,0
896146903,syncrodox1,10,3792,189,388,1,15,50.1775778511,50-59,710,7,21,44,65,65,21,44,7,2.6086169442,638.3259743248,0.0154730438,0.1048076923,0.3810782,0,59,1.2823702773128825E-4,1.4904643E-4,1.5085438E-4,175,23,0,200,0,0
896533812,aponce_97,10,263,93,153,0,0,35.9932942613,30-39,524,3,1,1,2,2,1,1,2,1.5,0,8.44957684185972E-5,0,0,48,132,3.380526145648663E-4,1.3549677E-5,1.3714035E-5,127,2,0,199,0,0
898482366,LiberalPinocchi,10,115,91,783,0,0,36.5799356141,30-39,470,4,10,52,62,62,10,52,6,2.6010137581,362.6211641828,0.0101991618,0.1882601798,0.32957393,0,59,7.126841619351763E-5,7.452322E-5,7.542719E-5,147,7,1,147,1,0.0068027211
898819561,AdrienneLKing,10,301,121,130,2,5,42.8892144335,40-49,553,4,26,23,49,49,26,23,7,2.8497465605,67.6301186426,0.026547559,0.1381802721,0.6068966,0,59,1.5899593408907173E-4,1.8292063E-4,1.8513948E-4,175,44,0,200,0,0
900481465,LouiseDgdn,10,15415,217,177,0,730,45.5830990989,40-49,759,7,6,8,14,14,6,8,3,1.6111111111,57.05,5.246253561740245E-4,0.0659340659,0.30357143,58,182,1.7567774522348075E-4,4.742387E-5,4.799912E-5,166,24,0,201,0,0
900667856,OkanaganD_anon,10,3610,736,1533,6,619,42.9848350724,40-49,682,7,38,60,98,98,38,60,6,2.556480811,361.0859718805,0.0360834208,0.0862613086,0.34180328,0,59,1.3595593365477987E-4,2.642187E-4,2.674237E-4,77,8,0,201,0,0
900693096,Airstream001,10,12,5,20,0,1,11.7341444214,10-19,85,1,0,3,3,3,0,3,7,3.3297140789,0,0,0.1666666667,0.16666667,0,271,4.766339181938244E-5,0,6.8570175E-6,175,1,0,15,0,0
901980590,UnionStuart,10,153,67,63,0,0,20.315004176,20-29,423,4,13,17,30,30,13,17,7,2.9507603186,155.0586534425,0.0097207882,0.1091954023,0.40350878,0,59,8.234282424697696E-5,9.484774E-5,9.599824E-5,182,9,0,187,0,0
905917039,PictouWestNDP,10,270,71,83,6,2,40.7182239859,40-49,437,4,21,15,36,36,21,15,6,2.7556118755,130.9660697025,0.0158370662,0.2007936508,0.5726496,0,59,1.4165517045754334E-4,1.4904643E-4,1.5085438E-4,147,13,0,200,0,0
907333980,JuliaMaksymetz,10,209,101,311,0,179,35.6326958925,30-39,395,3,28,65,93,93,28,65,7,2.5166545981,585.2773079288,0.0223635428,0.1242402992,0.36802885,0,59,1.342701544615608E-4,1.9647031E-4,1.9885351E-4,25,31,0,200,0,0
909289290,Planet350,10,731,316,779,4,206,46.2685843792,40-49,557,5,16,52,68,68,16,52,6,2.3979000724,371.1408754323,0.0221126906,0.1341088674,0.31676343,0,59,9.7347317552586E-5,1.1517225E-4,1.16569296E-4,77,10,0,199,0,0
911535572,s_elves,10,42,7,11,0,0,13.1537903205,10-19,42,2,0,1,1,1,0,1,7,3.2616720955,0,0,0,0,0,687,4.766339181938244E-5,0,6.8570175E-6,77,0,0,43,0,0
911582797,CrossingTheT,10,649,184,687,0,41,30.1834021039,30-39,473,5,6,16,22,22,6,16,6,2.8935553946,114.7118971166,0.0029257532,0.0822510823,0.175,0,59,7.356292105144014E-5,4.742387E-5,4.799912E-5,77,2,0,200,0,0
911693790,DFBaboulas,10,2436,194,498,0,584,44.6185355414,40-49,663,6,0,0,0,0,0,0,0,0,0,0,0,0,241,625,4.766339181938244E-5,0,0,245,8,0,201,0,0
911902255,LucaMoreno1956,10,169,31,103,0,2,29.4124199364,20-29,428,3,0,1,1,1,0,1,7,4.3571428571,0,0,0,0,42,517,4.766339181938244E-5,0,6.8570175E-6,197,3,0,200,0,0
912336096,EcoAvantis,10,395,99,248,2,0,37.5278014018,30-39,466,4,0,0,0,0,0,0,0,0,0,0,0,0,248,644,4.766339181938244E-5,0,0,253,14,0,201,0,0
913757827,panchOopanchOo,10,2228,79,270,0,130,42.100427862,40-49,604,6,1,3,4,4,1,3,7,3.3247646633,0.5477102119,2.510221507988584E-4,0.25,0.33333334,0,59,5.330242182634757E-5,1.3549677E-5,1.3714035E-5,25,5,0,199,0,0
915477338,Banks_Todd,10,633,32,78,0,16,35.6940640244,30-39,571,5,5,14,19,19,5,14,7,2.8490224475,28.3365129133,0.0054612941,0.1228070175,0.34285715,0,59,6.483721749158547E-5,4.064903E-5,4.1142106E-5,175,27,8,211,8,0.0379146919
917035056,HareFX,10,387,62,127,0,11,37.0824043023,30-39,491,4,28,36,64,64,28,36,6,2.6321506155,334.6599952073,0.031034655,0.1111111111,0.51551956,0,59,1.7949295401572973E-4,1.9647031E-4,1.9885351E-4,147,28,0,200,0,0
917466355,MasonCui,10,351,22,60,1,12,30.9871156955,30-39,525,5,11,13,24,24,11,13,7,2.8931933382,36.3584338724,0.0092623113,0.0905797101,0.38333333,0,59,8.419603224475472E-5,8.129806E-5,8.228421E-5,175,5,1,202,1,0.004950495
918348139,MonkEBizness,10,337,21,81,0,19,25.8541643914,20-29,281,4,3,24,27,27,3,24,6,2.4960173787,10.4455313053,0.0091338392,0.2165242165,0.38405797,0,59,5.772231015202303E-5,2.7099353E-5,2.742807E-5,77,1,3,199,2,0.0100502513
919226346,OttawapiskatBot,10,12,0,18,0,0,13.9481264984,10-19,22,3,3,7,10,10,3,7,7,2.9637943519,12.6742983658,0.0023662296,0.1222222222,0.30357143,0,59,5.544472246642661E-5,2.7099353E-5,2.742807E-5,77,0,0,77,0,0
919512212,NPDLO_NDPOL,10,102,264,890,6,0,40.1774126208,40-49,533,3,52,112,164,164,52,112,6,2.367487328,4029.8780293099,0.0696045486,0.1489226395,0.44969726,0,59,2.452555676280826E-4,3.590664E-4,3.6342192E-4,25,133,0,128,0,0
923744418,HuronbruceNDP,10,80,157,721,7,0,27.6529589042,20-29,348,3,36,109,145,145,36,109,6,2.301230992,476.2895543031,0.0444852741,0.2051245211,0.39385,0,59,1.269832668738368E-4,2.5066902E-4,2.5370964E-4,25,4,0,90,0,0
923853170,AngelaMRecord,10,1031,101,211,2,36,40.8605487306,40-49,616,6,7,22,29,29,7,22,7,2.9503982621,22.4032241291,0.0037919942,0.2056650246,0.42572463,0,59,7.404692184166655E-5,5.4198706E-5,5.485614E-5,147,15,0,200,0,0
926125051,brin_jones,10,61,16,40,0,0,13.8833241606,10-19,76,1,0,1,1,1,0,1,7,3.0441549041,0,0,0,0,0,667,4.766339181938244E-5,0,6.8570175E-6,25,0,0,61,0,0
926791760,juelzmai,10,253,52,140,0,12,32.4204478599,30-39,496,4,0,12,12,12,0,12,7,2.7864639884,0,0,0.3712121212,0.5681818,0,280,4.766339181938244E-5,0,6.8570175E-6,175,14,2,199,2,0.0100502513
927601921,AmosSweet1,10,37,11,142,0,0,,,15,1,0,0,0,0,0,0,0,0,0,0,0,0,161,359,4.766339181938244E-5,0,0,159,0,0,40,0,0
929877470,esistthomas,10,69,19,159,2,18,25.810532612,20-29,208,3,0,0,0,0,0,0,0,0,0,0,0,0,83,179,4.766339181938244E-5,0,0,74,0,0,91,0,0
930682112,Arijaycohen,10,171,130,105,1,35,41.3469838693,40-49,588,4,0,3,3,3,0,3,7,3.1389793702,0,0,0.5,0.8333333,0,283,4.766339181938244E-5,0,6.8570175E-6,77,6,0,182,0,0
932144096,KatBerton,10,29,8,27,0,1,19.8978804521,10-19,220,2,1,8,9,9,1,8,7,2.8066618392,2.7849509422,3.7636307880356724E-4,0.2638888889,0.5535714,0,59,5.208191414857681E-5,1.3549677E-5,1.3714035E-5,25,0,0,48,0,0
934620770,PatBigGeorge,10,715,54,94,1,19,38.2832650061,30-39,470,5,11,11,22,22,11,11,6,2.6850108617,93.9413904283,0.0080100624,0.1731601732,0.2868421,0,59,8.872841502408301E-5,8.129806E-5,8.228421E-5,77,2,0,200,0,0
935732234,_Tracey_S,10,3466,165,411,0,109,47.2248922226,40-49,694,7,54,114,168,168,54,114,6,2.2954380883,6757.1732033919,0.0539934267,0.0853293413,0.2567298,0,59,1.9180370369377612E-4,3.726161E-4,3.7713596E-4,77,150,0,211,0,0
937513957,adamdasilva3,10,4,0,2,0,0,10,10-19,0,0,0,0,0,0,0,0,0,0,0,0,0,0,4,67,4.766339181938244E-5,0,0,3,1,0,5,0,0
939998528,TheNationalEric,10,813,66,110,1,31,40.4534412693,40-49,610,5,12,9,21,21,12,9,7,2.9800868936,23.5093602248,0.0170133054,0.2785714286,0.44444445,0,59,8.27881279895817E-5,8.80729E-5,8.914123E-5,175,16,0,200,0,0
940055154,_MarkCameron_,10,648,77,259,0,0,28.5593573225,20-29,416,5,22,54,76,76,22,54,6,2.3859522085,569.0984485007,0.026120607,0.1263157895,0.34444445,0,59,1.0973112912053638E-4,1.5582128E-4,1.577114E-4,25,5,0,200,0,0
942629846,vernWittigAg,10,138,75,141,3,3,26.8259476872,20-29,422,4,4,8,12,12,4,8,7,2.9036929761,0.0375772135,0.005764922,0.1590909091,0.64285713,0,59,6.386111569803402E-5,3.3874192E-5,3.4285087E-5,175,5,0,194,0,0
943439419,Sheliostat,10,1099,100,243,1,73,39.241670642,30-39,542,5,2,7,9,9,2,7,7,2.9015206372,6.7320373738,7.897375645039821E-4,0.0833333333,0.14285715,0,59,5.264016556785352E-5,2.0324514E-5,2.0571053E-5,77,2,1,200,1,0.005
944396432,PIPSC_IPFPC,10,627,146,70,4,0,43.9140359501,40-49,580,4,25,18,43,43,25,18,6,2.6958725561,334.8999111696,0.0299592118,0.1295681063,0.29857397,0,59,1.4093931552480496E-4,1.761458E-4,1.7828245E-4,182,41,2,200,2,0.01
944417654,MaxoulParisien,10,836,71,193,0,72,41.1528379698,40-49,595,5,7,12,19,19,7,12,2,1.3333333333,116.15,6.131458281225802E-4,0.0730994152,0.2628205,58,182,3.1378792240987336E-4,5.4198706E-5,5.485614E-5,166,12,0,201,0,0
946356661,qctranslator,10,521,251,756,10,81,45.1241215137,40-49,563,5,0,11,11,11,0,11,7,2.9822656533,0,0,0.3090909091,0.35454544,0,288,4.766339181938244E-5,0,6.8570175E-6,175,0,0,200,0,0
947897366,billyjayray,10,40,17,143,0,0,16.1732486074,10-19,61,2,5,16,21,21,5,16,7,2.840333092,5.0574721586,0.0076683156,0.1761904762,0.3492647,0,59,6.40131386125819E-5,4.064903E-5,4.1142106E-5,25,0,1,41,1,0.0243902439
948394051,KenGuilford2,10,22,1,12,0,0,15.6708586376,10-19,11,1,0,0,0,0,0,0,0,0,0,0,0,0,155,346,4.766339181938244E-5,0,0,153,2,0,27,0,0
949806516,NDPPEI,10,92,123,166,7,0,40.0879443211,40-49,490,2,17,28,45,45,17,28,6,2.4656046343,454.0334209209,0.0157070263,0.1136363636,0.39408866,0,59,1.0410221162263057E-4,1.2194709E-4,1.2342632E-4,25,79,0,95,0,0
951406202,ILOVEMELSMYTH,10,3247,208,2001,0,1,29.9187103221,20-29,605,6,1,14,15,15,1,14,7,2.9873280232,0.1897879322,9.361174752738825E-5,0.3476190476,0.5934066,0,59,4.99664880024236E-5,1.3549677E-5,1.3714035E-5,182,18,0,200,0,0
952101181,Cree8Dawn,10,1194,139,122,7,235,48.8644561188,40-49,630,6,17,13,30,30,17,13,7,2.8225923244,235.0675017059,0.010562368,0.0977011494,0.2792208,0,59,1.0321586081874535E-4,1.2194709E-4,1.2342632E-4,77,69,0,198,0,0
952305139,manon_dqck,10,6922,90,86,0,125,45.9544766189,40-49,708,7,4,5,9,9,4,5,4,2.2222222222,22.1666666667,3.516266130303415E-4,0.125,0.4,58,182,2.602047279622379E-4,3.3874192E-5,3.4285087E-5,166,37,0,200,0,0
952580750,Erkin_TO,10,186,15,32,0,0,42.3376298321,40-49,560,4,5,1,6,6,5,1,7,3.5362056481,0,0.0054393126,0.2666666667,0.55,0,59,9.111207054019832E-5,4.064903E-5,4.1142106E-5,175,60,0,200,0,0
952606484,opseusandra,10,102,31,111,1,4,23.0462228847,20-29,324,3,7,16,23,23,7,16,6,2.8776249095,9.6905012913,0.0072817703,0.2114624506,0.43567252,0,59,6.373596892516792E-5,5.4198706E-5,5.485614E-5,182,7,0,139,0,0
952619623,BaronOldsfield,10,308,14,48,0,9,21.8024823457,20-29,508,4,5,7,12,12,5,7,7,2.8573497466,8.3499550183,0.0054246625,0.1515151515,0.4861111,0,59,6.275449634838992E-5,4.064903E-5,4.1142106E-5,175,6,3,200,3,0.015
953093676,calvindegroot,10,116,65,182,1,41,30.3647791728,30-39,383,3,2,12,14,14,2,12,6,2.7179580014,6.0384350503,7.181892423558567E-4,0.2802197802,0.47435898,0,59,5.2769777063693836E-5,2.0324514E-5,2.0571053E-5,77,3,0,122,0,0
953784768,Eric1Davis,10,34,47,189,0,0,25.4957357964,20-29,385,2,16,41,57,57,16,41,7,2.5709630702,87.4016853243,0.0153713136,0.1713659148,0.40697673,0,59,9.007827588620517E-5,1.1517225E-4,1.16569296E-4,25,17,0,47,0,0
955044062,AppCierta,10,127,192,285,0,11,45.2516278793,40-49,537,3,0,0,0,0,0,0,0,0,0,0,0,0,228,569,4.766339181938244E-5,0,0,232,46,0,153,0,0
955072836,popoanaklatip,10,14566,205,432,0,3000,47.3326210396,40-49,724,8,2,2,4,4,2,2,1,1,0,1.6551228476954845E-4,0.0833333333,1,47,131,3.177448371356425E-4,2.0324514E-5,2.0571053E-5,44,64,0,203,0,0
956358643,EunniceCortez,10,1598,110,449,0,22,36.0260157327,30-39,537,5,0,2,2,2,0,2,6,3.2222222222,0,0,0,0,31,108,4.766339181938244E-5,0,6.8570175E-6,108,26,0,201,0,0
956838308,AmandaBLumley,10,546,56,263,0,146,31.1881813312,30-39,500,4,1,0,1,1,1,0,0,0,0,9.867752238852986E-5,0,0,0,48,5.272828088090086E-5,1.3549677E-5,0,175,0,0,201,0,0
957332066,PPL4PARKS,10,679,173,432,0,3,46.2222863146,40-49,576,5,3,9,12,12,3,9,7,3.1270818248,2960.5025935107,0.0024037851,0.0909090909,0.14444445,0,59,5.362823241017768E-5,2.7099353E-5,2.742807E-5,175,25,0,201,0,0
958156850,JulietteVct,10,580,65,63,0,37,35.5657757025,30-39,596,3,2,2,4,4,2,2,1,1,2,1.619561731312207E-4,0,0,162,360,4.6360358251326255E-4,2.0324514E-5,2.0571053E-5,161,45,0,199,0,0
959017472,PhilJFBoychuk,10,346,94,372,1,2,41.9702140717,40-49,579,4,21,52,73,73,21,52,6,2.4438812455,948.6012889239,0.0218449887,0.1274733638,0.28523895,0,59,1.240134536521426E-4,1.4904643E-4,1.5085438E-4,25,27,0,200,0,0
960983546,YukonWorkers,10,22,108,347,2,0,21.5180322874,20-29,292,2,13,27,40,40,13,27,6,2.6531498914,170.410718229,0.0184663674,0.1435897436,0.39885056,0,59,9.244625900100092E-5,9.484774E-5,9.599824E-5,182,0,1,25,1,0.04
962044404,46nd2,10,7620,416,637,9,431,59.0816607515,50-59,740,7,41,22,63,63,41,22,6,2.6860970311,1942.7176576619,0.0376279545,0.105734767,0.30619797,0,59,1.7514387414368476E-4,2.845432E-4,2.8799474E-4,77,85,0,201,0,0
962950405,marina_delvgn,10,531,60,187,0,17,20.4876258894,20-29,467,4,1,1,2,2,1,1,2,1.6666666667,0,8.271798374069241E-5,0,0,58,145,1.1800910672257701E-4,1.3549677E-5,1.3714035E-5,166,0,0,199,0,0
963122683,LadyofYork,10,11052,755,1999,6,508,51.5616848934,50-59,692,8,50,104,154,154,50,104,6,2.3280231716,3901.7498580012,0.047457058,0.0927765045,0.24778761,0,59,1.8845653937458334E-4,3.4551675E-4,3.497079E-4,77,52,0,200,0,0
965540558,Galen__M,10,136,24,116,0,12,22.4426789197,20-29,364,3,1,10,11,11,1,10,7,2.7389572773,0.2393365455,0.0025856599,0.2818181818,0.43333334,0,59,5.629578801767496E-5,1.3549677E-5,1.3714035E-5,25,0,0,154,0,0
967227373,VE7KPM,10,3452,493,250,14,111,49.4748052713,40-49,706,7,19,24,43,43,19,24,7,2.8341781318,53.2248356352,0.0132415656,0.1301218162,0.40725806,0,59,1.3214165140897955E-4,1.3549677E-4,1.3714035E-4,175,38,0,206,0,0
968867714,martagalinanes,10,98,11,34,0,0,12.405003059,10-19,181,3,0,1,1,1,0,1,7,4.3571428571,0,0,0,0,42,440,4.766339181938244E-5,0,6.8570175E-6,197,2,0,130,0,0
969591588,tjbtories,10,78,82,297,1,0,22.4432183721,20-29,232,3,11,19,30,30,11,19,7,2.5984793628,645.5885796843,0.0115620104,0.0850574713,0.32163742,0,59,9.492616820315523E-5,8.129806E-5,8.228421E-5,175,1,10,83,6,0.0722891566
970856432,Alvinaccio,10,68,47,89,0,0,23.8333366955,20-29,227,3,0,1,1,1,0,1,7,4.3571428571,0,0,0,0,42,499,4.766339181938244E-5,0,6.8570175E-6,197,2,0,68,0,0
974785080,VisionGRAMintl,10,1006,59,384,2,84,41.0434443063,40-49,521,6,2,5,7,7,2,5,7,3.1068066618,30.1586245056,2.579086732325019E-4,0.0952380952,0.25,0,59,6.418359739719265E-5,2.0324514E-5,2.0571053E-5,77,33,0,202,0,0
976111975,zinniaz4bees,10,176,15,81,1,27,25.123184475,20-29,88,3,2,6,8,8,2,6,7,2.9996379435,0.7790625341,0.0020227444,0.125,0.4,0,59,5.507121535350544E-5,2.0324514E-5,2.0571053E-5,77,0,0,192,0,0
977630929,Astutelypoli,10,272,106,567,0,9,31.6788367423,30-39,428,4,8,74,82,82,8,74,6,2.3530050688,774.0111933879,0.009606786,0.1446853357,0.24486487,0,59,7.106604425103376E-5,6.0973543E-5,6.171316E-5,182,0,2,200,2,0.01
979235791,meaghkelly,10,362,94,218,1,140,25.4142065517,20-29,467,4,8,15,23,23,8,15,7,2.7965242578,8.376997448,0.019054984,0.2173913043,0.4869281,0,59,8.192319189243457E-5,6.0973543E-5,6.171316E-5,25,2,0,200,0,0
979325480,zayagirl,10,382,44,144,0,17,41.0359542167,40-49,436,3,4,15,19,19,4,15,7,2.8323678494,15.5874407454,0.0022953242,0.1403508772,0.36666667,0,59,6.018030322482441E-5,3.3874192E-5,3.4285087E-5,175,13,1,199,1,0.0050251256
979701122,gloriafgg,10,5552,201,184,0,269,43.3648845204,40-49,694,7,4,3,7,7,4,3,2,1.25,7,3.329957440533435E-4,0.0714285714,0.33333334,50,135,5.526283437205877E-4,3.3874192E-5,2.742807E-5,188,41,0,201,0,0
981391872,Common_Causes,10,274,624,498,20,1,50.1713597552,50-59,633,4,113,64,177,177,113,64,6,2.4391745112,5068.9065514082,0.1035533821,0.0795133539,0.16752873,0,59,4.987218467970355E-4,7.7233155E-4,7.74843E-4,182,87,0,200,0,0
984502298,Vichelinck,10,2339,62,105,0,36,37.8856985512,30-39,595,4,4,9,13,13,4,9,3,1.5555555556,41.7666666667,3.480096862803879E-4,0.1025641026,0.375,58,182,2.0586853784517912E-4,3.3874192E-5,3.4285087E-5,166,15,0,200,0,0
984791412,revpshych_tim,10,202,36,86,1,9,33.9863381893,30-39,396,3,5,9,14,14,5,9,6,2.7541636495,39.8622429386,0.01015413,0.1043956044,0.3888889,0,59,6.572248090928957E-5,4.064903E-5,4.1142106E-5,175,15,3,199,2,0.0100502513
984886105,SalSant1,10,312,243,211,3,0,43.027225935,40-49,593,4,4,3,7,7,4,3,5,2.6153846154,349.5,3.5077114858846526E-4,0.119047619,0.5,42,307,0.0012979662,3.3874192E-5,2.742807E-5,197,20,0,200,0,0
987421129,Penelope1915,10,168,6,23,0,2,16.1410085119,10-19,256,4,0,1,1,1,0,1,7,4.3571428571,0,0,0,0,42,503,4.766339181938244E-5,0,6.8570175E-6,197,1,0,200,0,0
988162094,MsNWimby,10,386,69,78,1,3,41.3657004681,40-49,607,5,2,4,6,6,2,4,7,2.9742939899,0.0322580645,0.0060838903,0.1333333333,0.5,0,59,5.797859674167497E-5,2.0324514E-5,2.0571053E-5,182,3,0,200,0,0
989152430,da_jetsfan,10,410,9,54,0,2,21.8067483245,20-29,327,4,0,2,2,2,0,2,8,3.6521896489,0,0,0,0,0,281,4.766339181938244E-5,0,6.8570175E-6,25,3,0,200,0,0
989207850,Adriendeclercq,10,2138,42,91,0,8,40.9898465596,40-49,644,5,3,5,8,8,3,5,4,2.2222222222,2.9166666667,2.649611034477825E-4,0.1428571429,0.55,58,182,1.0948120256262117E-4,2.7099353E-5,2.742807E-5,166,108,0,201,0,0
991748653,jessicabeth8412,10,359,204,535,2,37,42.1891239744,40-49,497,4,22,77,99,99,22,77,6,2.3540912382,484.510066214,0.0338556537,0.1752216038,0.4119959,0,59,1.342504911844456E-4,1.5582128E-4,1.577114E-4,25,7,2,199,2,0.0100502513
991765542,PentictonNDP,10,204,169,460,9,12,43.5359739648,40-49,518,3,41,60,101,101,41,60,6,2.4746560463,506.2645072717,0.0342003092,0.1314851485,0.37519562,0,59,1.370468099598672E-4,2.845432E-4,2.8799474E-4,182,40,0,200,0,0
993803760,jonathan_lvt,10,338,23,93,0,6,26.2495159205,20-29,525,4,2,4,6,6,2,4,4,2.2777777778,0,1.7487389424175004E-4,0.2,0.75,58,182,8.494106236653377E-5,2.0324514E-5,2.0571053E-5,166,8,0,193,0,0
993993534,RobertBaillieul,10,144,14,6,1,3,23.5516859994,20-29,266,2,0,0,0,0,0,0,0,0,0,0,0,0,12,78,4.766339181938244E-5,0,0,11,0,0,1,0,0
996132241,AdeliaPorter1,10,42,5,263,0,0,17.4422760038,10-19,8,2,0,0,0,0,0,0,0,0,0,0,0,0,25,99,4.766339181938244E-5,0,0,22,0,0,53,0,0
996277891,BrendonDudley,10,51,5,252,0,0,15,10-19,5,2,0,0,0,0,0,0,0,0,0,0,0,0,34,111,4.766339181938244E-5,0,0,31,0,0,56,0,0
996447847,TeamClarkOPCCA,10,120,72,176,0,14,38.4357923651,30-39,501,4,6,14,20,20,6,14,7,3.0973931933,182.5733007517,0.0010793769,0.0605263158,0.16483517,0,59,8.131566701965841E-5,4.742387E-5,4.799912E-5,175,19,2,177,2,0.011299435
996788659,JamarSalazar,10,22,6,187,0,0,12.0125759127,10-19,17,1,0,0,0,0,0,0,0,0,0,0,0,0,64,153,4.766339181938244E-5,0,0,57,0,0,201,0,0
997271294,lolabrgs,10,7178,147,136,0,45,44.8413321125,40-49,728,7,2,3,5,5,2,3,1,1,4,1.619561731312207E-4,0,0,58,145,2.482788485867868E-4,2.0324514E-5,2.0571053E-5,166,16,0,199,0,0
997498404,LeonoreOneal,10,37,14,203,0,0,,,25,1,0,0,0,0,0,0,0,0,0,0,0,0,61,149,4.766339181938244E-5,0,0,54,0,0,201,0,0
998331242,abuaysha007,10,13,9,52,0,2,13.2677859755,10-19,59,1,0,2,2,2,0,2,7,3.3966702859,0,0,0.5,1,0,200,4.766339181938244E-5,0,6.8570175E-6,25,1,0,13,0,0
1000455673,TheRealPNelson,10,1577,117,855,0,0,47.8840773321,40-49,642,6,12,43,55,55,12,43,6,2.4703113686,3690.0447297467,0.0118955647,0.1430976431,0.33554816,0,59,9.566155542992686E-5,8.80729E-5,8.914123E-5,175,31,0,200,0,0
1000734818,adamfeijoo,10,375,52,139,1,16,37.8542132456,30-39,578,5,0,0,0,0,0,0,0,0,0,0,0,0,92,206,4.766339181938244E-5,0,0,83,0,0,200,0,0
1000767104,llnpav,10,1885,98,396,2,1,43.3950639132,40-49,578,6,2,9,11,11,2,9,7,2.9587255612,17.4015933627,0.0037423731,0.1727272727,0.30555555,0,59,6.17233955649787E-5,2.0324514E-5,2.0571053E-5,145,4,0,201,0,0
1001077782,freechimchim,10,3884,182,2001,1,0,33.2250080867,30-39,640,6,2,19,21,21,2,19,7,2.661115134,3028.8638968608,0.0017624811,0.2857142857,0.48245615,0,59,5.1480970777448996E-5,2.0324514E-5,2.0571053E-5,182,88,0,201,0,0
1001875776,ale_briga,10,416,53,214,0,2,47.687902079,40-49,513,5,1,1,2,2,1,1,8,5.0666666667,0,8.095914281419891E-5,0,0,42,422,1.0633321402051042E-4,1.3549677E-5,1.3714035E-5,197,4,0,199,0,0
1004484314,dcbarrett_,10,729,64,226,0,85,38.2128872269,30-39,589,5,5,16,21,21,5,16,7,2.744750181,312.0224762357,0.0045525085,0.0952380952,0.25416666,0,59,7.638321795800674E-5,4.064903E-5,4.1142106E-5,25,10,0,200,0,0
1009127808,MonicaBALLUCB,10,876,39,76,1,29,35.9452747351,30-39,348,5,4,7,11,11,4,7,6,2.9207096307,2.0787302404,0.0040460868,0.1363636364,0.375,0,59,5.545244605278902E-5,3.3874192E-5,3.4285087E-5,77,3,3,199,3,0.0150753769
1009924706,WorkerView,10,251,24,68,0,5,35.645215846,30-39,449,4,6,9,15,15,6,9,7,2.8077480087,1618.067109519,0.0098524742,0.0904761905,0.4722222,0,59,1.0301674556977229E-4,4.742387E-5,4.799912E-5,175,0,1,200,1,0.005
1012122006,nativeadvocate,10,11545,222,417,5,1667,50.0377829385,50-59,700,8,7,12,19,19,7,12,6,2.8280231716,76.0692011698,0.0113399035,0.134502924,0.27142859,0,59,8.76394081647019E-5,5.4198706E-5,5.485614E-5,77,8,0,201,0,0
1012702262,JoelFromYEG,10,220,125,425,2,192,39.8281768402,30-39,556,4,13,41,54,54,13,41,7,2.5249818972,517.6080798885,0.0090529732,0.1163522013,0.286295,0,59,1.0304512741505502E-4,9.484774E-5,9.599824E-5,175,20,8,200,8,0.04
1013879910,comedian72,10,2330,86,228,1,362,42.6196970299,40-49,647,6,1,2,3,3,1,2,7,4.1333333333,0,8.095914281419891E-5,0.1666666667,0.5,42,437,8.289285873049163E-5,1.3549677E-5,1.3714035E-5,197,15,0,201,0,0
1016034486,Swanny_Sosa,10,3667,159,283,0,38,47.7765550721,40-49,714,7,1,1,2,2,1,1,3,2.1428571429,0,8.633201693929849E-5,0,0,18,88,1.220018385022069E-4,1.3549677E-5,1.3714035E-5,39,51,0,197,0,0
1016526673,odx13,10,30,46,74,0,1,37.6510988415,30-39,441,3,1,2,3,3,1,2,8,3.5651701665,0.7528504563,1.0478846817628962E-4,0,0,0,59,5.885974984883285E-5,1.3549677E-5,1.3714035E-5,77,21,0,43,0,0
1017332965,AnjaLambert,10,47,10,323,0,0,15.2216583497,10-19,40,2,0,0,0,0,0,0,0,0,0,0,0,0,264,691,4.766339181938244E-5,0,0,271,0,0,47,0,0
1017914738,JesusitaGood1,10,22,2,142,0,0,,,2,1,0,0,0,0,0,0,0,0,0,0,0,0,102,229,4.766339181938244E-5,0,0,92,0,0,27,0,0
1018008415,BabouinBarge,10,3372,334,88,0,1,42.1345986344,40-49,677,6,8,0,8,8,8,0,0,0,0,6.995577315092502E-4,0.3035714286,0.5535714,58,181,2.318234822432152E-4,6.0973543E-5,0,166,18,0,202,0,0
1019833886,jayaaronroy,10,50,27,24,0,2,21.6214571109,20-29,209,2,0,1,1,1,0,1,7,3.0441549041,0,0,0,0,0,311,4.766339181938244E-5,0,6.8570175E-6,25,0,0,52,0,0
1021542854,Mistikokan,10,980,52,128,0,47,33.291960164,30-39,497,5,4,10,14,14,4,10,6,2.6763215062,49.8941773421,0.0052186221,0.1373626374,0.3181818,0,59,5.942791088816573E-5,3.3874192E-5,3.4285087E-5,77,0,0,197,0,0
1022596632,BevClareNDP,10,231,74,149,4,0,35.7157629169,30-39,401,4,31,42,73,73,31,42,6,2.4663287473,652.7648596841,0.0338755888,0.1335616438,0.5439394,0,59,1.5490868385697895E-4,2.1679483E-4,2.1942456E-4,25,19,4,199,4,0.0201005025
1022666976,MWRiop,10,582,41,69,0,10,34.1937574312,30-39,592,5,7,8,15,15,7,8,7,2.9163649529,13.3213931913,0.0072137492,0.119047619,0.6111111,0,59,7.843438075233983E-5,5.4198706E-5,5.485614E-5,175,17,1,200,1,0.005
1025227592,KadsEdu,10,2238,66,87,1,120,42.839270022,40-49,603,6,11,10,21,21,11,10,7,2.9598117306,24.6412569629,0.0057057859,0.180952381,0.3011696,0,59,8.164702578629462E-5,8.129806E-5,8.228421E-5,182,3,0,200,0,0
1027658838,mloewen6,10,243,24,57,0,9,34.1972986062,30-39,417,4,0,1,1,1,0,1,1,1,0,0,0,0,0,577,4.766339181938244E-5,0,6.8570175E-6,25,1,0,200,0,0
1028563507,HauntedRiverNB,10,520,94,278,0,24,41.6725872785,40-49,565,5,23,71,94,94,23,71,6,2.3102824041,754.6013632809,0.0371567512,0.1345229925,0.36297786,0,59,1.1748949229009785E-4,1.6259612E-4,1.6456842E-4,77,19,7,200,7,0.035
1029611648,JMBealy,10,125,15,61,0,16,22.8522746182,20-29,392,3,1,3,4,4,1,3,7,3.0485155684,0,0.0041391127,0.1666666667,0.5,0,59,5.444496901079586E-5,1.3549677E-5,1.3714035E-5,77,1,0,136,0,0
1034615670,cinziascampini,10,183,4,39,0,3,20.0324167604,20-29,211,4,0,1,1,1,0,1,7,4.3571428571,0,0,0,0,42,492,4.766339181938244E-5,0,6.8570175E-6,197,0,0,198,0,0
1034865330,Skeptisynic,10,178,14,133,0,15,13.8246489581,10-19,165,4,1,4,5,5,1,4,7,3.2013034033,0.2173316103,3.073833002155888E-4,0.2,0.5,0,59,5.2130951925054486E-5,1.3549677E-5,1.3714035E-5,147,0,0,181,0,0
1038301598,ChantingWoman,10,6703,295,695,4,55,47.2707740349,40-49,630,7,35,64,99,99,35,64,6,2.481173063,1944.0818426308,0.0293240787,0.0698824985,0.23809524,0,59,1.9241131841390784E-4,2.4389417E-4,2.4685264E-4,77,12,0,202,0,0
1038618348,nathandueck,10,85,9,20,0,3,22.4985591915,20-29,229,3,0,0,0,0,0,0,0,0,0,0,0,0,140,319,4.766339181938244E-5,0,0,136,3,0,90,0,0
1043296272,anoncdn,10,2151,217,325,0,94,50.8192549519,50-59,668,7,5,12,17,17,5,12,7,2.9359160029,3024.0400782982,9.291514640986486E-4,0.1213235294,0.17619048,0,59,6.795113123239945E-5,4.064903E-5,3.4285087E-5,77,72,0,202,0,0
1044533689,vlastabernard,10,1477,110,379,0,238,35.0553049953,30-39,480,6,1,2,3,3,1,2,7,4.1333333333,14,8.095914281419891E-5,0,0,42,422,1.380466301787866E-4,1.3549677E-5,1.3714035E-5,197,0,0,200,0,0
1045802130,ChoiGoRena,10,753,76,166,0,23,32.4603110629,30-39,566,5,0,0,0,0,0,0,0,0,0,0,0,0,29,103,4.766339181938244E-5,0,0,27,28,0,200,0,0
1047212851,JcupidoCupido,10,1455,196,1232,1,16,43.9603310149,40-49,613,6,3,12,15,15,3,12,7,2.9923968139,53907.7822195252,7.500496752125876E-4,0.0714285714,0.15151516,0,59,1.0135644393122897E-4,2.7099353E-5,2.742807E-5,131,1,0,202,0,0
1048447759,Tenaciousceeee,10,39,3,46,0,6,34.98955094,30-39,429,4,5,29,34,34,5,29,7,2.6535119479,6.6546303255,0.0057354877,0.2495543672,0.43655914,0,59,5.5527909265885355E-5,4.064903E-5,4.1142106E-5,175,12,67,203,65,0.3201970443
1049489426,BookBabe2011,10,206,4,11,0,8,14.480216282,10-19,124,3,0,1,1,1,0,1,8,4.2479189287,0,0,0,0,0,296,4.766339181938244E-5,0,6.8570175E-6,77,1,0,197,0,0
1050282440,spaulcote,10,175,6,35,0,3,17.403833169,10-19,35,3,0,4,4,4,0,4,7,3.2167933406,0,0,0.3333333333,0.41666666,0,641,4.766339181938244E-5,0,6.8570175E-6,182,0,0,200,0,0
1051948640,BCPolitico,10,95,142,551,0,0,20.2484776959,20-29,243,4,19,90,109,109,19,90,6,2.3732802317,550.9839715743,0.0195667036,0.1736323479,0.35714287,0,59,1.0403564963797654E-4,1.3549677E-4,1.3714035E-4,182,0,0,109,0,0
1052983934,marco_king82,10,2634,35,170,0,194,23.961612071,20-29,287,6,0,1,1,1,0,1,7,4.3571428571,0,0,0,0,42,431,4.766339181938244E-5,0,6.8570175E-6,197,1,0,201,0,0
1053123560,loganaa515,10,1,6,24,0,1,16.4317320502,10-19,56,0,1,2,3,3,1,2,7,3.2577842143,235.8033990031,8.373081757371728E-5,0,0,0,59,7.186854780285767E-5,1.3549677E-5,1.3714035E-5,175,1,0,2,0,0
1053128252,jorgereyeszs,10,4808,263,419,0,167,43.7637018252,40-49,694,6,3,4,7,7,3,4,1,1,2.5,2.5371925759659007E-4,0.0952380952,0.5833333,50,135,3.6992121853306767E-4,2.7099353E-5,2.742807E-5,188,8,0,201,0,0
1053746012,JakeZJaffe,10,114,14,64,0,2,27.0380856808,20-29,190,3,3,9,12,12,3,9,7,3.12346126,11.0680310765,6.416176704030184E-4,0.1590909091,0.4722222,0,59,6.392293496894198E-5,2.7099353E-5,2.742807E-5,182,3,1,117,1,0.0085470085
1055278064,MondeMonden,10,277,9,111,0,2,24.5219654838,20-29,556,4,0,2,2,2,0,2,10,5.8820123055,0,0,0.5,1,0,400,4.766339181938244E-5,0,6.8570175E-6,131,2,0,200,0,0
1057691006,Julia_MR3,10,138,39,56,0,0,27.429032239,20-29,464,3,1,1,2,2,1,1,2,1.5,0,8.271798374069241E-5,0,0,162,360,2.4481546444683235E-4,1.3549677E-5,1.3714035E-5,161,13,0,153,0,0
1058370912,FletJan,10,1842,51,58,0,10,47.66713388,40-49,613,5,12,12,24,24,12,12,6,2.8204199855,39.9335365893,0.0094305641,0.1105072464,0.251634,0,59,8.137754818853693E-5,8.80729E-5,8.914123E-5,77,56,0,202,0,0
1058709871,Bill_Templeton,10,418,37,194,1,211,31.7958403914,30-39,430,4,0,3,3,3,0,3,8,3.600796236,0,0,0,0,0,122,4.766339181938244E-5,0,6.8570175E-6,182,0,0,200,0,0
1059015686,EmilianoAngius,10,2,4,45,0,0,11.5576855183,10-19,4,1,0,1,1,1,0,1,7,4.3571428571,0,0,0,0,42,515,4.766339181938244E-5,0,6.8570175E-6,197,0,0,10,0,0
1060545835,thelabandfield,10,116,28,42,3,0,41.4657069796,40-49,468,3,7,9,16,16,7,9,7,3.1911658219,6.4277290074,0.0017672867,0.15,0.7,0,59,9.183114204824508E-5,5.4198706E-5,5.485614E-5,77,17,0,188,0,0
1061511182,Emile_03,10,203,15,43,0,105,20.5522165417,20-29,418,4,0,2,2,2,0,2,7,2.9410061527,0,0,0,0,0,409,4.766339181938244E-5,0,6.8570175E-6,182,1,0,200,0,0
1065771643,ThaboSeseaneJr,10,5006,124,100,1,491,44.9310117869,40-49,602,7,0,1,1,1,0,1,1,1,0,0,0,0,0,640,4.766339181938244E-5,0,6.8570175E-6,77,0,0,200,0,0
1068791964,WillMcLean5,10,2736,284,564,3,1421,47.3559875205,40-49,637,6,40,58,98,98,40,58,7,2.6071687183,1599.6191863704,0.0242499604,0.0541763097,0.27797943,0,59,2.1538261515183208E-4,2.7776835E-4,2.811377E-4,175,30,0,200,0,0
1069600106,mikehammer2013,10,751,12,0,0,0,35.0499553169,30-39,615,5,0,0,0,0,0,0,0,0,0,0,0,0,11,76,4.766339181938244E-5,0,0,10,10,0,1,0,0
1072009236,Polkameister,10,2546,113,135,1,1,51.6923716987,50-59,699,6,27,21,48,48,27,21,7,2.7212165098,3275.2625386513,0.0159450675,0.1214539007,0.27192983,0,59,2.0234056818619866E-4,1.8969548E-4,1.8513948E-4,175,296,3,258,3,0.011627907
1072032300,ikwew_III,10,18672,834,1267,9,12947,55.4912653621,50-59,755,8,0,0,0,0,0,0,0,0,0,0,0,0,8,71,4.766339181938244E-5,0,0,7,44,0,1,0,0
1074835338,ZehrInsurance,10,39,39,60,0,0,24.8984799682,20-29,151,1,1,1,2,2,1,1,8,4.4453294714,0,8.284080759632974E-5,0,0,0,59,1.1081844225200397E-4,1.3549677E-5,1.3714035E-5,77,4,0,40,0,0
1075087957,YaWhatHeSaid,10,302,20,73,0,0,39.7181005404,30-39,475,4,6,26,32,32,6,26,6,2.6755973932,14.0944550507,0.0062774396,0.2298387097,0.41402116,0,59,6.241081540657361E-5,4.742387E-5,4.799912E-5,77,9,0,200,0,0
1076783226,BramWestNDP,10,76,31,67,4,1,28.6701599164,20-29,342,3,15,23,38,38,15,23,7,2.6669080377,48.3734302426,0.0137319809,0.2155049787,0.45172414,0,59,1.0043940434386424E-4,1.0839741E-4,1.0971228E-4,25,11,0,87,0,0
1077759668,thehillcat,10,253,103,410,2,1,33.5029998579,30-39,389,4,32,98,130,130,32,98,7,2.4333816075,162.3159641412,0.0514582067,0.2090041741,0.5267677,0,59,1.6016789044939576E-4,2.2356966E-4,2.2628158E-4,25,5,1,200,1,0.005
1078216555,Kellybwood,10,2,1,16,0,0,10.6708586376,10-19,1,0,0,0,0,0,0,0,0,0,0,0,0,0,267,695,4.766339181938244E-5,0,0,274,0,0,4,0,0
1078538047,katemcinturff,10,428,167,367,6,4,47.280782494,40-49,591,4,22,25,47,47,22,25,6,2.6803041274,536.8258145634,0.0201412048,0.1498612396,0.27884614,0,59,1.833104303120453E-4,1.5582128E-4,1.577114E-4,25,42,0,200,0,0
1080115680,CArgyleOFL,10,366,66,84,2,0,29.6307691493,20-29,167,5,22,20,42,42,22,20,6,2.7414916727,41.9447290753,0.0225697726,0.1550522648,0.52832514,0,59,1.1535082307091806E-4,1.5582128E-4,1.577114E-4,182,3,0,206,0,0
1080508939,hvg827,10,50,21,467,0,1,27.6683208717,20-29,169,3,1,9,10,10,1,9,7,2.914192614,1.3071943902,3.8179403608528897E-4,0.1555555556,0.25,0,59,5.2132662637807264E-5,1.3549677E-5,1.3714035E-5,77,1,0,63,0,0
1083627469,Ibrah_OvaarMarz,10,2324,67,94,0,71,43.5133648386,40-49,627,6,2,7,9,9,2,7,7,3.1209268646,2.6694555221,0.0060165641,0.1388888889,0.26190478,0,59,7.557231922891159E-5,2.0324514E-5,2.0571053E-5,25,14,2,232,2,0.0086206897
1084878776,PhatSra,10,296,17,80,0,10,35.7551991806,30-39,498,4,1,8,9,9,1,8,7,2.9293989862,19.6522651132,9.614898665273697E-5,0.2222222222,0.39285713,0,59,5.113474245927512E-5,1.3549677E-5,1.3714035E-5,175,17,0,200,0,0
1087992997,nmcdnld,10,79,44,91,1,105,33.2376993545,30-39,409,3,11,28,39,39,11,28,7,2.5380159305,75.8672048074,0.0112729653,0.1794871795,0.50123155,0,59,7.716722460860059E-5,8.129806E-5,8.228421E-5,25,19,2,94,2,0.0212765957
1088105096,bcprivcitizen,10,54,33,53,1,1,21.0740768827,20-29,212,2,0,0,0,0,0,0,0,0,0,0,0,0,137,313,4.766339181938244E-5,0,0,133,0,0,60,0,0
1088465473,BruceMcComber,10,1077,174,266,6,65,43.3385751136,40-49,578,6,9,15,24,24,9,15,6,2.8841419261,116.1947887854,0.0098692296,0.0815217391,0.25,0,59,9.949764412564196E-5,6.7748384E-5,6.8570174E-5,77,5,1,200,1,0.005
1089995856,swtkarrie777,10,472,26,39,0,74,15.548425623,10-19,257,4,3,5,8,8,3,5,7,3.2096307024,5.3859957106,0.001132518,0.1428571429,0.23809524,0,59,5.377780809108992E-5,2.7099353E-5,2.742807E-5,77,0,1,199,1,0.0050251256
1090069562,ellewist,10,1882,128,345,0,108,35.776874828,30-39,465,6,4,8,12,12,4,8,7,2.8750905141,36.3019906421,0.0052207164,0.1287878788,0.3888889,0,59,7.118719464547112E-5,3.3874192E-5,3.4285087E-5,175,4,0,201,0,0
1091259852,unruly_1,10,18,7,82,1,0,19.4645937779,10-19,47,2,0,3,3,3,0,3,7,3.0401737242,0,0,0.3333333333,0.5,0,368,4.766339181938244E-5,0,6.8570175E-6,25,0,0,19,0,0
1094058062,bc7rocks,10,514,25,22,0,55,44.803022416,40-49,598,5,6,10,16,16,6,10,6,2.8475742216,601.098156172,0.006403203,0.1166666667,0.4,0,59,6.413234054438067E-5,4.742387E-5,4.799912E-5,77,49,0,201,0,0
1095333092,JordanNReid,10,2,24,171,0,0,16.6229289464,10-19,60,2,12,93,105,105,12,93,6,2.4511223751,28.8700035033,0.0324861382,0.2769230769,0.54347825,0,59,1.628587530243277E-4,8.80729E-5,8.914123E-5,25,1,0,5,0,0
1096068614,MohamedNDP,10,153,262,172,7,30,45.7509920538,40-49,546,4,90,65,155,155,90,65,6,2.5126719768,5931.034644568,0.0750944893,0.0378718056,0.13158415,0,59,3.370824403381427E-4,6.165103E-4,6.2398857E-4,25,96,2,201,2,0.0099502488
1097270467,Idlenomoreyeg,10,5905,969,1478,22,0,57.166457919,50-59,737,4,47,38,85,85,47,38,6,2.5434467777,5498.5667370063,0.0370113422,0.0337535014,0.13914028,0,59,1.9753388071444956E-4,3.2519223E-4,3.2913685E-4,77,100,1,203,1,0.0049261084
1098248972,SBubbaFuller,10,123,37,72,0,1,26.6471888581,20-29,312,4,19,25,44,44,19,25,6,2.8276611151,75.0009789985,0.013458681,0.133192389,0.5641026,0,59,1.6773199818895772E-4,1.3549677E-4,1.3714035E-4,147,5,0,127,0,0
1099575902,ResidencyQ,10,1235,310,219,1,1,43.9076791991,40-49,640,6,7,20,27,27,7,20,6,2.6520637219,19.2189493038,0.0073960992,0.1367521368,0.2987013,0,59,6.441417572455972E-5,5.4198706E-5,5.485614E-5,77,37,4,200,4,0.02
1099800842,UCTE_RVP_BC,10,190,52,175,0,2,18.8871084566,10-19,196,4,14,30,44,44,14,30,7,2.670166546,217.3565863535,0.0130405961,0.1368921776,0.2857143,0,59,9.826630030138409E-5,1.0162257E-4,9.599824E-5,182,3,1,195,1,0.0051282051
1099809654,thunderdrums75,10,4364,405,524,8,954,52.7341199675,50-59,725,7,50,61,111,111,50,61,6,2.5952208545,7961.6889303071,0.0367473355,0.0476658477,0.20957342,0,59,3.2073579399024665E-4,3.4551675E-4,3.497079E-4,77,180,0,200,0,0
1100584747,MarianneLuez,10,623,38,48,0,56,41.078448781,40-49,593,5,5,5,10,10,5,5,3,1.9444444444,32.9666666667,4.4544704631698244E-4,0.1,0.55,58,182,3.37274888954253E-4,4.064903E-5,4.1142106E-5,166,14,0,201,0,0
1101378240,janetscott73,10,493,37,80,0,0,36.2964803352,30-39,501,5,9,13,22,22,9,13,6,2.7490948588,99.1704237915,0.0088979317,0.0930735931,0.46153846,0,59,8.696321464796085E-5,6.7748384E-5,6.8570174E-5,182,26,0,200,0,0
1102426495,jasonbrooks4562,10,369,107,528,0,6,34.6426697958,30-39,557,5,15,63,78,78,15,63,6,2.3700217234,1819.369503345,0.011831132,0.1307026307,0.28621033,0,59,1.0129196169074653E-4,1.0839741E-4,1.0971228E-4,147,62,1,200,1,0.005
1102814232,chickenbug,10,41,5,29,0,0,14.045853897,10-19,25,1,0,0,0,0,0,0,0,0,0,0,0,0,148,332,4.766339181938244E-5,0,0,144,0,0,43,0,0
1104113336,PoliSciWiseguy,10,108,56,202,1,3,29.1538088193,20-29,270,3,7,20,27,27,7,20,6,2.6549601738,8.726441509,0.0120782906,0.2578347578,0.5197629,0,59,7.501567901027216E-5,5.4198706E-5,5.485614E-5,25,3,0,112,0,0
1109181847,haruna0011,10,13343,708,763,0,0,40.1402752801,40-49,532,7,0,0,0,0,0,0,0,0,0,0,0,0,220,545,4.766339181938244E-5,0,0,224,0,0,201,0,0
1109812544,TunaLoo,10,55,14,46,0,11,17.0343878859,10-19,155,2,0,4,4,4,0,4,7,3.0843286283,0,0,0.3333333333,0.5833333,0,316,4.766339181938244E-5,0,6.8570175E-6,25,0,0,58,0,0
1110761798,Thatcherist,10,41,13,26,0,0,17.9145535175,10-19,176,3,2,5,7,7,2,5,7,3.1343229544,2.945634421,4.609711147047128E-4,0.119047619,0.45,0,59,5.641845970344325E-5,2.0324514E-5,2.0571053E-5,175,3,1,88,1,0.0113636364
1112892476,jeffreyawhiteca,10,15,8,14,0,0,12.1265715677,10-19,8,1,0,3,3,3,0,3,7,3.4201954397,0,0,0.1666666667,0.16666667,0,191,4.766339181938244E-5,0,6.8570175E-6,25,0,0,20,0,0
1114221001,MarcoMungai,10,250,80,121,0,61,28.9941638492,20-29,477,4,0,1,1,1,0,1,7,4.3571428571,0,0,0,0,42,496,4.766339181938244E-5,0,6.8570175E-6,197,0,0,200,0,0
1115237750,netdog713,10,11599,244,672,1,1762,16.3817164922,10-19,676,8,1,1,2,2,1,1,7,3.3783490224,0,4.340481443440544E-4,0,0,0,59,5.0274938070987655E-5,1.3549677E-5,1.3714035E-5,25,2,0,201,0,0
1117017337,Canada_Bikes,10,134,120,178,3,0,40.2865832277,40-49,426,3,3,10,13,13,3,10,7,2.8783490224,16.5455367007,4.0617939732892237E-4,0.2371794872,0.32575756,0,59,5.810103677943496E-5,2.7099353E-5,2.742807E-5,182,3,0,136,0,0
1118819690,Henshall4MLA,10,64,63,115,2,2,40.0233868283,40-49,495,4,20,19,39,39,20,19,7,3.122013034,166.03940268,0.0081179065,0.0937921727,0.44071147,0,59,1.710069498912043E-4,1.422716E-4,1.4399737E-4,182,63,0,122,0,0
1120740445,emiliocanals07,10,220,69,96,0,2,37.3234175258,30-39,515,4,0,0,0,0,0,0,0,0,0,0,0,0,59,147,4.766339181938244E-5,0,0,52,16,0,199,0,0
1120945118,Ghyde59,10,462,29,43,0,54,30.1284209241,30-39,474,4,0,0,0,0,0,0,0,0,0,0,0,0,249,645,4.766339181938244E-5,0,0,254,5,0,200,0,0
1124513556,canuckfan16,10,577,30,153,0,0,36.7034554288,30-39,516,6,0,4,4,4,0,4,7,3.2605863192,0,0,0.1666666667,0.25,0,257,4.766339181938244E-5,0,6.8570175E-6,182,0,0,200,0,0
1126191505,nandopagliara,10,1935,304,537,1,121,44.4715960655,40-49,631,6,0,1,1,1,0,1,7,4.3571428571,0,0,0,0,42,414,4.766339181938244E-5,0,6.8570175E-6,197,2,1,201,1,0.0049751244
1126806397,Queen8Bees,10,400,12,14,0,40,43.2110086046,40-49,592,5,11,15,26,26,11,15,7,2.7990586531,9.1706887398,0.0118964898,0.1538461538,0.5,0,59,7.124957500012253E-5,8.129806E-5,8.228421E-5,77,38,0,201,0,0
1128158299,respiroeanima,10,2397,314,330,0,486,46.811530922,40-49,678,6,2,2,4,4,2,2,8,4.8125,16,1.619561731312207E-4,0,0,42,433,2.3669167148763028E-4,2.0324514E-5,2.0571053E-5,197,22,0,201,0,0
1129424678,BeckyKentMLA,10,43,40,40,4,0,34.8345025224,30-39,427,3,23,16,39,39,23,16,7,3.0992034757,73.0386706968,0.0162936551,0.173414305,0.5595238,0,59,1.48289582011382E-4,1.6259612E-4,1.6456842E-4,147,54,0,67,0,0
1130456989,rikobrinkman,10,288,65,63,3,26,42.7107536405,40-49,495,5,21,24,45,45,21,24,7,2.7375090514,230.774997606,0.0186454023,0.1080808081,0.2452381,0,59,1.2456736718525634E-4,1.4904643E-4,1.5085438E-4,175,11,3,200,3,0.015
1132300357,Ibrahber,10,738,36,123,0,2,39.6572946641,30-39,607,5,4,21,25,25,4,21,6,2.60391021,2802.4426295116,0.0045885582,0.19,0.34415585,0,59,1.0514116839866046E-4,3.3874192E-5,3.4285087E-5,77,19,0,201,0,0
1132335180,jofo_,10,12,9,76,0,1,12.2285441559,10-19,9,1,0,4,4,4,0,4,7,3.2540716612,0,0,0.25,0.33333334,0,356,4.766339181938244E-5,0,6.8570175E-6,77,0,0,15,0,0
1135401164,DEG_1,10,353,8,41,0,0,37.2123206171,30-39,512,4,2,9,11,11,2,9,7,2.972121651,1.8000921964,6.802385439438294E-4,0.1818181818,0.4027778,0,59,5.206768262960254E-5,2.0324514E-5,2.0571053E-5,175,11,2,200,2,0.01
1136961996,QQ_ZZZ,10,544,44,427,0,83,36.3378432009,30-39,577,5,2,17,19,19,2,17,7,2.9322954381,28.4952335452,0.0014858666,0.1783625731,0.22875817,0,59,5.096202047391447E-5,2.0324514E-5,2.0571053E-5,175,3,0,201,0,0
1137791304,butthunder,10,364,17,20,0,108,13.4410238165,10-19,533,4,10,4,14,14,10,4,7,2.9840695148,2.653886753,0.0116645264,0.1923076923,0.5,0,59,7.153150688431855E-5,7.452322E-5,7.542719E-5,77,19,0,199,0,0
1137871406,RTFZine,10,2104,270,587,6,7,49.7756965506,40-49,639,6,22,65,87,87,22,65,6,2.3823316437,1141.8240728376,0.0227656063,0.0827318899,0.2423077,0,59,9.832186823301268E-5,1.5582128E-4,1.577114E-4,77,23,0,201,0,0
1138077696,MightyGreen1,10,1285,171,342,0,275,44.3009304955,40-49,567,6,20,54,74,74,20,54,6,2.4029688631,352.4121311119,0.0255786585,0.1247686042,0.3668763,0,59,9.448382297913098E-5,1.422716E-4,1.4399737E-4,77,36,0,200,0,0
1138100232,wrychrd,10,808,148,396,5,17,46.7810714971,40-49,581,5,6,16,22,22,6,16,7,2.8787110789,282.5965465843,0.0013830207,0.158008658,0.24561404,0,59,7.097763202630564E-5,4.742387E-5,4.799912E-5,182,12,0,200,0,0
1141969986,Misenos,10,409,97,114,1,5,43.3839437588,40-49,580,5,0,0,0,0,0,0,0,0,0,0,0,0,169,371,4.766339181938244E-5,0,0,168,0,0,200,0,0
1145495754,trilbeestirling,10,22,8,27,0,0,23.7329840409,20-29,99,1,1,7,8,8,1,7,7,3.0481535119,2950.1106229723,0.0010924931,0.1607142857,0.2857143,0,59,5.267450451078436E-5,1.3549677E-5,1.3714035E-5,182,0,0,24,0,0
1146813762,realdizzyizzy,10,11,6,35,0,0,25.178078711,20-29,177,1,3,6,9,9,3,6,7,3.1517016655,7.4952396988,0.0030059674,0.0972222222,0.3,0,59,7.459889878663577E-5,2.7099353E-5,2.742807E-5,25,7,0,15,0,0
1147659020,diegopescarini,10,28,25,125,0,1,19.4276943096,10-19,54,2,0,1,1,1,0,1,7,4.3571428571,0,0,0,0,42,467,4.766339181938244E-5,0,6.8570175E-6,197,0,0,34,0,0
1147690638,KrasnikovDmitry,10,938,5,3,0,0,19.2961767426,10-19,55,5,0,0,0,0,0,0,0,0,0,0,0,0,171,373,4.766339181938244E-5,0,0,170,1,0,198,0,0
1148336353,Iamnotsinatra,10,28,1,9,0,0,15.6708586376,10-19,42,2,0,2,2,2,0,2,8,3.4296055013,0,0,0.5,0.5,0,571,4.766339181938244E-5,0,6.8570175E-6,182,0,0,32,0,0
1149032365,RwkXdc,10,2132,202,450,0,35,45.467262558,40-49,612,6,0,12,12,12,0,12,7,2.9721317409,0,0,0.2272727273,0.2651515,0,202,4.766339181938244E-5,0,6.8570175E-6,77,6,0,202,0,0
1149562928,ProgCultureCan,10,84,162,1044,1,9,29.8705365785,20-29,400,3,38,214,252,252,38,214,6,2.1712527154,7604.5747319127,0.0387592769,0.144406501,0.27580962,0,59,1.418042113738149E-4,2.642187E-4,2.674237E-4,25,2,0,88,0,0
1151103258,CanadaLew,10,603,35,106,0,0,36.8560705221,30-39,568,5,2,6,8,8,2,6,7,3.3410572049,13.8100492553,4.3388183080780206E-4,0,0,0,59,5.375598858105298E-5,2.0324514E-5,2.0571053E-5,175,21,0,200,0,0
1152097489,siru_maru,10,14254,879,959,0,0,44.5353775702,40-49,586,7,1,1,2,2,1,1,7,2.9960173787,0,0.0036251983,0,0,0,59,5.1343015620857445E-5,1.3549677E-5,1.3714035E-5,77,0,0,201,0,0
1152425442,Alex_S_Cullen,10,59,30,30,2,0,30.5515449181,30-39,295,2,3,9,12,12,3,9,7,3.1379435192,4.5682375109,0.0024731891,0.2954545455,0.37878788,0,59,5.2636067620588107E-5,2.7099353E-5,2.742807E-5,25,3,0,70,0,0
1153364815,communityvote,10,156,74,153,2,0,42.8968258839,40-49,468,3,2,2,4,4,2,2,7,3.2744388125,0.5480591816,0.0010467355,0.0833333333,0.16666667,0,59,5.1275513088746416E-5,2.0324514E-5,2.0571053E-5,182,6,0,170,0,0
1154159796,transitgirljo,10,22,22,102,0,0,20.0266048478,20-29,149,2,1,0,1,1,1,0,0,0,0,8.380382256065438E-5,0,0,0,32,5.1817262732616596E-5,1.3549677E-5,0,175,0,0,33,0,0
1157796896,waldowilkins,10,57,18,225,0,790,18.5116586668,10-19,70,3,0,7,7,7,0,7,7,2.8110749186,0,0,0.380952381,0.52380955,0,611,4.766339181938244E-5,0,6.8570175E-6,175,0,0,65,0,0
1158164065,thePeteMartin,10,18,5,24,0,2,18.9329907796,10-19,57,1,0,2,2,2,0,2,8,3.786102063,0,0,0.5,0.5,0,349,4.766339181938244E-5,0,6.8570175E-6,147,0,0,201,0,0
1162715466,MicMorose,10,1062,56,179,0,90,43.4770542076,40-49,525,6,0,0,0,0,0,0,0,0,0,0,0,0,223,554,4.766339181938244E-5,0,0,227,5,0,201,0,0
1163407496,MacDonaldJoel,10,121,24,115,1,2,25.0802792947,20-29,317,3,14,22,36,36,14,22,6,2.7443881245,308.7093343727,0.0127799085,0.1626984127,0.56333333,0,59,1.107349551453251E-4,1.0162257E-4,1.02855265E-4,147,2,0,142,0,0
1163725992,2ndmortgagehub,10,302,200,173,1,1,43.3204899823,40-49,495,5,1,4,5,5,1,4,8,3.5126719768,971.8957729732,8.291027890805803E-5,0,0,0,59,8.38484243539035E-5,1.3549677E-5,1.3714035E-5,175,14,0,201,0,0
1164511201,EgmontNDP,10,96,27,47,3,0,30.2775148756,30-39,199,3,11,16,27,27,11,16,7,2.9116582187,25.7024382151,0.008067861,0.1994301994,0.38528138,0,59,7.813195013158611E-5,8.129806E-5,8.228421E-5,25,10,1,127,1,0.0078740157
1165028167,SoundingBrd_OHR,10,654,192,421,1,3,45.7968622573,40-49,629,4,2,4,6,6,2,4,7,3.0351194786,9.1755240484,0.0024216117,0.1,0.2,0,59,6.826951865862554E-5,2.0324514E-5,2.0571053E-5,175,13,0,200,0,0
1165937736,_cassandra_t,10,298,41,72,2,6,41.0200026074,40-49,464,4,0,2,2,2,0,2,7,3.3231994209,0,0,0.5,0.5,0,587,4.766339181938244E-5,0,6.8570175E-6,25,1,0,199,0,0
1165965612,paolo_dgnpaolo,10,160,27,119,0,34,37.4736111437,30-39,559,5,0,0,0,0,0,0,0,0,0,0,0,0,193,434,4.766339181938244E-5,0,0,196,1,0,201,0,0
1167595884,TheOtherRealJLo,10,47,13,74,0,15,21.0214683352,20-29,311,2,1,2,3,3,1,2,7,3.4938450398,0,1.2977722658618618E-4,0.1666666667,0.5,0,59,5.8358798694899036E-5,1.3549677E-5,1.3714035E-5,147,1,0,48,0,0
1168689936,job_diazg,10,175,40,55,0,14,38.6782923742,30-39,541,4,0,0,0,0,0,0,0,0,0,0,0,0,72,165,4.766339181938244E-5,0,0,64,12,0,202,0,0
1170530546,CUPE129,10,331,110,470,2,8,42.3193317589,40-49,519,5,25,87,112,112,25,87,6,2.4511223751,575.5657226797,0.0254439395,0.1421332046,0.31664965,0,59,1.148263617140701E-4,1.761458E-4,1.7828245E-4,182,109,0,200,0,0
1171731247,Mpeters18S,10,58,2,30,0,0,14.0971969197,10-19,62,3,0,10,10,10,0,10,7,2.6938110749,0,0,0.4777777778,0.73333335,0,210,4.766339181938244E-5,0,6.8570175E-6,25,0,1,67,1,0.0149253731
1172125220,larrysummers15,10,91,9,24,0,1,25.0721740459,20-29,324,3,0,1,1,1,0,1,7,4.3571428571,0,0,0,0,42,547,4.766339181938244E-5,0,6.8570175E-6,197,0,0,140,0,0
1173231918,E4Dca,10,100,176,311,8,0,52.4275983959,50-59,651,3,44,61,105,105,44,61,6,2.3204199855,17380.5854239882,0.0420478186,0.0825091575,0.2113924,0,59,3.3239978183356896E-4,3.0486772E-4,3.0170876E-4,77,131,0,115,0,0
1177675052,alexlanendp,10,144,81,366,1,5,40.1150837406,40-49,456,4,37,111,148,148,37,111,6,2.3602461984,3997.2792031163,0.0390353034,0.1301709873,0.31736282,0,59,1.7418758333244042E-4,2.5744384E-4,2.6056665E-4,25,62,3,199,3,0.0150753769
1179642390,GeosciencesEd,10,612,323,1086,9,3,47.1672570537,40-49,527,6,1,4,5,5,1,4,7,3.4116582187,12.2322892856,4.762496021136824E-4,0.15,0.5,0,59,5.2233075935260026E-5,1.3549677E-5,1.3714035E-5,77,0,0,201,0,0
1180466966,ajswurld,10,544,54,311,1,51,33.850969388,30-39,457,5,3,8,11,11,3,8,7,2.9181752353,0.8314069539,0.0015712937,0.2181818182,0.58928573,0,59,5.6263916463165746E-5,2.7099353E-5,2.742807E-5,182,2,0,199,0,0
1180553077,NBnavigators,10,13,77,409,1,1,31.3902154661,30-39,353,3,0,3,3,3,0,3,7,3.1197973218,0,0,0.5,0.8333333,0,166,4.766339181938244E-5,0,6.8570175E-6,182,8,0,49,0,0
1184156005,LPC338,10,9,1,282,0,0,42.2205270424,40-49,562,3,28,89,117,117,28,89,6,2.4489500362,641.7583432143,0.0223876174,0.1311523725,0.32259676,0,59,1.242119478567779E-4,1.9647031E-4,1.9885351E-4,175,51,0,203,0,0
1184200088,WowIvanTweets,10,255,12,97,0,39,24.6246914539,20-29,225,4,2,9,11,11,2,9,7,2.8526430123,1.917821129,0.0051716931,0.2090909091,0.34444445,0,59,5.4181155039102855E-5,2.0324514E-5,2.0571053E-5,77,1,7,200,7,0.035
1186554950,PaoloFratello,10,110,40,154,0,1,37.3777468295,30-39,484,3,0,1,1,1,0,1,7,4.3571428571,0,0,0,0,42,455,4.766339181938244E-5,0,6.8570175E-6,197,0,0,151,0,0
1187549712,konsultando,10,47,6,135,0,0,18.0782181361,10-19,20,3,0,1,1,1,0,1,7,4.3571428571,0,0,0,0,42,470,4.766339181938244E-5,0,6.8570175E-6,197,0,0,78,0,0
1188148028,ayano2ayano,10,4697,414,434,0,0,39.9701316779,30-39,537,7,1,1,2,2,1,1,7,2.9960173787,0,0.0036251983,0,0,0,59,5.1343015620857445E-5,1.3549677E-5,1.3714035E-5,77,0,0,201,0,0
1191498908,JordanKligman,10,518,26,114,0,12,38.0337278544,30-39,550,4,0,1,1,1,0,1,7,3.3170466884,0,0,0,0,0,390,4.766339181938244E-5,0,6.8570175E-6,77,0,0,200,0,0
1192013226,loo2404,10,101,9,21,0,0,12.3207895825,10-19,71,4,2,7,9,9,2,7,7,2.9840695148,0.6173479387,7.50438936511544E-4,0.1944444444,0.5714286,0,59,5.0660501979679774E-5,2.0324514E-5,2.0571053E-5,182,1,0,143,0,0
1193732328,EcoBooks4Kids,10,139,345,1972,10,2,44.1202034229,40-49,493,4,5,23,28,28,5,23,6,2.6538740043,97.3404566475,0.0028424356,0.1574074074,0.3458498,0,59,7.311883952957002E-5,4.064903E-5,4.1142106E-5,77,4,0,157,0,0
1195118856,saleamen,10,50,15,125,0,2,25.128241004,20-29,135,2,0,13,13,13,0,13,7,2.894679696,0,0,0.358974359,0.48076922,0,218,4.766339181938244E-5,0,6.8570175E-6,175,2,0,65,0,0
1195139166,Fernandajrz97,10,1123,90,218,0,4,41.663488727,40-49,597,4,0,0,0,0,0,0,0,0,0,0,0,0,167,369,4.766339181938244E-5,0,0,165,0,0,201,0,0
1196233544,keddieff,10,261,33,174,0,62,36.1063821882,30-39,407,4,7,44,51,51,7,44,6,2.4771904417,36.6292999329,0.0097760218,0.2015686275,0.40169132,0,59,6.761402432054735E-5,5.4198706E-5,5.485614E-5,25,5,0,199,0,0
1196307679,GilksM,10,14,12,51,0,3,18.3566369665,10-19,81,1,0,1,1,1,0,1,7,3.5570032573,0,0,0,0,0,397,4.766339181938244E-5,0,6.8570175E-6,182,0,0,16,0,0
1197195649,BeckfordgroLati,10,22,5,85,0,0,10.6708586376,10-19,18,1,0,0,0,0,0,0,0,0,0,0,0,0,136,309,4.766339181938244E-5,0,0,132,0,0,26,0,0
1197624048,BecklfvRena,10,14,3,92,0,0,,,13,0,0,0,0,0,0,0,0,0,0,0,0,0,168,370,4.766339181938244E-5,0,0,167,0,0,15,0,0
1199434388,creemy62,10,554,9,18,0,1,14.3242853883,10-19,67,5,1,0,1,1,1,0,0,0,0,0.0015342608,0,0,0,53,4.991970629142529E-5,1.3549677E-5,0,77,0,0,200,0,0
1199927678,WaiteshztNancie,10,11,3,59,0,0,,,4,0,0,0,0,0,0,0,0,0,0,0,0,0,23,96,4.766339181938244E-5,0,0,20,0,0,16,0,0
1200108570,BaileytjiMicael,10,21,8,93,0,0,,,9,1,0,0,0,0,0,0,0,0,0,0,0,0,202,514,4.766339181938244E-5,0,0,206,0,0,22,0,0
1200640753,AranavkaJamey,10,21,4,94,0,0,,,7,1,0,0,0,0,0,0,0,0,0,0,0,0,75,171,4.766339181938244E-5,0,0,67,0,0,31,0,0
1200867362,RhinehartbslShe,10,19,3,89,0,0,,,7,1,0,0,0,0,0,0,0,0,0,0,0,0,5,68,4.766339181938244E-5,0,0,4,0,0,24,0,0
1201105754,SticebthKristin,10,11,8,90,0,0,,,43,0,0,0,0,0,0,0,0,0,0,0,0,0,206,524,4.766339181938244E-5,0,0,210,0,0,17,0,0
1201618008,mrempey,10,118,11,65,0,42,23.8545120883,20-29,196,4,0,7,7,7,0,7,7,3.0893955845,0,0,0.3333333333,0.54761904,0,198,4.766339181938244E-5,0,6.8570175E-6,25,0,0,180,0,0
1203545232,KovachrfjCameli,10,18,3,60,0,0,,,6,1,0,0,0,0,0,0,0,0,0,0,0,0,21,93,4.766339181938244E-5,0,0,19,0,0,24,0,0
1203697909,ShumperthezAdri,10,18,9,104,0,0,,,7,1,0,0,0,0,0,0,0,0,0,0,0,0,187,406,4.766339181938244E-5,0,0,189,0,0,24,0,0
1203949657,GoodnightwtiLav,10,13,8,59,0,0,11.8833382982,10-19,19,0,0,0,0,0,0,0,0,0,0,0,0,0,44,128,4.766339181938244E-5,0,0,41,0,0,201,0,0
1203977845,CasanovafgoJean,10,34,8,79,0,0,,,19,1,0,0,0,0,0,0,0,0,0,0,0,0,166,366,4.766339181938244E-5,0,0,164,0,0,39,0,0
1204101085,CristkgfIsela,10,30,9,100,0,0,10.6708586376,10-19,9,1,0,0,0,0,0,0,0,0,0,0,0,0,179,382,4.766339181938244E-5,0,0,179,0,0,33,0,0
1204305224,BilbreydajBerni,10,15,7,61,0,0,,,7,0,0,0,0,0,0,0,0,0,0,0,0,0,134,304,4.766339181938244E-5,0,0,129,0,0,17,0,0
1204826154,MowrybuvGladis,10,4,0,2,0,0,,,11,0,0,0,0,0,0,0,0,0,0,0,0,0,203,519,4.766339181938244E-5,0,0,207,0,0,6,0,0
1204850634,FrantzztiDaphin,10,18,3,74,0,0,10.6708586376,10-19,7,1,0,0,0,0,0,0,0,0,0,0,0,0,9,72,4.766339181938244E-5,0,0,8,0,0,24,0,0
1205581352,JesseW2699,10,69,23,54,0,0,15.8192528723,10-19,77,3,0,7,7,7,0,7,7,3.0546507419,0,0,0.2142857143,0.23809524,0,355,4.766339181938244E-5,0,6.8570175E-6,25,0,0,84,0,0
1209167658,WhitbyOshawaNDP,10,11,6,33,0,0,17.1486163117,10-19,21,1,3,14,17,17,3,14,7,2.8816075308,0.5055596221,0.0052558255,0.3345588235,0.525,0,59,6.187336454300952E-5,2.7099353E-5,2.742807E-5,25,0,0,22,0,0
1209325026,haileylynna12,10,290,130,140,0,354,38.1648264789,30-39,501,4,2,2,4,4,2,2,2,1.3333333333,4,1.6371514892060646E-4,0,0,49,134,4.125104515726263E-4,2.0324514E-5,2.0571053E-5,181,12,0,199,0,0
1219686572,capelton15,10,29,7,51,0,0,12.0125759127,10-19,7,1,0,5,5,5,0,5,6,2.974665219,0,0,0.4,0.6,0,668,4.766339181938244E-5,0,6.8570175E-6,77,0,0,30,0,0
1219831238,IanBaranov,10,117,35,129,0,1,40.3645072712,40-49,481,4,7,14,21,21,7,14,7,2.8312816799,10.5525407791,0.00474245,0.2142857143,0.6375,0,59,8.03797359206739E-5,5.4198706E-5,5.485614E-5,175,9,7,156,7,0.0448717949
1219832994,wardblack4,10,42,3,15,0,0,20.2678127417,20-29,85,2,0,0,0,0,0,0,0,0,0,0,0,0,199,508,4.766339181938244E-5,0,0,203,3,0,53,0,0
1220209064,ana_michan,10,4138,559,131,0,78,42.2772245584,40-49,579,7,1,1,2,2,1,1,1,1,0,8.095914281419891E-5,0,0,260,675,3.177448371356425E-4,1.3549677E-5,1.3714035E-5,266,0,0,201,0,0
1220491525,andystewart76,10,638,71,303,4,686,42.9622338404,40-49,534,6,0,1,1,1,0,1,1,1,0,0,0,0,0,613,4.766339181938244E-5,0,6.8570175E-6,25,0,0,201,0,0
1222117520,hamar_scott,10,35,7,96,0,19,12.1265715677,10-19,8,2,0,4,4,4,0,4,7,3.2844733985,0,0,0.0833333333,0.083333336,0,664,4.766339181938244E-5,0,6.8570175E-6,182,0,0,36,0,0
1222478582,PEIismyhome,10,121,27,114,0,4,25.9587456578,20-29,283,2,1,7,8,8,1,7,7,3.0905141202,0.50248326,3.133389117117297E-4,0.3392857143,0.39285713,0,59,5.02830311468344E-5,1.3549677E-5,1.3714035E-5,77,15,1,122,1,0.0081967213
1222620624,CanadianProg,10,418,25,133,0,15,26.2277917262,20-29,375,4,5,45,50,50,5,45,6,2.4174511224,11.7153906773,0.0129114556,0.3285714286,0.5855689,0,59,6.748260793765261E-5,4.064903E-5,4.1142106E-5,25,5,0,203,0,0
1223613373,WACVictoria,10,16,18,44,0,0,34.9501011066,30-39,391,2,0,2,2,2,0,2,7,3.3293521535,0,0,0,0,0,163,4.766339181938244E-5,0,6.8570175E-6,77,0,0,45,0,0
1226176022,nama_house,10,3862,1418,1454,0,0,41.4114060963,40-49,571,6,1,1,2,2,1,1,1,1,0,8.095914281419891E-5,0,0,260,675,3.177448371356425E-4,1.3549677E-5,1.3714035E-5,266,1,0,201,0,0
1226281760,ziathailly,10,61,27,22,0,3,33.6887089335,30-39,531,4,1,1,2,2,1,1,2,1.6666666667,0,8.271798374069241E-5,0,0,58,145,1.1800910672257701E-4,1.3549677E-5,1.3714035E-5,166,23,0,200,0,0
1226426209,MiaWasp,10,673,55,177,1,29,43.6341949011,40-49,595,5,3,11,14,14,3,11,6,3.103186097,108.3244305575,5.437301411975771E-4,0.0384615385,0.08181818,0,59,7.222591639683898E-5,2.7099353E-5,2.742807E-5,175,23,0,201,0,0
1226952782,sarah_2588,10,98,22,120,0,0,31.1423104316,30-39,400,3,3,12,15,15,3,12,7,3.0358435916,92.0640051096,0.0019837688,0.1047619048,0.25757575,0,59,6.488000120886936E-5,2.7099353E-5,2.742807E-5,182,21,0,119,0,0
1227200887,stefaniacampani,10,1066,95,119,3,43,41.8255253551,40-49,554,5,1,0,1,1,1,0,0,0,0,7.92005701980554E-5,0,0,205,522,8.817727671970712E-5,1.3549677E-5,0,209,2,0,200,0,0
1227284359,Ernesto_Nobile,10,286,26,213,0,34,20.6532335598,20-29,107,4,0,1,1,1,0,1,7,4.3571428571,0,0,0,0,42,419,4.766339181938244E-5,0,6.8570175E-6,197,0,0,200,0,0
1228455248,PastaPolo1,10,20,16,59,0,0,22.4384881795,20-29,208,2,1,4,5,5,1,4,7,3.2465604634,0.4947734126,1.684691274809274E-4,0.3,0.5,0,59,5.1642327960862966E-5,1.3549677E-5,1.3714035E-5,182,1,0,44,0,0
1228889064,yegStrathconaPC,10,6,27,214,0,0,18.3083428107,10-19,101,2,1,11,12,12,1,11,7,2.9116582187,0.0688043918,7.853389160614392E-4,0.2651515152,0.54545456,0,59,5.3055346944817696E-5,1.3549677E-5,1.3714035E-5,175,4,1,21,1,0.0476190476
1230330985,StephaneGroulx,10,10,8,100,0,0,53.3676645039,50-59,63,1,5,23,28,28,5,23,6,2.585807386,69.0341498153,0.0106971351,0.2605820106,0.4523077,0,59,6.575439236591303E-5,4.064903E-5,4.1142106E-5,175,0,1,22,1,0.0454545455
1230441554,LeviINM,10,284,255,286,3,63,44.8380152847,40-49,597,4,37,42,79,79,37,42,6,2.6893555395,689.0555667634,0.0264921897,0.0496592016,0.21690822,0,59,1.8004454822763912E-4,2.5744384E-4,2.6056665E-4,77,24,0,195,0,0
1231540729,DanielleLemieu7,10,43,50,45,0,28,12.6834345503,10-19,414,2,1,1,2,2,1,1,9,4.6132416787,0,8.095914281419891E-5,0,0,0,261,8.05725874402837E-5,1.3549677E-5,1.3714035E-5,175,6,0,75,0,0
1231844737,Jack__Wagon,10,81,18,325,0,0,32.9474406492,30-39,276,4,2,49,51,51,2,49,6,2.538377987,99.1910235941,0.0096316738,0.288627451,0.519983,0,59,5.9542686241209616E-5,2.0324514E-5,2.0571053E-5,175,7,2,149,1,0.0067114094
1232470694,Khalin_McGiffen,10,37,19,167,0,0,17.9551159137,10-19,88,2,2,11,13,13,2,11,7,2.7295438088,0.1589415164,0.0011459913,0.2692307692,0.4909091,0,59,5.068844125121678E-5,2.0324514E-5,2.0571053E-5,25,0,0,48,0,0
1233036871,bcrussmo,10,23,28,234,0,25,31.6246375351,30-39,346,3,7,20,27,27,7,20,7,3.0897900072,116.3675874412,0.0052878839,0.1623931624,0.40238094,0,59,7.532770520753639E-5,5.4198706E-5,5.485614E-5,182,7,0,46,0,0
1234180500,StanMarshall8,10,71,27,121,0,1,26.6238069028,20-29,217,3,7,21,28,28,7,21,6,2.7146994931,24.7583626055,0.0121768579,0.1984126984,0.42885375,0,59,8.521811678059441E-5,5.4198706E-5,5.485614E-5,182,2,0,105,0,0
1237059938,TeamRevoltNow,10,4723,177,71,3,4,46.1539633465,40-49,610,9,30,11,41,41,30,11,7,3.0329471398,1842.5088038391,0.0185818841,0.0396341463,0.11827957,0,59,1.31624515511581E-4,2.1001999E-4,2.1256754E-4,77,6,0,222,0,0
1238329170,ScoMo68,10,82,5,43,0,0,34.556730397,30-39,483,4,0,1,1,1,0,1,7,3.7759681506,0,0,0,0,0,83,4.766339181938244E-5,0,6.8570175E-6,175,0,0,1,0,0
1239584623,tania_leonora,10,92,9,85,0,2,20.573957966,20-29,322,3,1,18,19,19,1,18,7,2.6708906589,0.0269816346,2.7641597006624057E-4,0.3888888889,0.64705884,0,59,4.809000532392957E-5,1.3549677E-5,1.3714035E-5,25,0,0,139,0,0
1239757610,CanConstitution,10,18,9,3,0,0,24.8040094374,20-29,293,0,1,3,4,4,1,3,7,3.2233888487,0.3660240183,3.037257349848907E-4,0.25,0.5,0,59,5.005217629447892E-5,1.3549677E-5,1.3714035E-5,175,0,0,51,0,0
1242439537,FilomenaFerraro,10,32,6,19,0,0,23.0746452114,20-29,86,2,0,2,2,2,0,2,7,3.226927253,0,0,0.5,0.5,0,705,4.766339181938244E-5,0,6.8570175E-6,182,0,0,32,0,0
1242788588,gharold3,10,5,1,9,0,0,14.9370856835,10-19,71,1,0,1,1,1,0,1,7,3.5946435034,0,0,0,0,0,74,4.766339181938244E-5,0,6.8570175E-6,175,0,0,7,0,0
1242985124,JessePewarchuk,10,25,15,37,0,0,22.9706227065,20-29,154,1,0,0,0,0,0,0,0,0,0,0,0,0,51,136,4.766339181938244E-5,0,0,45,0,0,28,0,0
1243862612,michel_loiselle,10,31,9,51,0,0,26.3729088672,20-29,186,1,0,2,2,2,0,2,7,3.7748823742,0,0,0,0,0,86,4.766339181938244E-5,0,6.8570175E-6,175,0,0,50,0,0
1245872196,astrinoertinsya,10,15,8,36,0,0,39.6312228843,30-39,473,4,0,0,0,0,0,0,0,0,0,0,0,0,74,170,4.766339181938244E-5,0,0,66,59,0,199,0,0
1247909665,FreezeFeesOn,10,50,11,22,0,3,12.8994027935,10-19,29,2,0,0,0,0,0,0,0,0,0,0,0,0,90,201,4.766339181938244E-5,0,0,81,4,0,69,0,0
1249794612,NDPInduNPD,10,6,10,6,0,0,22.7196314499,20-29,86,1,8,5,13,13,8,5,7,3.018826937,12.3761028002,0.0180802926,0.1346153846,0.5277778,0,59,1.2218597100567238E-4,6.0973543E-5,5.485614E-5,25,2,1,10,1,0.1
1250116735,ottawa_rt,10,5845,106,0,3,0,41.3578237281,40-49,532,9,8,0,8,8,8,0,0,0,0,0.0018789831,0.0714285714,0.071428575,0,5,1.2266660177567097E-4,6.0973543E-5,0,175,2,0,215,0,0
1250141665,halifaxns_rt,10,9004,180,0,6,0,40.9552232924,40-49,520,8,0,0,0,0,0,0,0,0,0,0,0,0,180,384,4.766339181938244E-5,0,0,180,1,0,205,0,0
1250146741,edmonton_rt,10,6473,109,0,2,0,36.6258516518,30-39,439,8,2,0,2,2,2,0,0,0,0,2.124349183375603E-4,0,0,0,34,5.720161440760698E-5,2.0324514E-5,0,175,0,2,201,2,0.0099502488
1250157301,quebec_rt,10,4715,63,0,0,0,38.6576306853,30-39,503,8,4,0,4,4,4,0,0,0,0,5.969955699358264E-4,0,0,0,24,7.02899322843204E-5,3.3874192E-5,0,175,1,1,213,1,0.0046948357
1252270711,MurielG6,10,22,26,209,0,0,21.7318132833,20-29,118,2,0,0,0,0,0,0,0,0,0,0,0,0,232,596,4.766339181938244E-5,0,0,236,0,0,30,0,0
1253549436,denise_kershner,10,148,26,220,0,6,24.1685451501,20-29,290,4,0,1,1,1,0,1,7,3.1132826638,0,0,0,0,0,655,4.766339181938244E-5,0,6.8570175E-6,77,2,0,200,0,0
1255273639,noYGKCasino,10,26,33,48,1,2,28.8914752588,20-29,312,2,7,10,17,17,7,10,7,3.000724113,95.8975936768,0.0066218175,0.0955882353,0.5222222,0,59,7.840714095680845E-5,5.4198706E-5,5.485614E-5,25,20,0,26,0,0
1255717705,ubcndp,10,6,6,64,0,0,35.0242426633,30-39,235,3,6,9,15,15,6,9,7,3.0231716148,42.358035774,0.0016663644,0.0380952381,0.16666667,0,59,6.529300786400647E-5,4.742387E-5,4.799912E-5,182,6,0,36,0,0
1255858122,GreenpeaceYEG,10,63,34,106,0,4,32.0996328813,30-39,260,3,2,3,5,5,2,3,7,3.0445329471,2984.4744047967,0.0019134638,0.1,0.33333334,0,59,6.38722822389279E-5,2.0324514E-5,2.0571053E-5,77,8,0,91,0,0
1257655196,anonGypsy,10,307,31,116,0,1,43.2626506991,40-49,532,5,1,2,3,3,1,2,7,3.1850108617,56.7075971924,8.812761348714236E-5,0,0,0,59,7.391386999546336E-5,1.3549677E-5,1.3714035E-5,77,5,0,200,0,0
1259539242,ReviveSSC,10,27,106,138,0,0,42.614159678,40-49,512,2,2,2,4,4,2,2,1,1,2,1.619561731312207E-4,0,0,67,157,4.6360358251326255E-4,2.0324514E-5,2.0571053E-5,59,11,0,60,0,0
1260243978,MulcairsBeard,10,10,2,10,0,0,11.0632857838,10-19,2,0,1,5,6,6,1,5,7,2.838884866,0.9269077648,0.0013096074,0.2,0.4,0,59,5.4654483413137206E-5,1.3549677E-5,1.3714035E-5,25,0,0,12,0,0
1262402966,cantbeeserious,10,42,4,18,0,0,22.905235186,20-29,186,3,1,4,5,5,1,4,7,3.1868211441,0.1015655614,0.0036251983,0.2,0.2,0,59,5.1343015620857445E-5,1.3549677E-5,1.3714035E-5,77,1,1,91,1,0.010989011
1262960174,coffeers,10,1769,52,0,0,0,44.1986608154,40-49,598,8,1,0,1,1,1,0,0,0,0,2.094310512059644E-4,0,0,0,58,4.926152597936347E-5,1.3549677E-5,0,175,0,0,201,0,0
1263738432,Test4Echoes,10,1,0,31,0,0,11.0632857838,10-19,2,2,1,38,39,39,1,38,7,2.6125995655,7.7976360856,8.954691059171172E-4,0.3333333333,0.47300944,0,59,5.0105976990949156E-5,1.3549677E-5,1.3714035E-5,25,0,1,22,1,0.0454545455
1264595090,BradenHutchinso,10,6,12,53,0,0,17.799891089,10-19,55,1,0,7,7,7,0,7,7,3.0492218603,0,0,0.2857142857,0.35714287,0,90,4.766339181938244E-5,0,6.8570175E-6,175,0,0,14,0,0
1264846567,LGNDP,10,20,27,125,0,0,33.7356245092,30-39,308,3,16,59,75,75,16,59,7,2.4724837075,1429.5647629473,0.0126776789,0.1691891892,0.3834015,0,59,1.2249229825950515E-4,1.1517225E-4,1.16569296E-4,25,19,0,57,0,0
1267034376,antpao6312,10,2,4,41,0,1,15.4395576876,10-19,116,2,0,0,0,0,0,0,0,0,0,0,0,0,6,69,4.766339181938244E-5,0,0,5,0,0,18,0,0
1268115974,LouiseAvery13,10,2,4,19,0,0,,,14,0,0,1,1,1,0,1,7,2.8668114368,0,0,0,0,0,627,4.766339181938244E-5,0,6.8570175E-6,25,0,0,2,0,0
1268250757,JillianLCurtin,10,2,4,13,0,0,14.1518828172,10-19,25,1,3,5,8,8,3,5,7,2.9348298335,3164.6945438266,9.85628705219148E-4,0.0892857143,0.35,0,59,7.951779905851463E-5,2.7099353E-5,2.742807E-5,77,0,0,11,0,0
1268953286,barry8ronald,10,0,0,14,0,0,,,0,0,0,1,1,1,0,1,8,3.6178067318,0,0,0,0,0,77,4.766339181938244E-5,0,6.8570175E-6,182,0,0,1,0,0
1269589020,gerrygoldsworth,10,5,2,43,0,0,12.0125759127,10-19,7,2,4,22,26,26,4,22,7,2.7404055033,67.8048217083,0.0035974503,0.2246153846,0.4387352,0,59,7.745814535429085E-5,3.3874192E-5,3.4285087E-5,147,0,0,202,0,0
1269887706,JorgeCanadiense,10,2,1,16,0,0,13.4896576879,10-19,42,1,0,0,0,0,0,0,0,0,0,0,0,0,2,65,4.766339181938244E-5,0,0,1,0,0,15,0,0
1272293930,Civitatem_Civis,10,7,2,30,0,1,24.3680667981,20-29,317,1,0,11,11,11,0,11,7,2.8414766558,0,0,0.3909090909,0.6454545,0,619,4.766339181938244E-5,0,6.8570175E-6,25,0,0,13,0,0
1272650227,ScareDeeCat2000,10,53,6,19,0,0,24.2228062601,20-29,276,3,0,2,2,2,0,2,7,3.2316322837,0,0,0.5,0.5,0,700,4.766339181938244E-5,0,6.8570175E-6,175,1,1,82,1,0.012195122
1273242876,dysseri,10,9,9,89,0,0,12.2285441559,10-19,19,2,1,9,10,10,1,9,7,2.7976104272,0.1714133212,0.004565401,0.2111111111,0.3611111,0,59,5.696947204984891E-5,1.3549677E-5,1.3714035E-5,25,0,0,31,0,0
1273382059,LaClaus85,10,194,29,196,0,11,28.2927784655,20-29,437,4,0,1,1,1,0,1,7,4.3571428571,0,0,0,0,42,439,4.766339181938244E-5,0,6.8570175E-6,197,2,0,200,0,0
1273559047,ReignFeral,10,22,2,13,0,0,42.8487866689,40-49,639,5,5,12,17,17,5,12,7,2.8537291818,20.2367979823,0.0046638941,0.125,0.1875,0,59,5.873720752714704E-5,4.064903E-5,3.4285087E-5,77,150,2,213,2,0.0093896714
1274297383,smiling_2002,10,5,0,175,0,0,10,10-19,0,2,0,0,0,0,0,0,0,0,0,0,0,0,7,70,4.766339181938244E-5,0,0,6,0,0,9,0,0
1274594959,muljba,10,526,66,275,0,137,46.965213994,40-49,674,6,0,1,1,1,0,1,7,4.3571428571,0,0,0,0,42,488,4.766339181938244E-5,0,6.8570175E-6,197,8,0,201,0,0
1275215894,JanineLexx,10,107,44,284,0,31,46.1868668588,40-49,568,4,8,20,28,28,8,20,6,2.734974656,59.3311519925,0.0077705916,0.1243386243,0.34415585,0,59,6.851260113962905E-5,6.0973543E-5,6.171316E-5,77,9,0,199,0,0
1275537583,groupenewton,10,62,21,386,0,0,31.2396657401,30-39,315,4,0,11,11,11,0,11,7,3.2468331524,0,0,0.1636363636,0.19090909,0,548,4.766339181938244E-5,0,6.8570175E-6,175,6,0,184,0,0
1275672991,MelanieMalb,10,7,5,12,0,0,28.4529031132,20-29,412,3,4,5,9,9,4,5,3,1.7777777778,6.1666666667,3.6067533095534145E-4,0.125,0.65,58,182,1.4459035318181178E-4,3.3874192E-5,3.4285087E-5,166,8,0,80,0,0
1276647637,otcimow,10,1710,139,467,1,699,55.7855244407,50-59,695,7,39,67,106,106,39,67,6,2.518102824,1761.1497147054,0.0336056193,0.0728661276,0.23219875,0,59,2.0037185300836357E-4,2.7099354E-4,2.742807E-4,77,156,0,205,0,0
1276931240,everythingyeg,10,262,21,174,0,2,43.2473053779,40-49,501,7,2,7,9,9,2,7,7,3.0510499638,355.756506172,0.001235642,0.0972222222,0.2857143,0,59,5.350949863312667E-5,2.0324514E-5,2.0571053E-5,175,2,0,200,0,0
1277092860,simoncott,10,79,25,241,1,20,30.7236705773,30-39,311,3,0,3,3,3,0,3,7,2.9833514296,0,0,0.3333333333,0.5,0,639,4.766339181938244E-5,0,6.8570175E-6,175,0,0,99,0,0
1277934066,ZombieLC,10,34,9,61,0,1,16.7231384364,10-19,87,1,0,2,2,2,0,2,7,3.4495114007,0,0,0,0,0,576,4.766339181938244E-5,0,6.8570175E-6,182,0,0,58,0,0
1278759175,TravisMB5,10,1,2,11,0,0,11.5576855183,10-19,4,1,0,1,1,1,0,1,1,1,0,0,0,0,0,207,4.766339181938244E-5,0,6.8570175E-6,25,0,0,7,0,0
1279462135,BrendaAnnB,10,15,9,132,0,1,16.8707649263,10-19,93,3,3,54,57,57,3,54,6,2.4612599566,12.1104589518,0.0024983865,0.2474937343,0.4007687,0,59,5.622739637598588E-5,2.7099353E-5,2.742807E-5,175,1,0,57,0,0
1283039702,move_GTHA,10,39,9,121,0,0,28.532688057,20-29,154,3,0,0,0,0,0,0,0,0,0,0,0,0,14,80,4.766339181938244E-5,0,0,13,0,0,1,0,0
1287167142,BrendanCalorie,10,37,8,50,0,0,16.7471707378,10-19,49,2,0,1,1,1,0,1,8,4.1643141513,0,0,0,0,0,605,4.766339181938244E-5,0,6.8570175E-6,175,0,0,52,0,0
1289312798,Antithesis_CB,10,2,2,27,0,0,14.7586477733,10-19,27,1,1,10,11,11,1,10,7,2.9011585807,9.0193740045,3.073833002155888E-4,0.2090909091,0.3888889,0,59,5.2130951925054486E-5,1.3549677E-5,1.3714035E-5,147,0,0,15,0,0
1289342136,SueSlean,10,29,12,30,0,0,25.4106721635,20-29,192,2,4,8,12,12,4,8,7,3.0003620565,4.2723897194,0.0014337364,0.1439393939,0.5535714,0,59,6.796900540681535E-5,3.3874192E-5,3.4285087E-5,182,7,2,33,1,0.0303030303
1292431874,anythingbutlibs,10,3,0,3,0,0,10,10-19,30,1,0,0,0,0,0,0,0,0,0,0,0,0,195,501,4.766339181938244E-5,0,0,199,0,0,5,0,0
1292584740,JasonMcGrawNB,10,3,0,19,0,0,10.6708586376,10-19,21,2,0,2,2,2,0,2,7,3.2935215346,0,0,0.5,0.5,0,572,4.766339181938244E-5,0,6.8570175E-6,182,0,0,27,0,0
1293099469,Pandemia_ANSIA,10,3,0,9,0,0,11.0632857838,10-19,107,3,0,1,1,1,0,1,7,4.3571428571,0,0,0,0,42,421,4.766339181938244E-5,0,6.8570175E-6,197,0,0,53,0,0
1294375350,siegfried_rives,10,37,2,17,0,1,23.7592993147,20-29,333,4,1,0,1,1,1,0,0,0,0,8.483361593107289E-5,0,0,0,44,6.365838266513032E-5,1.3549677E-5,0,145,4,0,201,0,0
1297903915,ZombieAFrack,10,16,20,171,1,0,35.3025012278,30-39,380,3,1,1,2,2,1,1,9,5.1263577118,0,9.332717723623285E-5,0,0,0,59,1.1874831691900532E-4,1.3549677E-5,1.3714035E-5,77,1,0,116,0,0
1298548159,eto771,10,2,0,6,0,0,10,10-19,0,0,0,0,0,0,0,0,0,0,0,0,0,0,207,526,4.766339181938244E-5,0,0,211,0,0,2,0,0
1298555100,lera_af_4481100,10,2,0,0,0,2,10,10-19,0,0,0,0,0,0,0,0,0,0,0,0,0,0,208,527,4.766339181938244E-5,0,0,212,0,0,2,0,0
1298577012,vadim_ro_075951,10,2,0,0,0,1,10,10-19,0,0,0,0,0,0,0,0,0,0,0,0,0,0,209,528,4.766339181938244E-5,0,0,213,0,0,6,0,0
1298580552,lena_la_5256382,10,3,0,0,0,1,10,10-19,10,0,0,0,0,0,0,0,0,0,0,0,0,0,210,529,4.766339181938244E-5,0,0,214,0,0,2,0,0
1298692566,olga_go_7481477,10,2,0,0,0,2,10,10-19,0,0,0,0,0,0,0,0,0,0,0,0,0,0,211,530,4.766339181938244E-5,0,0,215,0,0,201,0,0
1298696424,3f127riejuzji91,10,0,0,0,0,2,10,10-19,0,0,0,0,0,0,0,0,0,0,0,0,0,0,15,81,4.766339181938244E-5,0,0,14,0,0,1,0,0
1298711894,julija_is_22988,10,4,0,0,0,0,10,10-19,10,0,0,0,0,0,0,0,0,0,0,0,0,0,212,531,4.766339181938244E-5,0,0,216,0,0,4,0,0
1298749087,oleg_dm_8857434,10,1,0,0,0,1,10,10-19,0,0,0,0,0,0,0,0,0,0,0,0,0,0,16,82,4.766339181938244E-5,0,0,15,0,0,1,0,0
1298759239,vlad_af_7231101,10,3,0,0,0,0,10,10-19,0,0,0,0,0,0,0,0,0,0,0,0,0,0,213,532,4.766339181938244E-5,0,0,217,0,0,8,0,0
1298763265,nina_go_6542410,10,2,0,0,0,0,10,10-19,0,0,0,0,0,0,0,0,0,0,0,0,0,0,214,533,4.766339181938244E-5,0,0,218,0,0,2,0,0
1301486268,4thebirdiez,10,11,2,116,0,0,22.6780844369,20-29,90,3,0,44,44,44,0,44,6,2.4715888527,0,0,0.3525369979,0.5808668,0,678,4.766339181938244E-5,0,6.8570175E-6,175,0,0,27,0,0
1304352698,GarrettBawn,10,4,1,15,0,0,10.6708586376,10-19,1,1,0,3,3,3,0,3,7,3.1715526602,0,0,0.1666666667,0.33333334,0,580,4.766339181938244E-5,0,6.8570175E-6,25,0,0,9,0,0
1308946423,NPrometheus,10,1,0,13,0,0,44.8276644316,40-49,220,1,4,0,4,4,4,0,0,0,0,0.0038816079,0,0,0,30,5.7817159695317055E-5,3.3874192E-5,0,25,11,0,22,0,0
1310794578,justwatchmeCA,10,1,0,14,0,0,10,10-19,0,0,0,5,5,5,0,5,7,3.2363373145,0,0,0.25,0.25,0,84,4.766339181938244E-5,0,6.8570175E-6,175,0,0,1,0,0
1311844063,mo4change,10,3,0,78,0,0,21.0930252175,20-29,145,2,9,23,32,32,9,23,6,2.7610427227,738.5484872155,0.0034350641,0.0786290323,0.2173913,0,59,9.851808613903789E-5,6.7748384E-5,6.8570174E-5,25,4,0,8,0,0
1312540015,adamweaverURF,10,2,0,11,0,0,10,10-19,1,0,0,5,5,5,0,5,7,2.8280854144,0,0,0.3,0.35,0,708,4.766339181938244E-5,0,6.8570175E-6,25,0,0,5,0,0
